TransactionID,CustomerID,TransactionDate,Amount,TransactionType,Description,UpdatedBalance
1,708134283,1-29-24 19:28,27.03,Purchase,Pharmacy,318.8895352
2,708134283,02-05-24 21:28,2700,IncomingTransfer,Salary,3018.889535
3,708134283,02-10-24 21:28,900,Payment,Credit Card Payment,2118.889535
4,708134283,02-11-24 10:28,52.13,Withdrawal,ATM Withdrawal,2066.759535
5,708134283,2-18-24 11:28,146.98,OutgoingTransfer,Wire Transfer,1919.779535
6,708134283,2-18-24 21:28,900,Payment,Subscription Payment,1019.779535
7,708134283,2-21-24 15:28,40.69,Deposit,Mobile Deposit,1060.469535
8,708134283,2-29-24 23:28,140.45,Purchase,Clothing,920.0195352
9,708134283,03-04-24 21:28,2700,IncomingTransfer,Salary,3620.019535
10,708134283,03-09-24 21:28,800,Payment,Credit Card Payment,2820.019535
11,708134283,03-09-24 22:28,216.01,Return,Target Return,3036.029535
12,708134283,03-11-24 21:28,1000,Payment,Subscription Payment,2036.029535
13,708134283,3-13-24 12:28,185.02,OnlineShopping,Amazon,1851.009535
14,708134283,3-22-24 17:28,96.39,Withdrawal,ATM Withdrawal,1754.619535
15,708134283,3-27-24 20:28,98.29,Withdrawal,ATM Withdrawal,1656.329535
16,708134283,3-31-24 12:28,72.32,Deposit,Mobile Deposit,1728.649535
17,708134283,04-04-24 21:28,2700,IncomingTransfer,Salary,4428.649535
18,708134283,04-06-24 12:28,31.38,Deposit,Direct Deposit,4460.029535
19,708134283,04-09-24 21:28,800,Payment,Credit Card Payment,3660.029535
20,708134283,4-15-24 21:28,700,Payment,Installment Payment,2960.029535
21,708134283,4-23-24 14:28,33.27,Return,Best Buy Return,2993.299535
22,708134283,05-01-24 23:28,149.81,Purchase,Home Improvement,2843.489535
23,708134283,05-05-24 21:28,2700,IncomingTransfer,Salary,5543.489535
24,708134283,05-06-24 10:28,35.34,OnlineShopping,AliExpress,5508.149535
25,708134283,05-07-24 19:28,67.14,Purchase,Home Improvement,5441.009535
26,708134283,05-10-24 21:28,900,Payment,Credit Card Payment,4541.009535
27,708134283,5-14-24 21:28,1000,Payment,Installment Payment,3541.009535
28,708134283,5-15-24 18:28,64.2,Purchase,Entertainment,3476.809535
29,708134283,5-21-24 11:28,193.73,Withdrawal,Mobile App Withdrawal,3283.079535
30,708134283,5-26-24 12:28,173.64,Payment,Bill Payment,3109.439535
31,708134283,5-29-24 13:28,27.12,Return,Etsy Return,3136.559535
32,708134283,06-01-24 20:28,97.7,Deposit,Direct Deposit,3234.259535
33,708134283,06-02-24 21:28,2700,IncomingTransfer,Salary,5934.259535
34,708134283,06-04-24 10:28,118.31,Payment,Loan Payment,5815.949535
35,708134283,06-07-24 21:28,900,Payment,Credit Card Payment,4915.949535
36,708134283,06-11-24 21:28,56.58,Payment,Bill Payment,4859.369535
37,708134283,06-12-24 21:28,1000,Payment,Insurance Payment,3859.369535
38,708134283,6-13-24 18:28,147.63,OutgoingTransfer,Bank Transfer,3711.739535
39,708134283,6-21-24 15:28,64.78,OnlineShopping,Best Buy,3646.959535
40,708134283,6-24-24 16:28,150.79,Deposit,Direct Deposit,3797.749535
41,708134283,6-30-24 19:28,75.32,Withdrawal,Branch Withdrawal,3722.429535
42,708134283,6-30-24 21:28,132.66,OnlineShopping,Walmart,3589.769535
43,708134283,07-02-24 21:28,2700,IncomingTransfer,Salary,6289.769535
44,708134283,07-03-24 20:28,84.29,OnlineShopping,AliExpress,6205.479535
45,708134283,07-07-24 21:28,900,Payment,Credit Card Payment,5305.479535
46,708134283,07-08-24 19:28,235.56,Withdrawal,ATM Withdrawal,5069.919535
47,708134283,07-11-24 14:28,183.78,Deposit,Mobile Deposit,5253.699535
48,708134283,7-16-24 21:28,800,Payment,Insurance Payment,4453.699535
49,708134283,7-17-24 14:28,243.63,Purchase,Furniture,4210.069535
50,708147108,1-20-24 14:28,218.39,Payment,Mortgage Payment,1049.767445
51,708147108,1-27-24 10:28,359.05,OnlineShopping,Best Buy,690.7174454
52,708147108,1-29-24 10:28,12.17,Purchase,Clothing,678.5474454
53,708147108,02-02-24 21:28,7900,IncomingTransfer,Salary,8578.547445
54,708147108,02-03-24 22:28,86.25,Payment,Loan Payment,8492.297445
55,708147108,02-04-24 20:28,209.44,Withdrawal,Mobile App Withdrawal,8282.857445
56,708147108,02-06-24 16:28,217.63,Deposit,Direct Deposit,8500.487445
57,708147108,02-07-24 17:28,217.06,Deposit,Direct Deposit,8717.547445
58,708147108,02-07-24 21:28,3000,Payment,Credit Card Payment,5717.547445
59,708147108,02-08-24 13:28,217.72,Deposit,Check Deposit,5935.267445
60,708147108,02-10-24 21:28,2400,Payment,Rent Payment,3535.267445
61,708147108,02-11-24 21:28,67.94,Purchase,Home Improvement,3467.327445
62,708147108,02-12-24 11:28,211.58,Deposit,Mobile Deposit,3678.907445
63,708147108,2-15-24 19:28,110.32,Purchase,Grocery,3568.587445
64,708147108,2-15-24 20:28,480.03,Deposit,Mobile Deposit,4048.617445
65,708147108,2-15-24 22:28,214.47,Deposit,Mobile Deposit,4263.087445
66,708147108,2-17-24 13:28,277.38,Return,eBay Return,4540.467445
67,708147108,2-19-24 23:28,180.79,OutgoingTransfer,International Transfer,4359.677445
68,708147108,2-25-24 20:28,303.78,Deposit,Direct Deposit,4663.457445
69,708147108,2-27-24 13:28,276.94,Payment,Loan Payment,4386.517445
70,708147108,2-29-24 15:28,183.29,Payment,Bill Payment,4203.227445
71,708147108,03-02-24 21:28,7900,IncomingTransfer,Salary,12103.22745
72,708147108,03-04-24 20:28,446.51,Deposit,Direct Deposit,12549.73745
73,708147108,03-05-24 15:28,133.93,Purchase,Entertainment,12415.80745
74,708147108,03-05-24 16:28,92.12,Purchase,Furniture,12323.68745
75,708147108,03-07-24 21:28,3200,Payment,Credit Card Payment,9123.687445
76,708147108,03-09-24 21:28,428.9,Purchase,Gas,8694.787445
77,708147108,3-13-24 12:28,153.94,Return,Target Return,8848.727445
78,708147108,3-13-24 13:28,170.65,Purchase,Travel,8678.077445
79,708147108,3-13-24 14:28,455.75,IncomingTransfer,Freelance Payment,9133.827445
80,708147108,3-14-24 21:28,2400,Payment,Rent Payment,6733.827445
81,708147108,3-20-24 16:28,423.94,Withdrawal,Branch Withdrawal,6309.887445
82,708147108,3-21-24 13:28,38.94,OnlineShopping,Etsy,6270.947445
83,708147108,3-23-24 22:28,351.93,Return,Walmart Return,6622.877445
84,708147108,3-28-24 11:28,101.04,Return,Target Return,6723.917445
85,708147108,3-28-24 12:28,60.3,Return,Amazon Return,6784.217445
86,708147108,3-28-24 14:28,234.02,Return,Etsy Return,7018.237445
87,708147108,04-04-24 21:28,7900,IncomingTransfer,Salary,14918.23745
88,708147108,04-05-24 20:28,184.1,Deposit,Cash Deposit,15102.33745
89,708147108,04-09-24 21:28,3300,Payment,Credit Card Payment,11802.33745
90,708147108,04-09-24 22:28,367.24,Payment,Loan Payment,11435.09745
91,708147108,04-10-24 9:28,341.12,Deposit,Direct Deposit,11776.21745
92,708147108,04-11-24 16:28,120.37,Return,Target Return,11896.58745
93,708147108,4-14-24 16:28,305.65,OutgoingTransfer,Wire Transfer,11590.93745
94,708147108,4-15-24 13:28,119.41,OnlineShopping,Target,11471.52745
95,708147108,4-15-24 21:28,2000,Payment,Rent Payment,9471.527445
96,708147108,4-19-24 10:28,170.72,Return,eBay Return,9642.247445
97,708147108,4-28-24 17:28,172.99,Deposit,Cash Deposit,9815.237445
98,708147108,4-29-24 13:28,492.65,Payment,Loan Payment,9322.587445
99,708147108,4-29-24 20:28,269.05,Withdrawal,Mobile App Withdrawal,9053.537445
100,708147108,4-30-24 15:28,410.53,Deposit,Mobile Deposit,9464.067445
101,708147108,4-30-24 20:28,134.44,OutgoingTransfer,Peer-to-Peer Transfer,9329.627445
102,708147108,05-01-24 14:28,165.15,Withdrawal,Mobile App Withdrawal,9164.477445
103,708147108,05-01-24 21:28,7900,IncomingTransfer,Salary,17064.47745
104,708147108,05-01-24 23:28,53.92,Withdrawal,Mobile App Withdrawal,17010.55745
105,708147108,05-02-24 16:28,71.81,Deposit,Direct Deposit,17082.36745
106,708147108,05-06-24 21:28,3500,Payment,Credit Card Payment,13582.36745
107,708147108,05-08-24 9:28,206.87,Purchase,Furniture,13375.49745
108,708147108,05-08-24 23:28,153.73,Deposit,Cash Deposit,13529.22745
109,708147108,05-10-24 21:28,4300,Payment,Rent Payment,9229.227445
110,708147108,5-14-24 18:28,347.1,Purchase,Travel,8882.127445
111,708147108,5-17-24 18:28,126.71,Purchase,Pharmacy,8755.417445
112,708147108,5-17-24 21:28,224.81,Return,Target Return,8980.227445
113,708147108,5-25-24 14:28,428.12,Deposit,Mobile Deposit,9408.347445
114,708147108,5-31-24 14:28,202.31,Withdrawal,Branch Withdrawal,9206.037445
115,708147108,06-01-24 11:28,194.81,Deposit,Mobile Deposit,9400.847445
116,708147108,06-04-24 21:28,7900,IncomingTransfer,Salary,17300.84745
117,708147108,06-04-24 21:28,68.94,Deposit,Mobile Deposit,17369.78745
118,708147108,06-06-24 19:28,12.26,OnlineShopping,AliExpress,17357.52745
119,708147108,06-09-24 21:28,2600,Payment,Credit Card Payment,14757.52745
120,708147108,06-10-24 23:28,157.65,Deposit,Cash Deposit,14915.17745
121,708147108,06-11-24 21:28,3200,Payment,Rent Payment,11715.17745
122,708147108,06-12-24 22:28,87.72,OnlineShopping,Etsy,11627.45745
123,708147108,6-16-24 15:28,377.79,OnlineShopping,eBay,11249.66745
124,708147108,6-18-24 11:28,35.15,Deposit,Cash Deposit,11284.81745
125,708147108,6-23-24 12:28,306.84,OnlineShopping,AliExpress,10977.97745
126,708147108,6-25-24 14:28,293.55,OutgoingTransfer,International Transfer,10684.42745
127,708147108,6-27-24 19:28,493.68,Payment,Loan Payment,10190.74745
128,708147108,6-29-24 19:28,332.46,Return,eBay Return,10523.20745
129,708147108,07-02-24 12:28,240.89,Deposit,Mobile Deposit,10764.09745
130,708147108,07-02-24 21:28,7900,IncomingTransfer,Salary,18664.09745
131,708147108,07-04-24 19:28,105.13,Withdrawal,Mobile App Withdrawal,18558.96745
132,708147108,07-05-24 16:28,346.34,Deposit,Cash Deposit,18905.30745
133,708147108,07-07-24 21:28,3600,Payment,Credit Card Payment,15305.30745
134,708147108,07-09-24 9:28,89.67,Purchase,Restaurant,15215.63745
135,708147108,07-12-24 14:28,300.09,IncomingTransfer,Freelance Payment,15515.72745
136,708147108,07-12-24 21:28,2400,Payment,Rent Payment,13115.72745
137,708147108,7-13-24 20:28,491.8,Payment,Bill Payment,12623.92745
138,708147108,7-17-24 18:28,246.09,OnlineShopping,Etsy,12377.83745
139,708177333,1-24-24 21:28,248.42,IncomingTransfer,Freelance Payment,2453.304644
140,708177333,1-29-24 21:28,89.9,IncomingTransfer,Freelance Payment,2543.204644
141,708177333,02-04-24 21:28,2250,IncomingTransfer,Salary,4793.204644
142,708177333,02-09-24 21:28,3600,Payment,Credit Card Payment,1193.204644
143,708177333,02-10-24 15:28,82.45,Withdrawal,Mobile App Withdrawal,1110.754644
144,708177333,2-15-24 14:28,30.17,OutgoingTransfer,Bank Transfer,1080.584644
145,708177333,2-16-24 21:28,1400,Payment,Rent Payment,-319.4153561
146,708177333,2-20-24 11:28,245.46,Return,Amazon Return,-73.95535608
147,708177333,2-26-24 18:28,129.5,Deposit,Check Deposit,55.54464392
148,708177333,2-27-24 18:28,140.55,OnlineShopping,eBay,-85.00535608
149,708177333,2-29-24 10:28,243.44,OutgoingTransfer,Wire Transfer,-328.4453561
150,708177333,03-01-24 12:28,234.46,IncomingTransfer,Freelance Payment,-93.98535608
151,708177333,03-03-24 21:28,2250,IncomingTransfer,Salary,2156.014644
152,708177333,03-04-24 13:28,125.19,OnlineShopping,AliExpress,2030.824644
153,708177333,03-08-24 21:28,3600,Payment,Credit Card Payment,-1569.175356
154,708177333,03-10-24 21:28,600,Payment,Rent Payment,-2169.175356
155,708177333,3-14-24 10:28,212.13,OnlineShopping,Etsy,-2381.305356
156,708177333,3-20-24 12:28,125.95,IncomingTransfer,Freelance Payment,-2255.355356
157,708177333,3-22-24 14:28,81.2,OutgoingTransfer,Peer-to-Peer Transfer,-2336.555356
158,708177333,3-26-24 23:28,168.25,Withdrawal,Mobile App Withdrawal,-2504.805356
159,708177333,04-03-24 21:28,2250,IncomingTransfer,Salary,-254.8053561
160,708177333,04-08-24 9:28,189.23,Deposit,Check Deposit,-65.57535608
161,708177333,04-08-24 21:28,2700,Payment,Credit Card Payment,-2765.575356
162,708177333,04-10-24 21:28,1000,Payment,Rent Payment,-3765.575356
163,708177333,4-15-24 21:28,24,Deposit,Cash Deposit,-3741.575356
164,708177333,4-26-24 17:28,115.74,Deposit,Cash Deposit,-3625.835356
165,708177333,4-26-24 22:28,92.47,Purchase,Clothing,-3718.305356
166,708177333,4-30-24 16:28,214.68,Payment,Mortgage Payment,-3932.985356
167,708177333,05-04-24 21:28,2250,IncomingTransfer,Salary,-1682.985356
168,708177333,05-09-24 21:28,3200,Payment,Credit Card Payment,-4882.985356
169,708177333,5-13-24 17:28,48.21,Payment,Mortgage Payment,-4931.195356
170,708177333,5-14-24 21:28,1100,Payment,Rent Payment,-6031.195356
171,708177333,06-04-24 21:28,2250,IncomingTransfer,Salary,-3781.195356
172,708177333,06-05-24 21:28,188.49,Withdrawal,Branch Withdrawal,-3969.685356
173,708177333,06-09-24 21:28,3600,Payment,Credit Card Payment,-7569.685356
174,708177333,06-11-24 21:28,1300,Payment,Rent Payment,-8869.685356
175,708177333,6-15-24 17:28,109.3,Deposit,Mobile Deposit,-8760.385356
176,708177333,6-15-24 19:28,112.72,Payment,Mortgage Payment,-8873.105356
177,708177333,6-24-24 11:28,98.71,Purchase,Pharmacy,-8971.815356
178,708177333,07-01-24 21:28,2250,IncomingTransfer,Salary,-6721.815356
179,708177333,07-05-24 17:28,107.25,Purchase,Pharmacy,-6829.065356
180,708177333,07-06-24 19:28,176.67,Purchase,Home Improvement,-7005.735356
181,708177333,07-06-24 21:28,3600,Payment,Credit Card Payment,-10605.73536
182,708177333,07-10-24 21:28,1400,Payment,Rent Payment,-12005.73536
183,708242283,1-26-24 10:28,281.66,Purchase,Travel,-281.66
184,708242283,1-26-24 15:28,78.98,OutgoingTransfer,Wire Transfer,-360.64
185,708242283,1-26-24 18:28,106.82,Purchase,Home Improvement,-467.46
186,708242283,1-28-24 15:28,152.01,Deposit,Cash Deposit,-315.45
187,708242283,1-28-24 22:28,295.84,Payment,Loan Payment,-611.29
188,708242283,02-04-24 13:28,536.92,Purchase,Travel,-1148.21
189,708242283,02-04-24 21:28,5750,IncomingTransfer,Salary,4601.79
190,708242283,02-06-24 12:28,398.11,IncomingTransfer,Freelance Payment,4999.9
191,708242283,02-06-24 23:28,513.25,Withdrawal,Branch Withdrawal,4486.65
192,708242283,02-09-24 12:28,543.07,Withdrawal,Branch Withdrawal,3943.58
193,708242283,2-13-24 21:28,3600,Payment,Rent Payment,343.58
194,708242283,2-14-24 12:28,428.5,Purchase,Clothing,-84.92
195,708242283,2-14-24 12:28,364.23,Payment,Bill Payment,-449.15
196,708242283,2-15-24 21:28,254.42,IncomingTransfer,Freelance Payment,-194.73
197,708242283,2-21-24 17:28,431.06,Return,Target Return,236.33
198,708242283,2-29-24 11:28,99.16,OnlineShopping,eBay,137.17
199,708242283,03-01-24 12:28,531.08,Deposit,Check Deposit,668.25
200,708242283,03-01-24 17:28,483.88,Deposit,Mobile Deposit,1152.13
201,708242283,03-01-24 21:28,5750,IncomingTransfer,Salary,6902.13
202,708242283,03-02-24 17:28,156.22,Withdrawal,Mobile App Withdrawal,6745.91
203,708242283,03-05-24 9:28,497.23,OnlineShopping,Etsy,6248.68
204,708242283,03-05-24 20:28,328.5,Deposit,Check Deposit,6577.18
205,708242283,03-09-24 16:28,152.24,Return,eBay Return,6729.42
206,708242283,03-11-24 13:28,469.41,IncomingTransfer,Freelance Payment,7198.83
207,708242283,3-14-24 21:28,2700,Payment,Rent Payment,4498.83
208,708242283,3-15-24 16:28,334.34,Return,Store Return,4833.17
209,708242283,3-20-24 23:28,540.64,Purchase,Gas,4292.53
210,708242283,3-21-24 11:28,118.98,Deposit,Check Deposit,4411.51
211,708242283,3-21-24 14:28,213.16,Withdrawal,Branch Withdrawal,4198.35
212,708242283,3-31-24 19:28,369.17,Withdrawal,ATM Withdrawal,3829.18
213,708242283,04-02-24 17:28,540.76,Purchase,Entertainment,3288.42
214,708242283,04-02-24 21:28,5750,IncomingTransfer,Salary,9038.42
215,708242283,04-09-24 17:28,393.47,Withdrawal,Mobile App Withdrawal,8644.95
216,708242283,04-12-24 21:28,3000,Payment,Rent Payment,5644.95
217,708242283,4-13-24 17:28,179.1,IncomingTransfer,Freelance Payment,5824.05
218,708242283,4-16-24 10:28,338.39,Purchase,Electronics,5485.66
219,708242283,4-18-24 22:28,152.29,Withdrawal,Mobile App Withdrawal,5333.37
220,708242283,4-20-24 10:28,162.18,OnlineShopping,eBay,5171.19
221,708242283,4-20-24 12:28,171.66,OnlineShopping,Best Buy,4999.53
222,708242283,4-20-24 13:28,485.71,Withdrawal,Mobile App Withdrawal,4513.82
223,708242283,4-22-24 18:28,147.91,OutgoingTransfer,Bank Transfer,4365.91
224,708242283,4-22-24 23:28,265.78,Deposit,Direct Deposit,4631.69
225,708242283,4-23-24 10:28,162.46,OnlineShopping,Etsy,4469.23
226,708242283,4-29-24 13:28,214.06,Withdrawal,ATM Withdrawal,4255.17
227,708242283,4-29-24 20:28,268.33,Deposit,Mobile Deposit,4523.5
228,708242283,05-01-24 18:28,210.68,Deposit,Direct Deposit,4734.18
229,708242283,05-02-24 21:28,5750,IncomingTransfer,Salary,10484.18
230,708242283,05-04-24 21:28,142.08,Deposit,Direct Deposit,10626.26
231,708242283,05-05-24 10:28,102.01,OutgoingTransfer,Bank Transfer,10524.25
232,708242283,05-08-24 18:28,355.29,OutgoingTransfer,Bank Transfer,10168.96
233,708242283,05-08-24 21:28,447.58,Purchase,Furniture,9721.38
234,708242283,05-09-24 12:28,433.06,Withdrawal,ATM Withdrawal,9288.32
235,708242283,05-09-24 13:28,490.45,Purchase,Pharmacy,8797.87
236,708242283,05-10-24 15:28,530.83,Payment,Bill Payment,8267.04
237,708242283,05-10-24 16:28,198.91,Purchase,Pharmacy,8068.13
238,708242283,05-10-24 22:28,301.43,Return,Walmart Return,8369.56
239,708242283,5-14-24 19:28,243.75,Payment,Mortgage Payment,8125.81
240,708242283,5-17-24 11:28,534.31,Deposit,Direct Deposit,8660.12
241,708242283,5-17-24 21:28,3400,Payment,Rent Payment,5260.12
242,708242283,5-18-24 20:28,438.67,OutgoingTransfer,Bank Transfer,4821.45
243,708242283,5-24-24 9:28,196.68,OutgoingTransfer,Peer-to-Peer Transfer,4624.77
244,708242283,5-24-24 18:28,324.53,Deposit,Mobile Deposit,4949.3
245,708242283,5-26-24 21:28,522.73,Payment,Mortgage Payment,4426.57
246,708242283,5-29-24 19:28,52.98,Withdrawal,ATM Withdrawal,4373.59
247,708242283,5-31-24 9:28,419.66,Purchase,Travel,3953.93
248,708242283,06-02-24 15:28,226.05,Deposit,Mobile Deposit,4179.98
249,708242283,06-03-24 21:28,5750,IncomingTransfer,Salary,9929.98
250,708242283,06-05-24 12:28,508.34,Withdrawal,Mobile App Withdrawal,9421.64
251,708242283,06-05-24 20:28,290.74,Withdrawal,Branch Withdrawal,9130.9
252,708242283,06-08-24 19:28,152.11,Purchase,Furniture,8978.79
253,708242283,06-09-24 13:28,87.26,Return,Amazon Return,9066.05
254,708242283,06-10-24 18:28,120.33,Purchase,Travel,8945.72
255,708242283,06-11-24 11:28,475.24,Withdrawal,ATM Withdrawal,8470.48
256,708242283,06-11-24 12:28,473.86,Deposit,Direct Deposit,8944.34
257,708242283,06-11-24 21:28,2700,Payment,Rent Payment,6244.34
258,708242283,06-12-24 11:28,209.26,Purchase,Travel,6035.08
259,708242283,6-17-24 16:28,250.43,OutgoingTransfer,International Transfer,5784.65
260,708242283,6-21-24 11:28,435.48,OnlineShopping,eBay,5349.17
261,708242283,6-23-24 19:28,206.11,Payment,Loan Payment,5143.06
262,708242283,6-25-24 10:28,180.16,Withdrawal,ATM Withdrawal,4962.9
263,708242283,6-27-24 9:28,433.39,Return,Store Return,5396.29
264,708242283,6-29-24 15:28,212.93,Withdrawal,Mobile App Withdrawal,5183.36
265,708242283,07-02-24 11:28,425.02,Return,Etsy Return,5608.38
266,708242283,07-02-24 18:28,105.03,Purchase,Gas,5503.35
267,708242283,07-04-24 21:28,5750,IncomingTransfer,Salary,11253.35
268,708242283,07-07-24 15:28,137.52,Withdrawal,Branch Withdrawal,11115.83
269,708242283,07-07-24 21:28,380.42,Withdrawal,Mobile App Withdrawal,10735.41
270,708242283,07-09-24 23:28,148.92,Return,Best Buy Return,10884.33
271,708242283,07-10-24 10:28,478.69,Return,AliExpress Return,11363.02
272,708242283,07-10-24 20:28,288.22,OutgoingTransfer,International Transfer,11074.8
273,708242283,7-13-24 11:28,420.5,Withdrawal,ATM Withdrawal,10654.3
274,708242283,7-16-24 21:28,2000,Payment,Rent Payment,8654.3
275,708249708,1-20-24 16:28,53.36,Payment,Loan Payment,1349.694508
276,708249708,1-21-24 11:28,226.85,Withdrawal,Branch Withdrawal,1122.844508
277,708249708,1-26-24 13:28,71.12,Purchase,Travel,1051.724508
278,708249708,1-27-24 14:28,66.35,Deposit,Direct Deposit,1118.074508
279,708249708,1-28-24 17:28,207.41,Purchase,Home Improvement,910.6645084
280,708249708,1-29-24 15:28,187.1,Return,Target Return,1097.764508
281,708249708,02-05-24 21:28,2750,IncomingTransfer,Salary,3847.764508
282,708249708,02-06-24 22:28,103.66,Withdrawal,Mobile App Withdrawal,3744.104508
283,708249708,02-10-24 21:28,2200,Payment,Credit Card Payment,1544.104508
284,708249708,2-15-24 14:28,124.83,Return,AliExpress Return,1668.934508
285,708249708,2-16-24 21:28,800,Payment,Rent Payment,868.9345084
286,708249708,2-22-24 9:28,198.93,OnlineShopping,Target,670.0045084
287,708249708,2-23-24 12:28,94.59,Purchase,Furniture,575.4145084
288,708249708,2-27-24 10:28,181.7,Purchase,Clothing,393.7145084
289,708249708,03-02-24 21:28,2750,IncomingTransfer,Salary,3143.714508
290,708249708,03-07-24 21:28,2100,Payment,Credit Card Payment,1043.714508
291,708249708,03-10-24 21:28,900,Payment,Rent Payment,143.7145084
292,708249708,03-11-24 13:28,57.24,Withdrawal,Branch Withdrawal,86.47450835
293,708249708,03-12-24 19:28,28.15,Purchase,Gas,58.32450835
294,708249708,3-14-24 9:28,153.36,Purchase,Grocery,-95.03549165
295,708249708,3-17-24 19:28,85.13,IncomingTransfer,Freelance Payment,-9.905491649
296,708249708,3-18-24 19:28,108.45,OutgoingTransfer,Wire Transfer,-118.3554916
297,708249708,04-01-24 21:28,2750,IncomingTransfer,Salary,2631.644508
298,708249708,04-04-24 17:28,59.96,Withdrawal,ATM Withdrawal,2571.684508
299,708249708,04-06-24 21:28,1900,Payment,Credit Card Payment,671.6845084
300,708249708,04-08-24 11:28,75.59,OnlineShopping,eBay,596.0945084
301,708249708,04-09-24 17:28,79.9,Payment,Mortgage Payment,516.1945084
302,708249708,4-13-24 11:28,37.87,Deposit,Check Deposit,554.0645084
303,708249708,4-13-24 22:28,77.79,Return,AliExpress Return,631.8545084
304,708249708,4-15-24 21:28,800,Payment,Rent Payment,-168.1454916
305,708249708,4-15-24 22:28,239.59,Withdrawal,Mobile App Withdrawal,-407.7354916
306,708249708,4-16-24 15:28,238.1,Deposit,Cash Deposit,-169.6354916
307,708249708,4-17-24 16:28,39.35,Purchase,Furniture,-208.9854916
308,708249708,4-19-24 20:28,221.9,Purchase,Home Improvement,-430.8854916
309,708249708,4-20-24 10:28,204.01,Payment,Mortgage Payment,-634.8954916
310,708249708,4-20-24 11:28,62.87,OutgoingTransfer,International Transfer,-697.7654916
311,708249708,4-29-24 22:28,191.31,Deposit,Cash Deposit,-506.4554916
312,708249708,05-01-24 21:28,2750,IncomingTransfer,Salary,2243.544508
313,708249708,05-06-24 21:28,2200,Payment,Credit Card Payment,43.54450835
314,708249708,05-09-24 16:28,247.39,Payment,Loan Payment,-203.8454916
315,708249708,05-09-24 20:28,249.87,Deposit,Mobile Deposit,46.02450835
316,708249708,5-13-24 14:28,59.01,Deposit,Cash Deposit,105.0345084
317,708249708,5-14-24 12:28,50.08,Purchase,Restaurant,54.95450835
318,708249708,5-14-24 19:28,107.87,Deposit,Mobile Deposit,162.8245084
319,708249708,5-15-24 21:28,1700,Payment,Rent Payment,-1537.175492
320,708249708,5-15-24 21:28,90.53,Purchase,Entertainment,-1627.705492
321,708249708,5-24-24 9:28,97.09,IncomingTransfer,Freelance Payment,-1530.615492
322,708249708,5-24-24 18:28,217.21,IncomingTransfer,Freelance Payment,-1313.405492
323,708249708,5-26-24 16:28,173.5,Return,Amazon Return,-1139.905492
324,708249708,5-28-24 15:28,102.24,Return,AliExpress Return,-1037.665492
325,708249708,5-31-24 21:28,139.42,OnlineShopping,Walmart,-1177.085492
326,708249708,06-01-24 19:28,247.91,Payment,Loan Payment,-1424.995492
327,708249708,06-02-24 12:28,243.36,Deposit,Check Deposit,-1181.635492
328,708249708,06-04-24 16:28,76.74,Withdrawal,Mobile App Withdrawal,-1258.375492
329,708249708,06-04-24 21:28,2750,IncomingTransfer,Salary,1491.624508
330,708249708,06-09-24 21:28,1900,Payment,Credit Card Payment,-408.3754916
331,708249708,06-11-24 21:28,700,Payment,Rent Payment,-1108.375492
332,708249708,07-04-24 16:28,111.54,IncomingTransfer,Freelance Payment,-996.8354916
333,708249708,07-05-24 21:28,2750,IncomingTransfer,Salary,1753.164508
334,708249708,07-06-24 11:28,233.68,OnlineShopping,Etsy,1519.484508
335,708249708,07-08-24 9:28,225.88,Purchase,Pharmacy,1293.604508
336,708249708,07-09-24 19:28,54.01,Withdrawal,Mobile App Withdrawal,1239.594508
337,708249708,07-10-24 21:28,1800,Payment,Credit Card Payment,-560.4054916
338,708249708,7-14-24 14:28,231.22,Withdrawal,Mobile App Withdrawal,-791.6254916
339,708249708,7-15-24 10:28,87.47,Payment,Bill Payment,-879.0954916
340,708249708,7-15-24 21:28,1000,Payment,Rent Payment,-1879.095492
341,708303108,1-21-24 19:28,168.77,Return,eBay Return,1484.542107
342,708303108,1-22-24 11:28,213.4,Return,AliExpress Return,1697.942107
343,708303108,1-24-24 10:28,79.97,Payment,Mortgage Payment,1617.972107
344,708303108,1-26-24 23:28,111.86,Payment,Bill Payment,1506.112107
345,708303108,1-27-24 20:28,155.72,Purchase,Travel,1350.392107
346,708303108,02-01-24 17:28,128.79,Purchase,Furniture,1221.602107
347,708303108,02-01-24 22:28,102.45,Deposit,Mobile Deposit,1324.052107
348,708303108,02-02-24 16:28,191.91,Return,eBay Return,1515.962107
349,708303108,02-03-24 21:28,2500,IncomingTransfer,Salary,4015.962107
350,708303108,02-05-24 12:28,218.64,OutgoingTransfer,Bank Transfer,3797.322107
351,708303108,02-06-24 23:28,126.79,Withdrawal,Mobile App Withdrawal,3670.532107
352,708303108,02-07-24 20:28,81.67,OnlineShopping,Etsy,3588.862107
353,708303108,02-07-24 20:28,212.8,Deposit,Check Deposit,3801.662107
354,708303108,02-08-24 21:28,2000,Payment,Credit Card Payment,1801.662107
355,708303108,02-09-24 17:28,150.22,Withdrawal,ATM Withdrawal,1651.442107
356,708303108,02-10-24 12:28,177.4,Purchase,Restaurant,1474.042107
357,708303108,02-10-24 21:28,700,Payment,Rent Payment,774.0421068
358,708303108,02-11-24 14:28,195.14,Deposit,Mobile Deposit,969.1821068
359,708303108,2-18-24 17:28,154.4,Payment,Bill Payment,814.7821068
360,708303108,2-21-24 22:28,133.73,OnlineShopping,Amazon,681.0521068
361,708303108,2-23-24 11:28,138.22,Purchase,Gas,542.8321068
362,708303108,2-27-24 22:28,131.49,Payment,Mortgage Payment,411.3421068
363,708303108,2-28-24 14:28,60.2,IncomingTransfer,Freelance Payment,471.5421068
364,708303108,2-29-24 17:28,219.33,Withdrawal,Branch Withdrawal,252.2121068
365,708303108,03-01-24 10:28,211.62,Withdrawal,ATM Withdrawal,40.59210676
366,708303108,03-02-24 13:28,155.22,Payment,Mortgage Payment,-114.6278932
367,708303108,03-03-24 21:28,2500,IncomingTransfer,Salary,2385.372107
368,708303108,03-08-24 10:28,208.51,Withdrawal,ATM Withdrawal,2176.862107
369,708303108,03-08-24 12:28,229.07,Purchase,Gas,1947.792107
370,708303108,03-08-24 21:28,2000,Payment,Credit Card Payment,-52.20789324
371,708303108,03-09-24 12:28,171.9,Purchase,Travel,-224.1078932
372,708303108,03-10-24 10:28,172.26,OnlineShopping,AliExpress,-396.3678932
373,708303108,03-11-24 10:28,62.83,Purchase,Electronics,-459.1978932
374,708303108,03-12-24 12:28,189.11,Deposit,Mobile Deposit,-270.0878932
375,708303108,03-12-24 21:28,1000,Payment,Rent Payment,-1270.087893
376,708303108,3-16-24 20:28,155.33,Purchase,Electronics,-1425.417893
377,708303108,3-18-24 11:28,229.42,Payment,Mortgage Payment,-1654.837893
378,708303108,3-18-24 16:28,244.28,Payment,Bill Payment,-1899.117893
379,708303108,3-18-24 21:28,125.28,Deposit,Direct Deposit,-1773.837893
380,708303108,3-19-24 17:28,47.52,Return,Best Buy Return,-1726.317893
381,708303108,3-20-24 20:28,133.37,Purchase,Entertainment,-1859.687893
382,708303108,3-22-24 23:28,164.15,Purchase,Home Improvement,-2023.837893
383,708303108,3-23-24 19:28,63.26,Payment,Mortgage Payment,-2087.097893
384,708303108,3-24-24 13:28,177.37,Purchase,Restaurant,-2264.467893
385,708303108,3-27-24 20:28,26.07,OnlineShopping,Walmart,-2290.537893
386,708303108,04-01-24 22:28,157.47,OutgoingTransfer,Wire Transfer,-2448.007893
387,708303108,04-02-24 16:28,111.19,OnlineShopping,Walmart,-2559.197893
388,708303108,04-04-24 21:28,2500,IncomingTransfer,Salary,-59.19789324
389,708303108,04-05-24 14:28,44.54,OnlineShopping,Etsy,-103.7378932
390,708303108,04-07-24 13:28,38.98,Deposit,Mobile Deposit,-64.75789324
391,708303108,04-07-24 15:28,246.65,Withdrawal,Branch Withdrawal,-311.4078932
392,708303108,04-09-24 21:28,1900,Payment,Credit Card Payment,-2211.407893
393,708303108,04-10-24 9:28,32.99,Payment,Bill Payment,-2244.397893
394,708303108,04-11-24 9:28,165.25,IncomingTransfer,Freelance Payment,-2079.147893
395,708303108,4-17-24 9:28,95.42,Withdrawal,ATM Withdrawal,-2174.567893
396,708303108,4-17-24 21:28,1500,Payment,Rent Payment,-3674.567893
397,708303108,4-19-24 21:28,153.05,Return,Walmart Return,-3521.517893
398,708303108,4-22-24 17:28,22.42,Return,Target Return,-3499.097893
399,708303108,4-23-24 11:28,53.79,IncomingTransfer,Freelance Payment,-3445.307893
400,708303108,4-25-24 16:28,84.87,Deposit,Mobile Deposit,-3360.437893
401,708303108,05-02-24 21:28,2500,IncomingTransfer,Salary,-860.4378932
402,708303108,05-07-24 12:28,238.52,Withdrawal,Branch Withdrawal,-1098.957893
403,708303108,05-07-24 21:28,2300,Payment,Credit Card Payment,-3398.957893
404,708303108,05-10-24 17:28,242.75,Return,Amazon Return,-3156.207893
405,708303108,05-11-24 12:28,215.04,Deposit,Check Deposit,-2941.167893
406,708303108,05-11-24 16:28,78.58,Withdrawal,ATM Withdrawal,-3019.747893
407,708303108,05-11-24 18:28,144.85,OnlineShopping,Best Buy,-3164.597893
408,708303108,5-15-24 21:28,1100,Payment,Rent Payment,-4264.597893
409,708303108,5-18-24 11:28,95.19,Deposit,Check Deposit,-4169.407893
410,708303108,5-20-24 9:28,75.64,Payment,Bill Payment,-4245.047893
411,708303108,5-20-24 18:28,31.14,Return,Etsy Return,-4213.907893
412,708303108,5-21-24 17:28,203.05,Payment,Mortgage Payment,-4416.957893
413,708303108,5-23-24 9:28,170.03,Deposit,Check Deposit,-4246.927893
414,708303108,5-24-24 17:28,132.96,OutgoingTransfer,Wire Transfer,-4379.887893
415,708303108,5-27-24 10:28,137.54,Payment,Loan Payment,-4517.427893
416,708303108,5-27-24 19:28,73.96,Withdrawal,ATM Withdrawal,-4591.387893
417,708303108,5-31-24 10:28,222.22,Deposit,Direct Deposit,-4369.167893
418,708303108,06-03-24 17:28,188.49,Purchase,Entertainment,-4557.657893
419,708303108,06-03-24 20:28,200.93,OnlineShopping,eBay,-4758.587893
420,708303108,06-05-24 21:28,2500,IncomingTransfer,Salary,-2258.587893
421,708303108,06-06-24 13:28,221.33,Withdrawal,ATM Withdrawal,-2479.917893
422,708303108,06-06-24 19:28,40.95,Purchase,Home Improvement,-2520.867893
423,708303108,06-08-24 20:28,32.51,Withdrawal,Mobile App Withdrawal,-2553.377893
424,708303108,06-09-24 16:28,216.44,OutgoingTransfer,Bank Transfer,-2769.817893
425,708303108,06-10-24 21:28,2100,Payment,Credit Card Payment,-4869.817893
426,708303108,06-11-24 21:28,1200,Payment,Rent Payment,-6069.817893
427,708303108,6-15-24 13:28,174.89,Purchase,Clothing,-6244.707893
428,708303108,6-17-24 9:28,15.98,Withdrawal,ATM Withdrawal,-6260.687893
429,708303108,6-19-24 20:28,21.05,OnlineShopping,eBay,-6281.737893
430,708303108,6-20-24 13:28,26.76,Purchase,Gas,-6308.497893
431,708303108,6-24-24 17:28,70.45,Payment,Loan Payment,-6378.947893
432,708303108,6-25-24 22:28,122.61,Payment,Loan Payment,-6501.557893
433,708303108,6-26-24 20:28,152.82,Deposit,Check Deposit,-6348.737893
434,708303108,6-27-24 12:28,172.34,Deposit,Direct Deposit,-6176.397893
435,708303108,6-29-24 17:28,112.72,Purchase,Furniture,-6289.117893
436,708303108,6-29-24 19:28,110.05,Return,Best Buy Return,-6179.067893
437,708303108,6-29-24 20:28,229.03,Deposit,Check Deposit,-5950.037893
438,708303108,07-01-24 20:28,208.11,OnlineShopping,Walmart,-6158.147893
439,708303108,07-01-24 20:28,177.75,Payment,Mortgage Payment,-6335.897893
440,708303108,07-04-24 12:28,69.58,Deposit,Check Deposit,-6266.317893
441,708303108,07-05-24 21:28,2500,IncomingTransfer,Salary,-3766.317893
442,708303108,07-06-24 18:28,148.66,OutgoingTransfer,Wire Transfer,-3914.977893
443,708303108,07-07-24 14:28,98.91,OutgoingTransfer,Bank Transfer,-4013.887893
444,708303108,07-10-24 12:28,68.03,Purchase,Grocery,-4081.917893
445,708303108,07-10-24 15:28,45.58,Withdrawal,Mobile App Withdrawal,-4127.497893
446,708303108,07-10-24 21:28,2400,Payment,Credit Card Payment,-6527.497893
447,708303108,07-10-24 21:28,1200,Payment,Rent Payment,-7727.497893
448,708303108,07-10-24 21:28,158.9,Deposit,Check Deposit,-7568.597893
449,708303108,07-11-24 16:28,211.4,OnlineShopping,eBay,-7779.997893
450,708303108,07-12-24 21:28,30.73,Purchase,Gas,-7810.727893
451,708303108,7-15-24 10:28,150.23,Purchase,Restaurant,-7960.957893
452,708303108,7-16-24 13:28,232.7,Payment,Mortgage Payment,-8193.657893
453,708337683,1-22-24 19:28,494.65,Payment,Mortgage Payment,110.4912865
454,708337683,1-23-24 22:28,129.42,Deposit,Cash Deposit,239.9112865
455,708337683,1-27-24 18:28,187.77,OnlineShopping,Walmart,52.14128654
456,708337683,1-29-24 22:28,233.77,Purchase,Gas,-181.6287135
457,708337683,1-30-24 10:28,394.01,Return,AliExpress Return,212.3812865
458,708337683,1-30-24 17:28,213.34,Withdrawal,ATM Withdrawal,-0.958713462
459,708337683,02-02-24 21:28,6150,IncomingTransfer,Salary,6149.041287
460,708337683,02-04-24 11:28,352.01,Return,Target Return,6501.051287
461,708337683,02-07-24 13:28,122.68,Return,Etsy Return,6623.731287
462,708337683,02-07-24 21:28,1000,Payment,Credit Card Payment,5623.731287
463,708337683,02-08-24 13:28,92.6,Deposit,Cash Deposit,5716.331287
464,708337683,02-08-24 18:28,91.46,Purchase,Entertainment,5624.871287
465,708337683,2-13-24 10:28,244.27,Return,Best Buy Return,5869.141287
466,708337683,2-16-24 21:28,2300,Payment,Rent Payment,3569.141287
467,708337683,2-25-24 19:28,370.56,Purchase,Clothing,3198.581287
468,708337683,2-28-24 17:28,496.88,Purchase,Grocery,2701.701287
469,708337683,2-29-24 14:28,84.69,OutgoingTransfer,Bank Transfer,2617.011287
470,708337683,2-29-24 18:28,209.52,OnlineShopping,Etsy,2407.491287
471,708337683,03-05-24 21:28,6150,IncomingTransfer,Salary,8557.491287
472,708337683,03-06-24 13:28,545.42,Return,Walmart Return,9102.911287
473,708337683,03-06-24 21:28,506.47,Withdrawal,Branch Withdrawal,8596.441287
474,708337683,03-06-24 23:28,114.23,OutgoingTransfer,International Transfer,8482.211287
475,708337683,03-10-24 21:28,1100,Payment,Credit Card Payment,7382.211287
476,708337683,03-10-24 21:28,2300,Payment,Rent Payment,5082.211287
477,708337683,03-10-24 22:28,314.15,Payment,Bill Payment,4768.061287
478,708337683,03-12-24 11:28,542.72,Return,Best Buy Return,5310.781287
479,708337683,03-12-24 21:28,544.59,IncomingTransfer,Freelance Payment,5855.371287
480,708337683,3-14-24 13:28,173.21,Withdrawal,Mobile App Withdrawal,5682.161287
481,708337683,3-14-24 18:28,83.87,Withdrawal,Branch Withdrawal,5598.291287
482,708337683,3-14-24 23:28,452.69,Withdrawal,Branch Withdrawal,5145.601287
483,708337683,3-16-24 18:28,471.28,Deposit,Direct Deposit,5616.881287
484,708337683,3-21-24 11:28,309.58,OutgoingTransfer,Wire Transfer,5307.301287
485,708337683,3-25-24 18:28,53.71,Deposit,Direct Deposit,5361.011287
486,708337683,3-29-24 13:28,466.02,IncomingTransfer,Freelance Payment,5827.031287
487,708337683,3-29-24 22:28,330.67,Deposit,Check Deposit,6157.701287
488,708337683,04-03-24 21:28,6150,IncomingTransfer,Salary,12307.70129
489,708337683,04-07-24 19:28,175.45,Withdrawal,ATM Withdrawal,12132.25129
490,708337683,04-08-24 21:28,1200,Payment,Credit Card Payment,10932.25129
491,708337683,04-11-24 21:28,3200,Payment,Rent Payment,7732.251287
492,708337683,4-19-24 10:28,192.34,Purchase,Clothing,7539.911287
493,708337683,4-25-24 10:28,169.24,Purchase,Home Improvement,7370.671287
494,708337683,4-27-24 13:28,151.67,Deposit,Cash Deposit,7522.341287
495,708337683,4-27-24 21:28,162.19,Deposit,Mobile Deposit,7684.531287
496,708337683,4-28-24 19:28,407.78,Deposit,Direct Deposit,8092.311287
497,708337683,4-30-24 14:28,165,Payment,Mortgage Payment,7927.311287
498,708337683,05-04-24 21:28,6150,IncomingTransfer,Salary,14077.31129
499,708337683,05-05-24 12:28,511.27,Purchase,Grocery,13566.04129
500,708337683,05-09-24 21:28,1000,Payment,Credit Card Payment,12566.04129
501,708337683,05-11-24 21:28,3200,Payment,Rent Payment,9366.041287
502,708337683,05-12-24 15:28,377.58,Withdrawal,ATM Withdrawal,8988.461287
503,708337683,5-19-24 15:28,407.06,Withdrawal,Mobile App Withdrawal,8581.401287
504,708337683,5-26-24 10:28,374.04,Return,Store Return,8955.441287
505,708337683,06-01-24 18:28,520.63,OnlineShopping,Etsy,8434.811287
506,708337683,06-01-24 21:28,6150,IncomingTransfer,Salary,14584.81129
507,708337683,06-02-24 15:28,331.92,OnlineShopping,AliExpress,14252.89129
508,708337683,06-04-24 20:28,488.17,Purchase,Gas,13764.72129
509,708337683,06-06-24 21:28,1300,Payment,Credit Card Payment,12464.72129
510,708337683,06-08-24 15:28,250.97,Purchase,Pharmacy,12213.75129
511,708337683,6-14-24 10:28,340.83,Return,eBay Return,12554.58129
512,708337683,6-14-24 21:28,3000,Payment,Rent Payment,9554.581287
513,708337683,6-18-24 17:28,61.74,Withdrawal,Branch Withdrawal,9492.841287
514,708337683,6-19-24 22:28,549.79,Deposit,Check Deposit,10042.63129
515,708337683,6-20-24 17:28,402.48,Return,Walmart Return,10445.11129
516,708337683,6-20-24 22:28,81.84,Withdrawal,ATM Withdrawal,10363.27129
517,708337683,6-21-24 22:28,354.8,Withdrawal,ATM Withdrawal,10008.47129
518,708337683,6-22-24 18:28,100.16,Purchase,Gas,9908.311287
519,708337683,6-25-24 19:28,417.07,OnlineShopping,Target,9491.241287
520,708337683,6-25-24 22:28,294.36,OnlineShopping,AliExpress,9196.881287
521,708337683,6-26-24 17:28,325.99,Deposit,Mobile Deposit,9522.871287
522,708337683,6-28-24 20:28,443.85,Purchase,Clothing,9079.021287
523,708337683,6-30-24 22:28,308.4,Purchase,Pharmacy,8770.621287
524,708337683,07-01-24 22:28,353.15,OnlineShopping,Walmart,8417.471287
525,708337683,07-03-24 16:28,185.99,Purchase,Home Improvement,8231.481287
526,708337683,07-05-24 21:28,6150,IncomingTransfer,Salary,14381.48129
527,708337683,07-10-24 11:28,298.92,Withdrawal,ATM Withdrawal,14082.56129
528,708337683,07-10-24 21:28,1000,Payment,Credit Card Payment,13082.56129
529,708337683,07-11-24 19:28,235.18,Withdrawal,ATM Withdrawal,12847.38129
530,708337683,07-12-24 13:28,495.9,Payment,Bill Payment,12351.48129
531,708337683,7-14-24 20:28,275.78,Deposit,Check Deposit,12627.26129
532,708337683,7-15-24 21:28,2500,Payment,Rent Payment,10127.26129
533,708373083,1-20-24 20:28,388.78,IncomingTransfer,Freelance Payment,2510.17233
534,708373083,02-02-24 21:28,4800,IncomingTransfer,Salary,7310.17233
535,708373083,02-07-24 16:28,74.27,Payment,Bill Payment,7235.90233
536,708373083,02-07-24 21:28,3500,Payment,Credit Card Payment,3735.90233
537,708373083,02-12-24 22:28,310.11,OnlineShopping,eBay,3425.79233
538,708373083,2-13-24 21:28,2600,Payment,Rent Payment,825.7923295
539,708373083,2-17-24 20:28,222.43,Return,eBay Return,1048.22233
540,708373083,2-21-24 23:28,169.55,Purchase,Gas,878.6723295
541,708373083,03-02-24 21:28,4800,IncomingTransfer,Salary,5678.67233
542,708373083,03-07-24 21:28,3600,Payment,Credit Card Payment,2078.67233
543,708373083,03-08-24 12:28,266.14,Return,AliExpress Return,2344.81233
544,708373083,03-08-24 14:28,360.81,Purchase,Pharmacy,1984.00233
545,708373083,03-10-24 16:28,331.96,Deposit,Mobile Deposit,2315.96233
546,708373083,03-10-24 21:28,110.74,Deposit,Mobile Deposit,2426.70233
547,708373083,03-11-24 21:28,2200,Payment,Rent Payment,226.7023295
548,708373083,3-14-24 21:28,80.79,OutgoingTransfer,Bank Transfer,145.9123295
549,708373083,3-23-24 12:28,147.37,Purchase,Clothing,-1.457670488
550,708373083,04-03-24 21:28,4800,IncomingTransfer,Salary,4798.54233
551,708373083,04-08-24 21:28,3600,Payment,Credit Card Payment,1198.54233
552,708373083,04-10-24 15:28,299.53,Deposit,Mobile Deposit,1498.07233
553,708373083,04-10-24 20:28,203.61,Return,AliExpress Return,1701.68233
554,708373083,04-10-24 20:28,207.84,Withdrawal,Branch Withdrawal,1493.84233
555,708373083,4-14-24 21:28,2800,Payment,Rent Payment,-1306.15767
556,708373083,4-23-24 9:28,314.88,OnlineShopping,AliExpress,-1621.03767
557,708373083,4-28-24 18:28,21.2,Deposit,Cash Deposit,-1599.83767
558,708373083,4-28-24 19:28,252.84,OnlineShopping,AliExpress,-1852.67767
559,708373083,4-29-24 14:28,311.03,Purchase,Electronics,-2163.70767
560,708373083,05-03-24 21:28,4800,IncomingTransfer,Salary,2636.29233
561,708373083,05-06-24 9:28,367.48,Deposit,Check Deposit,3003.77233
562,708373083,05-07-24 20:28,115.87,Purchase,Travel,2887.90233
563,708373083,05-08-24 18:28,374.06,Purchase,Restaurant,2513.84233
564,708373083,05-08-24 21:28,2900,Payment,Credit Card Payment,-386.1576705
565,708373083,05-10-24 9:28,182.04,Withdrawal,ATM Withdrawal,-568.1976705
566,708373083,05-10-24 21:28,2600,Payment,Rent Payment,-3168.19767
567,708373083,5-16-24 12:28,71.91,Payment,Loan Payment,-3240.10767
568,708373083,5-19-24 18:28,74.9,Withdrawal,Branch Withdrawal,-3315.00767
569,708373083,5-21-24 16:28,347.86,OutgoingTransfer,Wire Transfer,-3662.86767
570,708373083,5-23-24 14:28,261.1,Withdrawal,ATM Withdrawal,-3923.96767
571,708373083,5-30-24 19:28,37.29,Purchase,Entertainment,-3961.25767
572,708373083,06-02-24 19:28,191.17,Return,Target Return,-3770.08767
573,708373083,06-02-24 21:28,4800,IncomingTransfer,Salary,1029.91233
574,708373083,06-06-24 9:28,126.42,Deposit,Direct Deposit,1156.33233
575,708373083,06-06-24 19:28,82.76,Purchase,Clothing,1073.57233
576,708373083,06-07-24 15:28,274.88,Purchase,Electronics,798.6923295
577,708373083,06-07-24 21:28,3600,Payment,Credit Card Payment,-2801.30767
578,708373083,06-10-24 22:28,389.44,Return,Target Return,-2411.86767
579,708373083,06-11-24 14:28,116.29,Purchase,Pharmacy,-2528.15767
580,708373083,6-13-24 18:28,216.22,Purchase,Home Improvement,-2744.37767
581,708373083,6-13-24 19:28,260.06,Withdrawal,ATM Withdrawal,-3004.43767
582,708373083,6-15-24 19:28,280.17,Deposit,Cash Deposit,-2724.26767
583,708373083,6-16-24 19:28,39.38,Purchase,Restaurant,-2763.64767
584,708373083,6-17-24 21:28,2000,Payment,Rent Payment,-4763.64767
585,708373083,07-01-24 17:28,348.49,OnlineShopping,eBay,-5112.13767
586,708373083,07-02-24 21:28,4800,IncomingTransfer,Salary,-312.1376705
587,708373083,07-07-24 21:28,2800,Payment,Credit Card Payment,-3112.13767
588,708373083,7-13-24 19:28,179.65,Return,Best Buy Return,-2932.48767
589,708373083,7-17-24 21:28,2500,Payment,Rent Payment,-5432.48767
590,708384033,1-26-24 21:28,115.3,Purchase,Pharmacy,1116.555002
591,708384033,1-28-24 12:28,204.16,Deposit,Cash Deposit,1320.715002
592,708384033,1-29-24 11:28,223.35,Withdrawal,Mobile App Withdrawal,1097.365002
593,708384033,02-03-24 21:28,2350,IncomingTransfer,Salary,3447.365002
594,708384033,02-05-24 18:28,19.38,Withdrawal,Branch Withdrawal,3427.985002
595,708384033,02-08-24 21:28,3100,Payment,Credit Card Payment,327.9850019
596,708384033,02-11-24 21:28,1300,Payment,Rent Payment,-972.0149981
597,708384033,2-23-24 19:28,229.87,Purchase,Pharmacy,-1201.884998
598,708384033,2-27-24 19:28,63.19,OutgoingTransfer,Peer-to-Peer Transfer,-1265.074998
599,708384033,03-01-24 22:28,157.19,Payment,Bill Payment,-1422.264998
600,708384033,03-02-24 21:28,2350,IncomingTransfer,Salary,927.7350019
601,708384033,03-04-24 20:28,191.22,Deposit,Mobile Deposit,1118.955002
602,708384033,03-07-24 21:28,3100,Payment,Credit Card Payment,-1981.044998
603,708384033,03-07-24 22:28,234.04,Withdrawal,ATM Withdrawal,-2215.084998
604,708384033,03-08-24 21:28,199.09,OutgoingTransfer,Wire Transfer,-2414.174998
605,708384033,3-16-24 21:28,1100,Payment,Rent Payment,-3514.174998
606,708384033,3-16-24 22:28,233.45,Purchase,Clothing,-3747.624998
607,708384033,3-23-24 13:28,176.16,Purchase,Restaurant,-3923.784998
608,708384033,3-23-24 22:28,115.02,Payment,Bill Payment,-4038.804998
609,708384033,3-26-24 9:28,174.8,Purchase,Restaurant,-4213.604998
610,708384033,04-01-24 17:28,44.96,Purchase,Pharmacy,-4258.564998
611,708384033,04-04-24 21:28,2350,IncomingTransfer,Salary,-1908.564998
612,708384033,04-09-24 21:28,2600,Payment,Credit Card Payment,-4508.564998
613,708384033,04-10-24 14:28,45.15,IncomingTransfer,Freelance Payment,-4463.414998
614,708384033,04-12-24 16:28,201.55,Return,Etsy Return,-4261.864998
615,708384033,04-12-24 21:28,1400,Payment,Rent Payment,-5661.864998
616,708384033,4-13-24 17:28,229.5,Deposit,Cash Deposit,-5432.364998
617,708384033,4-15-24 14:28,246.97,Deposit,Check Deposit,-5185.394998
618,708384033,4-23-24 20:28,139.75,Payment,Loan Payment,-5325.144998
619,708384033,4-25-24 9:28,62.86,Withdrawal,Mobile App Withdrawal,-5388.004998
620,708384033,4-25-24 13:28,47.57,Purchase,Home Improvement,-5435.574998
621,708384033,4-29-24 15:28,15.67,Deposit,Check Deposit,-5419.904998
622,708384033,05-04-24 15:28,249.66,Purchase,Travel,-5669.564998
623,708384033,05-05-24 21:28,2350,IncomingTransfer,Salary,-3319.564998
624,708384033,05-07-24 13:28,185.36,Purchase,Electronics,-3504.924998
625,708384033,05-10-24 21:28,3200,Payment,Credit Card Payment,-6704.924998
626,708384033,05-12-24 19:28,136.58,Purchase,Home Improvement,-6841.504998
627,708384033,5-13-24 9:28,36.73,Deposit,Check Deposit,-6804.774998
628,708384033,5-15-24 21:28,1000,Payment,Rent Payment,-7804.774998
629,708384033,5-31-24 9:28,104.9,Withdrawal,Branch Withdrawal,-7909.674998
630,708384033,06-01-24 19:28,107.74,Return,Target Return,-7801.934998
631,708384033,06-04-24 21:28,2350,IncomingTransfer,Salary,-5451.934998
632,708384033,06-09-24 21:28,2600,Payment,Credit Card Payment,-8051.934998
633,708384033,06-09-24 22:28,190.55,Deposit,Mobile Deposit,-7861.384998
634,708384033,06-11-24 21:28,50.23,IncomingTransfer,Freelance Payment,-7811.154998
635,708384033,06-12-24 13:28,135.9,Withdrawal,Mobile App Withdrawal,-7947.054998
636,708384033,06-12-24 21:28,700,Payment,Rent Payment,-8647.054998
637,708384033,6-14-24 9:28,10,OutgoingTransfer,International Transfer,-8657.054998
638,708384033,6-21-24 15:28,152.73,Purchase,Furniture,-8809.784998
639,708384033,6-21-24 21:28,69.04,Return,Store Return,-8740.744998
640,708384033,07-03-24 21:28,2350,IncomingTransfer,Salary,-6390.744998
641,708384033,07-08-24 19:28,46.86,Withdrawal,Branch Withdrawal,-6437.604998
642,708384033,07-08-24 21:28,3400,Payment,Credit Card Payment,-9837.604998
643,708384033,07-11-24 20:28,81.69,OnlineShopping,Etsy,-9919.294998
644,708384033,07-11-24 20:28,50.08,Purchase,Home Improvement,-9969.374998
645,708384033,7-14-24 21:28,1000,Payment,Rent Payment,-10969.375
646,708384033,7-17-24 9:28,141.22,OnlineShopping,eBay,-11110.595
647,708414033,1-23-24 20:28,50.38,OnlineShopping,Target,820.6268014
648,708414033,1-24-24 17:28,38.04,Payment,Loan Payment,782.5868014
649,708414033,1-27-24 17:28,172.1,OnlineShopping,Walmart,610.4868014
650,708414033,1-27-24 19:28,29.88,IncomingTransfer,Freelance Payment,640.3668014
651,708414033,1-29-24 15:28,197.58,OutgoingTransfer,Peer-to-Peer Transfer,442.7868014
652,708414033,02-01-24 23:28,249.25,IncomingTransfer,Freelance Payment,692.0368014
653,708414033,02-03-24 21:28,4900,IncomingTransfer,Salary,5592.036801
654,708414033,02-04-24 11:28,210.65,Return,Etsy Return,5802.686801
655,708414033,02-04-24 19:28,150.67,Return,Target Return,5953.356801
656,708414033,02-05-24 18:28,113.11,Withdrawal,ATM Withdrawal,5840.246801
657,708414033,02-06-24 11:28,335.57,Purchase,Pharmacy,5504.676801
658,708414033,02-08-24 21:28,1500,Payment,Credit Card Payment,4004.676801
659,708414033,02-12-24 20:28,332.44,OnlineShopping,eBay,3672.236801
660,708414033,2-13-24 13:28,384.16,OnlineShopping,AliExpress,3288.076801
661,708414033,2-18-24 21:28,1600,Payment,Rent Payment,1688.076801
662,708414033,2-25-24 19:28,101.22,Payment,Loan Payment,1586.856801
663,708414033,03-01-24 10:28,77.06,Deposit,Mobile Deposit,1663.916801
664,708414033,03-01-24 11:28,226.81,Payment,Bill Payment,1437.106801
665,708414033,03-01-24 21:28,27.27,OnlineShopping,Etsy,1409.836801
666,708414033,03-03-24 21:28,4900,IncomingTransfer,Salary,6309.836801
667,708414033,03-07-24 21:28,95.88,Withdrawal,Mobile App Withdrawal,6213.956801
668,708414033,03-08-24 21:28,1200,Payment,Credit Card Payment,5013.956801
669,708414033,03-11-24 16:28,111.45,Payment,Bill Payment,4902.506801
670,708414033,03-11-24 17:28,317.03,Deposit,Direct Deposit,5219.536801
671,708414033,3-14-24 23:28,387.69,OutgoingTransfer,Bank Transfer,4831.846801
672,708414033,3-15-24 21:28,2600,Payment,Rent Payment,2231.846801
673,708414033,3-15-24 22:28,161.65,Deposit,Cash Deposit,2393.496801
674,708414033,3-22-24 17:28,135.87,Payment,Bill Payment,2257.626801
675,708414033,3-23-24 12:28,182.45,Withdrawal,Mobile App Withdrawal,2075.176801
676,708414033,3-26-24 13:28,134.06,Purchase,Home Improvement,1941.116801
677,708414033,3-29-24 12:28,37.36,Purchase,Home Improvement,1903.756801
678,708414033,04-02-24 21:28,4900,IncomingTransfer,Salary,6803.756801
679,708414033,04-05-24 17:28,209.86,OutgoingTransfer,Peer-to-Peer Transfer,6593.896801
680,708414033,04-07-24 21:28,1200,Payment,Credit Card Payment,5393.896801
681,708414033,04-08-24 21:28,348.17,Purchase,Entertainment,5045.726801
682,708414033,04-09-24 9:28,167.07,Payment,Mortgage Payment,4878.656801
683,708414033,04-10-24 21:28,2500,Payment,Rent Payment,2378.656801
684,708414033,04-12-24 13:28,387.14,Purchase,Home Improvement,1991.516801
685,708414033,4-13-24 14:28,165.3,Withdrawal,ATM Withdrawal,1826.216801
686,708414033,4-16-24 22:28,389.6,Deposit,Direct Deposit,2215.816801
687,708414033,4-21-24 17:28,373.58,OnlineShopping,Amazon,1842.236801
688,708414033,4-24-24 13:28,212.1,Deposit,Mobile Deposit,2054.336801
689,708414033,4-26-24 20:28,263.59,Return,Etsy Return,2317.926801
690,708414033,4-30-24 13:28,283.37,Purchase,Grocery,2034.556801
691,708414033,05-01-24 21:28,4900,IncomingTransfer,Salary,6934.556801
692,708414033,05-06-24 21:28,1400,Payment,Credit Card Payment,5534.556801
693,708414033,05-07-24 21:28,76.18,Payment,Mortgage Payment,5458.376801
694,708414033,05-09-24 19:28,252.95,Purchase,Gas,5205.426801
695,708414033,05-10-24 15:28,347.86,Withdrawal,ATM Withdrawal,4857.566801
696,708414033,05-11-24 21:28,1900,Payment,Rent Payment,2957.566801
697,708414033,05-12-24 19:28,150.2,Purchase,Restaurant,2807.366801
698,708414033,5-14-24 15:28,291.13,Withdrawal,ATM Withdrawal,2516.236801
699,708414033,5-14-24 15:28,196.01,Purchase,Clothing,2320.226801
700,708414033,5-17-24 15:28,323.66,Payment,Bill Payment,1996.566801
701,708414033,5-20-24 16:28,133.4,Deposit,Direct Deposit,2129.966801
702,708414033,5-23-24 23:28,372.51,OutgoingTransfer,Bank Transfer,1757.456801
703,708414033,5-26-24 11:28,234.29,IncomingTransfer,Freelance Payment,1991.746801
704,708414033,5-28-24 15:28,156.05,Withdrawal,ATM Withdrawal,1835.696801
705,708414033,5-30-24 12:28,312.87,Return,AliExpress Return,2148.566801
706,708414033,5-30-24 16:28,289.59,OutgoingTransfer,Peer-to-Peer Transfer,1858.976801
707,708414033,5-30-24 23:28,82.02,Purchase,Furniture,1776.956801
708,708414033,06-04-24 21:28,4900,IncomingTransfer,Salary,6676.956801
709,708414033,06-06-24 23:28,23.71,Purchase,Travel,6653.246801
710,708414033,06-09-24 21:28,1400,Payment,Credit Card Payment,5253.246801
711,708414033,06-10-24 19:28,223.99,OnlineShopping,Etsy,5029.256801
712,708414033,06-10-24 21:28,1500,Payment,Rent Payment,3529.256801
713,708414033,6-15-24 12:28,204.67,Withdrawal,ATM Withdrawal,3324.586801
714,708414033,6-22-24 21:28,182.33,Purchase,Electronics,3142.256801
715,708414033,6-23-24 12:28,42.68,OnlineShopping,Walmart,3099.576801
716,708414033,6-23-24 17:28,20.96,Return,Etsy Return,3120.536801
717,708414033,6-25-24 17:28,23.58,Return,Amazon Return,3144.116801
718,708414033,6-26-24 14:28,356.69,Withdrawal,Branch Withdrawal,2787.426801
719,708414033,6-28-24 10:28,280.28,Payment,Bill Payment,2507.146801
720,708414033,6-28-24 16:28,179.76,Deposit,Direct Deposit,2686.906801
721,708414033,07-02-24 15:28,284.6,OnlineShopping,eBay,2402.306801
722,708414033,07-04-24 20:28,37.51,Purchase,Pharmacy,2364.796801
723,708414033,07-04-24 21:28,4900,IncomingTransfer,Salary,7264.796801
724,708414033,07-08-24 17:28,89.05,Purchase,Travel,7175.746801
725,708414033,07-09-24 21:28,1400,Payment,Credit Card Payment,5775.746801
726,708414033,07-10-24 15:28,120.97,Purchase,Restaurant,5654.776801
727,708414033,07-12-24 15:28,263.79,Return,Best Buy Return,5918.566801
728,708414033,7-13-24 21:28,234.52,OnlineShopping,AliExpress,5684.046801
729,708414033,7-13-24 22:28,373.73,Withdrawal,ATM Withdrawal,5310.316801
730,708414033,7-17-24 21:28,2700,Payment,Rent Payment,2610.316801
731,708423933,1-24-24 15:28,244.24,Purchase,Restaurant,-244.24
732,708423933,1-25-24 10:28,42.64,Deposit,Check Deposit,-201.6
733,708423933,1-26-24 12:28,354.33,Withdrawal,Mobile App Withdrawal,-555.93
734,708423933,1-26-24 22:28,43.14,Deposit,Direct Deposit,-512.79
735,708423933,1-27-24 17:28,397.98,Purchase,Gas,-910.77
736,708423933,1-28-24 11:28,197.87,Purchase,Entertainment,-1108.64
737,708423933,1-29-24 10:28,230.52,Return,eBay Return,-878.12
738,708423933,1-30-24 13:28,241.02,OutgoingTransfer,Wire Transfer,-1119.14
739,708423933,02-02-24 21:28,3750,IncomingTransfer,Salary,2630.86
740,708423933,02-05-24 15:28,36.23,OutgoingTransfer,Bank Transfer,2594.63
741,708423933,02-06-24 19:28,392.96,Deposit,Check Deposit,2987.59
742,708423933,02-09-24 9:28,155.24,Purchase,Electronics,2832.35
743,708423933,02-10-24 21:28,1600,Payment,Rent Payment,1232.35
744,708423933,02-11-24 12:28,125.99,Deposit,Cash Deposit,1358.34
745,708423933,02-11-24 17:28,298.12,Return,Walmart Return,1656.46
746,708423933,2-14-24 18:28,213.89,OnlineShopping,Target,1442.57
747,708423933,03-01-24 16:28,201.57,Return,Target Return,1644.14
748,708423933,03-03-24 21:28,3750,IncomingTransfer,Salary,5394.14
749,708423933,03-12-24 13:28,118,IncomingTransfer,Freelance Payment,5512.14
750,708423933,03-12-24 16:28,352.61,OutgoingTransfer,International Transfer,5159.53
751,708423933,03-12-24 21:28,2000,Payment,Rent Payment,3159.53
752,708423933,3-13-24 9:28,149.34,Deposit,Check Deposit,3308.87
753,708423933,3-21-24 18:28,340.93,Purchase,Home Improvement,2967.94
754,708423933,3-22-24 9:28,221.82,OnlineShopping,Walmart,2746.12
755,708423933,3-22-24 13:28,122.18,Payment,Bill Payment,2623.94
756,708423933,3-25-24 11:28,28.13,OnlineShopping,Target,2595.81
757,708423933,3-26-24 19:28,355.97,Return,Walmart Return,2951.78
758,708423933,3-28-24 11:28,183.88,OnlineShopping,Best Buy,2767.9
759,708423933,04-01-24 21:28,3750,IncomingTransfer,Salary,6517.9
760,708423933,04-02-24 16:28,196.82,Withdrawal,ATM Withdrawal,6321.08
761,708423933,04-02-24 18:28,333.38,Return,Etsy Return,6654.46
762,708423933,04-04-24 23:28,362.87,Return,Etsy Return,7017.33
763,708423933,04-06-24 11:28,370.95,Purchase,Home Improvement,6646.38
764,708423933,04-09-24 19:28,192.22,Deposit,Direct Deposit,6838.6
765,708423933,04-10-24 21:28,1600,Payment,Rent Payment,5238.6
766,708423933,4-17-24 20:28,156.06,Purchase,Restaurant,5082.54
767,708423933,4-17-24 22:28,84.35,Purchase,Entertainment,4998.19
768,708423933,4-19-24 13:28,182.06,Deposit,Cash Deposit,5180.25
769,708423933,4-19-24 18:28,356.28,Payment,Mortgage Payment,4823.97
770,708423933,4-28-24 20:28,234.39,Withdrawal,Branch Withdrawal,4589.58
771,708423933,05-02-24 21:28,3750,IncomingTransfer,Salary,8339.58
772,708423933,05-03-24 10:28,31.04,Payment,Mortgage Payment,8308.54
773,708423933,05-04-24 11:28,368.02,OnlineShopping,Best Buy,7940.52
774,708423933,05-06-24 14:28,132.12,Deposit,Mobile Deposit,8072.64
775,708423933,05-07-24 21:28,149.25,IncomingTransfer,Freelance Payment,8221.89
776,708423933,05-10-24 21:28,342.64,Deposit,Direct Deposit,8564.53
777,708423933,5-13-24 9:28,211.44,Return,AliExpress Return,8775.97
778,708423933,5-13-24 21:28,76.55,Purchase,Clothing,8699.42
779,708423933,5-14-24 14:28,237.47,IncomingTransfer,Freelance Payment,8936.89
780,708423933,5-14-24 21:28,1000,Payment,Rent Payment,7936.89
781,708423933,5-16-24 19:28,201.55,Payment,Bill Payment,7735.34
782,708423933,5-17-24 12:28,311.07,Payment,Bill Payment,7424.27
783,708423933,5-18-24 20:28,267.98,Purchase,Gas,7156.29
784,708423933,5-22-24 11:28,27.51,OnlineShopping,Target,7128.78
785,708423933,5-22-24 17:28,293.83,Purchase,Home Improvement,6834.95
786,708423933,5-23-24 15:28,371.29,Withdrawal,ATM Withdrawal,6463.66
787,708423933,5-24-24 22:28,307.04,Deposit,Mobile Deposit,6770.7
788,708423933,5-31-24 12:28,390.89,Return,Etsy Return,7161.59
789,708423933,06-01-24 15:28,144.35,Withdrawal,Branch Withdrawal,7017.24
790,708423933,06-04-24 19:28,198.22,Withdrawal,ATM Withdrawal,6819.02
791,708423933,06-04-24 21:28,3750,IncomingTransfer,Salary,10569.02
792,708423933,06-06-24 22:28,100.1,Withdrawal,ATM Withdrawal,10468.92
793,708423933,06-06-24 22:28,95.92,Withdrawal,ATM Withdrawal,10373
794,708423933,06-08-24 20:28,171.95,Return,Amazon Return,10544.95
795,708423933,06-11-24 14:28,262.65,IncomingTransfer,Freelance Payment,10807.6
796,708423933,6-16-24 21:28,1300,Payment,Rent Payment,9507.6
797,708423933,6-23-24 20:28,154.38,Deposit,Check Deposit,9661.98
798,708423933,6-27-24 20:28,160.47,OutgoingTransfer,Wire Transfer,9501.51
799,708423933,6-30-24 16:28,361.89,Purchase,Electronics,9139.62
800,708423933,07-02-24 11:28,295.67,Return,Best Buy Return,9435.29
801,708423933,07-03-24 23:28,199.46,Return,AliExpress Return,9634.75
802,708423933,07-04-24 21:28,3750,IncomingTransfer,Salary,13384.75
803,708423933,07-07-24 19:28,268.73,Withdrawal,ATM Withdrawal,13116.02
804,708423933,07-08-24 14:28,151.61,Payment,Mortgage Payment,12964.41
805,708423933,7-14-24 21:28,72.49,OutgoingTransfer,International Transfer,12891.92
806,708423933,7-18-24 21:28,1400,Payment,Rent Payment,11491.92
807,708474333,1-21-24 14:28,525.52,Withdrawal,Mobile App Withdrawal,1584.676626
808,708474333,1-21-24 16:28,355.01,OutgoingTransfer,Bank Transfer,1229.666626
809,708474333,1-21-24 19:28,371.99,OnlineShopping,Target,857.676626
810,708474333,1-22-24 16:28,194.27,OutgoingTransfer,Bank Transfer,663.406626
811,708474333,1-27-24 12:28,263.85,OutgoingTransfer,International Transfer,399.556626
812,708474333,1-29-24 9:28,170.13,IncomingTransfer,Freelance Payment,569.686626
813,708474333,1-29-24 13:28,463.42,Purchase,Clothing,106.266626
814,708474333,1-29-24 23:28,381.76,Purchase,Entertainment,-275.493374
815,708474333,02-01-24 21:28,5700,IncomingTransfer,Salary,5424.506626
816,708474333,02-03-24 20:28,263.87,OutgoingTransfer,Bank Transfer,5160.636626
817,708474333,02-06-24 21:28,3700,Payment,Credit Card Payment,1460.636626
818,708474333,02-12-24 12:28,123.14,Deposit,Direct Deposit,1583.776626
819,708474333,2-13-24 23:28,506.66,OutgoingTransfer,International Transfer,1077.116626
820,708474333,2-16-24 15:28,306.83,Deposit,Direct Deposit,1383.946626
821,708474333,2-16-24 16:28,372.5,OutgoingTransfer,Bank Transfer,1011.446626
822,708474333,2-16-24 18:28,275.96,Purchase,Entertainment,735.486626
823,708474333,2-17-24 21:28,3300,Payment,Rent Payment,-2564.513374
824,708474333,2-19-24 22:28,335.81,OnlineShopping,AliExpress,-2900.323374
825,708474333,2-22-24 12:28,263.7,IncomingTransfer,Freelance Payment,-2636.623374
826,708474333,03-01-24 17:28,238.18,Return,Store Return,-2398.443374
827,708474333,03-01-24 21:28,5700,IncomingTransfer,Salary,3301.556626
828,708474333,03-02-24 15:28,152.21,Withdrawal,ATM Withdrawal,3149.346626
829,708474333,03-02-24 19:28,442.38,Return,Etsy Return,3591.726626
830,708474333,03-02-24 22:28,477.75,Payment,Mortgage Payment,3113.976626
831,708474333,03-03-24 13:28,486.75,Withdrawal,Mobile App Withdrawal,2627.226626
832,708474333,03-04-24 9:28,500.75,IncomingTransfer,Freelance Payment,3127.976626
833,708474333,03-04-24 16:28,126.79,Purchase,Furniture,3001.186626
834,708474333,03-05-24 16:28,450.24,Deposit,Mobile Deposit,3451.426626
835,708474333,03-05-24 21:28,549.12,Deposit,Check Deposit,4000.546626
836,708474333,03-06-24 21:28,2900,Payment,Credit Card Payment,1100.546626
837,708474333,03-08-24 19:28,448.17,OutgoingTransfer,Bank Transfer,652.376626
838,708474333,03-10-24 18:28,223.72,Return,Store Return,876.096626
839,708474333,03-11-24 19:28,538.27,Return,AliExpress Return,1414.366626
840,708474333,03-11-24 19:28,93.19,OutgoingTransfer,Peer-to-Peer Transfer,1321.176626
841,708474333,3-13-24 21:28,1800,Payment,Rent Payment,-478.823374
842,708474333,3-14-24 20:28,168.49,Payment,Bill Payment,-647.313374
843,708474333,3-17-24 16:28,274.29,Withdrawal,Branch Withdrawal,-921.603374
844,708474333,3-19-24 17:28,375.67,Return,Best Buy Return,-545.933374
845,708474333,3-19-24 23:28,236.51,Deposit,Direct Deposit,-309.423374
846,708474333,3-20-24 19:28,512.55,Payment,Loan Payment,-821.973374
847,708474333,3-21-24 16:28,394.77,Purchase,Grocery,-1216.743374
848,708474333,3-22-24 10:28,363.2,Purchase,Travel,-1579.943374
849,708474333,3-22-24 18:28,57,OnlineShopping,Walmart,-1636.943374
850,708474333,3-22-24 23:28,402.91,OutgoingTransfer,Peer-to-Peer Transfer,-2039.853374
851,708474333,3-23-24 10:28,96.93,IncomingTransfer,Freelance Payment,-1942.923374
852,708474333,3-24-24 12:28,483.94,OnlineShopping,AliExpress,-2426.863374
853,708474333,3-25-24 18:28,311.91,Deposit,Cash Deposit,-2114.953374
854,708474333,3-26-24 21:28,371.83,Return,eBay Return,-1743.123374
855,708474333,3-26-24 23:28,158.77,Purchase,Grocery,-1901.893374
856,708474333,04-01-24 16:28,190.41,OutgoingTransfer,Peer-to-Peer Transfer,-2092.303374
857,708474333,04-02-24 12:28,374.59,Withdrawal,Mobile App Withdrawal,-2466.893374
858,708474333,04-02-24 21:28,5700,IncomingTransfer,Salary,3233.106626
859,708474333,04-07-24 14:28,475.52,OnlineShopping,Walmart,2757.586626
860,708474333,04-07-24 21:28,2800,Payment,Credit Card Payment,-42.41337402
861,708474333,04-09-24 12:28,166.47,Deposit,Cash Deposit,124.056626
862,708474333,04-10-24 9:28,82.06,Payment,Mortgage Payment,41.99662598
863,708474333,04-12-24 21:28,3000,Payment,Rent Payment,-2958.003374
864,708474333,4-16-24 18:28,182.78,Withdrawal,Mobile App Withdrawal,-3140.783374
865,708474333,4-19-24 16:28,253.45,Deposit,Mobile Deposit,-2887.333374
866,708474333,4-21-24 18:28,282.02,IncomingTransfer,Freelance Payment,-2605.313374
867,708474333,4-24-24 18:28,294.55,Payment,Mortgage Payment,-2899.863374
868,708474333,4-26-24 21:28,548.44,OnlineShopping,Target,-3448.303374
869,708474333,4-27-24 16:28,441.67,Return,Store Return,-3006.633374
870,708474333,4-27-24 20:28,102.95,Payment,Bill Payment,-3109.583374
871,708474333,4-28-24 17:28,121.98,Purchase,Gas,-3231.563374
872,708474333,05-03-24 21:28,5700,IncomingTransfer,Salary,2468.436626
873,708474333,05-05-24 13:28,176.11,Purchase,Pharmacy,2292.326626
874,708474333,05-06-24 15:28,297.93,Purchase,Entertainment,1994.396626
875,708474333,05-08-24 13:28,157.17,Deposit,Cash Deposit,2151.566626
876,708474333,05-08-24 15:28,268.82,Payment,Loan Payment,1882.746626
877,708474333,05-08-24 20:28,102.39,Withdrawal,ATM Withdrawal,1780.356626
878,708474333,05-08-24 21:28,3400,Payment,Credit Card Payment,-1619.643374
879,708474333,5-13-24 13:28,364.12,OnlineShopping,Best Buy,-1983.763374
880,708474333,5-16-24 22:28,68.9,Deposit,Direct Deposit,-1914.863374
881,708474333,5-17-24 21:28,3100,Payment,Rent Payment,-5014.863374
882,708474333,5-21-24 19:28,432.15,Purchase,Restaurant,-5447.013374
883,708474333,5-25-24 16:28,547.93,Deposit,Direct Deposit,-4899.083374
884,708474333,5-26-24 12:28,428.07,IncomingTransfer,Freelance Payment,-4471.013374
885,708474333,5-27-24 10:28,394.13,Withdrawal,Mobile App Withdrawal,-4865.143374
886,708474333,5-29-24 14:28,405,Deposit,Check Deposit,-4460.143374
887,708474333,5-31-24 9:28,112.43,Withdrawal,Branch Withdrawal,-4572.573374
888,708474333,5-31-24 23:28,283.72,Purchase,Travel,-4856.293374
889,708474333,06-02-24 21:28,5700,IncomingTransfer,Salary,843.706626
890,708474333,06-03-24 19:28,155.09,Withdrawal,Branch Withdrawal,688.616626
891,708474333,06-04-24 21:28,233.85,OutgoingTransfer,Bank Transfer,454.766626
892,708474333,06-05-24 9:28,436.24,Return,Etsy Return,891.006626
893,708474333,06-06-24 13:28,534.09,OutgoingTransfer,Peer-to-Peer Transfer,356.916626
894,708474333,06-07-24 21:28,2900,Payment,Credit Card Payment,-2543.083374
895,708474333,06-08-24 21:28,498.19,Payment,Mortgage Payment,-3041.273374
896,708474333,06-09-24 21:28,277.78,OnlineShopping,Walmart,-3319.053374
897,708474333,6-13-24 13:28,54.66,Purchase,Grocery,-3373.713374
898,708474333,6-13-24 15:28,189.66,Deposit,Mobile Deposit,-3184.053374
899,708474333,6-13-24 21:28,2700,Payment,Rent Payment,-5884.053374
900,708474333,6-14-24 22:28,174.02,Payment,Mortgage Payment,-6058.073374
901,708474333,6-16-24 15:28,110.17,Return,Etsy Return,-5947.903374
902,708474333,6-27-24 9:28,502.62,OutgoingTransfer,Bank Transfer,-6450.523374
903,708474333,6-28-24 20:28,209.32,Purchase,Furniture,-6659.843374
904,708474333,07-05-24 21:28,5700,IncomingTransfer,Salary,-959.843374
905,708474333,07-08-24 19:28,195.67,Deposit,Direct Deposit,-764.173374
906,708474333,07-10-24 21:28,3600,Payment,Credit Card Payment,-4364.173374
907,708474333,07-12-24 13:28,328.13,Purchase,Clothing,-4692.303374
908,708474333,07-12-24 21:28,3300,Payment,Rent Payment,-7992.303374
909,708474333,7-14-24 12:28,409.9,OutgoingTransfer,Wire Transfer,-8402.203374
910,708474333,7-16-24 20:28,294.09,Deposit,Cash Deposit,-8108.113374
911,708474333,7-17-24 12:28,398.36,Purchase,Furniture,-8506.473374
912,708482658,1-22-24 12:28,644.06,Purchase,Travel,1042.87074
913,708482658,1-24-24 17:28,679.02,OnlineShopping,Target,363.8507405
914,708482658,1-25-24 23:28,649.76,Purchase,Restaurant,-285.9092595
915,708482658,1-26-24 20:28,221.44,Purchase,Restaurant,-507.3492595
916,708482658,1-27-24 20:28,550.53,OnlineShopping,Target,-1057.87926
917,708482658,1-28-24 10:28,373.83,Withdrawal,ATM Withdrawal,-1431.70926
918,708482658,1-28-24 18:28,176.58,Deposit,Mobile Deposit,-1255.12926
919,708482658,1-28-24 22:28,230.84,Purchase,Travel,-1485.96926
920,708482658,1-31-24 19:28,745.81,Purchase,Home Improvement,-2231.77926
921,708482658,02-01-24 9:28,595.07,Purchase,Electronics,-2826.84926
922,708482658,02-03-24 21:28,7800,IncomingTransfer,Salary,4973.15074
923,708482658,02-04-24 12:28,250.46,Payment,Mortgage Payment,4722.69074
924,708482658,02-05-24 10:28,401.97,Purchase,Clothing,4320.72074
925,708482658,02-08-24 21:28,2200,Payment,Credit Card Payment,2120.72074
926,708482658,02-09-24 9:28,273.2,Deposit,Cash Deposit,2393.92074
927,708482658,02-10-24 10:28,611.87,Purchase,Furniture,1782.05074
928,708482658,02-10-24 12:28,312.15,Withdrawal,Branch Withdrawal,1469.90074
929,708482658,02-10-24 21:28,3700,Payment,Rent Payment,-2230.09926
930,708482658,02-12-24 22:28,603.86,Deposit,Cash Deposit,-1626.23926
931,708482658,2-16-24 14:28,337.41,Withdrawal,ATM Withdrawal,-1963.64926
932,708482658,2-17-24 13:28,105.11,Purchase,Clothing,-2068.75926
933,708482658,2-25-24 10:28,408.5,Withdrawal,Branch Withdrawal,-2477.25926
934,708482658,2-25-24 13:28,573.97,OnlineShopping,Etsy,-3051.22926
935,708482658,2-26-24 15:28,203.86,Deposit,Cash Deposit,-2847.36926
936,708482658,2-27-24 16:28,327.29,Deposit,Mobile Deposit,-2520.07926
937,708482658,2-27-24 18:28,530.94,Purchase,Home Improvement,-3051.01926
938,708482658,2-29-24 16:28,676.31,OnlineShopping,Target,-3727.32926
939,708482658,03-01-24 21:28,7800,IncomingTransfer,Salary,4072.67074
940,708482658,03-03-24 18:28,391.43,Return,Store Return,4464.10074
941,708482658,03-05-24 9:28,346.03,Withdrawal,Branch Withdrawal,4118.07074
942,708482658,03-05-24 18:28,328.2,OnlineShopping,Walmart,3789.87074
943,708482658,03-06-24 21:28,2100,Payment,Credit Card Payment,1689.87074
944,708482658,03-07-24 11:28,216.69,IncomingTransfer,Freelance Payment,1906.56074
945,708482658,03-07-24 15:28,152.17,Payment,Bill Payment,1754.39074
946,708482658,03-07-24 19:28,587.24,Return,AliExpress Return,2341.63074
947,708482658,03-09-24 14:28,106.52,Purchase,Clothing,2235.11074
948,708482658,03-09-24 20:28,729.24,Purchase,Entertainment,1505.87074
949,708482658,03-10-24 16:28,490.17,OnlineShopping,Etsy,1015.70074
950,708482658,03-11-24 14:28,555.84,Return,Walmart Return,1571.54074
951,708482658,3-13-24 12:28,191.65,Withdrawal,Branch Withdrawal,1379.89074
952,708482658,3-13-24 21:28,3000,Payment,Rent Payment,-1620.10926
953,708482658,3-14-24 9:28,211.35,Return,AliExpress Return,-1408.75926
954,708482658,3-14-24 19:28,717.26,Return,Amazon Return,-691.4992595
955,708482658,3-16-24 13:28,302.44,Deposit,Direct Deposit,-389.0592595
956,708482658,3-16-24 18:28,266.8,Withdrawal,ATM Withdrawal,-655.8592595
957,708482658,3-16-24 20:28,569.79,OutgoingTransfer,Peer-to-Peer Transfer,-1225.64926
958,708482658,3-18-24 17:28,208.31,Withdrawal,Branch Withdrawal,-1433.95926
959,708482658,3-22-24 10:28,449.62,Withdrawal,ATM Withdrawal,-1883.57926
960,708482658,3-24-24 15:28,644.29,Withdrawal,ATM Withdrawal,-2527.86926
961,708482658,3-28-24 21:28,103.46,Deposit,Check Deposit,-2424.40926
962,708482658,3-30-24 11:28,682.76,Withdrawal,Branch Withdrawal,-3107.16926
963,708482658,3-31-24 11:28,424.58,Deposit,Cash Deposit,-2682.58926
964,708482658,3-31-24 17:28,210.89,IncomingTransfer,Freelance Payment,-2471.69926
965,708482658,04-02-24 21:28,7800,IncomingTransfer,Salary,5328.30074
966,708482658,04-07-24 21:28,2100,Payment,Credit Card Payment,3228.30074
967,708482658,04-09-24 22:28,585.68,Deposit,Direct Deposit,3813.98074
968,708482658,04-10-24 21:28,2300,Payment,Rent Payment,1513.98074
969,708482658,04-12-24 9:28,716.82,Withdrawal,ATM Withdrawal,797.1607405
970,708482658,4-16-24 21:28,535.2,Withdrawal,Branch Withdrawal,261.9607405
971,708482658,4-17-24 13:28,255.21,Deposit,Direct Deposit,517.1707405
972,708482658,4-22-24 16:28,226.84,Deposit,Direct Deposit,744.0107405
973,708482658,4-22-24 21:28,195.46,Purchase,Grocery,548.5507405
974,708482658,4-25-24 10:28,600.2,Deposit,Mobile Deposit,1148.75074
975,708482658,4-25-24 10:28,189.62,Purchase,Pharmacy,959.1307405
976,708482658,4-26-24 9:28,149.3,IncomingTransfer,Freelance Payment,1108.43074
977,708482658,4-27-24 13:28,332.67,IncomingTransfer,Freelance Payment,1441.10074
978,708482658,4-27-24 16:28,246.45,Purchase,Gas,1194.65074
979,708482658,4-28-24 14:28,122.79,Purchase,Home Improvement,1071.86074
980,708482658,4-30-24 19:28,254.81,OnlineShopping,Best Buy,817.0507405
981,708482658,4-30-24 21:28,491.75,Payment,Loan Payment,325.3007405
982,708482658,05-03-24 15:28,671.62,Deposit,Direct Deposit,996.9207405
983,708482658,05-03-24 16:28,353.93,Deposit,Mobile Deposit,1350.85074
984,708482658,05-03-24 21:28,7800,IncomingTransfer,Salary,9150.85074
985,708482658,05-05-24 19:28,537.45,OnlineShopping,Target,8613.40074
986,708482658,05-06-24 16:28,159.9,Purchase,Grocery,8453.50074
987,708482658,05-07-24 9:28,593.27,Deposit,Check Deposit,9046.77074
988,708482658,05-08-24 21:28,2000,Payment,Credit Card Payment,7046.77074
989,708482658,05-09-24 15:28,613.59,Purchase,Electronics,6433.18074
990,708482658,05-09-24 19:28,738.36,Purchase,Pharmacy,5694.82074
991,708482658,05-12-24 13:28,328.14,Purchase,Pharmacy,5366.68074
992,708482658,05-12-24 17:28,179.63,Deposit,Check Deposit,5546.31074
993,708482658,5-13-24 23:28,373.13,Withdrawal,ATM Withdrawal,5173.18074
994,708482658,5-15-24 23:28,415.9,OutgoingTransfer,International Transfer,4757.28074
995,708482658,5-16-24 14:28,449.07,Purchase,Entertainment,4308.21074
996,708482658,5-17-24 21:28,4900,Payment,Rent Payment,-591.7892595
997,708482658,5-18-24 10:28,211.16,OutgoingTransfer,International Transfer,-802.9492595
998,708482658,5-19-24 11:28,446.21,Deposit,Cash Deposit,-356.7392595
999,708482658,5-20-24 15:28,106.65,Purchase,Restaurant,-463.3892595
1000,708482658,5-20-24 18:28,405.07,Deposit,Check Deposit,-58.31925953
1001,708482658,5-21-24 13:28,245.03,OutgoingTransfer,Bank Transfer,-303.3492595
1002,708482658,5-21-24 14:28,136.03,Deposit,Cash Deposit,-167.3192595
1003,708482658,5-21-24 16:28,183.32,Purchase,Electronics,-350.6392595
1004,708482658,5-23-24 23:28,114.73,Return,Etsy Return,-235.9092595
1005,708482658,5-24-24 18:28,270.17,Return,Amazon Return,34.26074047
1006,708482658,5-30-24 21:28,345.99,OutgoingTransfer,Bank Transfer,-311.7292595
1007,708482658,06-03-24 21:28,7800,IncomingTransfer,Salary,7488.27074
1008,708482658,06-06-24 9:28,170.55,Return,Best Buy Return,7658.82074
1009,708482658,06-06-24 17:28,574.75,IncomingTransfer,Freelance Payment,8233.57074
1010,708482658,06-08-24 21:28,2800,Payment,Credit Card Payment,5433.57074
1011,708482658,06-10-24 21:28,4700,Payment,Rent Payment,733.5707405
1012,708482658,06-10-24 21:28,430.27,Purchase,Furniture,303.3007405
1013,708482658,06-11-24 21:28,235.86,OutgoingTransfer,Wire Transfer,67.44074047
1014,708482658,6-13-24 12:28,251.57,OutgoingTransfer,Peer-to-Peer Transfer,-184.1292595
1015,708482658,6-15-24 17:28,563.98,Payment,Bill Payment,-748.1092595
1016,708482658,6-16-24 12:28,349.48,Payment,Bill Payment,-1097.58926
1017,708482658,6-16-24 19:28,540.24,Withdrawal,Mobile App Withdrawal,-1637.82926
1018,708482658,6-17-24 14:28,742.93,Purchase,Electronics,-2380.75926
1019,708482658,6-20-24 13:28,369.9,Purchase,Travel,-2750.65926
1020,708482658,6-21-24 20:28,197.37,Payment,Loan Payment,-2948.02926
1021,708482658,6-22-24 17:28,307.73,OnlineShopping,Amazon,-3255.75926
1022,708482658,6-24-24 16:28,266.72,Purchase,Restaurant,-3522.47926
1023,708482658,6-26-24 11:28,120.52,OnlineShopping,Target,-3642.99926
1024,708482658,6-27-24 10:28,433.22,OnlineShopping,Best Buy,-4076.21926
1025,708482658,6-28-24 23:28,162.84,Withdrawal,Mobile App Withdrawal,-4239.05926
1026,708482658,07-01-24 13:28,267.95,Withdrawal,Mobile App Withdrawal,-4507.00926
1027,708482658,07-01-24 21:28,7800,IncomingTransfer,Salary,3292.99074
1028,708482658,07-02-24 10:28,680.08,Purchase,Pharmacy,2612.91074
1029,708482658,07-04-24 13:28,144.24,Deposit,Check Deposit,2757.15074
1030,708482658,07-05-24 17:28,149.89,Return,Target Return,2907.04074
1031,708482658,07-05-24 20:28,201.66,Purchase,Travel,2705.38074
1032,708482658,07-06-24 11:28,577.92,Withdrawal,ATM Withdrawal,2127.46074
1033,708482658,07-06-24 14:28,503.77,Return,eBay Return,2631.23074
1034,708482658,07-06-24 21:28,2000,Payment,Credit Card Payment,631.2307405
1035,708482658,07-07-24 12:28,706.93,Purchase,Grocery,-75.69925953
1036,708482658,07-09-24 11:28,729.16,Purchase,Restaurant,-804.8592595
1037,708482658,07-09-24 17:28,406.91,IncomingTransfer,Freelance Payment,-397.9492595
1038,708482658,07-11-24 17:28,359.42,Deposit,Direct Deposit,-38.52925953
1039,708482658,07-11-24 21:28,508.01,Purchase,Restaurant,-546.5392595
1040,708482658,07-12-24 12:28,256.34,Payment,Loan Payment,-802.8792595
1041,708482658,7-13-24 11:28,452.74,Return,Best Buy Return,-350.1392595
1042,708482658,7-15-24 10:28,456.86,Purchase,Grocery,-806.9992595
1043,708482658,7-17-24 21:28,2500,Payment,Rent Payment,-3306.99926
1044,708525108,1-24-24 15:28,208.13,OutgoingTransfer,Wire Transfer,402.8205154
1045,708525108,1-29-24 18:28,226.05,Deposit,Direct Deposit,628.8705154
1046,708525108,1-30-24 13:28,281.7,Payment,Mortgage Payment,347.1705154
1047,708525108,02-01-24 9:28,173.85,Deposit,Mobile Deposit,521.0205154
1048,708525108,02-01-24 15:28,393.92,Deposit,Direct Deposit,914.9405154
1049,708525108,02-04-24 21:28,2450,IncomingTransfer,Salary,3364.940515
1050,708525108,02-09-24 9:28,230.64,OutgoingTransfer,Peer-to-Peer Transfer,3134.300515
1051,708525108,02-09-24 21:28,1700,Payment,Credit Card Payment,1434.300515
1052,708525108,02-12-24 13:28,324.71,IncomingTransfer,Freelance Payment,1759.010515
1053,708525108,2-16-24 21:28,271.76,Payment,Loan Payment,1487.250515
1054,708525108,2-18-24 21:28,900,Payment,Rent Payment,587.2505154
1055,708525108,2-19-24 10:28,45.02,Purchase,Restaurant,542.2305154
1056,708525108,2-24-24 16:28,489.07,OnlineShopping,Target,53.16051543
1057,708525108,2-26-24 18:28,379.84,OnlineShopping,AliExpress,-326.6794846
1058,708525108,03-01-24 21:28,2450,IncomingTransfer,Salary,2123.320515
1059,708525108,03-01-24 23:28,52.24,Purchase,Grocery,2071.080515
1060,708525108,03-02-24 10:28,265.9,Purchase,Pharmacy,1805.180515
1061,708525108,03-04-24 13:28,181.88,Purchase,Entertainment,1623.300515
1062,708525108,03-04-24 23:28,241.63,Deposit,Direct Deposit,1864.930515
1063,708525108,03-05-24 10:28,340.55,Deposit,Cash Deposit,2205.480515
1064,708525108,03-06-24 21:28,1200,Payment,Credit Card Payment,1005.480515
1065,708525108,03-06-24 23:28,441.87,Purchase,Pharmacy,563.6105154
1066,708525108,03-08-24 14:28,410.36,Return,AliExpress Return,973.9705154
1067,708525108,03-10-24 21:28,104.62,Return,Target Return,1078.590515
1068,708525108,3-15-24 21:28,1100,Payment,Rent Payment,-21.40948457
1069,708525108,3-16-24 21:28,243.59,OutgoingTransfer,Bank Transfer,-264.9994846
1070,708525108,3-20-24 10:28,218.82,Withdrawal,Mobile App Withdrawal,-483.8194846
1071,708525108,3-24-24 10:28,309.21,OutgoingTransfer,Wire Transfer,-793.0294846
1072,708525108,3-27-24 9:28,178.89,Withdrawal,ATM Withdrawal,-971.9194846
1073,708525108,04-03-24 18:28,393.3,OutgoingTransfer,Wire Transfer,-1365.219485
1074,708525108,04-04-24 21:28,2450,IncomingTransfer,Salary,1084.780515
1075,708525108,04-05-24 15:28,217.75,Payment,Bill Payment,867.0305154
1076,708525108,04-06-24 21:28,200.39,Purchase,Home Improvement,666.6405154
1077,708525108,04-08-24 18:28,19.95,Deposit,Cash Deposit,686.5905154
1078,708525108,04-09-24 11:28,379.11,OnlineShopping,AliExpress,307.4805154
1079,708525108,04-09-24 15:28,495.38,Purchase,Travel,-187.8994846
1080,708525108,04-09-24 21:28,1600,Payment,Credit Card Payment,-1787.899485
1081,708525108,04-11-24 14:28,389.6,Withdrawal,Branch Withdrawal,-2177.499485
1082,708525108,4-14-24 11:28,318.95,Purchase,Gas,-2496.449485
1083,708525108,4-16-24 21:28,1200,Payment,Rent Payment,-3696.449485
1084,708525108,4-16-24 21:28,55.59,OutgoingTransfer,Peer-to-Peer Transfer,-3752.039485
1085,708525108,4-18-24 21:28,175.09,Payment,Bill Payment,-3927.129485
1086,708525108,4-20-24 19:28,424,Withdrawal,Mobile App Withdrawal,-4351.129485
1087,708525108,4-23-24 18:28,203.3,Return,Walmart Return,-4147.829485
1088,708525108,4-23-24 20:28,224.11,IncomingTransfer,Freelance Payment,-3923.719485
1089,708525108,4-24-24 17:28,194.79,Purchase,Clothing,-4118.509485
1090,708525108,4-26-24 23:28,402.65,Withdrawal,Mobile App Withdrawal,-4521.159485
1091,708525108,4-27-24 22:28,35.16,Deposit,Check Deposit,-4485.999485
1092,708525108,4-28-24 16:28,263.94,OnlineShopping,Walmart,-4749.939485
1093,708525108,4-28-24 21:28,281.76,Withdrawal,Branch Withdrawal,-5031.699485
1094,708525108,4-29-24 10:28,108.34,Deposit,Check Deposit,-4923.359485
1095,708525108,4-30-24 20:28,326.96,Return,Walmart Return,-4596.399485
1096,708525108,05-04-24 17:28,127.25,OnlineShopping,Target,-4723.649485
1097,708525108,05-04-24 21:28,2450,IncomingTransfer,Salary,-2273.649485
1098,708525108,05-06-24 12:28,335.36,Payment,Mortgage Payment,-2609.009485
1099,708525108,05-07-24 23:28,184.11,Payment,Loan Payment,-2793.119485
1100,708525108,05-09-24 21:28,1200,Payment,Credit Card Payment,-3993.119485
1101,708525108,05-10-24 21:28,1100,Payment,Rent Payment,-5093.119485
1102,708525108,05-11-24 15:28,149.46,Deposit,Check Deposit,-4943.659485
1103,708525108,5-14-24 23:28,293.7,Return,Target Return,-4649.959485
1104,708525108,5-21-24 11:28,387.61,Return,Etsy Return,-4262.349485
1105,708525108,5-25-24 19:28,328.54,Purchase,Furniture,-4590.889485
1106,708525108,06-01-24 21:28,2450,IncomingTransfer,Salary,-2140.889485
1107,708525108,06-05-24 19:28,374.52,Purchase,Clothing,-2515.409485
1108,708525108,06-06-24 21:28,1700,Payment,Credit Card Payment,-4215.409485
1109,708525108,06-06-24 22:28,479.33,OutgoingTransfer,Peer-to-Peer Transfer,-4694.739485
1110,708525108,06-08-24 12:28,285.61,Payment,Bill Payment,-4980.349485
1111,708525108,06-11-24 21:28,1500,Payment,Rent Payment,-6480.349485
1112,708525108,6-13-24 22:28,445.41,OnlineShopping,AliExpress,-6925.759485
1113,708525108,6-14-24 13:28,182.83,Purchase,Furniture,-7108.589485
1114,708525108,6-14-24 18:28,266.98,OnlineShopping,AliExpress,-7375.569485
1115,708525108,6-14-24 22:28,113,OnlineShopping,eBay,-7488.569485
1116,708525108,6-15-24 18:28,356.39,Purchase,Restaurant,-7844.959485
1117,708525108,6-15-24 21:28,101.55,Deposit,Direct Deposit,-7743.409485
1118,708525108,6-16-24 13:28,289.34,OutgoingTransfer,Peer-to-Peer Transfer,-8032.749485
1119,708525108,6-17-24 20:28,302.1,Deposit,Mobile Deposit,-7730.649485
1120,708525108,6-18-24 12:28,141.37,Payment,Mortgage Payment,-7872.019485
1121,708525108,6-18-24 21:28,306.35,Purchase,Entertainment,-8178.369485
1122,708525108,6-22-24 10:28,395.54,OnlineShopping,Walmart,-8573.909485
1123,708525108,6-22-24 21:28,76.6,IncomingTransfer,Freelance Payment,-8497.309485
1124,708525108,6-23-24 10:28,280.97,Deposit,Mobile Deposit,-8216.339485
1125,708525108,6-25-24 11:28,110.49,Deposit,Mobile Deposit,-8105.849485
1126,708525108,6-26-24 18:28,57.13,OnlineShopping,eBay,-8162.979485
1127,708525108,6-27-24 9:28,197.1,Return,Best Buy Return,-7965.879485
1128,708525108,6-27-24 22:28,116.73,Purchase,Entertainment,-8082.609485
1129,708525108,07-01-24 13:28,405.2,Payment,Loan Payment,-8487.809485
1130,708525108,07-02-24 15:28,158.95,Payment,Mortgage Payment,-8646.759485
1131,708525108,07-04-24 21:28,2450,IncomingTransfer,Salary,-6196.759485
1132,708525108,07-06-24 15:28,155.76,Withdrawal,Branch Withdrawal,-6352.519485
1133,708525108,07-07-24 18:28,25.87,Deposit,Mobile Deposit,-6326.649485
1134,708525108,07-09-24 21:28,1200,Payment,Credit Card Payment,-7526.649485
1135,708525108,07-10-24 16:28,184.23,Payment,Mortgage Payment,-7710.879485
1136,708525108,07-11-24 21:28,1000,Payment,Rent Payment,-8710.879485
1137,708525108,7-16-24 15:28,473.87,Purchase,Gas,-9184.749485
1138,708525108,7-16-24 19:28,298.88,OutgoingTransfer,Wire Transfer,-9483.629485
1139,708597558,1-28-24 20:28,425.21,Purchase,Home Improvement,280.6531139
1140,708597558,02-02-24 14:28,210.27,Deposit,Direct Deposit,490.9231139
1141,708597558,02-02-24 21:28,6300,IncomingTransfer,Salary,6790.923114
1142,708597558,02-03-24 15:28,338.02,Return,Best Buy Return,7128.943114
1143,708597558,02-04-24 17:28,479.18,Purchase,Home Improvement,6649.763114
1144,708597558,02-07-24 11:28,123.92,Purchase,Furniture,6525.843114
1145,708597558,02-07-24 21:28,1000,Payment,Credit Card Payment,5525.843114
1146,708597558,02-12-24 17:28,353.67,Return,eBay Return,5879.513114
1147,708597558,2-13-24 21:28,3300,Payment,Rent Payment,2579.513114
1148,708597558,2-15-24 13:28,417.89,Return,Etsy Return,2997.403114
1149,708597558,2-15-24 14:28,76.98,Withdrawal,Branch Withdrawal,2920.423114
1150,708597558,2-18-24 11:28,96.98,Purchase,Restaurant,2823.443114
1151,708597558,2-20-24 12:28,383.06,Purchase,Restaurant,2440.383114
1152,708597558,2-20-24 22:28,299.17,IncomingTransfer,Freelance Payment,2739.553114
1153,708597558,2-20-24 23:28,209.97,Withdrawal,Mobile App Withdrawal,2529.583114
1154,708597558,2-29-24 15:28,274.39,Payment,Bill Payment,2255.193114
1155,708597558,03-02-24 11:28,548.04,OutgoingTransfer,Wire Transfer,1707.153114
1156,708597558,03-02-24 12:28,456.66,IncomingTransfer,Freelance Payment,2163.813114
1157,708597558,03-02-24 21:28,6300,IncomingTransfer,Salary,8463.813114
1158,708597558,03-04-24 16:28,436.33,Withdrawal,Branch Withdrawal,8027.483114
1159,708597558,03-04-24 20:28,52.22,IncomingTransfer,Freelance Payment,8079.703114
1160,708597558,03-06-24 15:28,478.98,Return,Walmart Return,8558.683114
1161,708597558,03-07-24 17:28,390.3,OutgoingTransfer,Bank Transfer,8168.383114
1162,708597558,03-07-24 21:28,800,Payment,Credit Card Payment,7368.383114
1163,708597558,03-11-24 21:28,3800,Payment,Rent Payment,3568.383114
1164,708597558,03-12-24 14:28,225.31,Purchase,Pharmacy,3343.073114
1165,708597558,3-13-24 10:28,311.98,OutgoingTransfer,Peer-to-Peer Transfer,3031.093114
1166,708597558,3-13-24 10:28,415.9,Deposit,Check Deposit,3446.993114
1167,708597558,3-13-24 19:28,143.69,Withdrawal,ATM Withdrawal,3303.303114
1168,708597558,3-16-24 11:28,99.33,Payment,Loan Payment,3203.973114
1169,708597558,3-17-24 12:28,94.73,OutgoingTransfer,International Transfer,3109.243114
1170,708597558,3-20-24 12:28,435.58,OutgoingTransfer,International Transfer,2673.663114
1171,708597558,3-23-24 12:28,67.05,Withdrawal,Mobile App Withdrawal,2606.613114
1172,708597558,3-25-24 13:28,484.19,Purchase,Furniture,2122.423114
1173,708597558,3-26-24 14:28,162.17,Payment,Bill Payment,1960.253114
1174,708597558,04-02-24 19:28,214.9,Deposit,Check Deposit,2175.153114
1175,708597558,04-03-24 16:28,389.56,Withdrawal,Mobile App Withdrawal,1785.593114
1176,708597558,04-04-24 21:28,6300,IncomingTransfer,Salary,8085.593114
1177,708597558,04-05-24 17:28,423.31,Deposit,Mobile Deposit,8508.903114
1178,708597558,04-06-24 10:28,317.01,Purchase,Home Improvement,8191.893114
1179,708597558,04-08-24 15:28,506.79,Purchase,Electronics,7685.103114
1180,708597558,04-09-24 21:28,1000,Payment,Credit Card Payment,6685.103114
1181,708597558,04-12-24 14:28,532.73,IncomingTransfer,Freelance Payment,7217.833114
1182,708597558,4-18-24 21:28,2800,Payment,Rent Payment,4417.833114
1183,708597558,05-05-24 21:28,6300,IncomingTransfer,Salary,10717.83311
1184,708597558,05-10-24 21:28,1000,Payment,Credit Card Payment,9717.833114
1185,708597558,05-12-24 21:28,3200,Payment,Rent Payment,6517.833114
1186,708597558,5-14-24 9:28,369.41,IncomingTransfer,Freelance Payment,6887.243114
1187,708597558,5-14-24 18:28,173.34,Return,Target Return,7060.583114
1188,708597558,5-17-24 16:28,395.4,IncomingTransfer,Freelance Payment,7455.983114
1189,708597558,5-17-24 16:28,157.4,OutgoingTransfer,Bank Transfer,7298.583114
1190,708597558,5-19-24 20:28,348.85,Return,Etsy Return,7647.433114
1191,708597558,5-19-24 22:28,264.76,Withdrawal,Branch Withdrawal,7382.673114
1192,708597558,5-21-24 9:28,214.55,OutgoingTransfer,Wire Transfer,7168.123114
1193,708597558,5-21-24 19:28,101.63,Payment,Bill Payment,7066.493114
1194,708597558,5-23-24 19:28,435.52,Purchase,Pharmacy,6630.973114
1195,708597558,5-24-24 14:28,248.49,Deposit,Mobile Deposit,6879.463114
1196,708597558,5-27-24 9:28,52.28,Deposit,Check Deposit,6931.743114
1197,708597558,5-29-24 21:28,82.25,Return,Amazon Return,7013.993114
1198,708597558,5-30-24 15:28,278.37,Deposit,Check Deposit,7292.363114
1199,708597558,06-04-24 11:28,479.28,Return,Walmart Return,7771.643114
1200,708597558,06-04-24 21:28,6300,IncomingTransfer,Salary,14071.64311
1201,708597558,06-08-24 12:28,509.05,Return,AliExpress Return,14580.69311
1202,708597558,06-08-24 21:28,469.17,OnlineShopping,Amazon,14111.52311
1203,708597558,06-09-24 10:28,441.45,OutgoingTransfer,Bank Transfer,13670.07311
1204,708597558,06-09-24 11:28,105.13,Deposit,Mobile Deposit,13775.20311
1205,708597558,06-09-24 21:28,1000,Payment,Credit Card Payment,12775.20311
1206,708597558,6-13-24 23:28,393.71,Deposit,Direct Deposit,13168.91311
1207,708597558,6-16-24 21:28,2400,Payment,Rent Payment,10768.91311
1208,708597558,6-21-24 13:28,302.2,OnlineShopping,eBay,10466.71311
1209,708597558,6-21-24 17:28,344.74,Deposit,Direct Deposit,10811.45311
1210,708597558,6-23-24 21:28,422.49,OnlineShopping,Target,10388.96311
1211,708597558,6-23-24 21:28,453.79,Withdrawal,Branch Withdrawal,9935.173114
1212,708597558,6-24-24 13:28,220.1,OutgoingTransfer,International Transfer,9715.073114
1213,708597558,6-29-24 16:28,459.23,Withdrawal,Mobile App Withdrawal,9255.843114
1214,708597558,07-01-24 21:28,6300,IncomingTransfer,Salary,15555.84311
1215,708597558,07-02-24 14:28,365.02,Purchase,Pharmacy,15190.82311
1216,708597558,07-03-24 9:28,445.11,Purchase,Pharmacy,14745.71311
1217,708597558,07-03-24 12:28,249.57,Purchase,Grocery,14496.14311
1218,708597558,07-03-24 16:28,442.28,Return,eBay Return,14938.42311
1219,708597558,07-03-24 22:28,156.49,Withdrawal,Branch Withdrawal,14781.93311
1220,708597558,07-06-24 18:28,406.88,OnlineShopping,Etsy,14375.05311
1221,708597558,07-06-24 21:28,1200,Payment,Credit Card Payment,13175.05311
1222,708597558,07-06-24 21:28,513.96,OutgoingTransfer,Bank Transfer,12661.09311
1223,708597558,07-10-24 21:28,3200,Payment,Rent Payment,9461.093114
1224,708597558,7-14-24 12:28,439.4,Purchase,Grocery,9021.693114
1225,708646233,1-27-24 17:28,236.93,IncomingTransfer,Freelance Payment,1192.880497
1226,708646233,1-28-24 11:28,491.8,Withdrawal,Mobile App Withdrawal,701.0804965
1227,708646233,1-29-24 10:28,320.65,Payment,Bill Payment,380.4304965
1228,708646233,1-30-24 11:28,148.27,Purchase,Travel,232.1604965
1229,708646233,02-03-24 22:28,50.86,Payment,Bill Payment,181.3004965
1230,708646233,02-04-24 21:28,4800,IncomingTransfer,Salary,4981.300497
1231,708646233,02-09-24 21:28,1700,Payment,Credit Card Payment,3281.300497
1232,708646233,2-17-24 21:28,2900,Payment,Rent Payment,381.3004965
1233,708646233,2-19-24 14:28,341.95,OnlineShopping,eBay,39.35049651
1234,708646233,2-27-24 11:28,444.31,OutgoingTransfer,Wire Transfer,-404.9595035
1235,708646233,03-04-24 21:28,4800,IncomingTransfer,Salary,4395.040497
1236,708646233,03-09-24 21:28,1600,Payment,Credit Card Payment,2795.040497
1237,708646233,3-15-24 17:28,496.81,Deposit,Direct Deposit,3291.850497
1238,708646233,3-16-24 21:28,2300,Payment,Rent Payment,991.8504965
1239,708646233,3-18-24 17:28,454.05,IncomingTransfer,Freelance Payment,1445.900497
1240,708646233,3-20-24 20:28,199.79,Purchase,Furniture,1246.110497
1241,708646233,3-31-24 15:28,127.41,Return,Etsy Return,1373.520497
1242,708646233,04-04-24 21:28,4800,IncomingTransfer,Salary,6173.520497
1243,708646233,04-05-24 10:28,360.92,Withdrawal,Branch Withdrawal,5812.600497
1244,708646233,04-08-24 17:28,109.39,Payment,Bill Payment,5703.210497
1245,708646233,04-09-24 21:28,1500,Payment,Credit Card Payment,4203.210497
1246,708646233,04-10-24 21:28,314.69,OnlineShopping,Walmart,3888.520497
1247,708646233,04-12-24 20:28,372.47,OutgoingTransfer,Wire Transfer,3516.050497
1248,708646233,04-12-24 20:28,416.88,Purchase,Pharmacy,3099.170497
1249,708646233,04-12-24 21:28,2800,Payment,Rent Payment,299.1704965
1250,708646233,4-15-24 17:28,353.38,Purchase,Grocery,-54.20950349
1251,708646233,4-19-24 23:28,392.87,Purchase,Entertainment,-447.0795035
1252,708646233,4-21-24 12:28,39.87,OutgoingTransfer,Bank Transfer,-486.9495035
1253,708646233,4-21-24 20:28,390.39,Withdrawal,Branch Withdrawal,-877.3395035
1254,708646233,4-23-24 23:28,489.54,Purchase,Clothing,-1366.879503
1255,708646233,4-23-24 23:28,347.86,Withdrawal,Mobile App Withdrawal,-1714.739503
1256,708646233,4-24-24 17:28,77.89,Purchase,Grocery,-1792.629503
1257,708646233,4-25-24 23:28,227.48,OutgoingTransfer,International Transfer,-2020.109503
1258,708646233,4-26-24 10:28,458.35,OnlineShopping,Amazon,-2478.459503
1259,708646233,4-27-24 22:28,327.28,OnlineShopping,Target,-2805.739503
1260,708646233,4-29-24 12:28,347.59,Return,Walmart Return,-2458.149503
1261,708646233,05-02-24 18:28,337.35,OnlineShopping,Walmart,-2795.499503
1262,708646233,05-02-24 18:28,94.8,OutgoingTransfer,Peer-to-Peer Transfer,-2890.299503
1263,708646233,05-02-24 21:28,4800,IncomingTransfer,Salary,1909.700497
1264,708646233,05-07-24 21:28,1500,Payment,Credit Card Payment,409.7004965
1265,708646233,05-08-24 17:28,87.96,Purchase,Furniture,321.7404965
1266,708646233,05-12-24 21:28,3000,Payment,Rent Payment,-2678.259503
1267,708646233,5-15-24 18:28,316.66,IncomingTransfer,Freelance Payment,-2361.599503
1268,708646233,5-21-24 15:28,84.15,Deposit,Mobile Deposit,-2277.449503
1269,708646233,5-28-24 22:28,270.72,Purchase,Travel,-2548.169503
1270,708646233,5-29-24 13:28,173.44,OutgoingTransfer,Peer-to-Peer Transfer,-2721.609503
1271,708646233,5-30-24 14:28,468.7,OutgoingTransfer,Bank Transfer,-3190.309503
1272,708646233,5-31-24 23:28,287.34,Return,Walmart Return,-2902.969503
1273,708646233,06-01-24 18:28,314.34,Purchase,Furniture,-3217.309503
1274,708646233,06-02-24 21:28,4800,IncomingTransfer,Salary,1582.690497
1275,708646233,06-07-24 21:28,1700,Payment,Credit Card Payment,-117.3095035
1276,708646233,06-09-24 22:28,60.53,OnlineShopping,Amazon,-177.8395035
1277,708646233,06-12-24 21:28,2700,Payment,Rent Payment,-2877.839503
1278,708646233,6-20-24 9:28,437.52,OutgoingTransfer,Bank Transfer,-3315.359503
1279,708646233,6-20-24 11:28,287.94,Deposit,Direct Deposit,-3027.419503
1280,708646233,6-21-24 15:28,93.42,Purchase,Pharmacy,-3120.839503
1281,708646233,07-01-24 21:28,4800,IncomingTransfer,Salary,1679.160497
1282,708646233,07-05-24 18:28,436.71,OutgoingTransfer,International Transfer,1242.450497
1283,708646233,07-06-24 13:28,277.35,Withdrawal,Branch Withdrawal,965.1004965
1284,708646233,07-06-24 21:28,1900,Payment,Credit Card Payment,-934.8995035
1285,708646233,07-06-24 22:28,450.97,Deposit,Direct Deposit,-483.9295035
1286,708646233,07-09-24 20:28,368.24,Withdrawal,ATM Withdrawal,-852.1695035
1287,708646233,07-10-24 9:28,221.64,OutgoingTransfer,Wire Transfer,-1073.809503
1288,708646233,07-12-24 14:28,462.24,Return,Walmart Return,-611.5695035
1289,708646233,07-12-24 19:28,449.01,OutgoingTransfer,Wire Transfer,-1060.579503
1290,708646233,7-14-24 10:28,30.37,Deposit,Check Deposit,-1030.209503
1291,708646233,7-17-24 11:28,452.49,Deposit,Cash Deposit,-577.7195035
1292,708646233,7-17-24 21:28,2800,Payment,Rent Payment,-3377.719503
1293,708689958,1-21-24 12:28,106.18,Purchase,Gas,891.2066896
1294,708689958,1-22-24 13:28,102.41,Return,Target Return,993.6166896
1295,708689958,1-22-24 16:28,112.64,Return,Target Return,1106.25669
1296,708689958,1-24-24 15:28,115.2,Purchase,Gas,991.0566896
1297,708689958,1-25-24 15:28,176.63,Deposit,Cash Deposit,1167.68669
1298,708689958,1-27-24 22:28,239.71,Purchase,Gas,927.9766896
1299,708689958,1-30-24 21:28,57.69,OutgoingTransfer,Bank Transfer,870.2866896
1300,708689958,1-31-24 10:28,86.11,Deposit,Check Deposit,956.3966896
1301,708689958,02-01-24 11:28,181.69,Purchase,Travel,774.7066896
1302,708689958,02-01-24 21:28,2700,IncomingTransfer,Salary,3474.70669
1303,708689958,02-02-24 13:28,110.61,Deposit,Cash Deposit,3585.31669
1304,708689958,02-03-24 19:28,15.75,Withdrawal,ATM Withdrawal,3569.56669
1305,708689958,02-04-24 12:28,51.9,Deposit,Cash Deposit,3621.46669
1306,708689958,02-04-24 15:28,158.16,Payment,Loan Payment,3463.30669
1307,708689958,02-05-24 20:28,54.29,Purchase,Furniture,3409.01669
1308,708689958,02-06-24 21:28,2400,Payment,Credit Card Payment,1009.01669
1309,708689958,02-11-24 20:28,64.36,OutgoingTransfer,Wire Transfer,944.6566896
1310,708689958,2-13-24 19:28,242.08,Payment,Loan Payment,702.5766896
1311,708689958,2-13-24 23:28,53.3,Payment,Loan Payment,649.2766896
1312,708689958,2-15-24 9:28,188.83,Withdrawal,Branch Withdrawal,460.4466896
1313,708689958,2-16-24 13:28,92.52,IncomingTransfer,Freelance Payment,552.9666896
1314,708689958,2-17-24 15:28,185.43,Withdrawal,ATM Withdrawal,367.5366896
1315,708689958,2-17-24 21:28,800,Payment,Rent Payment,-432.4633104
1316,708689958,2-21-24 16:28,223.07,OnlineShopping,Best Buy,-655.5333104
1317,708689958,2-24-24 19:28,73.91,Withdrawal,ATM Withdrawal,-729.4433104
1318,708689958,03-01-24 17:28,135.02,Purchase,Pharmacy,-864.4633104
1319,708689958,03-02-24 20:28,66.42,Purchase,Entertainment,-930.8833104
1320,708689958,03-02-24 21:28,2700,IncomingTransfer,Salary,1769.11669
1321,708689958,03-04-24 18:28,82.81,Purchase,Gas,1686.30669
1322,708689958,03-05-24 11:28,238.94,OnlineShopping,Etsy,1447.36669
1323,708689958,03-05-24 13:28,61.21,Return,eBay Return,1508.57669
1324,708689958,03-07-24 21:28,2600,Payment,Credit Card Payment,-1091.42331
1325,708689958,03-09-24 13:28,160.87,Payment,Mortgage Payment,-1252.29331
1326,708689958,03-12-24 16:28,161.72,Deposit,Check Deposit,-1090.57331
1327,708689958,3-14-24 23:28,82.91,IncomingTransfer,Freelance Payment,-1007.66331
1328,708689958,3-15-24 14:28,154.16,Withdrawal,Branch Withdrawal,-1161.82331
1329,708689958,3-16-24 21:28,1300,Payment,Rent Payment,-2461.82331
1330,708689958,3-18-24 18:28,220.96,Withdrawal,Mobile App Withdrawal,-2682.78331
1331,708689958,3-19-24 19:28,80.31,Return,Store Return,-2602.47331
1332,708689958,3-26-24 9:28,102.24,Payment,Bill Payment,-2704.71331
1333,708689958,3-27-24 11:28,146.45,Purchase,Furniture,-2851.16331
1334,708689958,3-27-24 13:28,247.49,OutgoingTransfer,Wire Transfer,-3098.65331
1335,708689958,04-02-24 21:28,2700,IncomingTransfer,Salary,-398.6533104
1336,708689958,04-02-24 22:28,124.66,Deposit,Direct Deposit,-273.9933104
1337,708689958,04-03-24 14:28,167.9,Deposit,Direct Deposit,-106.0933104
1338,708689958,04-06-24 13:28,64.21,Withdrawal,Mobile App Withdrawal,-170.3033104
1339,708689958,04-07-24 21:28,2200,Payment,Credit Card Payment,-2370.30331
1340,708689958,04-11-24 20:28,121,OnlineShopping,Etsy,-2491.30331
1341,708689958,04-12-24 20:28,194.14,OnlineShopping,eBay,-2685.44331
1342,708689958,04-12-24 20:28,177.06,Return,Best Buy Return,-2508.38331
1343,708689958,4-16-24 21:28,800,Payment,Rent Payment,-3308.38331
1344,708689958,4-20-24 14:28,228.86,IncomingTransfer,Freelance Payment,-3079.52331
1345,708689958,4-25-24 19:28,60.08,Withdrawal,ATM Withdrawal,-3139.60331
1346,708689958,4-27-24 21:28,233.79,Return,Best Buy Return,-2905.81331
1347,708689958,4-29-24 10:28,213.55,Withdrawal,Branch Withdrawal,-3119.36331
1348,708689958,4-30-24 22:28,67.46,Payment,Bill Payment,-3186.82331
1349,708689958,05-01-24 13:28,216.72,OnlineShopping,Target,-3403.54331
1350,708689958,05-02-24 16:28,106.81,Deposit,Cash Deposit,-3296.73331
1351,708689958,05-03-24 16:28,163.43,Purchase,Restaurant,-3460.16331
1352,708689958,05-03-24 21:28,2700,IncomingTransfer,Salary,-760.1633104
1353,708689958,05-04-24 14:28,101.43,Payment,Loan Payment,-861.5933104
1354,708689958,05-08-24 13:28,105.92,Withdrawal,Mobile App Withdrawal,-967.5133104
1355,708689958,05-08-24 21:28,2600,Payment,Credit Card Payment,-3567.51331
1356,708689958,05-11-24 21:28,1500,Payment,Rent Payment,-5067.51331
1357,708689958,05-12-24 13:28,142.94,Deposit,Check Deposit,-4924.57331
1358,708689958,5-15-24 17:28,128.96,Purchase,Clothing,-5053.53331
1359,708689958,5-16-24 14:28,86.29,Withdrawal,Mobile App Withdrawal,-5139.82331
1360,708689958,5-17-24 17:28,217.14,Withdrawal,Branch Withdrawal,-5356.96331
1361,708689958,5-17-24 20:28,55.19,Purchase,Pharmacy,-5412.15331
1362,708689958,5-20-24 21:28,120.85,Deposit,Direct Deposit,-5291.30331
1363,708689958,5-21-24 22:28,150.23,OutgoingTransfer,Peer-to-Peer Transfer,-5441.53331
1364,708689958,5-22-24 19:28,68.36,Purchase,Gas,-5509.89331
1365,708689958,5-24-24 21:28,123.63,Return,AliExpress Return,-5386.26331
1366,708689958,5-24-24 22:28,60.35,Return,Walmart Return,-5325.91331
1367,708689958,5-25-24 12:28,236.66,Deposit,Check Deposit,-5089.25331
1368,708689958,5-25-24 16:28,15.48,Purchase,Gas,-5104.73331
1369,708689958,5-25-24 18:28,209.71,Purchase,Gas,-5314.44331
1370,708689958,06-01-24 21:28,180.95,Withdrawal,Branch Withdrawal,-5495.39331
1371,708689958,06-02-24 21:28,2700,IncomingTransfer,Salary,-2795.39331
1372,708689958,06-04-24 22:28,37.58,OutgoingTransfer,Peer-to-Peer Transfer,-2832.97331
1373,708689958,06-07-24 9:28,96.8,Withdrawal,ATM Withdrawal,-2929.77331
1374,708689958,06-07-24 21:28,1800,Payment,Credit Card Payment,-4729.77331
1375,708689958,06-10-24 21:28,1300,Payment,Rent Payment,-6029.77331
1376,708689958,06-12-24 15:28,188.82,Withdrawal,ATM Withdrawal,-6218.59331
1377,708689958,6-15-24 12:28,210.56,Purchase,Home Improvement,-6429.15331
1378,708689958,6-15-24 16:28,224.62,Return,Walmart Return,-6204.53331
1379,708689958,6-18-24 19:28,227.54,Withdrawal,Mobile App Withdrawal,-6432.07331
1380,708689958,6-18-24 22:28,147.95,Deposit,Check Deposit,-6284.12331
1381,708689958,6-24-24 23:28,210.75,Return,Amazon Return,-6073.37331
1382,708689958,6-25-24 15:28,173.23,IncomingTransfer,Freelance Payment,-5900.14331
1383,708689958,6-26-24 19:28,156.17,Withdrawal,Mobile App Withdrawal,-6056.31331
1384,708689958,6-29-24 16:28,160.83,Withdrawal,Mobile App Withdrawal,-6217.14331
1385,708689958,6-29-24 20:28,201.48,Return,Etsy Return,-6015.66331
1386,708689958,6-30-24 14:28,16.27,Withdrawal,Branch Withdrawal,-6031.93331
1387,708689958,07-01-24 16:28,246.78,Purchase,Electronics,-6278.71331
1388,708689958,07-02-24 12:28,175.25,Return,Etsy Return,-6103.46331
1389,708689958,07-03-24 14:28,191.77,OutgoingTransfer,International Transfer,-6295.23331
1390,708689958,07-04-24 21:28,2700,IncomingTransfer,Salary,-3595.23331
1391,708689958,07-05-24 20:28,166.32,Withdrawal,Mobile App Withdrawal,-3761.55331
1392,708689958,07-06-24 21:28,137.95,Deposit,Mobile Deposit,-3623.60331
1393,708689958,07-09-24 21:28,2100,Payment,Credit Card Payment,-5723.60331
1394,708689958,07-11-24 18:28,68.31,Deposit,Direct Deposit,-5655.29331
1395,708689958,7-13-24 21:28,1600,Payment,Rent Payment,-7255.29331
1396,708689958,7-16-24 13:28,200.2,Return,Walmart Return,-7055.09331
1397,708689958,7-17-24 10:28,227.17,Purchase,Clothing,-7282.26331
1398,708689958,7-17-24 17:28,113.3,OutgoingTransfer,Peer-to-Peer Transfer,-7395.56331
1399,708704433,1-20-24 18:28,102.22,Purchase,Travel,1129.076988
1400,708704433,1-25-24 15:28,440.29,Purchase,Electronics,688.7869879
1401,708704433,1-25-24 20:28,318.53,Payment,Bill Payment,370.2569879
1402,708704433,1-26-24 20:28,194.89,Purchase,Furniture,175.3669879
1403,708704433,1-27-24 10:28,196.42,Deposit,Check Deposit,371.7869879
1404,708704433,1-29-24 15:28,212.86,OutgoingTransfer,Bank Transfer,158.9269879
1405,708704433,02-04-24 17:28,236.49,OnlineShopping,Amazon,-77.5630121
1406,708704433,02-06-24 17:28,495.46,Purchase,Restaurant,-573.0230121
1407,708704433,02-07-24 14:28,51.43,OutgoingTransfer,International Transfer,-624.4530121
1408,708704433,02-07-24 17:28,57.86,Deposit,Mobile Deposit,-566.5930121
1409,708704433,02-08-24 11:28,384.77,OutgoingTransfer,International Transfer,-951.3630121
1410,708704433,02-10-24 10:28,220.41,OnlineShopping,Target,-1171.773012
1411,708704433,02-11-24 12:28,284.81,OutgoingTransfer,Bank Transfer,-1456.583012
1412,708704433,2-15-24 15:28,481.94,OnlineShopping,Walmart,-1938.523012
1413,708704433,2-16-24 14:28,195.74,Purchase,Travel,-2134.263012
1414,708704433,2-17-24 10:28,283.18,OutgoingTransfer,Peer-to-Peer Transfer,-2417.443012
1415,708704433,2-18-24 13:28,64.11,OutgoingTransfer,Peer-to-Peer Transfer,-2481.553012
1416,708704433,2-20-24 11:28,343.04,Purchase,Gas,-2824.593012
1417,708704433,2-20-24 20:28,401.27,Payment,Loan Payment,-3225.863012
1418,708704433,2-22-24 18:28,67.59,Withdrawal,ATM Withdrawal,-3293.453012
1419,708704433,2-23-24 21:28,314.21,Purchase,Grocery,-3607.663012
1420,708704433,2-25-24 14:28,256.17,OutgoingTransfer,Peer-to-Peer Transfer,-3863.833012
1421,708704433,2-25-24 15:28,89.56,OutgoingTransfer,Bank Transfer,-3953.393012
1422,708704433,2-26-24 10:28,312.79,OutgoingTransfer,International Transfer,-4266.183012
1423,708704433,2-27-24 23:28,413.27,Return,Target Return,-3852.913012
1424,708704433,2-28-24 19:28,248.91,OnlineShopping,Target,-4101.823012
1425,708704433,03-03-24 13:28,116.68,Purchase,Entertainment,-4218.503012
1426,708704433,03-10-24 13:28,129.07,OutgoingTransfer,International Transfer,-4347.573012
1427,708704433,03-11-24 16:28,410.68,Deposit,Check Deposit,-3936.893012
1428,708704433,3-17-24 19:28,284.39,Deposit,Cash Deposit,-3652.503012
1429,708704433,3-23-24 12:28,54.46,Payment,Mortgage Payment,-3706.963012
1430,708704433,3-23-24 19:28,376.25,Purchase,Grocery,-4083.213012
1431,708704433,3-25-24 16:28,412.15,Deposit,Check Deposit,-3671.063012
1432,708704433,3-28-24 23:28,82.37,OnlineShopping,eBay,-3753.433012
1433,708704433,3-29-24 22:28,327.93,Purchase,Pharmacy,-4081.363012
1434,708704433,3-30-24 10:28,157.4,Purchase,Furniture,-4238.763012
1435,708704433,3-31-24 21:28,352.23,Return,Best Buy Return,-3886.533012
1436,708704433,04-02-24 14:28,353.34,OutgoingTransfer,International Transfer,-4239.873012
1437,708704433,04-04-24 10:28,280.65,Purchase,Restaurant,-4520.523012
1438,708704433,04-07-24 18:28,311.05,Purchase,Pharmacy,-4831.573012
1439,708704433,04-11-24 11:28,184.16,Purchase,Electronics,-5015.733012
1440,708704433,4-14-24 12:28,50.35,OutgoingTransfer,Wire Transfer,-5066.083012
1441,708704433,4-15-24 20:28,99.89,Purchase,Electronics,-5165.973012
1442,708704433,4-17-24 12:28,465.56,OnlineShopping,Amazon,-5631.533012
1443,708704433,4-20-24 17:28,269.37,Withdrawal,Branch Withdrawal,-5900.903012
1444,708704433,4-20-24 22:28,146,Purchase,Gas,-6046.903012
1445,708704433,4-22-24 15:28,316.25,OutgoingTransfer,Bank Transfer,-6363.153012
1446,708704433,4-23-24 21:28,409.45,OutgoingTransfer,Bank Transfer,-6772.603012
1447,708704433,4-23-24 23:28,478.61,Deposit,Cash Deposit,-6293.993012
1448,708704433,4-26-24 15:28,209.49,OutgoingTransfer,Wire Transfer,-6503.483012
1449,708704433,4-29-24 22:28,223.26,Return,AliExpress Return,-6280.223012
1450,708704433,05-04-24 12:28,253.68,Deposit,Direct Deposit,-6026.543012
1451,708704433,05-07-24 10:28,344.73,Withdrawal,Branch Withdrawal,-6371.273012
1452,708704433,05-10-24 13:28,301.13,Deposit,Check Deposit,-6070.143012
1453,708704433,05-12-24 14:28,291.11,Return,Store Return,-5779.033012
1454,708704433,5-19-24 22:28,244.56,Deposit,Cash Deposit,-5534.473012
1455,708704433,5-20-24 18:28,155.91,Withdrawal,ATM Withdrawal,-5690.383012
1456,708704433,5-22-24 17:28,419.17,OutgoingTransfer,International Transfer,-6109.553012
1457,708704433,5-28-24 22:28,266.58,OnlineShopping,AliExpress,-6376.133012
1458,708704433,5-29-24 11:28,413.71,OnlineShopping,Target,-6789.843012
1459,708704433,5-31-24 10:28,208.13,Return,Best Buy Return,-6581.713012
1460,708704433,06-09-24 13:28,261.22,Purchase,Restaurant,-6842.933012
1461,708704433,06-11-24 11:28,350.77,Payment,Loan Payment,-7193.703012
1462,708704433,6-13-24 23:28,94.95,Purchase,Entertainment,-7288.653012
1463,708704433,6-14-24 14:28,475.76,Withdrawal,Mobile App Withdrawal,-7764.413012
1464,708704433,6-17-24 9:28,132.38,Return,Walmart Return,-7632.033012
1465,708704433,6-17-24 18:28,106.42,Return,eBay Return,-7525.613012
1466,708704433,6-18-24 12:28,137.58,Payment,Mortgage Payment,-7663.193012
1467,708704433,6-20-24 19:28,175.98,Deposit,Mobile Deposit,-7487.213012
1468,708704433,6-21-24 20:28,294.01,Withdrawal,ATM Withdrawal,-7781.223012
1469,708704433,6-22-24 19:28,420.54,OutgoingTransfer,International Transfer,-8201.763012
1470,708704433,6-23-24 21:28,457.95,OutgoingTransfer,Wire Transfer,-8659.713012
1471,708704433,6-24-24 14:28,323.38,Withdrawal,Branch Withdrawal,-8983.093012
1472,708704433,6-25-24 23:28,387.52,OnlineShopping,Best Buy,-9370.613012
1473,708704433,07-06-24 20:28,130.03,Withdrawal,Mobile App Withdrawal,-9500.643012
1474,708704433,07-08-24 15:28,38.36,IncomingTransfer,Freelance Payment,-9462.283012
1475,708704433,7-17-24 20:28,218.03,Deposit,Cash Deposit,-9244.253012
1476,708745983,1-20-24 14:28,28.44,Deposit,Check Deposit,1016.332024
1477,708745983,1-21-24 14:28,170.62,Withdrawal,Branch Withdrawal,845.7120237
1478,708745983,1-21-24 16:28,265.78,IncomingTransfer,Freelance Payment,1111.492024
1479,708745983,1-21-24 22:28,48.05,IncomingTransfer,Freelance Payment,1159.542024
1480,708745983,1-25-24 20:28,308.09,Withdrawal,Mobile App Withdrawal,851.4520237
1481,708745983,1-26-24 15:28,53.22,Purchase,Home Improvement,798.2320237
1482,708745983,1-26-24 18:28,111.02,Payment,Loan Payment,687.2120237
1483,708745983,1-26-24 20:28,264.71,Withdrawal,ATM Withdrawal,422.5020237
1484,708745983,1-28-24 12:28,77.51,Withdrawal,Mobile App Withdrawal,344.9920237
1485,708745983,1-29-24 15:28,246.32,Withdrawal,ATM Withdrawal,98.67202372
1486,708745983,1-31-24 12:28,31.43,OutgoingTransfer,Peer-to-Peer Transfer,67.24202372
1487,708745983,02-01-24 16:28,345.24,Purchase,Travel,-277.9979763
1488,708745983,02-03-24 17:28,62.64,Purchase,Clothing,-340.6379763
1489,708745983,02-05-24 15:28,335.06,Purchase,Travel,-675.6979763
1490,708745983,02-05-24 21:28,4550,IncomingTransfer,Salary,3874.302024
1491,708745983,02-07-24 9:28,157.81,IncomingTransfer,Freelance Payment,4032.112024
1492,708745983,02-10-24 21:28,2000,Payment,Credit Card Payment,2032.112024
1493,708745983,02-12-24 17:28,178.28,Return,Amazon Return,2210.392024
1494,708745983,2-15-24 21:28,1200,Payment,Installment Payment,1010.392024
1495,708745983,2-17-24 20:28,135.24,OnlineShopping,Walmart,875.1520237
1496,708745983,2-19-24 13:28,276.87,Payment,Loan Payment,598.2820237
1497,708745983,2-20-24 20:28,376.32,OutgoingTransfer,International Transfer,221.9620237
1498,708745983,2-22-24 13:28,132.98,Purchase,Home Improvement,88.98202372
1499,708745983,2-26-24 15:28,71.01,Deposit,Mobile Deposit,159.9920237
1500,708745983,2-29-24 18:28,147.91,Return,AliExpress Return,307.9020237
1501,708745983,2-29-24 20:28,120.77,Purchase,Restaurant,187.1320237
1502,708745983,03-02-24 10:28,319.4,Purchase,Furniture,-132.2679763
1503,708745983,03-02-24 21:28,4550,IncomingTransfer,Salary,4417.732024
1504,708745983,03-04-24 9:28,399.39,Return,AliExpress Return,4817.122024
1505,708745983,03-07-24 21:28,1900,Payment,Credit Card Payment,2917.122024
1506,708745983,03-07-24 22:28,181.14,OutgoingTransfer,Peer-to-Peer Transfer,2735.982024
1507,708745983,03-10-24 13:28,52.9,Deposit,Check Deposit,2788.882024
1508,708745983,03-10-24 21:28,1400,Payment,Insurance Payment,1388.882024
1509,708745983,03-11-24 11:28,327.26,OutgoingTransfer,International Transfer,1061.622024
1510,708745983,3-13-24 10:28,289.75,Withdrawal,Branch Withdrawal,771.8720237
1511,708745983,3-15-24 10:28,208.98,OnlineShopping,Amazon,562.8920237
1512,708745983,3-19-24 9:28,163.19,Payment,Mortgage Payment,399.7020237
1513,708745983,3-19-24 16:28,295.21,Return,Store Return,694.9120237
1514,708745983,3-25-24 12:28,356.81,Return,Walmart Return,1051.722024
1515,708745983,3-25-24 14:28,264.49,Deposit,Mobile Deposit,1316.212024
1516,708745983,3-25-24 21:28,385.63,OutgoingTransfer,Peer-to-Peer Transfer,930.5820237
1517,708745983,3-29-24 22:28,305.62,Return,Target Return,1236.202024
1518,708745983,3-30-24 16:28,341.09,OutgoingTransfer,Wire Transfer,895.1120237
1519,708745983,04-02-24 21:28,4550,IncomingTransfer,Salary,5445.112024
1520,708745983,04-05-24 10:28,230.28,Withdrawal,Mobile App Withdrawal,5214.832024
1521,708745983,04-06-24 20:28,108.24,Payment,Mortgage Payment,5106.592024
1522,708745983,04-07-24 21:28,2100,Payment,Credit Card Payment,3006.592024
1523,708745983,04-11-24 18:28,337.8,Deposit,Direct Deposit,3344.392024
1524,708745983,4-15-24 21:28,1200,Payment,Insurance Payment,2144.392024
1525,708745983,4-18-24 16:28,160.76,Deposit,Mobile Deposit,2305.152024
1526,708745983,4-20-24 10:28,111.75,Return,Best Buy Return,2416.902024
1527,708745983,4-23-24 11:28,360.51,Return,Amazon Return,2777.412024
1528,708745983,05-02-24 12:28,125.56,Purchase,Grocery,2651.852024
1529,708745983,05-02-24 21:28,4550,IncomingTransfer,Salary,7201.852024
1530,708745983,05-03-24 16:28,127.73,Purchase,Gas,7074.122024
1531,708745983,05-03-24 20:28,255.62,OnlineShopping,Etsy,6818.502024
1532,708745983,05-05-24 12:28,319.73,Purchase,Electronics,6498.772024
1533,708745983,05-07-24 20:28,368.15,Deposit,Cash Deposit,6866.922024
1534,708745983,05-07-24 21:28,1900,Payment,Credit Card Payment,4966.922024
1535,708745983,5-14-24 11:28,356.26,IncomingTransfer,Freelance Payment,5323.182024
1536,708745983,5-14-24 14:28,281.52,Deposit,Mobile Deposit,5604.702024
1537,708745983,5-15-24 9:28,199.17,Return,eBay Return,5803.872024
1538,708745983,5-15-24 23:28,343.14,Deposit,Cash Deposit,6147.012024
1539,708745983,5-16-24 10:28,234.84,Payment,Mortgage Payment,5912.172024
1540,708745983,5-16-24 12:28,140.29,OutgoingTransfer,International Transfer,5771.882024
1541,708745983,5-17-24 21:28,2000,Payment,Installment Payment,3771.882024
1542,708745983,5-26-24 20:28,377.91,Deposit,Mobile Deposit,4149.792024
1543,708745983,06-01-24 11:28,264.98,Return,Best Buy Return,4414.772024
1544,708745983,06-02-24 17:28,61.38,OnlineShopping,eBay,4353.392024
1545,708745983,06-04-24 10:28,118.1,Deposit,Check Deposit,4471.492024
1546,708745983,06-04-24 23:28,128.95,OnlineShopping,Etsy,4342.542024
1547,708745983,06-05-24 21:28,4550,IncomingTransfer,Salary,8892.542024
1548,708745983,06-08-24 13:28,165.17,Purchase,Gas,8727.372024
1549,708745983,06-08-24 13:28,102.53,OutgoingTransfer,Peer-to-Peer Transfer,8624.842024
1550,708745983,06-10-24 21:28,1600,Payment,Credit Card Payment,7024.842024
1551,708745983,6-15-24 20:28,282.42,Payment,Loan Payment,6742.422024
1552,708745983,6-16-24 21:28,1400,Payment,Subscription Payment,5342.422024
1553,708745983,6-16-24 22:28,156.14,Payment,Loan Payment,5186.282024
1554,708745983,6-16-24 22:28,60.53,Deposit,Check Deposit,5246.812024
1555,708745983,6-17-24 12:28,328.39,Purchase,Restaurant,4918.422024
1556,708745983,6-17-24 22:28,274.94,Return,AliExpress Return,5193.362024
1557,708745983,6-22-24 22:28,278.09,Payment,Bill Payment,4915.272024
1558,708745983,6-23-24 13:28,64.23,IncomingTransfer,Freelance Payment,4979.502024
1559,708745983,6-26-24 19:28,303.8,Deposit,Cash Deposit,5283.302024
1560,708745983,07-01-24 22:28,333.97,Return,Walmart Return,5617.272024
1561,708745983,07-02-24 21:28,4550,IncomingTransfer,Salary,10167.27202
1562,708745983,07-04-24 9:28,156.36,OutgoingTransfer,International Transfer,10010.91202
1563,708745983,07-04-24 15:28,303.41,Return,Walmart Return,10314.32202
1564,708745983,07-05-24 18:28,152.99,OutgoingTransfer,Peer-to-Peer Transfer,10161.33202
1565,708745983,07-05-24 22:28,298.21,Return,AliExpress Return,10459.54202
1566,708745983,07-06-24 11:28,52.57,Purchase,Restaurant,10406.97202
1567,708745983,07-07-24 21:28,1800,Payment,Credit Card Payment,8606.972024
1568,708745983,07-10-24 21:28,1300,Payment,Installment Payment,7306.972024
1569,708745983,07-12-24 18:28,239.32,Purchase,Electronics,7067.652024
1570,708745983,7-13-24 16:28,50.65,OutgoingTransfer,Wire Transfer,7017.002024
1571,708745983,7-13-24 18:28,218.6,Deposit,Direct Deposit,7235.602024
1572,708745983,7-14-24 19:28,308.03,Return,Amazon Return,7543.632024
1573,708745983,7-15-24 15:28,85.48,IncomingTransfer,Freelance Payment,7629.112024
1574,708745983,7-17-24 10:28,380.66,Purchase,Pharmacy,7248.452024
1575,708796458,1-21-24 11:28,75.97,Return,eBay Return,1267.702787
1576,708796458,1-22-24 11:28,116.78,Deposit,Cash Deposit,1384.482787
1577,708796458,1-25-24 14:28,63.04,Purchase,Clothing,1321.442787
1578,708796458,1-25-24 15:28,172.52,Return,Amazon Return,1493.962787
1579,708796458,1-29-24 19:28,186.86,Purchase,Travel,1307.102787
1580,708796458,02-02-24 21:28,2850,IncomingTransfer,Salary,4157.102787
1581,708796458,02-07-24 21:28,2000,Payment,Credit Card Payment,2157.102787
1582,708796458,02-09-24 12:28,208.27,OutgoingTransfer,Bank Transfer,1948.832787
1583,708796458,02-12-24 22:28,145.69,OutgoingTransfer,Wire Transfer,1803.142787
1584,708796458,2-14-24 18:28,112.82,OnlineShopping,Walmart,1690.322787
1585,708796458,2-15-24 10:28,227.06,Return,Store Return,1917.382787
1586,708796458,2-16-24 10:28,75.5,IncomingTransfer,Freelance Payment,1992.882787
1587,708796458,2-16-24 21:28,1300,Payment,Rent Payment,692.8827867
1588,708796458,2-20-24 11:28,16.16,OutgoingTransfer,International Transfer,676.7227867
1589,708796458,2-20-24 18:28,22.91,Return,Store Return,699.6327867
1590,708796458,2-22-24 21:28,121.54,Withdrawal,Branch Withdrawal,578.0927867
1591,708796458,2-26-24 19:28,93.75,Withdrawal,Mobile App Withdrawal,484.3427867
1592,708796458,03-03-24 21:28,2850,IncomingTransfer,Salary,3334.342787
1593,708796458,03-08-24 21:28,2300,Payment,Credit Card Payment,1034.342787
1594,708796458,3-14-24 10:28,69.66,IncomingTransfer,Freelance Payment,1104.002787
1595,708796458,3-16-24 21:28,1200,Payment,Rent Payment,-95.9972133
1596,708796458,3-17-24 10:28,214.18,Deposit,Mobile Deposit,118.1827867
1597,708796458,3-17-24 20:28,136.25,Deposit,Direct Deposit,254.4327867
1598,708796458,3-18-24 19:28,170.49,OutgoingTransfer,Wire Transfer,83.9427867
1599,708796458,3-19-24 16:28,192.06,Payment,Mortgage Payment,-108.1172133
1600,708796458,3-22-24 19:28,107.5,Return,AliExpress Return,-0.617213301
1601,708796458,3-24-24 21:28,147.37,OnlineShopping,Target,-147.9872133
1602,708796458,3-26-24 12:28,45.68,Payment,Bill Payment,-193.6672133
1603,708796458,3-28-24 22:28,66.2,Deposit,Cash Deposit,-127.4672133
1604,708796458,3-31-24 14:28,121.14,Withdrawal,ATM Withdrawal,-248.6072133
1605,708796458,04-01-24 21:28,2850,IncomingTransfer,Salary,2601.392787
1606,708796458,04-03-24 13:28,248.47,Purchase,Entertainment,2352.922787
1607,708796458,04-05-24 18:28,143.33,Purchase,Entertainment,2209.592787
1608,708796458,04-06-24 11:28,36.81,Withdrawal,Mobile App Withdrawal,2172.782787
1609,708796458,04-06-24 21:28,2600,Payment,Credit Card Payment,-427.2172133
1610,708796458,04-08-24 15:28,205.27,Withdrawal,Mobile App Withdrawal,-632.4872133
1611,708796458,04-12-24 21:28,1400,Payment,Rent Payment,-2032.487213
1612,708796458,4-13-24 13:28,181.68,Return,Walmart Return,-1850.807213
1613,708796458,4-25-24 13:28,59.68,Purchase,Furniture,-1910.487213
1614,708796458,4-28-24 11:28,141.05,Purchase,Grocery,-2051.537213
1615,708796458,05-02-24 21:28,2850,IncomingTransfer,Salary,798.4627867
1616,708796458,05-03-24 18:28,183.1,Return,Best Buy Return,981.5627867
1617,708796458,05-04-24 10:28,171.76,Return,Target Return,1153.322787
1618,708796458,05-04-24 15:28,198.04,Return,Target Return,1351.362787
1619,708796458,05-04-24 16:28,95.37,Deposit,Check Deposit,1446.732787
1620,708796458,05-05-24 12:28,147.66,IncomingTransfer,Freelance Payment,1594.392787
1621,708796458,05-07-24 21:28,2100,Payment,Credit Card Payment,-505.6072133
1622,708796458,05-08-24 10:28,93.59,OnlineShopping,Walmart,-599.1972133
1623,708796458,05-08-24 19:28,129.6,Purchase,Travel,-728.7972133
1624,708796458,05-10-24 20:28,211.84,Purchase,Restaurant,-940.6372133
1625,708796458,05-11-24 22:28,62.3,Deposit,Cash Deposit,-878.3372133
1626,708796458,5-13-24 21:28,1100,Payment,Rent Payment,-1978.337213
1627,708796458,5-16-24 15:28,216.71,Purchase,Restaurant,-2195.047213
1628,708796458,5-17-24 12:28,182.41,Return,eBay Return,-2012.637213
1629,708796458,5-19-24 19:28,162.8,Withdrawal,ATM Withdrawal,-2175.437213
1630,708796458,5-21-24 17:28,98.92,Deposit,Direct Deposit,-2076.517213
1631,708796458,5-25-24 13:28,199.5,Return,Amazon Return,-1877.017213
1632,708796458,5-25-24 16:28,189.33,Payment,Bill Payment,-2066.347213
1633,708796458,5-25-24 18:28,232.63,Deposit,Check Deposit,-1833.717213
1634,708796458,5-27-24 21:28,107.56,Payment,Loan Payment,-1941.277213
1635,708796458,5-28-24 14:28,29.58,Purchase,Electronics,-1970.857213
1636,708796458,06-02-24 11:28,216.84,Withdrawal,Branch Withdrawal,-2187.697213
1637,708796458,06-02-24 13:28,220.48,Purchase,Pharmacy,-2408.177213
1638,708796458,06-04-24 21:28,2850,IncomingTransfer,Salary,441.8227867
1639,708796458,06-05-24 20:28,64.13,Return,AliExpress Return,505.9527867
1640,708796458,06-08-24 18:28,104.21,Purchase,Clothing,401.7427867
1641,708796458,06-09-24 21:28,2500,Payment,Credit Card Payment,-2098.257213
1642,708796458,06-10-24 21:28,1800,Payment,Rent Payment,-3898.257213
1643,708796458,06-11-24 12:28,89.95,Purchase,Clothing,-3988.207213
1644,708796458,06-11-24 23:28,110.57,Deposit,Direct Deposit,-3877.637213
1645,708796458,6-13-24 18:28,21.44,OnlineShopping,Target,-3899.077213
1646,708796458,6-14-24 16:28,70.8,OutgoingTransfer,International Transfer,-3969.877213
1647,708796458,6-15-24 18:28,67.2,Deposit,Cash Deposit,-3902.677213
1648,708796458,6-17-24 9:28,34.39,Deposit,Mobile Deposit,-3868.287213
1649,708796458,6-17-24 13:28,70.34,OutgoingTransfer,Peer-to-Peer Transfer,-3938.627213
1650,708796458,6-17-24 14:28,157.68,Purchase,Gas,-4096.307213
1651,708796458,6-18-24 19:28,184.88,Deposit,Mobile Deposit,-3911.427213
1652,708796458,6-22-24 18:28,37.29,OnlineShopping,AliExpress,-3948.717213
1653,708796458,6-22-24 22:28,97.55,Withdrawal,Mobile App Withdrawal,-4046.267213
1654,708796458,07-02-24 21:28,2850,IncomingTransfer,Salary,-1196.267213
1655,708796458,07-07-24 21:28,2400,Payment,Credit Card Payment,-3596.267213
1656,708796458,07-10-24 21:28,1100,Payment,Rent Payment,-4696.267213
1657,708796458,7-15-24 10:28,140.01,IncomingTransfer,Freelance Payment,-4556.257213
1658,708796458,7-17-24 9:28,146.9,Deposit,Direct Deposit,-4409.357213
1659,708796458,7-17-24 19:28,127.33,OutgoingTransfer,Wire Transfer,-4536.687213
1660,708804633,1-20-24 16:28,117.29,Deposit,Direct Deposit,117.29
1661,708804633,1-25-24 19:28,53.38,Deposit,Mobile Deposit,170.67
1662,708804633,1-31-24 18:28,142.31,Withdrawal,Mobile App Withdrawal,28.36
1663,708804633,02-02-24 17:28,50.41,Deposit,Cash Deposit,78.77
1664,708804633,02-04-24 21:28,2200,IncomingTransfer,Salary,2278.77
1665,708804633,02-06-24 17:28,215.83,Deposit,Cash Deposit,2494.6
1666,708804633,02-12-24 23:28,18.93,Deposit,Direct Deposit,2513.53
1667,708804633,2-14-24 19:28,242.37,Deposit,Check Deposit,2755.9
1668,708804633,2-15-24 17:28,30.92,Payment,Bill Payment,2724.98
1669,708804633,2-16-24 21:28,1000,Payment,Rent Payment,1724.98
1670,708804633,2-18-24 18:28,247.71,Purchase,Entertainment,1477.27
1671,708804633,2-25-24 13:28,198.12,OnlineShopping,Amazon,1279.15
1672,708804633,2-25-24 13:28,87.91,Deposit,Check Deposit,1367.06
1673,708804633,2-26-24 22:28,83.79,Deposit,Check Deposit,1450.85
1674,708804633,03-01-24 21:28,2200,IncomingTransfer,Salary,3650.85
1675,708804633,03-03-24 16:28,96.7,Withdrawal,Branch Withdrawal,3554.15
1676,708804633,03-03-24 18:28,108.01,Purchase,Electronics,3446.14
1677,708804633,03-05-24 15:28,53.34,Deposit,Direct Deposit,3499.48
1678,708804633,3-13-24 21:28,600,Payment,Rent Payment,2899.48
1679,708804633,3-23-24 10:28,82.71,Withdrawal,ATM Withdrawal,2816.77
1680,708804633,3-23-24 13:28,179.59,Payment,Mortgage Payment,2637.18
1681,708804633,3-28-24 13:28,199.86,Withdrawal,Mobile App Withdrawal,2437.32
1682,708804633,3-30-24 22:28,194.64,Deposit,Mobile Deposit,2631.96
1683,708804633,04-03-24 13:28,203.93,Deposit,Direct Deposit,2835.89
1684,708804633,04-05-24 21:28,2200,IncomingTransfer,Salary,5035.89
1685,708804633,04-07-24 10:28,194.53,Purchase,Clothing,4841.36
1686,708804633,04-08-24 14:28,240.24,OnlineShopping,Etsy,4601.12
1687,708804633,04-09-24 15:28,238.25,OutgoingTransfer,International Transfer,4362.87
1688,708804633,4-18-24 21:28,600,Payment,Rent Payment,3762.87
1689,708804633,4-20-24 13:28,136.41,IncomingTransfer,Freelance Payment,3899.28
1690,708804633,4-24-24 11:28,59.58,Purchase,Grocery,3839.7
1691,708804633,05-05-24 21:28,2200,IncomingTransfer,Salary,6039.7
1692,708804633,5-13-24 18:28,171.25,Payment,Bill Payment,5868.45
1693,708804633,5-15-24 21:28,1100,Payment,Rent Payment,4768.45
1694,708804633,5-17-24 12:28,171.57,Withdrawal,Mobile App Withdrawal,4596.88
1695,708804633,5-18-24 22:28,246.07,Withdrawal,Mobile App Withdrawal,4350.81
1696,708804633,5-23-24 16:28,189.84,Payment,Bill Payment,4160.97
1697,708804633,5-24-24 11:28,121.09,OutgoingTransfer,Peer-to-Peer Transfer,4039.88
1698,708804633,5-29-24 11:28,200.65,OnlineShopping,eBay,3839.23
1699,708804633,06-03-24 21:28,2200,IncomingTransfer,Salary,6039.23
1700,708804633,06-04-24 14:28,234.06,OnlineShopping,Best Buy,5805.17
1701,708804633,06-07-24 20:28,64.26,Deposit,Direct Deposit,5869.43
1702,708804633,06-10-24 16:28,34.69,Withdrawal,Branch Withdrawal,5834.74
1703,708804633,06-10-24 21:28,1300,Payment,Rent Payment,4534.74
1704,708804633,6-28-24 14:28,238.75,Withdrawal,ATM Withdrawal,4295.99
1705,708804633,07-05-24 18:28,107.64,Withdrawal,Mobile App Withdrawal,4188.35
1706,708804633,07-05-24 21:28,2200,IncomingTransfer,Salary,6388.35
1707,708804633,07-07-24 11:28,219.05,IncomingTransfer,Freelance Payment,6607.4
1708,708804633,07-07-24 18:28,81.81,Withdrawal,Branch Withdrawal,6525.59
1709,708804633,7-14-24 21:28,600,Payment,Rent Payment,5925.59
1710,708804633,7-15-24 19:28,62.99,Payment,Bill Payment,5862.6
1711,708816408,1-20-24 15:28,694.09,Payment,Loan Payment,-694.09
1712,708816408,1-22-24 21:28,506.45,OnlineShopping,Target,-1200.54
1713,708816408,1-24-24 13:28,480.17,OutgoingTransfer,Bank Transfer,-1680.71
1714,708816408,1-28-24 14:28,178.93,Payment,Loan Payment,-1859.64
1715,708816408,1-30-24 13:28,102.22,OutgoingTransfer,Wire Transfer,-1961.86
1716,708816408,02-01-24 10:28,339.87,Deposit,Mobile Deposit,-1621.99
1717,708816408,02-02-24 21:28,9300,IncomingTransfer,Salary,7678.01
1718,708816408,02-02-24 22:28,309.02,Withdrawal,Branch Withdrawal,7368.99
1719,708816408,02-04-24 11:28,562.95,OnlineShopping,Etsy,6806.04
1720,708816408,02-04-24 17:28,747.29,Withdrawal,ATM Withdrawal,6058.75
1721,708816408,02-09-24 20:28,559.17,Withdrawal,ATM Withdrawal,5499.58
1722,708816408,02-10-24 14:28,533.72,Return,AliExpress Return,6033.3
1723,708816408,02-11-24 19:28,260.97,OutgoingTransfer,Wire Transfer,5772.33
1724,708816408,2-14-24 10:28,344.39,OutgoingTransfer,Wire Transfer,5427.94
1725,708816408,2-14-24 13:28,406.31,IncomingTransfer,Freelance Payment,5834.25
1726,708816408,2-14-24 21:28,2700,Payment,Rent Payment,3134.25
1727,708816408,2-16-24 14:28,109.49,Withdrawal,Mobile App Withdrawal,3024.76
1728,708816408,2-16-24 20:28,386.5,Withdrawal,ATM Withdrawal,2638.26
1729,708816408,2-17-24 19:28,217.08,Return,AliExpress Return,2855.34
1730,708816408,2-22-24 14:28,691.64,Withdrawal,Mobile App Withdrawal,2163.7
1731,708816408,2-24-24 18:28,651.26,OutgoingTransfer,Bank Transfer,1512.44
1732,708816408,2-25-24 13:28,362.06,Return,AliExpress Return,1874.5
1733,708816408,2-25-24 21:28,163.26,OnlineShopping,eBay,1711.24
1734,708816408,03-01-24 15:28,375.82,Withdrawal,ATM Withdrawal,1335.42
1735,708816408,03-01-24 21:28,9300,IncomingTransfer,Salary,10635.42
1736,708816408,03-02-24 12:28,220.64,Deposit,Check Deposit,10856.06
1737,708816408,03-03-24 15:28,708.36,Purchase,Furniture,10147.7
1738,708816408,03-06-24 22:28,572.44,Withdrawal,Mobile App Withdrawal,9575.26
1739,708816408,03-08-24 21:28,273.82,Purchase,Clothing,9301.44
1740,708816408,03-11-24 21:28,106.9,Deposit,Check Deposit,9408.34
1741,708816408,03-12-24 23:28,128.58,Payment,Loan Payment,9279.76
1742,708816408,3-17-24 21:28,5500,Payment,Rent Payment,3779.76
1743,708816408,3-17-24 21:28,486.24,OutgoingTransfer,Peer-to-Peer Transfer,3293.52
1744,708816408,3-18-24 13:28,602.21,Return,eBay Return,3895.73
1745,708816408,3-21-24 14:28,501.11,Deposit,Direct Deposit,4396.84
1746,708816408,3-22-24 9:28,552.3,Deposit,Check Deposit,4949.14
1747,708816408,3-28-24 13:28,656.02,Return,Amazon Return,5605.16
1748,708816408,04-03-24 16:28,552.72,Purchase,Electronics,5052.44
1749,708816408,04-04-24 13:28,346.09,IncomingTransfer,Freelance Payment,5398.53
1750,708816408,04-05-24 21:28,9300,IncomingTransfer,Salary,14698.53
1751,708816408,04-07-24 19:28,321.88,Payment,Mortgage Payment,14376.65
1752,708816408,04-07-24 20:28,115.02,Payment,Bill Payment,14261.63
1753,708816408,04-08-24 10:28,159.61,IncomingTransfer,Freelance Payment,14421.24
1754,708816408,04-08-24 23:28,547.8,Return,eBay Return,14969.04
1755,708816408,04-09-24 20:28,217.54,OnlineShopping,Amazon,14751.5
1756,708816408,04-11-24 23:28,511.03,IncomingTransfer,Freelance Payment,15262.53
1757,708816408,4-13-24 15:28,707,Withdrawal,ATM Withdrawal,14555.53
1758,708816408,4-13-24 21:28,3200,Payment,Rent Payment,11355.53
1759,708816408,4-16-24 16:28,682.06,Payment,Mortgage Payment,10673.47
1760,708816408,4-20-24 14:28,221.26,Purchase,Travel,10452.21
1761,708816408,4-26-24 10:28,111,Purchase,Restaurant,10341.21
1762,708816408,05-02-24 10:28,714.79,Deposit,Cash Deposit,11056
1763,708816408,05-04-24 21:28,9300,IncomingTransfer,Salary,20356
1764,708816408,05-05-24 20:28,541.98,Withdrawal,Mobile App Withdrawal,19814.02
1765,708816408,05-06-24 15:28,611.58,Deposit,Cash Deposit,20425.6
1766,708816408,05-08-24 11:28,620.33,Deposit,Check Deposit,21045.93
1767,708816408,05-11-24 21:28,4900,Payment,Rent Payment,16145.93
1768,708816408,05-12-24 17:28,206.99,OutgoingTransfer,Bank Transfer,15938.94
1769,708816408,5-16-24 15:28,241.8,Payment,Mortgage Payment,15697.14
1770,708816408,5-18-24 16:28,616.79,Deposit,Check Deposit,16313.93
1771,708816408,5-28-24 20:28,666.89,Deposit,Mobile Deposit,16980.82
1772,708816408,06-04-24 9:28,703.9,Deposit,Direct Deposit,17684.72
1773,708816408,06-05-24 21:28,9300,IncomingTransfer,Salary,26984.72
1774,708816408,06-12-24 19:28,427.08,Deposit,Mobile Deposit,27411.8
1775,708816408,6-13-24 9:28,169.69,Purchase,Electronics,27242.11
1776,708816408,6-13-24 10:28,104.19,Return,eBay Return,27346.3
1777,708816408,6-13-24 18:28,676.29,OnlineShopping,AliExpress,26670.01
1778,708816408,6-14-24 9:28,125.37,Purchase,Entertainment,26544.64
1779,708816408,6-14-24 21:28,3400,Payment,Rent Payment,23144.64
1780,708816408,6-16-24 10:28,733.98,Purchase,Gas,22410.66
1781,708816408,6-16-24 15:28,668,IncomingTransfer,Freelance Payment,23078.66
1782,708816408,6-18-24 22:28,500.21,Purchase,Pharmacy,22578.45
1783,708816408,6-20-24 18:28,313.08,Payment,Mortgage Payment,22265.37
1784,708816408,6-23-24 20:28,671.18,Payment,Loan Payment,21594.19
1785,708816408,6-25-24 20:28,216.87,Withdrawal,Branch Withdrawal,21377.32
1786,708816408,6-30-24 21:28,480.1,Payment,Mortgage Payment,20897.22
1787,708816408,07-04-24 19:28,713.38,Withdrawal,Mobile App Withdrawal,20183.84
1788,708816408,07-05-24 21:28,9300,IncomingTransfer,Salary,29483.84
1789,708816408,07-09-24 20:28,447.07,OutgoingTransfer,Peer-to-Peer Transfer,29036.77
1790,708816408,07-10-24 17:28,535.76,Deposit,Mobile Deposit,29572.53
1791,708816408,7-14-24 11:28,503.24,Purchase,Gas,29069.29
1792,708816408,7-15-24 21:28,2900,Payment,Rent Payment,26169.29
1793,708816408,7-16-24 17:28,608.38,Payment,Bill Payment,25560.91
1794,708823908,1-22-24 12:28,80.76,Return,Target Return,965.8398502
1795,708823908,1-24-24 9:28,417.13,Deposit,Cash Deposit,1382.96985
1796,708823908,1-24-24 20:28,360.47,Purchase,Pharmacy,1022.49985
1797,708823908,1-26-24 10:28,127.1,Payment,Mortgage Payment,895.3998502
1798,708823908,1-27-24 17:28,489.91,Deposit,Direct Deposit,1385.30985
1799,708823908,1-28-24 12:28,163.45,Purchase,Travel,1221.85985
1800,708823908,1-29-24 21:28,535.63,Withdrawal,Mobile App Withdrawal,686.2298502
1801,708823908,02-01-24 21:28,5700,IncomingTransfer,Salary,6386.22985
1802,708823908,02-02-24 11:28,223.63,Purchase,Travel,6162.59985
1803,708823908,02-02-24 13:28,480.42,OnlineShopping,Etsy,5682.17985
1804,708823908,02-06-24 12:28,223.36,Purchase,Clothing,5458.81985
1805,708823908,02-06-24 21:28,1700,Payment,Credit Card Payment,3758.81985
1806,708823908,02-07-24 15:28,486.44,Deposit,Check Deposit,4245.25985
1807,708823908,02-10-24 21:28,2400,Payment,Insurance Payment,1845.25985
1808,708823908,02-12-24 13:28,302.41,Payment,Mortgage Payment,1542.84985
1809,708823908,2-13-24 9:28,331.54,Deposit,Check Deposit,1874.38985
1810,708823908,2-19-24 16:28,277.4,Payment,Bill Payment,1596.98985
1811,708823908,2-20-24 22:28,249.71,OnlineShopping,Amazon,1347.27985
1812,708823908,2-22-24 11:28,530.13,Deposit,Mobile Deposit,1877.40985
1813,708823908,2-22-24 16:28,289.3,Deposit,Mobile Deposit,2166.70985
1814,708823908,03-02-24 13:28,101.64,OutgoingTransfer,Bank Transfer,2065.06985
1815,708823908,03-02-24 22:28,472.75,Payment,Bill Payment,1592.31985
1816,708823908,03-03-24 16:28,126.94,Payment,Mortgage Payment,1465.37985
1817,708823908,03-04-24 21:28,5700,IncomingTransfer,Salary,7165.37985
1818,708823908,03-08-24 15:28,514.2,IncomingTransfer,Freelance Payment,7679.57985
1819,708823908,03-09-24 12:28,465.82,Withdrawal,Branch Withdrawal,7213.75985
1820,708823908,03-09-24 15:28,169.27,Payment,Bill Payment,7044.48985
1821,708823908,03-09-24 21:28,2000,Payment,Credit Card Payment,5044.48985
1822,708823908,3-15-24 12:28,74.26,Purchase,Grocery,4970.22985
1823,708823908,3-16-24 21:28,2600,Payment,Subscription Payment,2370.22985
1824,708823908,3-17-24 10:28,400.03,Purchase,Gas,1970.19985
1825,708823908,3-20-24 23:28,506.24,Deposit,Mobile Deposit,2476.43985
1826,708823908,3-30-24 12:28,270.73,Return,Target Return,2747.16985
1827,708823908,04-01-24 9:28,411,OutgoingTransfer,Peer-to-Peer Transfer,2336.16985
1828,708823908,04-02-24 18:28,487.69,Payment,Bill Payment,1848.47985
1829,708823908,04-02-24 21:28,5700,IncomingTransfer,Salary,7548.47985
1830,708823908,04-06-24 21:28,538.52,Deposit,Mobile Deposit,8086.99985
1831,708823908,04-07-24 12:28,61.76,Purchase,Travel,8025.23985
1832,708823908,04-07-24 21:28,1700,Payment,Credit Card Payment,6325.23985
1833,708823908,04-08-24 22:28,219.93,Deposit,Check Deposit,6545.16985
1834,708823908,04-11-24 21:28,2500,Payment,Insurance Payment,4045.16985
1835,708823908,4-13-24 20:28,440.48,Deposit,Cash Deposit,4485.64985
1836,708823908,4-15-24 19:28,137.08,Withdrawal,Branch Withdrawal,4348.56985
1837,708823908,4-21-24 16:28,529.43,Purchase,Home Improvement,3819.13985
1838,708823908,4-22-24 18:28,312.13,Return,Store Return,4131.26985
1839,708823908,4-25-24 12:28,326.35,Purchase,Gas,3804.91985
1840,708823908,4-26-24 9:28,385.47,Return,Amazon Return,4190.38985
1841,708823908,4-27-24 16:28,154.05,Withdrawal,ATM Withdrawal,4036.33985
1842,708823908,05-02-24 21:28,5700,IncomingTransfer,Salary,9736.33985
1843,708823908,05-03-24 20:28,486.71,OnlineShopping,Etsy,9249.62985
1844,708823908,05-04-24 13:28,532.04,Deposit,Check Deposit,9781.66985
1845,708823908,05-07-24 13:28,184.42,Deposit,Direct Deposit,9966.08985
1846,708823908,05-07-24 21:28,2000,Payment,Credit Card Payment,7966.08985
1847,708823908,05-08-24 14:28,82.2,Deposit,Mobile Deposit,8048.28985
1848,708823908,5-14-24 16:28,530.88,Withdrawal,Mobile App Withdrawal,7517.40985
1849,708823908,5-16-24 21:28,2600,Payment,Subscription Payment,4917.40985
1850,708823908,5-17-24 11:28,386.52,IncomingTransfer,Freelance Payment,5303.92985
1851,708823908,5-20-24 16:28,145.92,Purchase,Home Improvement,5158.00985
1852,708823908,5-23-24 21:28,284.35,Return,Best Buy Return,5442.35985
1853,708823908,5-26-24 17:28,326.46,Payment,Loan Payment,5115.89985
1854,708823908,5-27-24 11:28,65.07,Withdrawal,Mobile App Withdrawal,5050.82985
1855,708823908,5-27-24 22:28,132.33,Deposit,Cash Deposit,5183.15985
1856,708823908,5-28-24 10:28,346.98,OnlineShopping,AliExpress,4836.17985
1857,708823908,5-28-24 22:28,177.95,Purchase,Electronics,4658.22985
1858,708823908,5-31-24 23:28,124.23,Purchase,Travel,4533.99985
1859,708823908,06-01-24 20:28,442.67,IncomingTransfer,Freelance Payment,4976.66985
1860,708823908,06-01-24 21:28,5700,IncomingTransfer,Salary,10676.66985
1861,708823908,06-03-24 17:28,453.13,Return,Walmart Return,11129.79985
1862,708823908,06-06-24 21:28,1900,Payment,Credit Card Payment,9229.79985
1863,708823908,06-08-24 22:28,151.09,Payment,Mortgage Payment,9078.70985
1864,708823908,06-11-24 21:28,1900,Payment,Subscription Payment,7178.70985
1865,708823908,6-17-24 20:28,281.94,OnlineShopping,Etsy,6896.76985
1866,708823908,6-19-24 21:28,161.91,OnlineShopping,Etsy,6734.85985
1867,708823908,6-21-24 20:28,236.84,Withdrawal,ATM Withdrawal,6498.01985
1868,708823908,6-29-24 12:28,83.74,Purchase,Entertainment,6414.27985
1869,708823908,6-29-24 22:28,516.76,Deposit,Mobile Deposit,6931.03985
1870,708823908,07-01-24 21:28,5700,IncomingTransfer,Salary,12631.03985
1871,708823908,07-03-24 9:28,267.14,Deposit,Check Deposit,12898.17985
1872,708823908,07-06-24 21:28,2000,Payment,Credit Card Payment,10898.17985
1873,708823908,07-11-24 11:28,161.08,Purchase,Restaurant,10737.09985
1874,708823908,7-16-24 12:28,232.96,Payment,Bill Payment,10504.13985
1875,708823908,7-17-24 21:28,2500,Payment,Subscription Payment,8004.13985
1876,708862233,1-20-24 10:28,345.26,OutgoingTransfer,Bank Transfer,-345.26
1877,708862233,1-26-24 13:28,236.51,Return,Target Return,-108.75
1878,708862233,1-29-24 10:28,129.86,Deposit,Direct Deposit,21.11
1879,708862233,1-31-24 11:28,346.28,Return,Best Buy Return,367.39
1880,708862233,02-02-24 9:28,203.08,Payment,Bill Payment,164.31
1881,708862233,02-02-24 21:28,4900,IncomingTransfer,Salary,5064.31
1882,708862233,02-04-24 18:28,129.51,Withdrawal,ATM Withdrawal,4934.8
1883,708862233,02-05-24 21:28,325.48,Deposit,Cash Deposit,5260.28
1884,708862233,02-06-24 22:28,257.39,Purchase,Travel,5002.89
1885,708862233,02-07-24 10:28,32.66,Deposit,Cash Deposit,5035.55
1886,708862233,02-07-24 22:28,386.87,OutgoingTransfer,Wire Transfer,4648.68
1887,708862233,02-10-24 17:28,146.83,OutgoingTransfer,Wire Transfer,4501.85
1888,708862233,02-11-24 21:28,223.95,Purchase,Electronics,4277.9
1889,708862233,02-12-24 9:28,165.55,OutgoingTransfer,Bank Transfer,4112.35
1890,708862233,2-13-24 21:28,2400,Payment,Rent Payment,1712.35
1891,708862233,2-15-24 20:28,183.58,OutgoingTransfer,International Transfer,1528.77
1892,708862233,2-18-24 10:28,172.93,OnlineShopping,Walmart,1355.84
1893,708862233,2-18-24 17:28,224.89,OutgoingTransfer,International Transfer,1130.95
1894,708862233,2-22-24 14:28,194.02,Withdrawal,ATM Withdrawal,936.93
1895,708862233,03-01-24 12:28,240.98,OutgoingTransfer,Bank Transfer,695.95
1896,708862233,03-03-24 12:28,363.08,Return,Target Return,1059.03
1897,708862233,03-04-24 20:28,51.6,Purchase,Clothing,1007.43
1898,708862233,03-05-24 11:28,43.99,Withdrawal,ATM Withdrawal,963.44
1899,708862233,03-05-24 12:28,179.63,Purchase,Furniture,783.81
1900,708862233,03-05-24 21:28,4900,IncomingTransfer,Salary,5683.81
1901,708862233,03-11-24 21:28,216.14,Deposit,Direct Deposit,5899.95
1902,708862233,03-12-24 11:28,387.41,Purchase,Entertainment,5512.54
1903,708862233,3-14-24 21:28,2500,Payment,Rent Payment,3012.54
1904,708862233,3-21-24 9:28,181.51,Withdrawal,Branch Withdrawal,2831.03
1905,708862233,3-22-24 23:28,316.92,Purchase,Electronics,2514.11
1906,708862233,3-26-24 15:28,99.68,Withdrawal,Branch Withdrawal,2414.43
1907,708862233,3-27-24 15:28,294.35,Purchase,Travel,2120.08
1908,708862233,3-31-24 18:28,104.65,IncomingTransfer,Freelance Payment,2224.73
1909,708862233,04-01-24 9:28,240.32,Purchase,Home Improvement,1984.41
1910,708862233,04-02-24 14:28,359.98,Withdrawal,ATM Withdrawal,1624.43
1911,708862233,04-02-24 15:28,191.74,Deposit,Direct Deposit,1816.17
1912,708862233,04-03-24 10:28,29.78,Purchase,Home Improvement,1786.39
1913,708862233,04-04-24 21:28,4900,IncomingTransfer,Salary,6686.39
1914,708862233,04-05-24 10:28,371.31,OnlineShopping,AliExpress,6315.08
1915,708862233,04-05-24 12:28,34.99,Purchase,Travel,6280.09
1916,708862233,04-05-24 14:28,61.76,Purchase,Home Improvement,6218.33
1917,708862233,04-07-24 11:28,334.42,Purchase,Clothing,5883.91
1918,708862233,04-10-24 19:28,105.01,Deposit,Check Deposit,5988.92
1919,708862233,04-12-24 21:28,346.97,Deposit,Check Deposit,6335.89
1920,708862233,4-13-24 14:28,137.43,Withdrawal,Mobile App Withdrawal,6198.46
1921,708862233,4-14-24 10:28,104.41,Withdrawal,Mobile App Withdrawal,6094.05
1922,708862233,4-14-24 21:28,2000,Payment,Rent Payment,4094.05
1923,708862233,4-15-24 18:28,396.81,Deposit,Cash Deposit,4490.86
1924,708862233,4-22-24 12:28,344.32,Purchase,Entertainment,4146.54
1925,708862233,4-24-24 20:28,154.57,OutgoingTransfer,Peer-to-Peer Transfer,3991.97
1926,708862233,4-25-24 17:28,182.88,Withdrawal,ATM Withdrawal,3809.09
1927,708862233,4-26-24 11:28,277.56,Deposit,Direct Deposit,4086.65
1928,708862233,4-27-24 10:28,86.43,OnlineShopping,Target,4000.22
1929,708862233,05-01-24 21:28,4900,IncomingTransfer,Salary,8900.22
1930,708862233,05-02-24 9:28,45.98,Purchase,Pharmacy,8854.24
1931,708862233,05-03-24 15:28,256.51,Purchase,Clothing,8597.73
1932,708862233,05-03-24 22:28,263.09,OutgoingTransfer,International Transfer,8334.64
1933,708862233,05-04-24 10:28,53.25,OnlineShopping,eBay,8281.39
1934,708862233,05-04-24 11:28,248.98,OnlineShopping,Target,8032.41
1935,708862233,05-07-24 10:28,107.7,Return,Amazon Return,8140.11
1936,708862233,05-07-24 23:28,245.89,OutgoingTransfer,Wire Transfer,7894.22
1937,708862233,05-11-24 21:28,2500,Payment,Rent Payment,5394.22
1938,708862233,5-13-24 14:28,150.3,Payment,Loan Payment,5243.92
1939,708862233,5-15-24 13:28,273.12,Purchase,Gas,4970.8
1940,708862233,5-18-24 22:28,387.05,OutgoingTransfer,Bank Transfer,4583.75
1941,708862233,5-20-24 11:28,346.61,OutgoingTransfer,International Transfer,4237.14
1942,708862233,5-21-24 11:28,52.66,Withdrawal,ATM Withdrawal,4184.48
1943,708862233,5-22-24 22:28,26.65,Purchase,Grocery,4157.83
1944,708862233,5-24-24 13:28,268.65,Withdrawal,Branch Withdrawal,3889.18
1945,708862233,5-29-24 19:28,238.97,Deposit,Direct Deposit,4128.15
1946,708862233,5-29-24 21:28,101.88,Purchase,Entertainment,4026.27
1947,708862233,5-30-24 11:28,93.7,Withdrawal,Mobile App Withdrawal,3932.57
1948,708862233,5-30-24 12:28,187.21,Return,AliExpress Return,4119.78
1949,708862233,5-31-24 16:28,79.26,Withdrawal,ATM Withdrawal,4040.52
1950,708862233,06-01-24 21:28,4900,IncomingTransfer,Salary,8940.52
1951,708862233,06-03-24 10:28,57.14,Payment,Mortgage Payment,8883.38
1952,708862233,06-06-24 19:28,32.49,Return,Store Return,8915.87
1953,708862233,06-08-24 10:28,256.63,Deposit,Cash Deposit,9172.5
1954,708862233,06-09-24 16:28,80.49,OutgoingTransfer,Wire Transfer,9092.01
1955,708862233,06-10-24 21:28,220,OutgoingTransfer,Bank Transfer,8872.01
1956,708862233,6-13-24 18:28,88.73,Deposit,Check Deposit,8960.74
1957,708862233,6-15-24 21:28,3000,Payment,Rent Payment,5960.74
1958,708862233,6-23-24 20:28,169.77,Payment,Loan Payment,5790.97
1959,708862233,6-28-24 21:28,289.24,OnlineShopping,eBay,5501.73
1960,708862233,6-29-24 21:28,132.63,Purchase,Clothing,5369.1
1961,708862233,07-01-24 21:28,4900,IncomingTransfer,Salary,10269.1
1962,708862233,07-03-24 13:28,292.9,Purchase,Electronics,9976.2
1963,708862233,07-05-24 18:28,194.19,Payment,Loan Payment,9782.01
1964,708862233,07-07-24 18:28,143.12,Return,AliExpress Return,9925.13
1965,708862233,7-14-24 19:28,381.09,Withdrawal,Mobile App Withdrawal,9544.04
1966,708862233,7-14-24 21:28,1500,Payment,Rent Payment,8044.04
1967,708862233,7-15-24 18:28,328.29,Withdrawal,Mobile App Withdrawal,7715.75
1968,708862233,7-16-24 20:28,55.34,Purchase,Home Improvement,7660.41
1969,708862233,7-17-24 17:28,197.42,Purchase,Furniture,7462.99
1970,708862233,7-17-24 19:28,219.82,Payment,Mortgage Payment,7243.17
1971,708868233,1-23-24 10:28,248.7,OutgoingTransfer,International Transfer,293.5546186
1972,708868233,1-23-24 18:28,24.6,Deposit,Check Deposit,318.1546186
1973,708868233,1-24-24 18:28,38.83,Deposit,Cash Deposit,356.9846186
1974,708868233,1-26-24 21:28,104.51,Payment,Bill Payment,252.4746186
1975,708868233,02-05-24 21:28,3150,IncomingTransfer,Salary,3402.474619
1976,708868233,02-10-24 21:28,900,Payment,Credit Card Payment,2502.474619
1977,708868233,02-10-24 21:28,1500,Payment,Rent Payment,1002.474619
1978,708868233,02-12-24 14:28,163.65,OutgoingTransfer,Wire Transfer,838.8246186
1979,708868233,2-21-24 10:28,199.99,Deposit,Cash Deposit,1038.814619
1980,708868233,03-02-24 13:28,77.22,OnlineShopping,Walmart,961.5946186
1981,708868233,03-02-24 21:28,3150,IncomingTransfer,Salary,4111.594619
1982,708868233,03-07-24 21:28,1100,Payment,Credit Card Payment,3011.594619
1983,708868233,03-09-24 13:28,202.99,Purchase,Electronics,2808.604619
1984,708868233,03-12-24 9:28,28.59,OutgoingTransfer,Peer-to-Peer Transfer,2780.014619
1985,708868233,3-16-24 12:28,166.95,Payment,Bill Payment,2613.064619
1986,708868233,3-17-24 21:28,1300,Payment,Rent Payment,1313.064619
1987,708868233,3-23-24 10:28,111.52,OutgoingTransfer,International Transfer,1201.544619
1988,708868233,3-24-24 12:28,195.18,OnlineShopping,Best Buy,1006.364619
1989,708868233,3-26-24 18:28,195.87,Purchase,Furniture,810.4946186
1990,708868233,04-01-24 21:28,3150,IncomingTransfer,Salary,3960.494619
1991,708868233,04-02-24 14:28,42.53,OnlineShopping,AliExpress,3917.964619
1992,708868233,04-06-24 21:28,1300,Payment,Credit Card Payment,2617.964619
1993,708868233,04-07-24 17:28,83.42,Purchase,Pharmacy,2534.544619
1994,708868233,4-15-24 21:28,1900,Payment,Rent Payment,634.5446186
1995,708868233,05-04-24 21:28,3150,IncomingTransfer,Salary,3784.544619
1996,708868233,05-09-24 21:28,1300,Payment,Credit Card Payment,2484.544619
1997,708868233,5-18-24 21:28,2000,Payment,Rent Payment,484.5446186
1998,708868233,5-23-24 19:28,189.26,Purchase,Pharmacy,295.2846186
1999,708868233,5-27-24 19:28,244.2,Purchase,Restaurant,51.08461858
2000,708868233,06-04-24 21:28,3150,IncomingTransfer,Salary,3201.084619
2001,708868233,06-09-24 11:28,183.64,Deposit,Mobile Deposit,3384.724619
2002,708868233,06-09-24 21:28,1300,Payment,Credit Card Payment,2084.724619
2003,708868233,06-11-24 21:28,2000,Payment,Rent Payment,84.72461858
2004,708868233,6-21-24 20:28,16.69,Purchase,Electronics,68.03461858
2005,708868233,07-04-24 21:28,3150,IncomingTransfer,Salary,3218.034619
2006,708868233,07-08-24 12:28,170.82,OutgoingTransfer,Peer-to-Peer Transfer,3047.214619
2007,708868233,07-09-24 21:28,1100,Payment,Credit Card Payment,1947.214619
2008,708868233,7-17-24 23:28,103.92,Withdrawal,ATM Withdrawal,1843.294619
2009,708868233,7-18-24 21:28,1600,Payment,Rent Payment,243.2946186
2010,708902883,1-20-24 15:28,640.96,Withdrawal,ATM Withdrawal,-640.96
2011,708902883,1-25-24 21:28,946.08,OnlineShopping,eBay,-1587.04
2012,708902883,1-25-24 21:28,738.56,OnlineShopping,eBay,-2325.6
2013,708902883,1-29-24 15:28,413,OnlineShopping,Amazon,-2738.6
2014,708902883,02-01-24 9:28,396.88,Return,Amazon Return,-2341.72
2015,708902883,02-01-24 19:28,781.97,Return,Etsy Return,-1559.75
2016,708902883,02-01-24 20:28,338.9,OnlineShopping,Etsy,-1898.65
2017,708902883,02-01-24 21:28,10200,IncomingTransfer,Salary,8301.35
2018,708902883,02-11-24 21:28,3800,Payment,Insurance Payment,4501.35
2019,708902883,02-12-24 10:28,720.68,OutgoingTransfer,International Transfer,3780.67
2020,708902883,2-13-24 22:28,762.15,Deposit,Cash Deposit,4542.82
2021,708902883,2-16-24 19:28,292.39,Withdrawal,Branch Withdrawal,4250.43
2022,708902883,2-21-24 21:28,747.52,IncomingTransfer,Freelance Payment,4997.95
2023,708902883,2-22-24 13:28,935.45,OutgoingTransfer,Wire Transfer,4062.5
2024,708902883,2-25-24 12:28,342.12,Payment,Mortgage Payment,3720.38
2025,708902883,2-28-24 9:28,617.83,Deposit,Mobile Deposit,4338.21
2026,708902883,2-29-24 10:28,745.14,Withdrawal,ATM Withdrawal,3593.07
2027,708902883,2-29-24 19:28,426.25,Payment,Bill Payment,3166.82
2028,708902883,03-01-24 13:28,399.84,Purchase,Electronics,2766.98
2029,708902883,03-05-24 12:28,623.18,Purchase,Gas,2143.8
2030,708902883,03-05-24 21:28,10200,IncomingTransfer,Salary,12343.8
2031,708902883,03-07-24 10:28,240.13,Deposit,Mobile Deposit,12583.93
2032,708902883,03-07-24 10:28,420.53,OnlineShopping,Etsy,12163.4
2033,708902883,3-13-24 15:28,831.89,Withdrawal,ATM Withdrawal,11331.51
2034,708902883,3-13-24 21:28,3600,Payment,Insurance Payment,7731.51
2035,708902883,3-14-24 22:28,331.53,OutgoingTransfer,Peer-to-Peer Transfer,7399.98
2036,708902883,3-16-24 15:28,434.25,Deposit,Mobile Deposit,7834.23
2037,708902883,3-21-24 21:28,319.74,Payment,Loan Payment,7514.49
2038,708902883,3-23-24 12:28,318.92,Deposit,Direct Deposit,7833.41
2039,708902883,04-01-24 21:28,10200,IncomingTransfer,Salary,18033.41
2040,708902883,04-04-24 22:28,426.54,Purchase,Grocery,17606.87
2041,708902883,04-06-24 17:28,542.21,IncomingTransfer,Freelance Payment,18149.08
2042,708902883,04-07-24 13:28,340.58,Deposit,Cash Deposit,18489.66
2043,708902883,04-11-24 14:28,603.64,OnlineShopping,Best Buy,17886.02
2044,708902883,4-13-24 18:28,771.95,Withdrawal,Branch Withdrawal,17114.07
2045,708902883,4-15-24 21:28,4300,Payment,Installment Payment,12814.07
2046,708902883,4-16-24 12:28,469.87,Purchase,Entertainment,12344.2
2047,708902883,4-20-24 12:28,758.86,Return,AliExpress Return,13103.06
2048,708902883,05-03-24 21:28,10200,IncomingTransfer,Salary,23303.06
2049,708902883,05-04-24 20:28,501.78,Purchase,Electronics,22801.28
2050,708902883,05-05-24 11:28,706.57,OnlineShopping,Walmart,22094.71
2051,708902883,05-05-24 22:28,530,OutgoingTransfer,Wire Transfer,21564.71
2052,708902883,05-09-24 23:28,432.2,Deposit,Mobile Deposit,21996.91
2053,708902883,5-17-24 23:28,483.57,OnlineShopping,Target,21513.34
2054,708902883,5-18-24 12:28,791.21,Purchase,Restaurant,20722.13
2055,708902883,5-18-24 21:28,3600,Payment,Subscription Payment,17122.13
2056,708902883,5-28-24 12:28,263.16,OnlineShopping,Best Buy,16858.97
2057,708902883,5-28-24 20:28,719.15,Payment,Mortgage Payment,16139.82
2058,708902883,5-29-24 16:28,603.55,OutgoingTransfer,Wire Transfer,15536.27
2059,708902883,06-03-24 21:28,10200,IncomingTransfer,Salary,25736.27
2060,708902883,06-04-24 13:28,595.11,Payment,Mortgage Payment,25141.16
2061,708902883,06-06-24 19:28,508.58,Purchase,Furniture,24632.58
2062,708902883,06-11-24 9:28,445.06,Return,AliExpress Return,25077.64
2063,708902883,6-14-24 18:28,510.89,OutgoingTransfer,International Transfer,24566.75
2064,708902883,6-14-24 20:28,243.38,Return,Best Buy Return,24810.13
2065,708902883,6-15-24 21:28,3600,Payment,Installment Payment,21210.13
2066,708902883,6-16-24 18:28,384.82,OutgoingTransfer,Peer-to-Peer Transfer,20825.31
2067,708902883,6-16-24 20:28,294.93,Deposit,Direct Deposit,21120.24
2068,708902883,6-17-24 19:28,541.57,OnlineShopping,Best Buy,20578.67
2069,708902883,6-19-24 12:28,785.77,OnlineShopping,Walmart,19792.9
2070,708902883,6-19-24 16:28,610.75,Purchase,Clothing,19182.15
2071,708902883,6-23-24 14:28,822.24,Return,Store Return,20004.39
2072,708902883,6-25-24 23:28,702.31,Return,Target Return,20706.7
2073,708902883,6-27-24 10:28,637.76,Withdrawal,Branch Withdrawal,20068.94
2074,708902883,6-28-24 19:28,357.15,Withdrawal,Branch Withdrawal,19711.79
2075,708902883,07-02-24 21:28,10200,IncomingTransfer,Salary,29911.79
2076,708902883,07-03-24 14:28,514.47,Deposit,Direct Deposit,30426.26
2077,708902883,07-03-24 15:28,751.65,OnlineShopping,AliExpress,29674.61
2078,708902883,07-06-24 16:28,300.61,Withdrawal,Mobile App Withdrawal,29374
2079,708902883,07-10-24 21:28,3100,Payment,Installment Payment,26274
2080,708902883,07-12-24 20:28,433.8,Purchase,Grocery,25840.2
2081,708902883,7-16-24 20:28,929.9,Withdrawal,Branch Withdrawal,24910.3
2082,708902883,7-17-24 16:28,849.96,OnlineShopping,Best Buy,24060.34
2083,709040508,1-20-24 20:28,640.26,Withdrawal,Branch Withdrawal,701.2268551
2084,709040508,1-23-24 9:28,868.06,OnlineShopping,Amazon,-166.8331449
2085,709040508,02-01-24 21:28,11000,IncomingTransfer,Salary,10833.16686
2086,709040508,02-03-24 15:28,346.57,OutgoingTransfer,Bank Transfer,10486.59686
2087,709040508,02-06-24 21:28,2600,Payment,Credit Card Payment,7886.596855
2088,709040508,02-08-24 12:28,525.58,OutgoingTransfer,Peer-to-Peer Transfer,7361.016855
2089,709040508,02-09-24 14:28,535.77,OnlineShopping,Walmart,6825.246855
2090,709040508,2-13-24 16:28,469.13,Deposit,Mobile Deposit,7294.376855
2091,709040508,2-14-24 15:28,501.91,Deposit,Mobile Deposit,7796.286855
2092,709040508,2-16-24 10:28,771.63,OnlineShopping,AliExpress,7024.656855
2093,709040508,2-16-24 21:28,6800,Payment,Rent Payment,224.6568551
2094,709040508,2-28-24 17:28,508.99,OutgoingTransfer,Peer-to-Peer Transfer,-284.3331449
2095,709040508,03-02-24 21:28,11000,IncomingTransfer,Salary,10715.66686
2096,709040508,03-04-24 11:28,277.88,OutgoingTransfer,International Transfer,10437.78686
2097,709040508,03-06-24 21:28,865.05,Purchase,Travel,9572.736855
2098,709040508,03-07-24 21:28,2700,Payment,Credit Card Payment,6872.736855
2099,709040508,03-08-24 19:28,506.64,Deposit,Mobile Deposit,7379.376855
2100,709040508,03-10-24 22:28,783.6,Withdrawal,Mobile App Withdrawal,6595.776855
2101,709040508,03-11-24 12:28,662.62,Purchase,Home Improvement,5933.156855
2102,709040508,3-17-24 21:28,6600,Payment,Rent Payment,-666.8431449
2103,709040508,3-17-24 21:28,929.87,Return,Target Return,263.0268551
2104,709040508,3-20-24 18:28,724.51,Payment,Bill Payment,-461.4831449
2105,709040508,3-20-24 18:28,796.35,Return,AliExpress Return,334.8668551
2106,709040508,3-21-24 12:28,536.05,Return,eBay Return,870.9168551
2107,709040508,3-28-24 19:28,901.8,Withdrawal,Mobile App Withdrawal,-30.88314492
2108,709040508,3-29-24 10:28,654.37,Return,AliExpress Return,623.4868551
2109,709040508,04-01-24 17:28,508.83,Deposit,Check Deposit,1132.316855
2110,709040508,04-01-24 17:28,264.94,Withdrawal,ATM Withdrawal,867.3768551
2111,709040508,04-03-24 14:28,506.67,Return,eBay Return,1374.046855
2112,709040508,04-03-24 15:28,257.15,Purchase,Clothing,1116.896855
2113,709040508,04-04-24 19:28,895.02,Deposit,Check Deposit,2011.916855
2114,709040508,04-05-24 21:28,11000,IncomingTransfer,Salary,13011.91686
2115,709040508,04-06-24 19:28,507.86,OnlineShopping,Target,12504.05686
2116,709040508,04-10-24 16:28,319.62,Payment,Mortgage Payment,12184.43686
2117,709040508,04-10-24 21:28,2500,Payment,Credit Card Payment,9684.436855
2118,709040508,4-15-24 20:28,760.29,Payment,Bill Payment,8924.146855
2119,709040508,4-15-24 21:28,3300,Payment,Rent Payment,5624.146855
2120,709040508,4-18-24 12:28,331.79,OutgoingTransfer,Wire Transfer,5292.356855
2121,709040508,4-20-24 13:28,200.63,Withdrawal,Mobile App Withdrawal,5091.726855
2122,709040508,4-22-24 11:28,460.62,OutgoingTransfer,International Transfer,4631.106855
2123,709040508,4-23-24 17:28,653.36,OnlineShopping,Best Buy,3977.746855
2124,709040508,4-23-24 23:28,841.95,Purchase,Gas,3135.796855
2125,709040508,4-25-24 23:28,525.15,Payment,Mortgage Payment,2610.646855
2126,709040508,05-02-24 13:28,452.07,Payment,Loan Payment,2158.576855
2127,709040508,05-02-24 14:28,797.01,OnlineShopping,Amazon,1361.566855
2128,709040508,05-02-24 21:28,11000,IncomingTransfer,Salary,12361.56686
2129,709040508,05-03-24 16:28,551.88,Purchase,Gas,11809.68686
2130,709040508,05-04-24 14:28,492.24,IncomingTransfer,Freelance Payment,12301.92686
2131,709040508,05-05-24 19:28,777.15,IncomingTransfer,Freelance Payment,13079.07686
2132,709040508,05-07-24 21:28,2400,Payment,Credit Card Payment,10679.07686
2133,709040508,05-12-24 17:28,631.66,Deposit,Mobile Deposit,11310.73686
2134,709040508,5-15-24 21:28,918.45,Purchase,Electronics,10392.28686
2135,709040508,5-18-24 21:28,4100,Payment,Rent Payment,6292.286855
2136,709040508,5-19-24 17:28,264.19,OnlineShopping,AliExpress,6028.096855
2137,709040508,5-19-24 21:28,766.26,Purchase,Home Improvement,5261.836855
2138,709040508,5-30-24 17:28,380.99,OutgoingTransfer,International Transfer,4880.846855
2139,709040508,06-01-24 15:28,728.44,OnlineShopping,Etsy,4152.406855
2140,709040508,06-01-24 18:28,723.81,Withdrawal,ATM Withdrawal,3428.596855
2141,709040508,06-01-24 21:28,11000,IncomingTransfer,Salary,14428.59686
2142,709040508,06-06-24 17:28,520.95,Purchase,Restaurant,13907.64686
2143,709040508,06-06-24 21:28,2500,Payment,Credit Card Payment,11407.64686
2144,709040508,06-08-24 11:28,514.86,IncomingTransfer,Freelance Payment,11922.50686
2145,709040508,06-09-24 20:28,681.24,Return,Amazon Return,12603.74686
2146,709040508,06-10-24 21:28,4200,Payment,Rent Payment,8403.746855
2147,709040508,06-12-24 20:28,487.93,Purchase,Entertainment,7915.816855
2148,709040508,6-14-24 14:28,293.41,Withdrawal,Branch Withdrawal,7622.406855
2149,709040508,6-16-24 18:28,280.51,Purchase,Entertainment,7341.896855
2150,709040508,6-16-24 22:28,919.27,Payment,Mortgage Payment,6422.626855
2151,709040508,6-17-24 14:28,717.93,IncomingTransfer,Freelance Payment,7140.556855
2152,709040508,6-17-24 19:28,763.61,Return,Walmart Return,7904.166855
2153,709040508,6-20-24 17:28,444.16,Deposit,Cash Deposit,8348.326855
2154,709040508,07-01-24 21:28,11000,IncomingTransfer,Salary,19348.32686
2155,709040508,07-06-24 21:28,2300,Payment,Credit Card Payment,17048.32686
2156,709040508,07-08-24 16:28,522.44,Payment,Mortgage Payment,16525.88686
2157,709040508,07-11-24 16:28,360.27,Payment,Bill Payment,16165.61686
2158,709040508,7-18-24 21:28,4100,Payment,Rent Payment,12065.61686
2159,709061658,1-28-24 14:28,240.27,OnlineShopping,Best Buy,391.7158464
2160,709061658,1-28-24 17:28,82.82,Payment,Mortgage Payment,308.8958464
2161,709061658,1-28-24 19:28,164.56,Deposit,Direct Deposit,473.4558464
2162,709061658,1-29-24 23:28,35.13,Deposit,Check Deposit,508.5858464
2163,709061658,1-31-24 9:28,198.62,IncomingTransfer,Freelance Payment,707.2058464
2164,709061658,1-31-24 12:28,137.33,Deposit,Check Deposit,844.5358464
2165,709061658,02-01-24 17:28,108.46,OnlineShopping,Etsy,736.0758464
2166,709061658,02-03-24 18:28,148.97,Deposit,Mobile Deposit,885.0458464
2167,709061658,02-05-24 9:28,51.61,Purchase,Entertainment,833.4358464
2168,709061658,02-07-24 12:28,91.75,Withdrawal,Mobile App Withdrawal,741.6858464
2169,709061658,02-07-24 20:28,178.84,Return,Etsy Return,920.5258464
2170,709061658,02-08-24 12:28,142.84,Purchase,Restaurant,777.6858464
2171,709061658,02-10-24 17:28,178.14,IncomingTransfer,Freelance Payment,955.8258464
2172,709061658,2-14-24 19:28,68.06,Purchase,Pharmacy,887.7658464
2173,709061658,2-19-24 14:28,209.69,OutgoingTransfer,Wire Transfer,678.0758464
2174,709061658,2-19-24 23:28,150.69,Purchase,Electronics,527.3858464
2175,709061658,2-22-24 12:28,203.86,Purchase,Gas,323.5258464
2176,709061658,2-22-24 14:28,217.01,Purchase,Restaurant,106.5158464
2177,709061658,2-22-24 14:28,176.98,Withdrawal,Mobile App Withdrawal,-70.46415359
2178,709061658,2-23-24 11:28,77.9,Withdrawal,ATM Withdrawal,-148.3641536
2179,709061658,2-23-24 12:28,138.88,Purchase,Pharmacy,-287.2441536
2180,709061658,2-23-24 16:28,45.23,Deposit,Mobile Deposit,-242.0141536
2181,709061658,2-25-24 12:28,21.25,OutgoingTransfer,Bank Transfer,-263.2641536
2182,709061658,2-29-24 18:28,234.23,Return,Amazon Return,-29.03415359
2183,709061658,2-29-24 22:28,76.79,Deposit,Mobile Deposit,47.75584641
2184,709061658,03-05-24 22:28,82.56,Purchase,Gas,-34.80415359
2185,709061658,03-06-24 20:28,141.99,Withdrawal,ATM Withdrawal,-176.7941536
2186,709061658,03-10-24 14:28,116.97,Return,Walmart Return,-59.82415359
2187,709061658,3-14-24 12:28,51.34,OnlineShopping,Best Buy,-111.1641536
2188,709061658,3-17-24 12:28,135.9,Payment,Bill Payment,-247.0641536
2189,709061658,3-21-24 14:28,103.23,Deposit,Mobile Deposit,-143.8341536
2190,709061658,3-23-24 11:28,136.62,Payment,Loan Payment,-280.4541536
2191,709061658,3-24-24 16:28,113.95,Deposit,Cash Deposit,-166.5041536
2192,709061658,3-27-24 15:28,27.85,Deposit,Cash Deposit,-138.6541536
2193,709061658,3-27-24 16:28,246.44,Purchase,Travel,-385.0941536
2194,709061658,3-28-24 23:28,137.29,IncomingTransfer,Freelance Payment,-247.8041536
2195,709061658,04-01-24 15:28,226.22,Withdrawal,Mobile App Withdrawal,-474.0241536
2196,709061658,04-05-24 10:28,170.77,Return,Store Return,-303.2541536
2197,709061658,04-09-24 12:28,59.61,Purchase,Pharmacy,-362.8641536
2198,709061658,04-10-24 10:28,83.36,Purchase,Home Improvement,-446.2241536
2199,709061658,4-15-24 11:28,121.84,Purchase,Restaurant,-568.0641536
2200,709061658,4-16-24 21:28,91.77,Purchase,Furniture,-659.8341536
2201,709061658,4-23-24 11:28,85.82,Purchase,Entertainment,-745.6541536
2202,709061658,4-23-24 12:28,28.87,Purchase,Travel,-774.5241536
2203,709061658,4-25-24 22:28,89.29,Deposit,Cash Deposit,-685.2341536
2204,709061658,4-30-24 9:28,174.64,Deposit,Check Deposit,-510.5941536
2205,709061658,05-01-24 22:28,171.14,OutgoingTransfer,Bank Transfer,-681.7341536
2206,709061658,05-06-24 9:28,115.76,OutgoingTransfer,Peer-to-Peer Transfer,-797.4941536
2207,709061658,05-07-24 16:28,188.45,Return,Target Return,-609.0441536
2208,709061658,05-07-24 21:28,106.9,Withdrawal,Branch Withdrawal,-715.9441536
2209,709061658,05-09-24 17:28,84.25,Return,AliExpress Return,-631.6941536
2210,709061658,05-11-24 17:28,139.72,Deposit,Cash Deposit,-491.9741536
2211,709061658,5-14-24 22:28,101.72,Purchase,Grocery,-593.6941536
2212,709061658,5-17-24 13:28,123.21,Purchase,Entertainment,-716.9041536
2213,709061658,5-18-24 18:28,16.16,OnlineShopping,AliExpress,-733.0641536
2214,709061658,5-20-24 9:28,71.64,Withdrawal,Mobile App Withdrawal,-804.7041536
2215,709061658,5-20-24 15:28,194.62,Return,Walmart Return,-610.0841536
2216,709061658,5-20-24 20:28,176.63,OutgoingTransfer,Peer-to-Peer Transfer,-786.7141536
2217,709061658,5-23-24 23:28,101.8,Deposit,Mobile Deposit,-684.9141536
2218,709061658,5-25-24 12:28,70.37,Purchase,Pharmacy,-755.2841536
2219,709061658,5-26-24 15:28,20.42,Return,Etsy Return,-734.8641536
2220,709061658,5-26-24 22:28,172.49,Return,Store Return,-562.3741536
2221,709061658,06-01-24 19:28,30.57,Deposit,Check Deposit,-531.8041536
2222,709061658,06-02-24 20:28,162.05,Payment,Mortgage Payment,-693.8541536
2223,709061658,06-05-24 18:28,50.31,Purchase,Grocery,-744.1641536
2224,709061658,06-08-24 16:28,60.9,IncomingTransfer,Freelance Payment,-683.2641536
2225,709061658,06-08-24 18:28,125.31,OutgoingTransfer,Peer-to-Peer Transfer,-808.5741536
2226,709061658,06-10-24 15:28,169.16,Return,Amazon Return,-639.4141536
2227,709061658,06-11-24 15:28,111.6,OutgoingTransfer,Wire Transfer,-751.0141536
2228,709061658,06-11-24 23:28,165.13,Deposit,Direct Deposit,-585.8841536
2229,709061658,06-12-24 10:28,200.27,Deposit,Direct Deposit,-385.6141536
2230,709061658,06-12-24 14:28,123.84,Withdrawal,ATM Withdrawal,-509.4541536
2231,709061658,6-13-24 9:28,224.15,OutgoingTransfer,Wire Transfer,-733.6041536
2232,709061658,6-14-24 20:28,141.67,OnlineShopping,Etsy,-875.2741536
2233,709061658,6-14-24 22:28,81.88,Return,Etsy Return,-793.3941536
2234,709061658,6-15-24 16:28,245.38,OnlineShopping,eBay,-1038.774154
2235,709061658,6-16-24 14:28,116.01,Deposit,Cash Deposit,-922.7641536
2236,709061658,6-23-24 21:28,226.76,Purchase,Furniture,-1149.524154
2237,709061658,6-25-24 22:28,123.35,OutgoingTransfer,Bank Transfer,-1272.874154
2238,709061658,6-28-24 16:28,141.02,Return,Walmart Return,-1131.854154
2239,709061658,07-02-24 10:28,227.56,Purchase,Pharmacy,-1359.414154
2240,709061658,07-03-24 18:28,192.63,Withdrawal,Mobile App Withdrawal,-1552.044154
2241,709061658,07-03-24 22:28,246.19,OnlineShopping,AliExpress,-1798.234154
2242,709061658,07-04-24 10:28,31.53,Purchase,Entertainment,-1829.764154
2243,709061658,07-08-24 21:28,11.51,IncomingTransfer,Freelance Payment,-1818.254154
2244,709061658,07-11-24 12:28,123.36,Purchase,Clothing,-1941.614154
2245,709061658,7-15-24 16:28,245.27,Purchase,Grocery,-2186.884154
2246,709077933,1-20-24 19:28,77.55,Payment,Mortgage Payment,329.4108213
2247,709077933,1-21-24 10:28,195.83,Payment,Bill Payment,133.5808213
2248,709077933,1-21-24 15:28,117.19,Payment,Loan Payment,16.39082127
2249,709077933,1-25-24 19:28,231.27,Deposit,Check Deposit,247.6608213
2250,709077933,1-28-24 18:28,126.51,Deposit,Direct Deposit,374.1708213
2251,709077933,1-31-24 12:28,224.39,OutgoingTransfer,Bank Transfer,149.7808213
2252,709077933,02-03-24 16:28,87.53,Purchase,Electronics,62.25082127
2253,709077933,02-03-24 21:28,3300,IncomingTransfer,Salary,3362.250821
2254,709077933,02-08-24 21:28,700,Payment,Credit Card Payment,2662.250821
2255,709077933,02-10-24 15:28,130.05,OutgoingTransfer,Wire Transfer,2532.200821
2256,709077933,02-10-24 21:28,1900,Payment,Rent Payment,632.2008213
2257,709077933,02-11-24 21:28,179.78,Return,eBay Return,811.9808213
2258,709077933,2-17-24 16:28,56.43,Purchase,Pharmacy,755.5508213
2259,709077933,2-18-24 21:28,42.96,Payment,Mortgage Payment,712.5908213
2260,709077933,2-21-24 13:28,247.88,Return,Store Return,960.4708213
2261,709077933,2-25-24 21:28,228.87,Deposit,Check Deposit,1189.340821
2262,709077933,2-26-24 9:28,168.01,Deposit,Direct Deposit,1357.350821
2263,709077933,2-29-24 10:28,74.8,Deposit,Check Deposit,1432.150821
2264,709077933,03-05-24 21:28,3300,IncomingTransfer,Salary,4732.150821
2265,709077933,03-06-24 9:28,241.15,Deposit,Check Deposit,4973.300821
2266,709077933,03-06-24 16:28,45.23,Payment,Loan Payment,4928.070821
2267,709077933,03-10-24 21:28,1000,Payment,Credit Card Payment,3928.070821
2268,709077933,3-14-24 21:28,1000,Payment,Rent Payment,2928.070821
2269,709077933,3-16-24 11:28,180.16,OutgoingTransfer,Wire Transfer,2747.910821
2270,709077933,3-17-24 22:28,193.9,Payment,Loan Payment,2554.010821
2271,709077933,3-19-24 20:28,57.69,Return,Etsy Return,2611.700821
2272,709077933,3-29-24 16:28,95.75,Deposit,Cash Deposit,2707.450821
2273,709077933,04-01-24 21:28,3300,IncomingTransfer,Salary,6007.450821
2274,709077933,04-02-24 18:28,220.12,Withdrawal,Branch Withdrawal,5787.330821
2275,709077933,04-06-24 21:28,1000,Payment,Credit Card Payment,4787.330821
2276,709077933,04-09-24 20:28,216.4,IncomingTransfer,Freelance Payment,5003.730821
2277,709077933,04-10-24 10:28,57.48,IncomingTransfer,Freelance Payment,5061.210821
2278,709077933,04-10-24 13:28,134.69,Payment,Mortgage Payment,4926.520821
2279,709077933,04-11-24 21:28,142.42,Return,Amazon Return,5068.940821
2280,709077933,4-13-24 12:28,76.31,Purchase,Gas,4992.630821
2281,709077933,4-14-24 17:28,215.33,Return,AliExpress Return,5207.960821
2282,709077933,4-14-24 21:28,167.89,Return,Target Return,5375.850821
2283,709077933,4-17-24 21:28,32.35,OutgoingTransfer,Bank Transfer,5343.500821
2284,709077933,4-18-24 21:28,1100,Payment,Rent Payment,4243.500821
2285,709077933,4-26-24 18:28,25.44,Deposit,Mobile Deposit,4268.940821
2286,709077933,4-28-24 17:28,207.73,Deposit,Cash Deposit,4476.670821
2287,709077933,4-30-24 21:28,65.69,Purchase,Electronics,4410.980821
2288,709077933,05-03-24 11:28,228.88,Return,Best Buy Return,4639.860821
2289,709077933,05-03-24 21:28,3300,IncomingTransfer,Salary,7939.860821
2290,709077933,05-04-24 18:28,120.65,Return,AliExpress Return,8060.510821
2291,709077933,05-07-24 11:28,39.74,Purchase,Grocery,8020.770821
2292,709077933,05-08-24 21:28,1000,Payment,Credit Card Payment,7020.770821
2293,709077933,05-11-24 19:28,203.9,Purchase,Entertainment,6816.870821
2294,709077933,05-11-24 22:28,42.98,OutgoingTransfer,International Transfer,6773.890821
2295,709077933,05-12-24 10:28,96.26,OutgoingTransfer,Wire Transfer,6677.630821
2296,709077933,05-12-24 14:28,114.79,Return,Amazon Return,6792.420821
2297,709077933,05-12-24 21:28,1100,Payment,Rent Payment,5692.420821
2298,709077933,5-15-24 21:28,66.59,Deposit,Mobile Deposit,5759.010821
2299,709077933,5-18-24 19:28,208.36,OnlineShopping,Etsy,5550.650821
2300,709077933,5-20-24 17:28,174.35,Withdrawal,Mobile App Withdrawal,5376.300821
2301,709077933,5-23-24 14:28,233.22,Purchase,Restaurant,5143.080821
2302,709077933,5-24-24 17:28,126.38,Deposit,Cash Deposit,5269.460821
2303,709077933,5-24-24 22:28,124.86,Deposit,Mobile Deposit,5394.320821
2304,709077933,5-30-24 19:28,144.37,Deposit,Mobile Deposit,5538.690821
2305,709077933,5-31-24 13:28,240.01,Deposit,Check Deposit,5778.700821
2306,709077933,06-01-24 13:28,230.77,Purchase,Furniture,5547.930821
2307,709077933,06-02-24 21:28,3300,IncomingTransfer,Salary,8847.930821
2308,709077933,06-03-24 22:28,95.7,OutgoingTransfer,Peer-to-Peer Transfer,8752.230821
2309,709077933,06-07-24 21:28,900,Payment,Credit Card Payment,7852.230821
2310,709077933,06-07-24 22:28,88.67,Purchase,Furniture,7763.560821
2311,709077933,06-12-24 21:28,900,Payment,Rent Payment,6863.560821
2312,709077933,6-17-24 10:28,10.75,Withdrawal,Branch Withdrawal,6852.810821
2313,709077933,6-19-24 12:28,76.7,IncomingTransfer,Freelance Payment,6929.510821
2314,709077933,6-20-24 13:28,24.74,IncomingTransfer,Freelance Payment,6954.250821
2315,709077933,6-30-24 17:28,239.45,Purchase,Travel,6714.800821
2316,709077933,07-01-24 12:28,246.34,Return,Amazon Return,6961.140821
2317,709077933,07-04-24 21:28,3300,IncomingTransfer,Salary,10261.14082
2318,709077933,07-06-24 16:28,147.93,Payment,Loan Payment,10113.21082
2319,709077933,07-09-24 21:28,1000,Payment,Credit Card Payment,9113.210821
2320,709077933,07-10-24 14:28,47.67,Payment,Bill Payment,9065.540821
2321,709077933,7-13-24 10:28,182.22,IncomingTransfer,Freelance Payment,9247.760821
2322,709077933,7-13-24 14:28,16.25,OnlineShopping,eBay,9231.510821
2323,709077933,7-13-24 16:28,227.58,OnlineShopping,Target,9003.930821
2324,709077933,7-15-24 21:28,1000,Payment,Rent Payment,8003.930821
2325,709077933,7-16-24 18:28,51.48,Deposit,Cash Deposit,8055.410821
2326,709134333,1-22-24 21:28,140.36,Deposit,Cash Deposit,1504.130092
2327,709134333,1-27-24 13:28,228.12,Payment,Bill Payment,1276.010092
2328,709134333,1-28-24 22:28,175.32,Deposit,Direct Deposit,1451.330092
2329,709134333,1-29-24 23:28,91.55,Withdrawal,Branch Withdrawal,1359.780092
2330,709134333,02-02-24 12:28,132.56,Withdrawal,Branch Withdrawal,1227.220092
2331,709134333,02-03-24 21:28,3100,IncomingTransfer,Salary,4327.220092
2332,709134333,02-04-24 12:28,63.26,Purchase,Restaurant,4263.960092
2333,709134333,02-08-24 21:28,3000,Payment,Credit Card Payment,1263.960092
2334,709134333,02-11-24 10:28,92.27,Withdrawal,Mobile App Withdrawal,1171.690092
2335,709134333,02-11-24 11:28,79.62,Return,AliExpress Return,1251.310092
2336,709134333,02-11-24 18:28,74.31,Purchase,Pharmacy,1177.000092
2337,709134333,2-13-24 19:28,237.81,Deposit,Direct Deposit,1414.810092
2338,709134333,2-13-24 21:28,1300,Payment,Rent Payment,114.8100921
2339,709134333,2-14-24 19:28,186.74,Purchase,Restaurant,-71.92990789
2340,709134333,2-15-24 11:28,237.34,Return,Target Return,165.4100921
2341,709134333,2-16-24 17:28,175.01,Purchase,Gas,-9.599907893
2342,709134333,2-17-24 17:28,72.04,Return,Amazon Return,62.44009211
2343,709134333,2-18-24 18:28,220.25,Purchase,Home Improvement,-157.8099079
2344,709134333,03-04-24 21:28,3100,IncomingTransfer,Salary,2942.190092
2345,709134333,03-05-24 16:28,112.24,Withdrawal,Mobile App Withdrawal,2829.950092
2346,709134333,03-05-24 22:28,125.63,IncomingTransfer,Freelance Payment,2955.580092
2347,709134333,03-09-24 20:28,33.87,Withdrawal,Branch Withdrawal,2921.710092
2348,709134333,03-09-24 21:28,3200,Payment,Credit Card Payment,-278.2899079
2349,709134333,03-10-24 18:28,151.25,Withdrawal,Mobile App Withdrawal,-429.5399079
2350,709134333,03-11-24 15:28,197.82,Return,Target Return,-231.7199079
2351,709134333,03-11-24 16:28,170.89,Withdrawal,ATM Withdrawal,-402.6099079
2352,709134333,03-11-24 19:28,59.33,IncomingTransfer,Freelance Payment,-343.2799079
2353,709134333,03-12-24 20:28,52.02,Purchase,Home Improvement,-395.2999079
2354,709134333,3-14-24 21:28,1300,Payment,Rent Payment,-1695.299908
2355,709134333,3-15-24 9:28,176.7,Deposit,Check Deposit,-1518.599908
2356,709134333,3-18-24 11:28,104.15,Return,Walmart Return,-1414.449908
2357,709134333,3-21-24 23:28,179.33,IncomingTransfer,Freelance Payment,-1235.119908
2358,709134333,3-23-24 15:28,14.79,Withdrawal,Branch Withdrawal,-1249.909908
2359,709134333,3-24-24 16:28,236.81,Deposit,Direct Deposit,-1013.099908
2360,709134333,3-27-24 15:28,111.28,OutgoingTransfer,Wire Transfer,-1124.379908
2361,709134333,3-27-24 19:28,73.81,Purchase,Travel,-1198.189908
2362,709134333,3-28-24 18:28,211.31,OutgoingTransfer,Peer-to-Peer Transfer,-1409.499908
2363,709134333,3-30-24 10:28,12.89,Deposit,Cash Deposit,-1396.609908
2364,709134333,3-30-24 12:28,19.24,IncomingTransfer,Freelance Payment,-1377.369908
2365,709134333,04-01-24 16:28,51.99,Withdrawal,Mobile App Withdrawal,-1429.359908
2366,709134333,04-02-24 11:28,188.96,Purchase,Clothing,-1618.319908
2367,709134333,04-03-24 14:28,87.31,Payment,Bill Payment,-1705.629908
2368,709134333,04-05-24 21:28,3100,IncomingTransfer,Salary,1394.370092
2369,709134333,04-08-24 18:28,18.38,OnlineShopping,AliExpress,1375.990092
2370,709134333,04-08-24 21:28,96.77,Purchase,Furniture,1279.220092
2371,709134333,04-10-24 21:28,2900,Payment,Credit Card Payment,-1620.779908
2372,709134333,04-11-24 15:28,91.63,Deposit,Mobile Deposit,-1529.149908
2373,709134333,4-13-24 18:28,12.62,Deposit,Mobile Deposit,-1516.529908
2374,709134333,4-14-24 12:28,27.53,Deposit,Direct Deposit,-1488.999908
2375,709134333,4-15-24 21:28,1100,Payment,Rent Payment,-2588.999908
2376,709134333,4-20-24 15:28,45.58,Deposit,Cash Deposit,-2543.419908
2377,709134333,4-28-24 22:28,74.69,Purchase,Grocery,-2618.109908
2378,709134333,05-01-24 21:28,3100,IncomingTransfer,Salary,481.8900921
2379,709134333,05-03-24 21:28,214.58,Return,Best Buy Return,696.4700921
2380,709134333,05-03-24 22:28,48.28,Payment,Bill Payment,648.1900921
2381,709134333,05-04-24 20:28,130.6,Return,Amazon Return,778.7900921
2382,709134333,05-05-24 17:28,96.63,OnlineShopping,Target,682.1600921
2383,709134333,05-06-24 21:28,2700,Payment,Credit Card Payment,-2017.839908
2384,709134333,05-08-24 19:28,219.45,Purchase,Entertainment,-2237.289908
2385,709134333,5-16-24 21:28,1700,Payment,Rent Payment,-3937.289908
2386,709134333,5-16-24 21:28,196.33,Deposit,Cash Deposit,-3740.959908
2387,709134333,5-17-24 13:28,50.16,Payment,Loan Payment,-3791.119908
2388,709134333,5-19-24 16:28,120.28,Purchase,Clothing,-3911.399908
2389,709134333,5-19-24 22:28,178.8,OutgoingTransfer,International Transfer,-4090.199908
2390,709134333,06-02-24 18:28,175.12,OutgoingTransfer,Wire Transfer,-4265.319908
2391,709134333,06-05-24 21:28,3100,IncomingTransfer,Salary,-1165.319908
2392,709134333,06-06-24 9:28,242.72,Withdrawal,Mobile App Withdrawal,-1408.039908
2393,709134333,06-07-24 20:28,151.29,Payment,Bill Payment,-1559.329908
2394,709134333,06-10-24 21:28,2300,Payment,Credit Card Payment,-3859.329908
2395,709134333,06-11-24 21:28,1000,Payment,Rent Payment,-4859.329908
2396,709134333,6-18-24 14:28,198.66,Return,Amazon Return,-4660.669908
2397,709134333,6-20-24 12:28,13.58,Purchase,Furniture,-4674.249908
2398,709134333,6-20-24 18:28,70.42,Purchase,Travel,-4744.669908
2399,709134333,6-24-24 18:28,91.93,Withdrawal,Mobile App Withdrawal,-4836.599908
2400,709134333,07-03-24 21:28,3100,IncomingTransfer,Salary,-1736.599908
2401,709134333,07-07-24 20:28,195.84,Payment,Mortgage Payment,-1932.439908
2402,709134333,07-08-24 16:28,238.7,Deposit,Direct Deposit,-1693.739908
2403,709134333,07-08-24 21:28,2500,Payment,Credit Card Payment,-4193.739908
2404,709134333,07-09-24 10:28,121.75,OnlineShopping,Amazon,-4315.489908
2405,709134333,07-10-24 21:28,1700,Payment,Rent Payment,-6015.489908
2406,709134333,07-11-24 12:28,66.81,Withdrawal,ATM Withdrawal,-6082.299908
2407,709134333,07-12-24 9:28,203.38,Purchase,Grocery,-6285.679908
2408,709134333,7-15-24 12:28,180.44,Purchase,Pharmacy,-6466.119908
2409,709134333,7-16-24 17:28,153.01,OutgoingTransfer,Wire Transfer,-6619.129908
2410,709134333,7-17-24 18:28,29.93,OnlineShopping,Target,-6649.059908
2411,709169133,1-22-24 15:28,479.27,Withdrawal,Branch Withdrawal,-479.27
2412,709169133,1-24-24 12:28,180.32,Withdrawal,ATM Withdrawal,-659.59
2413,709169133,1-25-24 19:28,10.25,OutgoingTransfer,Peer-to-Peer Transfer,-669.84
2414,709169133,1-26-24 9:28,317.64,IncomingTransfer,Freelance Payment,-352.2
2415,709169133,1-26-24 13:28,286.81,Withdrawal,Branch Withdrawal,-639.01
2416,709169133,1-27-24 10:28,262.43,Deposit,Cash Deposit,-376.58
2417,709169133,02-01-24 9:28,92.65,Purchase,Furniture,-469.23
2418,709169133,02-03-24 11:28,368.71,Return,AliExpress Return,-100.52
2419,709169133,02-06-24 19:28,277.26,OutgoingTransfer,Peer-to-Peer Transfer,-377.78
2420,709169133,02-07-24 10:28,408.95,Deposit,Mobile Deposit,31.17
2421,709169133,02-07-24 15:28,438.7,Deposit,Check Deposit,469.87
2422,709169133,2-21-24 9:28,366.69,Payment,Loan Payment,103.18
2423,709169133,2-21-24 17:28,183.9,Deposit,Check Deposit,287.08
2424,709169133,2-22-24 10:28,52.63,Withdrawal,Mobile App Withdrawal,234.45
2425,709169133,2-27-24 11:28,108.51,Withdrawal,ATM Withdrawal,125.94
2426,709169133,2-27-24 15:28,339.85,Withdrawal,ATM Withdrawal,-213.91
2427,709169133,2-28-24 18:28,19.13,Withdrawal,Branch Withdrawal,-233.04
2428,709169133,2-29-24 11:28,408.38,OutgoingTransfer,Bank Transfer,-641.42
2429,709169133,03-03-24 10:28,250.32,Purchase,Clothing,-891.74
2430,709169133,03-12-24 15:28,439.89,Withdrawal,Mobile App Withdrawal,-1331.63
2431,709169133,3-15-24 9:28,456.84,Withdrawal,ATM Withdrawal,-1788.47
2432,709169133,3-21-24 10:28,355.02,Purchase,Furniture,-2143.49
2433,709169133,3-24-24 22:28,32.55,Purchase,Entertainment,-2176.04
2434,709169133,3-25-24 11:28,211.72,Purchase,Home Improvement,-2387.76
2435,709169133,3-25-24 18:28,450.74,IncomingTransfer,Freelance Payment,-1937.02
2436,709169133,3-28-24 18:28,182.7,Return,Store Return,-1754.32
2437,709169133,3-29-24 13:28,216.85,OnlineShopping,AliExpress,-1971.17
2438,709169133,3-29-24 13:28,14.51,Deposit,Direct Deposit,-1956.66
2439,709169133,3-30-24 21:28,426.64,Deposit,Mobile Deposit,-1530.02
2440,709169133,3-30-24 22:28,129.95,Purchase,Grocery,-1659.97
2441,709169133,04-04-24 18:28,412.9,OutgoingTransfer,Peer-to-Peer Transfer,-2072.87
2442,709169133,04-04-24 19:28,129.47,Deposit,Cash Deposit,-1943.4
2443,709169133,04-05-24 20:28,166.4,IncomingTransfer,Freelance Payment,-1777
2444,709169133,04-06-24 10:28,348.46,Purchase,Furniture,-2125.46
2445,709169133,04-12-24 15:28,275.59,OnlineShopping,Best Buy,-2401.05
2446,709169133,4-16-24 12:28,343.05,OnlineShopping,Best Buy,-2744.1
2447,709169133,4-16-24 13:28,430.52,Withdrawal,ATM Withdrawal,-3174.62
2448,709169133,4-20-24 19:28,353.98,Purchase,Clothing,-3528.6
2449,709169133,4-20-24 22:28,481.03,Payment,Mortgage Payment,-4009.63
2450,709169133,4-25-24 13:28,429.46,Deposit,Check Deposit,-3580.17
2451,709169133,4-30-24 9:28,200.36,OnlineShopping,Etsy,-3780.53
2452,709169133,4-30-24 13:28,454.09,Purchase,Clothing,-4234.62
2453,709169133,05-03-24 11:28,152.58,Withdrawal,Branch Withdrawal,-4387.2
2454,709169133,05-04-24 19:28,164.74,Withdrawal,Branch Withdrawal,-4551.94
2455,709169133,05-06-24 18:28,307.48,Withdrawal,ATM Withdrawal,-4859.42
2456,709169133,05-09-24 10:28,412.11,Payment,Bill Payment,-5271.53
2457,709169133,05-12-24 22:28,424.08,Payment,Bill Payment,-5695.61
2458,709169133,5-14-24 15:28,150.15,OutgoingTransfer,Wire Transfer,-5845.76
2459,709169133,5-15-24 12:28,346.1,OnlineShopping,eBay,-6191.86
2460,709169133,5-18-24 20:28,412.62,Deposit,Cash Deposit,-5779.24
2461,709169133,5-19-24 10:28,288.95,OnlineShopping,eBay,-6068.19
2462,709169133,5-21-24 11:28,491.42,OutgoingTransfer,International Transfer,-6559.61
2463,709169133,5-21-24 12:28,263.33,Withdrawal,ATM Withdrawal,-6822.94
2464,709169133,5-25-24 15:28,378.99,Deposit,Mobile Deposit,-6443.95
2465,709169133,5-26-24 16:28,270.14,Payment,Loan Payment,-6714.09
2466,709169133,5-26-24 18:28,39,Deposit,Check Deposit,-6675.09
2467,709169133,5-27-24 16:28,326.14,Deposit,Mobile Deposit,-6348.95
2468,709169133,5-27-24 19:28,258.23,Payment,Mortgage Payment,-6607.18
2469,709169133,5-27-24 23:28,365.18,Purchase,Entertainment,-6972.36
2470,709169133,06-02-24 22:28,310.68,Return,Store Return,-6661.68
2471,709169133,06-06-24 16:28,437.96,Purchase,Electronics,-7099.64
2472,709169133,06-08-24 10:28,27.82,OutgoingTransfer,Wire Transfer,-7127.46
2473,709169133,06-10-24 10:28,413,Purchase,Home Improvement,-7540.46
2474,709169133,6-13-24 23:28,221.53,Withdrawal,ATM Withdrawal,-7761.99
2475,709169133,6-13-24 23:28,181.49,IncomingTransfer,Freelance Payment,-7580.5
2476,709169133,6-14-24 23:28,112.67,Deposit,Mobile Deposit,-7467.83
2477,709169133,6-16-24 21:28,76.77,Deposit,Cash Deposit,-7391.06
2478,709169133,6-18-24 14:28,460.92,OutgoingTransfer,International Transfer,-7851.98
2479,709169133,6-18-24 14:28,199.13,OutgoingTransfer,Wire Transfer,-8051.11
2480,709169133,6-20-24 9:28,150.58,Deposit,Check Deposit,-7900.53
2481,709169133,6-20-24 13:28,226.53,Withdrawal,Mobile App Withdrawal,-8127.06
2482,709169133,6-20-24 20:28,381.18,Withdrawal,Branch Withdrawal,-8508.24
2483,709169133,6-21-24 12:28,36.21,Withdrawal,Mobile App Withdrawal,-8544.45
2484,709169133,6-24-24 13:28,130.62,Purchase,Home Improvement,-8675.07
2485,709169133,6-25-24 22:28,470.98,OutgoingTransfer,Wire Transfer,-9146.05
2486,709169133,6-27-24 9:28,15.25,OnlineShopping,AliExpress,-9161.3
2487,709169133,6-30-24 15:28,34.93,Payment,Bill Payment,-9196.23
2488,709169133,07-03-24 23:28,58.91,Deposit,Cash Deposit,-9137.32
2489,709169133,07-05-24 11:28,446.36,Withdrawal,Branch Withdrawal,-9583.68
2490,709169133,07-09-24 19:28,473.71,OutgoingTransfer,International Transfer,-10057.39
2491,709169133,7-14-24 19:28,127.97,OutgoingTransfer,Bank Transfer,-10185.36
2492,709169133,7-15-24 17:28,396.11,Deposit,Check Deposit,-9789.25
2493,709207458,02-05-24 21:28,3750,IncomingTransfer,Salary,4634.771518
2494,709207458,02-10-24 21:28,1900,Payment,Credit Card Payment,2734.771518
2495,709207458,02-11-24 10:28,355.59,IncomingTransfer,Freelance Payment,3090.361518
2496,709207458,2-14-24 21:28,1600,Payment,Rent Payment,1490.361518
2497,709207458,2-19-24 13:28,216.78,Purchase,Grocery,1273.581518
2498,709207458,2-21-24 16:28,245.5,Payment,Bill Payment,1028.081518
2499,709207458,2-22-24 15:28,175.38,Purchase,Pharmacy,852.7015179
2500,709207458,2-24-24 18:28,121.92,OnlineShopping,Target,730.7815179
2501,709207458,2-24-24 18:28,158.2,OnlineShopping,Amazon,572.5815179
2502,709207458,03-03-24 21:28,3750,IncomingTransfer,Salary,4322.581518
2503,709207458,03-04-24 11:28,24.5,Withdrawal,Mobile App Withdrawal,4298.081518
2504,709207458,03-08-24 21:28,1800,Payment,Credit Card Payment,2498.081518
2505,709207458,03-12-24 13:28,29.89,Deposit,Cash Deposit,2527.971518
2506,709207458,3-16-24 21:28,1200,Payment,Rent Payment,1327.971518
2507,709207458,3-23-24 18:28,121.84,Purchase,Travel,1206.131518
2508,709207458,3-27-24 17:28,362.35,IncomingTransfer,Freelance Payment,1568.481518
2509,709207458,3-30-24 22:28,372.99,Return,eBay Return,1941.471518
2510,709207458,04-04-24 21:28,3750,IncomingTransfer,Salary,5691.471518
2511,709207458,04-05-24 23:28,182.45,OutgoingTransfer,Peer-to-Peer Transfer,5509.021518
2512,709207458,04-09-24 21:28,2000,Payment,Credit Card Payment,3509.021518
2513,709207458,04-11-24 21:28,2000,Payment,Rent Payment,1509.021518
2514,709207458,4-16-24 23:28,151.56,Payment,Loan Payment,1357.461518
2515,709207458,4-24-24 9:28,95.75,Purchase,Clothing,1261.711518
2516,709207458,4-29-24 13:28,142.82,Deposit,Direct Deposit,1404.531518
2517,709207458,05-02-24 21:28,3750,IncomingTransfer,Salary,5154.531518
2518,709207458,05-06-24 16:28,230.55,Withdrawal,Mobile App Withdrawal,4923.981518
2519,709207458,05-07-24 21:28,2100,Payment,Credit Card Payment,2823.981518
2520,709207458,05-12-24 15:28,184.73,Purchase,Pharmacy,2639.251518
2521,709207458,5-17-24 21:28,2400,Payment,Rent Payment,239.2515179
2522,709207458,5-30-24 16:28,384.06,Deposit,Cash Deposit,623.3115179
2523,709207458,06-01-24 16:28,399.83,Payment,Mortgage Payment,223.4815179
2524,709207458,06-01-24 21:28,3750,IncomingTransfer,Salary,3973.481518
2525,709207458,06-06-24 21:28,2200,Payment,Credit Card Payment,1773.481518
2526,709207458,06-11-24 21:28,2300,Payment,Rent Payment,-526.5184821
2527,709207458,6-14-24 22:28,299.88,OnlineShopping,Walmart,-826.3984821
2528,709207458,6-20-24 15:28,164.01,Withdrawal,Branch Withdrawal,-990.4084821
2529,709207458,6-23-24 15:28,169.43,Purchase,Restaurant,-1159.838482
2530,709207458,6-30-24 19:28,342.89,Purchase,Restaurant,-1502.728482
2531,709207458,07-01-24 21:28,3750,IncomingTransfer,Salary,2247.271518
2532,709207458,07-06-24 21:28,2300,Payment,Credit Card Payment,-52.72848214
2533,709207458,07-09-24 13:28,299.13,Purchase,Restaurant,-351.8584821
2534,709207458,7-14-24 17:28,136.1,Withdrawal,Mobile App Withdrawal,-487.9584821
2535,709207458,7-15-24 21:28,2100,Payment,Rent Payment,-2587.958482
2536,709224858,1-20-24 20:28,316.52,Deposit,Mobile Deposit,1526.904612
2537,709224858,1-27-24 17:28,367.3,Withdrawal,Mobile App Withdrawal,1159.604612
2538,709224858,02-02-24 21:28,8350,IncomingTransfer,Salary,9509.604612
2539,709224858,02-02-24 22:28,335.48,Withdrawal,ATM Withdrawal,9174.124612
2540,709224858,02-04-24 12:28,396.59,OutgoingTransfer,Wire Transfer,8777.534612
2541,709224858,02-07-24 10:28,152.43,Purchase,Clothing,8625.104612
2542,709224858,02-07-24 21:28,2300,Payment,Credit Card Payment,6325.104612
2543,709224858,2-13-24 21:28,3800,Payment,Rent Payment,2525.104612
2544,709224858,2-14-24 10:28,243.81,Deposit,Cash Deposit,2768.914612
2545,709224858,2-16-24 21:28,739.7,Deposit,Cash Deposit,3508.614612
2546,709224858,2-22-24 17:28,286.13,OutgoingTransfer,Bank Transfer,3222.484612
2547,709224858,2-24-24 17:28,481.5,Withdrawal,ATM Withdrawal,2740.984612
2548,709224858,2-28-24 13:28,736.75,Withdrawal,Branch Withdrawal,2004.234612
2549,709224858,03-01-24 17:28,715.31,Withdrawal,Mobile App Withdrawal,1288.924612
2550,709224858,03-02-24 21:28,8350,IncomingTransfer,Salary,9638.924612
2551,709224858,03-03-24 20:28,243.3,Payment,Bill Payment,9395.624612
2552,709224858,03-03-24 22:28,709.16,Payment,Mortgage Payment,8686.464612
2553,709224858,03-05-24 22:28,698.54,Purchase,Furniture,7987.924612
2554,709224858,03-06-24 20:28,334.53,Deposit,Direct Deposit,8322.454612
2555,709224858,03-06-24 23:28,549.13,Deposit,Direct Deposit,8871.584612
2556,709224858,03-07-24 21:28,1600,Payment,Credit Card Payment,7271.584612
2557,709224858,3-13-24 23:28,623.94,Return,AliExpress Return,7895.524612
2558,709224858,3-17-24 21:28,4300,Payment,Rent Payment,3595.524612
2559,709224858,3-21-24 11:28,538.71,Purchase,Electronics,3056.814612
2560,709224858,3-25-24 23:28,245.8,Deposit,Cash Deposit,3302.614612
2561,709224858,04-01-24 20:28,703.1,IncomingTransfer,Freelance Payment,4005.714612
2562,709224858,04-02-24 22:28,491.55,Purchase,Entertainment,3514.164612
2563,709224858,04-03-24 20:28,713.68,IncomingTransfer,Freelance Payment,4227.844612
2564,709224858,04-05-24 21:28,8350,IncomingTransfer,Salary,12577.84461
2565,709224858,04-10-24 21:28,2100,Payment,Credit Card Payment,10477.84461
2566,709224858,4-13-24 11:28,273.34,Deposit,Direct Deposit,10751.18461
2567,709224858,4-17-24 11:28,282.43,Deposit,Check Deposit,11033.61461
2568,709224858,4-18-24 21:28,4900,Payment,Rent Payment,6133.614612
2569,709224858,4-21-24 12:28,176.86,Purchase,Entertainment,5956.754612
2570,709224858,4-23-24 12:28,242.46,Purchase,Electronics,5714.294612
2571,709224858,4-29-24 10:28,151.8,Payment,Loan Payment,5562.494612
2572,709224858,05-04-24 11:28,403.3,Deposit,Mobile Deposit,5965.794612
2573,709224858,05-05-24 21:28,8350,IncomingTransfer,Salary,14315.79461
2574,709224858,05-10-24 9:28,148.72,Deposit,Mobile Deposit,14464.51461
2575,709224858,05-10-24 21:28,1700,Payment,Credit Card Payment,12764.51461
2576,709224858,5-14-24 21:28,3600,Payment,Rent Payment,9164.514612
2577,709224858,5-26-24 20:28,562.43,Payment,Mortgage Payment,8602.084612
2578,709224858,5-28-24 21:28,256.08,Return,Etsy Return,8858.164612
2579,709224858,5-30-24 22:28,568.8,OnlineShopping,eBay,8289.364612
2580,709224858,06-03-24 21:28,8350,IncomingTransfer,Salary,16639.36461
2581,709224858,06-04-24 13:28,743.7,IncomingTransfer,Freelance Payment,17383.06461
2582,709224858,06-07-24 21:28,729.61,Purchase,Home Improvement,16653.45461
2583,709224858,06-08-24 21:28,2300,Payment,Credit Card Payment,14353.45461
2584,709224858,06-09-24 18:28,288.79,Purchase,Restaurant,14064.66461
2585,709224858,6-14-24 14:28,649.66,Purchase,Electronics,13415.00461
2586,709224858,6-14-24 21:28,5300,Payment,Rent Payment,8115.004612
2587,709224858,07-01-24 12:28,185.01,Withdrawal,Mobile App Withdrawal,7929.994612
2588,709224858,07-04-24 19:28,452.74,Payment,Loan Payment,7477.254612
2589,709224858,07-05-24 21:28,8350,IncomingTransfer,Salary,15827.25461
2590,709224858,07-09-24 12:28,100.26,Payment,Bill Payment,15726.99461
2591,709224858,07-10-24 21:28,1900,Payment,Credit Card Payment,13826.99461
2592,709224858,07-10-24 21:28,2400,Payment,Rent Payment,11426.99461
2593,709224858,7-13-24 11:28,229.14,Payment,Loan Payment,11197.85461
2594,709267308,1-21-24 17:28,491.21,IncomingTransfer,Freelance Payment,1326.700167
2595,709267308,02-03-24 21:28,8900,IncomingTransfer,Salary,10226.70017
2596,709267308,02-05-24 20:28,718.07,OnlineShopping,Target,9508.630167
2597,709267308,02-06-24 10:28,655.95,Withdrawal,Branch Withdrawal,8852.680167
2598,709267308,02-08-24 21:28,1800,Payment,Credit Card Payment,7052.680167
2599,709267308,02-11-24 12:28,358.03,Deposit,Mobile Deposit,7410.710167
2600,709267308,2-15-24 21:28,2500,Payment,Rent Payment,4910.710167
2601,709267308,2-18-24 12:28,496.74,Deposit,Mobile Deposit,5407.450167
2602,709267308,03-02-24 21:28,8900,IncomingTransfer,Salary,14307.45017
2603,709267308,03-07-24 21:28,2000,Payment,Credit Card Payment,12307.45017
2604,709267308,03-11-24 11:28,422.07,Purchase,Gas,11885.38017
2605,709267308,03-11-24 19:28,577.63,Purchase,Grocery,11307.75017
2606,709267308,03-11-24 21:28,3300,Payment,Rent Payment,8007.750167
2607,709267308,3-14-24 23:28,432.63,Deposit,Direct Deposit,8440.380167
2608,709267308,3-22-24 16:28,542.16,Deposit,Mobile Deposit,8982.540167
2609,709267308,04-03-24 21:28,8900,IncomingTransfer,Salary,17882.54017
2610,709267308,04-08-24 19:28,442.75,Deposit,Mobile Deposit,18325.29017
2611,709267308,04-08-24 21:28,2100,Payment,Credit Card Payment,16225.29017
2612,709267308,04-09-24 12:28,122.72,Return,eBay Return,16348.01017
2613,709267308,04-09-24 23:28,470.83,Purchase,Grocery,15877.18017
2614,709267308,04-11-24 23:28,252.94,OnlineShopping,Best Buy,15624.24017
2615,709267308,4-13-24 20:28,133.96,Withdrawal,Mobile App Withdrawal,15490.28017
2616,709267308,4-16-24 21:28,5200,Payment,Rent Payment,10290.28017
2617,709267308,4-27-24 14:28,512.37,IncomingTransfer,Freelance Payment,10802.65017
2618,709267308,4-29-24 22:28,718.72,Return,AliExpress Return,11521.37017
2619,709267308,05-01-24 21:28,265.86,IncomingTransfer,Freelance Payment,11787.23017
2620,709267308,05-02-24 21:28,8900,IncomingTransfer,Salary,20687.23017
2621,709267308,05-05-24 16:28,383.78,Withdrawal,Branch Withdrawal,20303.45017
2622,709267308,05-07-24 21:28,1600,Payment,Credit Card Payment,18703.45017
2623,709267308,05-10-24 21:28,2700,Payment,Rent Payment,16003.45017
2624,709267308,05-12-24 17:28,521.2,OutgoingTransfer,Bank Transfer,15482.25017
2625,709267308,5-14-24 16:28,423.36,Deposit,Cash Deposit,15905.61017
2626,709267308,5-20-24 17:28,724.85,Purchase,Home Improvement,15180.76017
2627,709267308,5-26-24 12:28,471.82,Deposit,Mobile Deposit,15652.58017
2628,709267308,5-26-24 17:28,211.12,Purchase,Clothing,15441.46017
2629,709267308,06-03-24 14:28,613.15,IncomingTransfer,Freelance Payment,16054.61017
2630,709267308,06-04-24 9:28,584.53,OutgoingTransfer,Bank Transfer,15470.08017
2631,709267308,06-04-24 21:28,8900,IncomingTransfer,Salary,24370.08017
2632,709267308,06-09-24 11:28,167.32,OnlineShopping,Amazon,24202.76017
2633,709267308,06-09-24 21:28,1500,Payment,Credit Card Payment,22702.76017
2634,709267308,06-10-24 23:28,602.96,Purchase,Entertainment,22099.80017
2635,709267308,6-17-24 14:28,197.61,Purchase,Home Improvement,21902.19017
2636,709267308,6-18-24 21:28,5000,Payment,Rent Payment,16902.19017
2637,709267308,6-18-24 23:28,335.18,Deposit,Check Deposit,17237.37017
2638,709267308,6-23-24 19:28,590.08,Return,Walmart Return,17827.45017
2639,709267308,07-03-24 21:28,8900,IncomingTransfer,Salary,26727.45017
2640,709267308,07-04-24 20:28,281.66,Deposit,Check Deposit,27009.11017
2641,709267308,07-08-24 21:28,1800,Payment,Credit Card Payment,25209.11017
2642,709267308,07-09-24 23:28,402.41,Withdrawal,ATM Withdrawal,24806.70017
2643,709267308,7-17-24 21:28,4100,Payment,Rent Payment,20706.70017
2644,709274583,1-20-24 16:28,464.94,IncomingTransfer,Freelance Payment,1533.267989
2645,709274583,1-23-24 17:28,789.95,Deposit,Check Deposit,2323.217989
2646,709274583,1-24-24 13:28,861.29,Withdrawal,Branch Withdrawal,1461.927989
2647,709274583,1-25-24 17:28,659.55,Deposit,Check Deposit,2121.477989
2648,709274583,1-28-24 19:28,541.74,OnlineShopping,Target,1579.737989
2649,709274583,1-29-24 22:28,843.94,Purchase,Home Improvement,735.7979892
2650,709274583,02-01-24 12:28,726.38,Withdrawal,Branch Withdrawal,9.417989243
2651,709274583,02-01-24 23:28,937.14,Deposit,Cash Deposit,946.5579892
2652,709274583,02-03-24 15:28,890.89,OutgoingTransfer,Wire Transfer,55.66798924
2653,709274583,02-04-24 16:28,533.18,Deposit,Cash Deposit,588.8479892
2654,709274583,02-04-24 21:28,15650,IncomingTransfer,Salary,16238.84799
2655,709274583,02-06-24 9:28,864.1,Purchase,Pharmacy,15374.74799
2656,709274583,02-08-24 13:28,679.8,Withdrawal,Mobile App Withdrawal,14694.94799
2657,709274583,02-08-24 20:28,471.77,Withdrawal,Mobile App Withdrawal,14223.17799
2658,709274583,02-09-24 21:28,1400,Payment,Credit Card Payment,12823.17799
2659,709274583,02-09-24 22:28,530.96,Payment,Mortgage Payment,12292.21799
2660,709274583,02-10-24 15:28,892.78,Purchase,Electronics,11399.43799
2661,709274583,2-16-24 15:28,533.93,OnlineShopping,Amazon,10865.50799
2662,709274583,2-16-24 21:28,5300,Payment,Installment Payment,5565.507989
2663,709274583,2-17-24 14:28,326.59,Payment,Bill Payment,5238.917989
2664,709274583,2-17-24 22:28,318.47,Return,eBay Return,5557.387989
2665,709274583,2-19-24 15:28,322.43,Return,Etsy Return,5879.817989
2666,709274583,2-22-24 23:28,511.59,Deposit,Direct Deposit,6391.407989
2667,709274583,2-22-24 23:28,475.41,Return,Walmart Return,6866.817989
2668,709274583,2-24-24 16:28,867.63,Payment,Mortgage Payment,5999.187989
2669,709274583,2-25-24 18:28,484.36,Return,Best Buy Return,6483.547989
2670,709274583,2-27-24 16:28,647.38,OnlineShopping,AliExpress,5836.167989
2671,709274583,03-01-24 17:28,416.05,Withdrawal,Branch Withdrawal,5420.117989
2672,709274583,03-01-24 21:28,15650,IncomingTransfer,Salary,21070.11799
2673,709274583,03-02-24 11:28,249.17,Purchase,Travel,20820.94799
2674,709274583,03-06-24 21:28,1900,Payment,Credit Card Payment,18920.94799
2675,709274583,03-10-24 14:28,853.23,Payment,Bill Payment,18067.71799
2676,709274583,3-13-24 21:28,6500,Payment,Subscription Payment,11567.71799
2677,709274583,3-14-24 13:28,259.19,OutgoingTransfer,Peer-to-Peer Transfer,11308.52799
2678,709274583,3-18-24 12:28,520.55,Return,Best Buy Return,11829.07799
2679,709274583,3-19-24 23:28,667.71,OnlineShopping,Amazon,11161.36799
2680,709274583,3-24-24 14:28,421.31,Return,AliExpress Return,11582.67799
2681,709274583,3-24-24 19:28,479.22,Payment,Mortgage Payment,11103.45799
2682,709274583,3-24-24 20:28,700.46,Return,Best Buy Return,11803.91799
2683,709274583,04-01-24 21:28,15650,IncomingTransfer,Salary,27453.91799
2684,709274583,04-03-24 11:28,509.05,OutgoingTransfer,Peer-to-Peer Transfer,26944.86799
2685,709274583,04-03-24 16:28,524.53,Purchase,Furniture,26420.33799
2686,709274583,04-05-24 19:28,785.6,Purchase,Clothing,25634.73799
2687,709274583,04-06-24 21:28,1900,Payment,Credit Card Payment,23734.73799
2688,709274583,04-07-24 21:28,930.48,OnlineShopping,Walmart,22804.25799
2689,709274583,04-08-24 12:28,202.74,Purchase,Entertainment,22601.51799
2690,709274583,04-08-24 19:28,672.2,Withdrawal,Branch Withdrawal,21929.31799
2691,709274583,04-08-24 20:28,319.56,Deposit,Check Deposit,22248.87799
2692,709274583,04-12-24 21:28,401.86,Return,Etsy Return,22650.73799
2693,709274583,4-13-24 14:28,398.66,OutgoingTransfer,Wire Transfer,22252.07799
2694,709274583,4-13-24 21:28,4100,Payment,Insurance Payment,18152.07799
2695,709274583,4-14-24 14:28,439.31,Deposit,Mobile Deposit,18591.38799
2696,709274583,4-15-24 16:28,309.63,Purchase,Gas,18281.75799
2697,709274583,4-17-24 20:28,719.52,Purchase,Pharmacy,17562.23799
2698,709274583,4-20-24 20:28,422.27,Purchase,Grocery,17139.96799
2699,709274583,4-21-24 14:28,934.69,OutgoingTransfer,Bank Transfer,16205.27799
2700,709274583,4-25-24 12:28,568.64,Deposit,Check Deposit,16773.91799
2701,709274583,4-27-24 16:28,338.23,Purchase,Clothing,16435.68799
2702,709274583,4-30-24 12:28,516.5,Payment,Mortgage Payment,15919.18799
2703,709274583,05-01-24 18:28,848.98,IncomingTransfer,Freelance Payment,16768.16799
2704,709274583,05-04-24 15:28,415.89,Deposit,Direct Deposit,17184.05799
2705,709274583,05-04-24 16:28,744.75,Purchase,Clothing,16439.30799
2706,709274583,05-05-24 11:28,576.21,Deposit,Check Deposit,17015.51799
2707,709274583,05-05-24 21:28,15650,IncomingTransfer,Salary,32665.51799
2708,709274583,05-10-24 21:28,1700,Payment,Credit Card Payment,30965.51799
2709,709274583,5-15-24 21:28,5700,Payment,Subscription Payment,25265.51799
2710,709274583,5-21-24 19:28,863.02,Payment,Bill Payment,24402.49799
2711,709274583,5-21-24 20:28,258.65,Withdrawal,ATM Withdrawal,24143.84799
2712,709274583,5-22-24 12:28,492.03,Purchase,Clothing,23651.81799
2713,709274583,5-24-24 17:28,695.34,Payment,Loan Payment,22956.47799
2714,709274583,5-24-24 21:28,911.7,Payment,Mortgage Payment,22044.77799
2715,709274583,5-25-24 22:28,212.34,Deposit,Cash Deposit,22257.11799
2716,709274583,5-28-24 21:28,489.91,OnlineShopping,AliExpress,21767.20799
2717,709274583,5-29-24 14:28,373.56,Deposit,Check Deposit,22140.76799
2718,709274583,5-30-24 18:28,351.81,Purchase,Grocery,21788.95799
2719,709274583,06-02-24 10:28,433.72,Purchase,Restaurant,21355.23799
2720,709274583,06-02-24 13:28,291.53,OutgoingTransfer,Peer-to-Peer Transfer,21063.70799
2721,709274583,06-02-24 14:28,430.4,OnlineShopping,AliExpress,20633.30799
2722,709274583,06-04-24 19:28,647.14,Deposit,Cash Deposit,21280.44799
2723,709274583,06-04-24 21:28,15650,IncomingTransfer,Salary,36930.44799
2724,709274583,06-07-24 13:28,592.08,Return,Target Return,37522.52799
2725,709274583,06-09-24 10:28,430.37,Purchase,Travel,37092.15799
2726,709274583,06-09-24 21:28,1600,Payment,Credit Card Payment,35492.15799
2727,709274583,06-09-24 21:28,373.26,Payment,Mortgage Payment,35118.89799
2728,709274583,06-10-24 13:28,939.46,OutgoingTransfer,International Transfer,34179.43799
2729,709274583,06-10-24 17:28,670.24,Deposit,Mobile Deposit,34849.67799
2730,709274583,06-10-24 18:28,831.67,OnlineShopping,Best Buy,34018.00799
2731,709274583,06-10-24 21:28,4800,Payment,Subscription Payment,29218.00799
2732,709274583,6-14-24 19:28,876.77,Withdrawal,Branch Withdrawal,28341.23799
2733,709274583,6-14-24 20:28,438.1,Deposit,Check Deposit,28779.33799
2734,709274583,6-15-24 18:28,809.62,OnlineShopping,Etsy,27969.71799
2735,709274583,6-16-24 16:28,863.5,IncomingTransfer,Freelance Payment,28833.21799
2736,709274583,6-17-24 14:28,717.43,Return,Amazon Return,29550.64799
2737,709274583,6-22-24 15:28,677.7,OutgoingTransfer,Bank Transfer,28872.94799
2738,709274583,6-23-24 12:28,427.45,Purchase,Pharmacy,28445.49799
2739,709274583,6-23-24 16:28,430.33,Purchase,Furniture,28015.16799
2740,709274583,6-23-24 21:28,805.07,OutgoingTransfer,International Transfer,27210.09799
2741,709274583,6-25-24 13:28,250.74,Payment,Loan Payment,26959.35799
2742,709274583,6-27-24 23:28,376.8,Deposit,Mobile Deposit,27336.15799
2743,709274583,6-28-24 19:28,829.72,Purchase,Restaurant,26506.43799
2744,709274583,6-28-24 20:28,735.64,Deposit,Mobile Deposit,27242.07799
2745,709274583,07-03-24 12:28,817.49,OutgoingTransfer,Wire Transfer,26424.58799
2746,709274583,07-03-24 15:28,380.27,Purchase,Travel,26044.31799
2747,709274583,07-03-24 21:28,15650,IncomingTransfer,Salary,41694.31799
2748,709274583,07-04-24 15:28,855.22,OnlineShopping,Etsy,40839.09799
2749,709274583,07-08-24 21:28,1500,Payment,Credit Card Payment,39339.09799
2750,709274583,07-10-24 11:28,814.3,Purchase,Clothing,38524.79799
2751,709274583,07-12-24 21:28,4100,Payment,Subscription Payment,34424.79799
2752,709274583,7-14-24 19:28,362.62,Withdrawal,Branch Withdrawal,34062.17799
2753,709327383,1-27-24 16:28,220.85,Purchase,Travel,684.287622
2754,709327383,1-29-24 9:28,470.79,Withdrawal,ATM Withdrawal,213.497622
2755,709327383,02-01-24 21:28,4650,IncomingTransfer,Salary,4863.497622
2756,709327383,02-06-24 21:28,1600,Payment,Credit Card Payment,3263.497622
2757,709327383,02-10-24 11:28,490.1,Withdrawal,ATM Withdrawal,2773.397622
2758,709327383,02-11-24 21:28,3000,Payment,Rent Payment,-226.602378
2759,709327383,2-15-24 23:28,248.48,Return,Target Return,21.87762204
2760,709327383,2-24-24 16:28,467.07,Withdrawal,Branch Withdrawal,-445.192378
2761,709327383,2-29-24 23:28,434.98,Deposit,Mobile Deposit,-10.21237796
2762,709327383,03-03-24 21:28,4650,IncomingTransfer,Salary,4639.787622
2763,709327383,03-04-24 18:28,471.83,OnlineShopping,Walmart,4167.957622
2764,709327383,03-08-24 21:28,1200,Payment,Credit Card Payment,2967.957622
2765,709327383,3-15-24 21:28,1500,Payment,Rent Payment,1467.957622
2766,709327383,3-23-24 22:28,480.88,Deposit,Mobile Deposit,1948.837622
2767,709327383,3-25-24 13:28,215.46,Return,AliExpress Return,2164.297622
2768,709327383,3-28-24 16:28,110.6,OutgoingTransfer,Peer-to-Peer Transfer,2053.697622
2769,709327383,3-29-24 9:28,412.8,OutgoingTransfer,International Transfer,1640.897622
2770,709327383,04-05-24 21:28,4650,IncomingTransfer,Salary,6290.897622
2771,709327383,04-10-24 21:28,1400,Payment,Credit Card Payment,4890.897622
2772,709327383,4-14-24 19:28,447.93,Withdrawal,Mobile App Withdrawal,4442.967622
2773,709327383,4-14-24 21:28,1400,Payment,Rent Payment,3042.967622
2774,709327383,4-18-24 13:28,131.62,Return,Store Return,3174.587622
2775,709327383,4-24-24 9:28,38.75,Payment,Bill Payment,3135.837622
2776,709327383,05-03-24 20:28,224.54,Purchase,Entertainment,2911.297622
2777,709327383,05-03-24 21:28,4650,IncomingTransfer,Salary,7561.297622
2778,709327383,05-06-24 23:28,165.03,Deposit,Mobile Deposit,7726.327622
2779,709327383,05-08-24 21:28,1400,Payment,Credit Card Payment,6326.327622
2780,709327383,05-12-24 15:28,409.45,Purchase,Grocery,5916.877622
2781,709327383,5-18-24 21:28,3000,Payment,Rent Payment,2916.877622
2782,709327383,06-04-24 16:28,38.02,Withdrawal,Branch Withdrawal,2878.857622
2783,709327383,06-05-24 21:28,4650,IncomingTransfer,Salary,7528.857622
2784,709327383,06-10-24 21:28,1500,Payment,Credit Card Payment,6028.857622
2785,709327383,06-12-24 20:28,346.69,Return,Store Return,6375.547622
2786,709327383,6-13-24 18:28,227.7,OutgoingTransfer,Bank Transfer,6147.847622
2787,709327383,6-13-24 21:28,2800,Payment,Rent Payment,3347.847622
2788,709327383,6-17-24 18:28,24.47,Deposit,Cash Deposit,3372.317622
2789,709327383,07-01-24 21:28,4650,IncomingTransfer,Salary,8022.317622
2790,709327383,07-06-24 21:28,1300,Payment,Credit Card Payment,6722.317622
2791,709327383,7-13-24 21:28,2100,Payment,Rent Payment,4622.317622
2792,709346133,1-22-24 21:28,361.36,Return,Target Return,1627.324044
2793,709346133,1-23-24 12:28,249.37,Purchase,Grocery,1377.954044
2794,709346133,02-01-24 21:28,2400,IncomingTransfer,Salary,3777.954044
2795,709346133,02-02-24 10:28,74.94,OutgoingTransfer,Wire Transfer,3703.014044
2796,709346133,02-03-24 14:28,279.72,Withdrawal,Branch Withdrawal,3423.294044
2797,709346133,02-06-24 21:28,3300,Payment,Credit Card Payment,123.2940444
2798,709346133,2-16-24 21:28,800,Payment,Rent Payment,-676.7059556
2799,709346133,2-19-24 9:28,398.97,Purchase,Electronics,-1075.675956
2800,709346133,2-21-24 18:28,300.11,Purchase,Clothing,-1375.785956
2801,709346133,2-28-24 23:28,40.06,Withdrawal,ATM Withdrawal,-1415.845956
2802,709346133,03-04-24 21:28,2400,IncomingTransfer,Salary,984.1540444
2803,709346133,03-06-24 13:28,475.7,OutgoingTransfer,Bank Transfer,508.4540444
2804,709346133,03-09-24 21:28,3000,Payment,Credit Card Payment,-2491.545956
2805,709346133,3-15-24 21:28,1200,Payment,Rent Payment,-3691.545956
2806,709346133,3-21-24 19:28,425.18,OutgoingTransfer,International Transfer,-4116.725956
2807,709346133,3-27-24 14:28,330.85,OnlineShopping,Amazon,-4447.575956
2808,709346133,04-03-24 21:28,2400,IncomingTransfer,Salary,-2047.575956
2809,709346133,04-07-24 22:28,395.84,Deposit,Check Deposit,-1651.735956
2810,709346133,04-08-24 21:28,3300,Payment,Credit Card Payment,-4951.735956
2811,709346133,04-11-24 21:28,1400,Payment,Rent Payment,-6351.735956
2812,709346133,4-15-24 14:28,148.16,Purchase,Clothing,-6499.895956
2813,709346133,4-20-24 18:28,392.16,Payment,Loan Payment,-6892.055956
2814,709346133,05-01-24 21:28,2400,IncomingTransfer,Salary,-4492.055956
2815,709346133,05-06-24 15:28,123.49,Return,Best Buy Return,-4368.565956
2816,709346133,05-06-24 21:28,2600,Payment,Credit Card Payment,-6968.565956
2817,709346133,5-14-24 21:28,1200,Payment,Rent Payment,-8168.565956
2818,709346133,5-16-24 18:28,290.29,Deposit,Check Deposit,-7878.275956
2819,709346133,5-16-24 19:28,261.62,Purchase,Home Improvement,-8139.895956
2820,709346133,06-02-24 12:28,341.89,IncomingTransfer,Freelance Payment,-7798.005956
2821,709346133,06-02-24 21:28,2400,IncomingTransfer,Salary,-5398.005956
2822,709346133,06-07-24 21:28,3200,Payment,Credit Card Payment,-8598.005956
2823,709346133,06-11-24 15:28,303.53,OutgoingTransfer,International Transfer,-8901.535956
2824,709346133,06-11-24 21:28,700,Payment,Rent Payment,-9601.535956
2825,709346133,6-24-24 16:28,212.4,Deposit,Direct Deposit,-9389.135956
2826,709346133,6-25-24 10:28,175.45,IncomingTransfer,Freelance Payment,-9213.685956
2827,709346133,07-03-24 21:28,2400,IncomingTransfer,Salary,-6813.685956
2828,709346133,07-05-24 10:28,196.75,OnlineShopping,Etsy,-7010.435956
2829,709346133,07-08-24 21:28,2500,Payment,Credit Card Payment,-9510.435956
2830,709346133,7-13-24 12:28,368.05,Payment,Mortgage Payment,-9878.485956
2831,709346133,7-14-24 13:28,403.18,Return,Walmart Return,-9475.305956
2832,709346133,7-18-24 21:28,900,Payment,Rent Payment,-10375.30596
2833,709410033,1-20-24 11:28,677.29,Deposit,Mobile Deposit,1206.41907
2834,709410033,1-20-24 13:28,642.54,Deposit,Direct Deposit,1848.95907
2835,709410033,1-22-24 19:28,441.69,Deposit,Cash Deposit,2290.64907
2836,709410033,1-23-24 13:28,294.59,Purchase,Pharmacy,1996.05907
2837,709410033,1-25-24 16:28,600.8,Purchase,Home Improvement,1395.25907
2838,709410033,1-26-24 18:28,258.02,Payment,Mortgage Payment,1137.23907
2839,709410033,1-29-24 15:28,348.45,Payment,Loan Payment,788.7890696
2840,709410033,1-31-24 20:28,708.57,Purchase,Furniture,80.21906958
2841,709410033,02-01-24 18:28,630.09,OutgoingTransfer,International Transfer,-549.8709304
2842,709410033,02-01-24 21:28,8300,IncomingTransfer,Salary,7750.12907
2843,709410033,02-02-24 10:28,706.48,OnlineShopping,Target,7043.64907
2844,709410033,02-03-24 10:28,636.24,Return,AliExpress Return,7679.88907
2845,709410033,02-06-24 20:28,398.58,Withdrawal,Mobile App Withdrawal,7281.30907
2846,709410033,02-06-24 21:28,1200,Payment,Credit Card Payment,6081.30907
2847,709410033,02-08-24 17:28,622.11,Deposit,Check Deposit,6703.41907
2848,709410033,02-11-24 21:28,110.24,Purchase,Electronics,6593.17907
2849,709410033,2-13-24 17:28,421.17,Withdrawal,Mobile App Withdrawal,6172.00907
2850,709410033,2-14-24 12:28,251.2,Payment,Loan Payment,5920.80907
2851,709410033,2-16-24 15:28,489.92,Withdrawal,Branch Withdrawal,5430.88907
2852,709410033,2-16-24 20:28,202.62,IncomingTransfer,Freelance Payment,5633.50907
2853,709410033,2-18-24 12:28,247.74,Deposit,Cash Deposit,5881.24907
2854,709410033,2-18-24 21:28,5100,Payment,Rent Payment,781.2490696
2855,709410033,2-22-24 17:28,492.58,Withdrawal,Branch Withdrawal,288.6690696
2856,709410033,2-25-24 22:28,304.69,Payment,Bill Payment,-16.02093042
2857,709410033,2-29-24 11:28,107.22,Payment,Bill Payment,-123.2409304
2858,709410033,2-29-24 20:28,408.33,Purchase,Electronics,-531.5709304
2859,709410033,2-29-24 21:28,688.21,OnlineShopping,Target,-1219.78093
2860,709410033,03-01-24 10:28,189.3,Purchase,Pharmacy,-1409.08093
2861,709410033,03-01-24 21:28,8300,IncomingTransfer,Salary,6890.91907
2862,709410033,03-03-24 17:28,153.93,Purchase,Clothing,6736.98907
2863,709410033,03-05-24 14:28,404.36,Withdrawal,Branch Withdrawal,6332.62907
2864,709410033,03-06-24 21:28,900,Payment,Credit Card Payment,5432.62907
2865,709410033,03-08-24 9:28,207.95,Payment,Bill Payment,5224.67907
2866,709410033,03-11-24 18:28,387.73,Purchase,Electronics,4836.94907
2867,709410033,03-12-24 11:28,454.77,Withdrawal,ATM Withdrawal,4382.17907
2868,709410033,3-13-24 22:28,333.91,Deposit,Check Deposit,4716.08907
2869,709410033,3-13-24 23:28,115.93,Purchase,Home Improvement,4600.15907
2870,709410033,3-14-24 21:28,3100,Payment,Rent Payment,1500.15907
2871,709410033,3-16-24 17:28,370.95,Payment,Loan Payment,1129.20907
2872,709410033,3-18-24 11:28,381.83,Return,Best Buy Return,1511.03907
2873,709410033,3-18-24 16:28,596.31,Purchase,Clothing,914.7290696
2874,709410033,3-18-24 22:28,477.87,Purchase,Electronics,436.8590696
2875,709410033,3-21-24 10:28,599.34,Withdrawal,Branch Withdrawal,-162.4809304
2876,709410033,3-21-24 11:28,141.25,OutgoingTransfer,International Transfer,-303.7309304
2877,709410033,3-21-24 19:28,137.44,Purchase,Furniture,-441.1709304
2878,709410033,3-21-24 21:28,428.01,Payment,Bill Payment,-869.1809304
2879,709410033,3-23-24 13:28,734,Purchase,Gas,-1603.18093
2880,709410033,3-25-24 17:28,347.05,Purchase,Clothing,-1950.23093
2881,709410033,3-26-24 22:28,196.23,Purchase,Entertainment,-2146.46093
2882,709410033,3-27-24 14:28,285.02,Deposit,Check Deposit,-1861.44093
2883,709410033,3-27-24 20:28,614.72,Payment,Mortgage Payment,-2476.16093
2884,709410033,3-27-24 20:28,389.71,OnlineShopping,eBay,-2865.87093
2885,709410033,3-29-24 15:28,372.96,Return,Amazon Return,-2492.91093
2886,709410033,04-05-24 21:28,8300,IncomingTransfer,Salary,5807.08907
2887,709410033,04-06-24 20:28,266.54,Purchase,Grocery,5540.54907
2888,709410033,04-09-24 20:28,638.68,Purchase,Electronics,4901.86907
2889,709410033,04-10-24 21:28,1100,Payment,Credit Card Payment,3801.86907
2890,709410033,04-11-24 12:28,620.39,Withdrawal,Mobile App Withdrawal,3181.47907
2891,709410033,04-11-24 13:28,709.73,Deposit,Check Deposit,3891.20907
2892,709410033,4-13-24 21:28,621.59,Return,Target Return,4512.79907
2893,709410033,4-14-24 21:28,3800,Payment,Rent Payment,712.7990696
2894,709410033,4-14-24 22:28,376.75,Deposit,Cash Deposit,1089.54907
2895,709410033,4-15-24 11:28,213.75,Deposit,Check Deposit,1303.29907
2896,709410033,4-18-24 12:28,211.31,IncomingTransfer,Freelance Payment,1514.60907
2897,709410033,4-18-24 15:28,280.01,Payment,Bill Payment,1234.59907
2898,709410033,4-21-24 11:28,457.78,Payment,Mortgage Payment,776.8190696
2899,709410033,4-23-24 15:28,655.68,Return,AliExpress Return,1432.49907
2900,709410033,4-25-24 19:28,693.04,Withdrawal,ATM Withdrawal,739.4590696
2901,709410033,4-26-24 10:28,310.28,Deposit,Check Deposit,1049.73907
2902,709410033,4-26-24 13:28,599.57,OutgoingTransfer,Wire Transfer,450.1690696
2903,709410033,4-27-24 16:28,699.64,OutgoingTransfer,Peer-to-Peer Transfer,-249.4709304
2904,709410033,4-27-24 20:28,544.23,OutgoingTransfer,Wire Transfer,-793.7009304
2905,709410033,4-28-24 19:28,526.4,Purchase,Gas,-1320.10093
2906,709410033,4-30-24 10:28,324.27,Deposit,Mobile Deposit,-995.8309304
2907,709410033,4-30-24 10:28,430.83,Payment,Mortgage Payment,-1426.66093
2908,709410033,4-30-24 11:28,539.22,Payment,Bill Payment,-1965.88093
2909,709410033,4-30-24 15:28,326.53,Payment,Loan Payment,-2292.41093
2910,709410033,05-05-24 13:28,119.1,IncomingTransfer,Freelance Payment,-2173.31093
2911,709410033,05-05-24 21:28,8300,IncomingTransfer,Salary,6126.68907
2912,709410033,05-06-24 17:28,368.93,Withdrawal,Mobile App Withdrawal,5757.75907
2913,709410033,05-10-24 21:28,1000,Payment,Credit Card Payment,4757.75907
2914,709410033,05-10-24 23:28,488.2,Purchase,Restaurant,4269.55907
2915,709410033,05-11-24 18:28,327.74,Deposit,Cash Deposit,4597.29907
2916,709410033,5-13-24 10:28,569.43,Withdrawal,ATM Withdrawal,4027.86907
2917,709410033,5-13-24 21:28,5400,Payment,Rent Payment,-1372.13093
2918,709410033,5-18-24 11:28,412.56,Deposit,Check Deposit,-959.5709304
2919,709410033,5-20-24 17:28,160.91,Withdrawal,ATM Withdrawal,-1120.48093
2920,709410033,5-20-24 19:28,387.05,Purchase,Restaurant,-1507.53093
2921,709410033,5-21-24 15:28,147.91,Deposit,Cash Deposit,-1359.62093
2922,709410033,5-22-24 14:28,710.79,Withdrawal,Mobile App Withdrawal,-2070.41093
2923,709410033,5-24-24 11:28,608.57,Deposit,Check Deposit,-1461.84093
2924,709410033,5-25-24 22:28,395.1,Purchase,Entertainment,-1856.94093
2925,709410033,5-26-24 20:28,583.88,OnlineShopping,AliExpress,-2440.82093
2926,709410033,5-27-24 12:28,298.47,Return,Best Buy Return,-2142.35093
2927,709410033,5-28-24 14:28,380.44,Return,eBay Return,-1761.91093
2928,709410033,5-30-24 19:28,301.37,IncomingTransfer,Freelance Payment,-1460.54093
2929,709410033,5-31-24 21:28,504.53,OutgoingTransfer,Bank Transfer,-1965.07093
2930,709410033,06-01-24 18:28,579.8,Deposit,Mobile Deposit,-1385.27093
2931,709410033,06-02-24 16:28,179.33,Withdrawal,Mobile App Withdrawal,-1564.60093
2932,709410033,06-04-24 18:28,656.71,OnlineShopping,AliExpress,-2221.31093
2933,709410033,06-05-24 15:28,507.5,Return,Store Return,-1713.81093
2934,709410033,06-05-24 21:28,8300,IncomingTransfer,Salary,6586.18907
2935,709410033,06-07-24 9:28,351.38,Payment,Mortgage Payment,6234.80907
2936,709410033,06-07-24 21:28,455.15,IncomingTransfer,Freelance Payment,6689.95907
2937,709410033,06-07-24 23:28,178.43,Deposit,Check Deposit,6868.38907
2938,709410033,06-08-24 12:28,426.27,Deposit,Mobile Deposit,7294.65907
2939,709410033,06-10-24 11:28,536.87,Deposit,Cash Deposit,7831.52907
2940,709410033,06-10-24 13:28,580.44,Deposit,Direct Deposit,8411.96907
2941,709410033,06-10-24 21:28,1100,Payment,Credit Card Payment,7311.96907
2942,709410033,06-11-24 21:28,5000,Payment,Rent Payment,2311.96907
2943,709410033,6-14-24 17:28,635.95,Deposit,Mobile Deposit,2947.91907
2944,709410033,6-17-24 22:28,380.47,Payment,Loan Payment,2567.44907
2945,709410033,6-18-24 15:28,384.22,Purchase,Furniture,2183.22907
2946,709410033,6-20-24 19:28,296.99,Deposit,Cash Deposit,2480.21907
2947,709410033,6-20-24 21:28,637.46,Deposit,Cash Deposit,3117.67907
2948,709410033,6-21-24 9:28,274.42,Deposit,Mobile Deposit,3392.09907
2949,709410033,6-21-24 11:28,471.15,Deposit,Mobile Deposit,3863.24907
2950,709410033,6-21-24 21:28,586.98,Payment,Mortgage Payment,3276.26907
2951,709410033,6-22-24 12:28,469.01,Deposit,Cash Deposit,3745.27907
2952,709410033,6-22-24 22:28,537.13,Withdrawal,Branch Withdrawal,3208.14907
2953,709410033,6-23-24 19:28,270.56,Return,Store Return,3478.70907
2954,709410033,6-25-24 16:28,642,Payment,Mortgage Payment,2836.70907
2955,709410033,6-25-24 21:28,295.65,OutgoingTransfer,Wire Transfer,2541.05907
2956,709410033,6-30-24 21:28,352.55,Withdrawal,ATM Withdrawal,2188.50907
2957,709410033,07-01-24 21:28,8300,IncomingTransfer,Salary,10488.50907
2958,709410033,07-02-24 11:28,739.47,Withdrawal,Mobile App Withdrawal,9749.03907
2959,709410033,07-02-24 13:28,739.09,Return,Amazon Return,10488.12907
2960,709410033,07-02-24 19:28,645.29,Purchase,Clothing,9842.83907
2961,709410033,07-02-24 23:28,572.84,IncomingTransfer,Freelance Payment,10415.67907
2962,709410033,07-06-24 21:28,1100,Payment,Credit Card Payment,9315.67907
2963,709410033,07-11-24 18:28,477.64,Purchase,Grocery,8838.03907
2964,709410033,07-12-24 21:28,3100,Payment,Rent Payment,5738.03907
2965,709410033,7-13-24 11:28,530.53,Withdrawal,ATM Withdrawal,5207.50907
2966,709410033,7-13-24 11:28,749.28,Deposit,Direct Deposit,5956.78907
2967,709410033,7-13-24 16:28,438.04,IncomingTransfer,Freelance Payment,6394.82907
2968,709410033,7-14-24 19:28,738.62,Return,Best Buy Return,7133.44907
2969,709449333,1-23-24 16:28,453.6,Withdrawal,ATM Withdrawal,627.704956
2970,709449333,1-24-24 9:28,512.74,OutgoingTransfer,Wire Transfer,114.964956
2971,709449333,1-24-24 19:28,409.14,OutgoingTransfer,Bank Transfer,-294.175044
2972,709449333,1-26-24 22:28,352.04,Purchase,Travel,-646.215044
2973,709449333,1-28-24 21:28,134.41,Purchase,Pharmacy,-780.625044
2974,709449333,02-02-24 16:28,359.34,IncomingTransfer,Freelance Payment,-421.285044
2975,709449333,02-03-24 18:28,285.72,Return,Best Buy Return,-135.565044
2976,709449333,02-04-24 16:28,320.65,OutgoingTransfer,International Transfer,-456.215044
2977,709449333,02-04-24 21:28,5100,IncomingTransfer,Salary,4643.784956
2978,709449333,02-07-24 9:28,408.22,IncomingTransfer,Freelance Payment,5052.004956
2979,709449333,02-08-24 22:28,267.52,IncomingTransfer,Freelance Payment,5319.524956
2980,709449333,02-09-24 21:28,2000,Payment,Credit Card Payment,3319.524956
2981,709449333,02-10-24 18:28,346.9,Withdrawal,Mobile App Withdrawal,2972.624956
2982,709449333,02-12-24 21:28,2200,Payment,Rent Payment,772.624956
2983,709449333,2-23-24 17:28,131.14,IncomingTransfer,Freelance Payment,903.764956
2984,709449333,2-24-24 13:28,134.89,Purchase,Restaurant,768.874956
2985,709449333,2-25-24 21:28,236.68,Return,Target Return,1005.554956
2986,709449333,2-26-24 17:28,239.43,Return,Amazon Return,1244.984956
2987,709449333,2-27-24 14:28,104.28,Withdrawal,Mobile App Withdrawal,1140.704956
2988,709449333,03-01-24 18:28,369.71,Payment,Bill Payment,770.994956
2989,709449333,03-02-24 14:28,501.67,IncomingTransfer,Freelance Payment,1272.664956
2990,709449333,03-04-24 19:28,91.48,OutgoingTransfer,International Transfer,1181.184956
2991,709449333,03-05-24 13:28,240.41,Purchase,Gas,940.774956
2992,709449333,03-05-24 14:28,207.94,Withdrawal,Mobile App Withdrawal,732.834956
2993,709449333,03-05-24 15:28,437.4,IncomingTransfer,Freelance Payment,1170.234956
2994,709449333,03-05-24 21:28,5100,IncomingTransfer,Salary,6270.234956
2995,709449333,03-06-24 20:28,325.21,Purchase,Entertainment,5945.024956
2996,709449333,03-10-24 21:28,1700,Payment,Credit Card Payment,4245.024956
2997,709449333,03-10-24 21:28,2400,Payment,Rent Payment,1845.024956
2998,709449333,03-11-24 19:28,61.41,OutgoingTransfer,International Transfer,1783.614956
2999,709449333,03-12-24 18:28,64.63,Withdrawal,Branch Withdrawal,1718.984956
3000,709449333,3-13-24 10:28,161.72,Purchase,Clothing,1557.264956
3001,709449333,3-21-24 12:28,525.66,Return,AliExpress Return,2082.924956
3002,709449333,3-24-24 15:28,405.48,OutgoingTransfer,Bank Transfer,1677.444956
3003,709449333,3-25-24 12:28,537.59,OnlineShopping,Etsy,1139.854956
3004,709449333,3-27-24 9:28,364.21,OnlineShopping,AliExpress,775.644956
3005,709449333,3-28-24 16:28,95.75,IncomingTransfer,Freelance Payment,871.394956
3006,709449333,3-30-24 22:28,271.59,Payment,Mortgage Payment,599.804956
3007,709449333,04-01-24 10:28,301.21,Deposit,Mobile Deposit,901.014956
3008,709449333,04-03-24 21:28,5100,IncomingTransfer,Salary,6001.014956
3009,709449333,04-08-24 21:28,2100,Payment,Credit Card Payment,3901.014956
3010,709449333,04-09-24 16:28,132.75,Purchase,Travel,3768.264956
3011,709449333,04-10-24 14:28,527.89,Payment,Bill Payment,3240.374956
3012,709449333,04-11-24 21:28,134.28,OnlineShopping,Best Buy,3106.094956
3013,709449333,4-14-24 21:28,355.09,Purchase,Pharmacy,2751.004956
3014,709449333,4-18-24 21:28,2600,Payment,Rent Payment,151.004956
3015,709449333,4-19-24 12:28,180.66,OutgoingTransfer,Peer-to-Peer Transfer,-29.65504396
3016,709449333,4-19-24 23:28,363.5,OnlineShopping,Amazon,-393.155044
3017,709449333,4-21-24 17:28,68.43,Deposit,Direct Deposit,-324.725044
3018,709449333,4-26-24 13:28,514.4,Payment,Loan Payment,-839.125044
3019,709449333,4-30-24 17:28,490.65,OnlineShopping,Target,-1329.775044
3020,709449333,05-02-24 13:28,163.79,Deposit,Check Deposit,-1165.985044
3021,709449333,05-02-24 17:28,211.09,Return,Store Return,-954.895044
3022,709449333,05-03-24 21:28,5100,IncomingTransfer,Salary,4145.104956
3023,709449333,05-06-24 9:28,171.6,Payment,Loan Payment,3973.504956
3024,709449333,05-07-24 9:28,70.82,Payment,Loan Payment,3902.684956
3025,709449333,05-08-24 21:28,1500,Payment,Credit Card Payment,2402.684956
3026,709449333,05-08-24 22:28,59.33,Return,eBay Return,2462.014956
3027,709449333,5-13-24 23:28,107.04,OnlineShopping,eBay,2354.974956
3028,709449333,5-13-24 23:28,431.21,Purchase,Pharmacy,1923.764956
3029,709449333,5-15-24 22:28,264.59,Payment,Bill Payment,1659.174956
3030,709449333,5-16-24 10:28,521.21,Payment,Loan Payment,1137.964956
3031,709449333,5-17-24 21:28,2300,Payment,Rent Payment,-1162.035044
3032,709449333,5-21-24 10:28,86.51,Withdrawal,Branch Withdrawal,-1248.545044
3033,709449333,5-23-24 20:28,97.81,OutgoingTransfer,Wire Transfer,-1346.355044
3034,709449333,5-26-24 17:28,278.78,Purchase,Clothing,-1625.135044
3035,709449333,06-03-24 21:28,5100,IncomingTransfer,Salary,3474.864956
3036,709449333,06-08-24 21:28,1900,Payment,Credit Card Payment,1574.864956
3037,709449333,06-10-24 15:28,236.4,Deposit,Mobile Deposit,1811.264956
3038,709449333,06-12-24 18:28,220.58,OutgoingTransfer,Wire Transfer,1590.684956
3039,709449333,6-13-24 12:28,185.06,Purchase,Pharmacy,1405.624956
3040,709449333,6-14-24 21:28,53.47,OutgoingTransfer,Peer-to-Peer Transfer,1352.154956
3041,709449333,6-15-24 19:28,161.52,Withdrawal,Mobile App Withdrawal,1190.634956
3042,709449333,6-17-24 21:28,3300,Payment,Rent Payment,-2109.365044
3043,709449333,6-18-24 20:28,417.74,OnlineShopping,Best Buy,-2527.105044
3044,709449333,6-24-24 23:28,508.9,OnlineShopping,Etsy,-3036.005044
3045,709449333,6-25-24 23:28,541.65,Return,Target Return,-2494.355044
3046,709449333,6-29-24 21:28,328.49,Purchase,Electronics,-2822.845044
3047,709449333,6-29-24 22:28,440.83,Deposit,Check Deposit,-2382.015044
3048,709449333,07-03-24 16:28,471.63,Withdrawal,Branch Withdrawal,-2853.645044
3049,709449333,07-03-24 21:28,218.42,Payment,Bill Payment,-3072.065044
3050,709449333,07-05-24 18:28,222.97,Purchase,Home Improvement,-3295.035044
3051,709449333,07-05-24 19:28,332.52,OnlineShopping,Etsy,-3627.555044
3052,709449333,07-05-24 21:28,5100,IncomingTransfer,Salary,1472.444956
3053,709449333,07-06-24 18:28,83.98,Return,AliExpress Return,1556.424956
3054,709449333,07-08-24 19:28,269.1,IncomingTransfer,Freelance Payment,1825.524956
3055,709449333,07-10-24 21:28,1500,Payment,Credit Card Payment,325.524956
3056,709449333,07-11-24 9:28,491.56,Deposit,Check Deposit,817.084956
3057,709449333,7-15-24 17:28,313.22,IncomingTransfer,Freelance Payment,1130.304956
3058,709449333,7-16-24 21:28,2100,Payment,Rent Payment,-969.695044
3059,709455108,1-20-24 19:28,139.82,Return,Walmart Return,1374.757494
3060,709455108,1-24-24 19:28,182.38,Withdrawal,ATM Withdrawal,1192.377494
3061,709455108,1-25-24 19:28,115.16,OnlineShopping,Walmart,1077.217494
3062,709455108,1-26-24 19:28,161.06,Return,Target Return,1238.277494
3063,709455108,1-29-24 15:28,24.92,OutgoingTransfer,International Transfer,1213.357494
3064,709455108,1-30-24 17:28,58.24,OutgoingTransfer,Peer-to-Peer Transfer,1155.117494
3065,709455108,1-30-24 21:28,61.16,Purchase,Restaurant,1093.957494
3066,709455108,02-01-24 12:28,43.57,Deposit,Direct Deposit,1137.527494
3067,709455108,02-01-24 21:28,2800,IncomingTransfer,Salary,3937.527494
3068,709455108,02-04-24 18:28,15.95,Return,Walmart Return,3953.477494
3069,709455108,02-06-24 21:28,2200,Payment,Credit Card Payment,1753.477494
3070,709455108,02-08-24 11:28,205.93,Deposit,Direct Deposit,1959.407494
3071,709455108,02-09-24 21:28,132.24,Return,Store Return,2091.647494
3072,709455108,02-10-24 18:28,98.42,IncomingTransfer,Freelance Payment,2190.067494
3073,709455108,2-16-24 14:28,154.51,Purchase,Electronics,2035.557494
3074,709455108,2-16-24 21:28,1200,Payment,Installment Payment,835.5574942
3075,709455108,2-23-24 19:28,16.28,Purchase,Entertainment,819.2774942
3076,709455108,2-24-24 21:28,153.44,Purchase,Furniture,665.8374942
3077,709455108,2-25-24 17:28,220.51,Payment,Loan Payment,445.3274942
3078,709455108,2-29-24 12:28,113.25,Purchase,Furniture,332.0774942
3079,709455108,03-02-24 20:28,99.86,Deposit,Mobile Deposit,431.9374942
3080,709455108,03-05-24 21:28,2800,IncomingTransfer,Salary,3231.937494
3081,709455108,03-06-24 18:28,185.29,Purchase,Pharmacy,3046.647494
3082,709455108,03-07-24 20:28,238.67,Purchase,Pharmacy,2807.977494
3083,709455108,03-10-24 21:28,2400,Payment,Credit Card Payment,407.9774942
3084,709455108,03-11-24 23:28,199.1,OutgoingTransfer,Wire Transfer,208.8774942
3085,709455108,3-13-24 18:28,141.79,Return,AliExpress Return,350.6674942
3086,709455108,3-16-24 15:28,248.04,Return,Etsy Return,598.7074942
3087,709455108,3-18-24 21:28,1100,Payment,Installment Payment,-501.2925058
3088,709455108,3-20-24 16:28,98.81,Purchase,Furniture,-600.1025058
3089,709455108,3-25-24 16:28,34.37,Purchase,Entertainment,-634.4725058
3090,709455108,3-28-24 10:28,249.75,OutgoingTransfer,Wire Transfer,-884.2225058
3091,709455108,3-29-24 20:28,90.86,Deposit,Check Deposit,-793.3625058
3092,709455108,3-30-24 20:28,53.42,Payment,Mortgage Payment,-846.7825058
3093,709455108,3-31-24 16:28,77.69,Withdrawal,Mobile App Withdrawal,-924.4725058
3094,709455108,3-31-24 20:28,247.74,OutgoingTransfer,Wire Transfer,-1172.212506
3095,709455108,04-01-24 21:28,2800,IncomingTransfer,Salary,1627.787494
3096,709455108,04-05-24 14:28,160.27,Purchase,Restaurant,1467.517494
3097,709455108,04-06-24 21:28,2100,Payment,Credit Card Payment,-632.4825058
3098,709455108,04-07-24 15:28,228.86,Withdrawal,ATM Withdrawal,-861.3425058
3099,709455108,04-08-24 9:28,59.05,Return,Amazon Return,-802.2925058
3100,709455108,04-09-24 13:28,43.52,Purchase,Clothing,-845.8125058
3101,709455108,04-11-24 20:28,209.98,Withdrawal,ATM Withdrawal,-1055.792506
3102,709455108,04-11-24 23:28,22.03,Return,Target Return,-1033.762506
3103,709455108,04-12-24 10:28,155.46,Payment,Loan Payment,-1189.222506
3104,709455108,4-13-24 21:28,700,Payment,Insurance Payment,-1889.222506
3105,709455108,4-16-24 13:28,213.57,Purchase,Electronics,-2102.792506
3106,709455108,4-17-24 19:28,82.72,Purchase,Furniture,-2185.512506
3107,709455108,4-25-24 17:28,231.84,Return,Best Buy Return,-1953.672506
3108,709455108,4-25-24 19:28,218.91,Payment,Loan Payment,-2172.582506
3109,709455108,4-27-24 11:28,85.78,Purchase,Home Improvement,-2258.362506
3110,709455108,4-30-24 11:28,129.63,OutgoingTransfer,International Transfer,-2387.992506
3111,709455108,05-03-24 21:28,2800,IncomingTransfer,Salary,412.0074942
3112,709455108,05-06-24 15:28,214.03,IncomingTransfer,Freelance Payment,626.0374942
3113,709455108,05-07-24 15:28,249.74,Deposit,Mobile Deposit,875.7774942
3114,709455108,05-07-24 18:28,135.41,Deposit,Direct Deposit,1011.187494
3115,709455108,05-08-24 21:28,2300,Payment,Credit Card Payment,-1288.812506
3116,709455108,05-09-24 9:28,199.9,OutgoingTransfer,Wire Transfer,-1488.712506
3117,709455108,05-10-24 13:28,98.78,Purchase,Pharmacy,-1587.492506
3118,709455108,05-11-24 18:28,192.85,Purchase,Restaurant,-1780.342506
3119,709455108,5-15-24 20:28,92.29,Withdrawal,Branch Withdrawal,-1872.632506
3120,709455108,5-16-24 19:28,81.91,OnlineShopping,Etsy,-1954.542506
3121,709455108,5-16-24 21:28,800,Payment,Insurance Payment,-2754.542506
3122,709455108,5-19-24 13:28,244.21,Purchase,Restaurant,-2998.752506
3123,709455108,5-22-24 21:28,239.81,OutgoingTransfer,Bank Transfer,-3238.562506
3124,709455108,5-23-24 18:28,229.64,Deposit,Cash Deposit,-3008.922506
3125,709455108,5-29-24 16:28,71.52,Withdrawal,ATM Withdrawal,-3080.442506
3126,709455108,5-31-24 19:28,77.26,Withdrawal,Mobile App Withdrawal,-3157.702506
3127,709455108,5-31-24 21:28,64.18,OnlineShopping,Best Buy,-3221.882506
3128,709455108,06-01-24 11:28,24.11,Purchase,Clothing,-3245.992506
3129,709455108,06-03-24 15:28,93.75,Deposit,Direct Deposit,-3152.242506
3130,709455108,06-04-24 19:28,149.23,Purchase,Home Improvement,-3301.472506
3131,709455108,06-05-24 21:28,2800,IncomingTransfer,Salary,-501.4725058
3132,709455108,06-06-24 13:28,28.15,Purchase,Restaurant,-529.6225058
3133,709455108,06-06-24 19:28,51.63,Return,Amazon Return,-477.9925058
3134,709455108,06-09-24 16:28,112.81,OnlineShopping,eBay,-590.8025058
3135,709455108,06-10-24 21:28,1800,Payment,Credit Card Payment,-2390.802506
3136,709455108,06-11-24 10:28,208.76,IncomingTransfer,Freelance Payment,-2182.042506
3137,709455108,06-11-24 12:28,246.8,Deposit,Mobile Deposit,-1935.242506
3138,709455108,06-11-24 21:28,800,Payment,Subscription Payment,-2735.242506
3139,709455108,06-12-24 12:28,103.52,Deposit,Cash Deposit,-2631.722506
3140,709455108,6-13-24 12:28,137.77,Purchase,Home Improvement,-2769.492506
3141,709455108,6-14-24 18:28,63.53,Deposit,Mobile Deposit,-2705.962506
3142,709455108,6-16-24 11:28,54.77,Purchase,Restaurant,-2760.732506
3143,709455108,6-23-24 17:28,159.25,Deposit,Mobile Deposit,-2601.482506
3144,709455108,07-01-24 21:28,59.95,OutgoingTransfer,International Transfer,-2661.432506
3145,709455108,07-03-24 15:28,248.39,Payment,Loan Payment,-2909.822506
3146,709455108,07-03-24 17:28,157.01,Purchase,Entertainment,-3066.832506
3147,709455108,07-04-24 11:28,248.06,Purchase,Entertainment,-3314.892506
3148,709455108,07-04-24 21:28,2800,IncomingTransfer,Salary,-514.8925058
3149,709455108,07-06-24 11:28,173.35,Payment,Mortgage Payment,-688.2425058
3150,709455108,07-07-24 20:28,151.35,Payment,Loan Payment,-839.5925058
3151,709455108,07-09-24 21:28,1700,Payment,Credit Card Payment,-2539.592506
3152,709455108,07-11-24 22:28,188.81,Deposit,Mobile Deposit,-2350.782506
3153,709455108,7-13-24 21:28,1000,Payment,Insurance Payment,-3350.782506
3154,709455108,7-15-24 16:28,12.15,Payment,Bill Payment,-3362.932506
3155,709455108,7-16-24 15:28,249.73,Withdrawal,Branch Withdrawal,-3612.662506
3156,709486158,1-21-24 15:28,211.26,IncomingTransfer,Freelance Payment,211.26
3157,709486158,1-22-24 16:28,247.99,OnlineShopping,Etsy,-36.73
3158,709486158,1-25-24 12:28,43.5,Return,eBay Return,6.77
3159,709486158,1-25-24 21:28,79.68,Deposit,Direct Deposit,86.45
3160,709486158,1-27-24 18:28,30.26,Purchase,Electronics,56.19
3161,709486158,1-29-24 23:28,27.99,Deposit,Mobile Deposit,84.18
3162,709486158,02-01-24 14:28,32.31,Payment,Mortgage Payment,51.87
3163,709486158,02-01-24 16:28,169.71,Purchase,Entertainment,-117.84
3164,709486158,02-02-24 10:28,126.92,Deposit,Cash Deposit,9.08
3165,709486158,02-02-24 10:28,37.12,Purchase,Entertainment,-28.04
3166,709486158,02-02-24 14:28,63.5,Deposit,Direct Deposit,35.46
3167,709486158,02-04-24 10:28,65.31,Deposit,Mobile Deposit,100.77
3168,709486158,02-04-24 21:28,3200,IncomingTransfer,Salary,3300.77
3169,709486158,02-07-24 19:28,154.52,OutgoingTransfer,Peer-to-Peer Transfer,3146.25
3170,709486158,02-07-24 22:28,29.46,IncomingTransfer,Freelance Payment,3175.71
3171,709486158,02-12-24 10:28,154.41,Purchase,Restaurant,3021.3
3172,709486158,2-13-24 23:28,157.33,OnlineShopping,Target,2863.97
3173,709486158,2-14-24 15:28,132.12,Purchase,Home Improvement,2731.85
3174,709486158,2-15-24 21:28,1300,Payment,Rent Payment,1431.85
3175,709486158,2-18-24 15:28,168.58,Deposit,Check Deposit,1600.43
3176,709486158,2-19-24 23:28,225.31,Return,AliExpress Return,1825.74
3177,709486158,2-22-24 9:28,123.88,IncomingTransfer,Freelance Payment,1949.62
3178,709486158,2-27-24 18:28,58.13,OnlineShopping,eBay,1891.49
3179,709486158,03-03-24 21:28,3200,IncomingTransfer,Salary,5091.49
3180,709486158,03-04-24 10:28,153.56,Payment,Bill Payment,4937.93
3181,709486158,03-05-24 21:28,112.96,Return,Amazon Return,5050.89
3182,709486158,03-10-24 11:28,226.86,OnlineShopping,Walmart,4824.03
3183,709486158,03-11-24 21:28,1400,Payment,Rent Payment,3424.03
3184,709486158,3-13-24 13:28,226.99,Deposit,Direct Deposit,3651.02
3185,709486158,3-17-24 12:28,220.55,Deposit,Check Deposit,3871.57
3186,709486158,3-17-24 17:28,126.91,Withdrawal,Mobile App Withdrawal,3744.66
3187,709486158,3-18-24 18:28,64.48,Purchase,Home Improvement,3680.18
3188,709486158,3-20-24 10:28,68.8,Purchase,Clothing,3611.38
3189,709486158,3-20-24 11:28,202.81,Withdrawal,ATM Withdrawal,3408.57
3190,709486158,3-22-24 18:28,72.15,Withdrawal,ATM Withdrawal,3336.42
3191,709486158,3-24-24 13:28,226.4,Deposit,Check Deposit,3562.82
3192,709486158,3-24-24 21:28,226.18,Purchase,Electronics,3336.64
3193,709486158,3-25-24 20:28,68.31,Withdrawal,Mobile App Withdrawal,3268.33
3194,709486158,3-26-24 13:28,34.1,Return,Etsy Return,3302.43
3195,709486158,04-01-24 21:28,3200,IncomingTransfer,Salary,6502.43
3196,709486158,04-04-24 13:28,108.4,OnlineShopping,Best Buy,6394.03
3197,709486158,04-05-24 13:28,117.94,Purchase,Pharmacy,6276.09
3198,709486158,04-08-24 23:28,154.42,Deposit,Check Deposit,6430.51
3199,709486158,04-11-24 21:28,1300,Payment,Rent Payment,5130.51
3200,709486158,4-13-24 22:28,37.31,Deposit,Check Deposit,5167.82
3201,709486158,4-14-24 19:28,213.97,Deposit,Direct Deposit,5381.79
3202,709486158,4-14-24 22:28,72.87,OutgoingTransfer,Wire Transfer,5308.92
3203,709486158,4-15-24 9:28,175.2,Payment,Bill Payment,5133.72
3204,709486158,4-16-24 11:28,162.6,IncomingTransfer,Freelance Payment,5296.32
3205,709486158,4-16-24 14:28,157.17,Payment,Bill Payment,5139.15
3206,709486158,4-21-24 15:28,189.22,Withdrawal,Mobile App Withdrawal,4949.93
3207,709486158,4-25-24 15:28,203.51,Return,Target Return,5153.44
3208,709486158,4-26-24 22:28,81.59,OutgoingTransfer,International Transfer,5071.85
3209,709486158,4-26-24 23:28,185.91,IncomingTransfer,Freelance Payment,5257.76
3210,709486158,05-05-24 11:28,160.17,Withdrawal,ATM Withdrawal,5097.59
3211,709486158,05-05-24 21:28,3200,IncomingTransfer,Salary,8297.59
3212,709486158,05-08-24 20:28,84.08,Deposit,Check Deposit,8381.67
3213,709486158,05-10-24 17:28,170.93,Purchase,Gas,8210.74
3214,709486158,5-14-24 20:28,210.03,Payment,Mortgage Payment,8000.71
3215,709486158,5-16-24 21:28,1000,Payment,Rent Payment,7000.71
3216,709486158,5-18-24 14:28,163.76,Return,Store Return,7164.47
3217,709486158,5-23-24 12:28,134.91,Purchase,Pharmacy,7029.56
3218,709486158,5-27-24 10:28,51.84,Deposit,Direct Deposit,7081.4
3219,709486158,5-31-24 10:28,133.73,Purchase,Grocery,6947.67
3220,709486158,06-04-24 16:28,36.5,Purchase,Travel,6911.17
3221,709486158,06-04-24 23:28,34.19,OutgoingTransfer,Wire Transfer,6876.98
3222,709486158,06-05-24 21:28,3200,IncomingTransfer,Salary,10076.98
3223,709486158,06-08-24 16:28,248.1,Withdrawal,Branch Withdrawal,9828.88
3224,709486158,6-13-24 11:28,62.58,OutgoingTransfer,Peer-to-Peer Transfer,9766.3
3225,709486158,6-13-24 23:28,73.53,OnlineShopping,Etsy,9692.77
3226,709486158,6-15-24 10:28,185.92,Return,Best Buy Return,9878.69
3227,709486158,6-16-24 22:28,111.73,Deposit,Mobile Deposit,9990.42
3228,709486158,6-18-24 21:28,900,Payment,Rent Payment,9090.42
3229,709486158,6-20-24 9:28,212.83,Withdrawal,Branch Withdrawal,8877.59
3230,709486158,6-23-24 10:28,84.54,OnlineShopping,Best Buy,8793.05
3231,709486158,6-30-24 15:28,160.03,Withdrawal,Mobile App Withdrawal,8633.02
3232,709486158,07-03-24 12:28,84.03,Payment,Bill Payment,8548.99
3233,709486158,07-03-24 21:28,3200,IncomingTransfer,Salary,11748.99
3234,709486158,07-04-24 10:28,152.11,OutgoingTransfer,Wire Transfer,11596.88
3235,709486158,07-08-24 12:28,98.51,Payment,Bill Payment,11498.37
3236,709486158,07-09-24 10:28,88.15,Return,Walmart Return,11586.52
3237,709486158,7-14-24 15:28,171.46,Purchase,Electronics,11415.06
3238,709486158,7-16-24 21:28,1300,Payment,Rent Payment,10115.06
3239,709486158,7-16-24 22:28,20.51,OutgoingTransfer,Peer-to-Peer Transfer,10094.55
3240,709537683,1-21-24 17:28,275.51,Deposit,Check Deposit,799.1381018
3241,709537683,02-03-24 13:28,653.9,OutgoingTransfer,Wire Transfer,145.2381018
3242,709537683,02-04-24 21:28,8750,IncomingTransfer,Salary,8895.238102
3243,709537683,02-05-24 18:28,568.15,Deposit,Check Deposit,9463.388102
3244,709537683,02-09-24 21:28,1300,Payment,Credit Card Payment,8163.388102
3245,709537683,2-14-24 21:28,2400,Payment,Rent Payment,5763.388102
3246,709537683,2-16-24 22:28,375.16,IncomingTransfer,Freelance Payment,6138.548102
3247,709537683,03-03-24 21:28,8750,IncomingTransfer,Salary,14888.5481
3248,709537683,03-06-24 13:28,558.66,IncomingTransfer,Freelance Payment,15447.2081
3249,709537683,03-07-24 14:28,545.79,Purchase,Clothing,14901.4181
3250,709537683,03-08-24 21:28,1200,Payment,Credit Card Payment,13701.4181
3251,709537683,3-18-24 21:28,4000,Payment,Rent Payment,9701.418102
3252,709537683,3-24-24 22:28,122.23,Deposit,Cash Deposit,9823.648102
3253,709537683,04-04-24 21:28,8750,IncomingTransfer,Salary,18573.6481
3254,709537683,04-08-24 11:28,570.03,Return,Store Return,19143.6781
3255,709537683,04-09-24 21:28,1200,Payment,Credit Card Payment,17943.6781
3256,709537683,04-12-24 21:28,4600,Payment,Rent Payment,13343.6781
3257,709537683,4-13-24 20:28,623.76,Deposit,Direct Deposit,13967.4381
3258,709537683,05-04-24 21:28,8750,IncomingTransfer,Salary,22717.4381
3259,709537683,05-09-24 21:28,1000,Payment,Credit Card Payment,21717.4381
3260,709537683,5-13-24 21:28,3500,Payment,Rent Payment,18217.4381
3261,709537683,5-16-24 10:28,734.31,IncomingTransfer,Freelance Payment,18951.7481
3262,709537683,5-23-24 12:28,536.56,Payment,Bill Payment,18415.1881
3263,709537683,06-01-24 21:28,8750,IncomingTransfer,Salary,27165.1881
3264,709537683,06-06-24 21:28,1200,Payment,Credit Card Payment,25965.1881
3265,709537683,6-16-24 21:28,2200,Payment,Rent Payment,23765.1881
3266,709537683,6-17-24 20:28,651.84,Withdrawal,ATM Withdrawal,23113.3481
3267,709537683,6-22-24 16:28,649.43,OutgoingTransfer,Peer-to-Peer Transfer,22463.9181
3268,709537683,6-25-24 15:28,484.34,Return,Store Return,22948.2581
3269,709537683,07-05-24 21:28,8750,IncomingTransfer,Salary,31698.2581
3270,709537683,07-10-24 21:28,1100,Payment,Credit Card Payment,30598.2581
3271,709537683,7-14-24 21:28,3200,Payment,Rent Payment,27398.2581
3272,709537683,7-14-24 22:28,378.5,Return,Etsy Return,27776.7581
3273,709585758,1-23-24 9:28,598.14,Withdrawal,ATM Withdrawal,-598.14
3274,709585758,1-24-24 22:28,922.47,Payment,Mortgage Payment,-1520.61
3275,709585758,1-25-24 20:28,764.25,Withdrawal,ATM Withdrawal,-2284.86
3276,709585758,1-27-24 16:28,284.78,Purchase,Electronics,-2569.64
3277,709585758,1-28-24 15:28,440.12,Purchase,Gas,-3009.76
3278,709585758,1-30-24 12:28,854.21,OutgoingTransfer,Bank Transfer,-3863.97
3279,709585758,02-01-24 19:28,918.37,Purchase,Gas,-4782.34
3280,709585758,02-03-24 21:28,14150,IncomingTransfer,Salary,9367.66
3281,709585758,02-08-24 9:28,656.73,Deposit,Check Deposit,10024.39
3282,709585758,02-10-24 15:28,416.96,Deposit,Cash Deposit,10441.35
3283,709585758,02-10-24 17:28,860.03,Purchase,Travel,9581.32
3284,709585758,02-10-24 21:28,8200,Payment,Rent Payment,1381.32
3285,709585758,02-11-24 10:28,911.89,Payment,Bill Payment,469.43
3286,709585758,02-11-24 13:28,479.96,OutgoingTransfer,Bank Transfer,-10.53
3287,709585758,2-14-24 18:28,536.18,Purchase,Electronics,-546.71
3288,709585758,2-17-24 11:28,321.5,Purchase,Pharmacy,-868.21
3289,709585758,2-17-24 15:28,308.84,Return,AliExpress Return,-559.37
3290,709585758,2-17-24 16:28,646.37,Payment,Loan Payment,-1205.74
3291,709585758,2-18-24 13:28,518.13,OnlineShopping,Target,-1723.87
3292,709585758,2-18-24 14:28,777.96,Deposit,Cash Deposit,-945.91
3293,709585758,2-18-24 16:28,331.47,OutgoingTransfer,International Transfer,-1277.38
3294,709585758,2-18-24 17:28,676.14,Return,eBay Return,-601.24
3295,709585758,2-19-24 11:28,856.45,Purchase,Furniture,-1457.69
3296,709585758,2-21-24 9:28,501.08,OnlineShopping,eBay,-1958.77
3297,709585758,2-21-24 15:28,602.26,Purchase,Restaurant,-2561.03
3298,709585758,2-28-24 11:28,755.44,IncomingTransfer,Freelance Payment,-1805.59
3299,709585758,2-29-24 17:28,262.63,OutgoingTransfer,Peer-to-Peer Transfer,-2068.22
3300,709585758,03-02-24 16:28,635.53,Withdrawal,ATM Withdrawal,-2703.75
3301,709585758,03-02-24 18:28,833.06,Payment,Bill Payment,-3536.81
3302,709585758,03-04-24 12:28,447.1,OutgoingTransfer,International Transfer,-3983.91
3303,709585758,03-04-24 21:28,14150,IncomingTransfer,Salary,10166.09
3304,709585758,03-05-24 19:28,643.63,IncomingTransfer,Freelance Payment,10809.72
3305,709585758,03-06-24 12:28,700.9,Purchase,Home Improvement,10108.82
3306,709585758,03-07-24 10:28,517.52,Purchase,Restaurant,9591.3
3307,709585758,03-10-24 10:28,923.29,Deposit,Cash Deposit,10514.59
3308,709585758,03-10-24 14:28,463.53,Deposit,Check Deposit,10978.12
3309,709585758,3-13-24 21:28,8900,Payment,Rent Payment,2078.12
3310,709585758,3-15-24 21:28,835.96,Purchase,Gas,1242.16
3311,709585758,3-21-24 20:28,800.89,Purchase,Entertainment,441.27
3312,709585758,3-24-24 20:28,435.45,Payment,Bill Payment,5.82
3313,709585758,3-27-24 13:28,402.29,OutgoingTransfer,International Transfer,-396.47
3314,709585758,3-27-24 19:28,638.54,Deposit,Check Deposit,242.07
3315,709585758,3-30-24 18:28,721.15,IncomingTransfer,Freelance Payment,963.22
3316,709585758,3-31-24 18:28,383.41,Payment,Bill Payment,579.81
3317,709585758,04-02-24 22:28,915.46,OutgoingTransfer,Bank Transfer,-335.65
3318,709585758,04-03-24 21:28,14150,IncomingTransfer,Salary,13814.35
3319,709585758,04-05-24 13:28,804.08,Deposit,Mobile Deposit,14618.43
3320,709585758,04-05-24 21:28,918.06,Purchase,Entertainment,13700.37
3321,709585758,04-06-24 16:28,684.04,OutgoingTransfer,Peer-to-Peer Transfer,13016.33
3322,709585758,04-07-24 16:28,935.81,OnlineShopping,Best Buy,12080.52
3323,709585758,04-11-24 17:28,242.63,Purchase,Grocery,11837.89
3324,709585758,04-12-24 13:28,892.17,OutgoingTransfer,Peer-to-Peer Transfer,10945.72
3325,709585758,04-12-24 17:28,876.43,Payment,Bill Payment,10069.29
3326,709585758,04-12-24 21:28,3900,Payment,Rent Payment,6169.29
3327,709585758,4-18-24 15:28,806.75,Withdrawal,Branch Withdrawal,5362.54
3328,709585758,4-22-24 14:28,629.2,OnlineShopping,AliExpress,4733.34
3329,709585758,4-23-24 19:28,267.79,Deposit,Cash Deposit,5001.13
3330,709585758,4-25-24 18:28,810.74,OutgoingTransfer,Bank Transfer,4190.39
3331,709585758,4-26-24 22:28,519.36,Purchase,Home Improvement,3671.03
3332,709585758,4-28-24 16:28,924.88,OutgoingTransfer,Peer-to-Peer Transfer,2746.15
3333,709585758,4-30-24 15:28,732.83,Deposit,Mobile Deposit,3478.98
3334,709585758,05-03-24 9:28,940.08,OutgoingTransfer,Wire Transfer,2538.9
3335,709585758,05-04-24 10:28,863.67,Purchase,Furniture,1675.23
3336,709585758,05-05-24 21:28,14150,IncomingTransfer,Salary,15825.23
3337,709585758,05-06-24 21:28,472.55,IncomingTransfer,Freelance Payment,16297.78
3338,709585758,5-15-24 14:28,379.41,Purchase,Pharmacy,15918.37
3339,709585758,5-16-24 13:28,879.46,Deposit,Mobile Deposit,16797.83
3340,709585758,5-17-24 10:28,356.96,OutgoingTransfer,Bank Transfer,16440.87
3341,709585758,5-17-24 21:28,8700,Payment,Rent Payment,7740.87
3342,709585758,5-18-24 16:28,447.8,Withdrawal,ATM Withdrawal,7293.07
3343,709585758,5-21-24 23:28,819.38,Withdrawal,Mobile App Withdrawal,6473.69
3344,709585758,5-26-24 11:28,506.48,Purchase,Electronics,5967.21
3345,709585758,5-27-24 23:28,687.64,OutgoingTransfer,Bank Transfer,5279.57
3346,709585758,5-28-24 15:28,823.49,Withdrawal,Mobile App Withdrawal,4456.08
3347,709585758,06-02-24 21:28,14150,IncomingTransfer,Salary,18606.08
3348,709585758,06-06-24 22:28,253.04,Deposit,Mobile Deposit,18859.12
3349,709585758,06-10-24 11:28,479,Deposit,Direct Deposit,19338.12
3350,709585758,6-13-24 21:28,4600,Payment,Rent Payment,14738.12
3351,709585758,6-15-24 12:28,536.22,Deposit,Direct Deposit,15274.34
3352,709585758,6-15-24 16:28,550.41,OutgoingTransfer,Wire Transfer,14723.93
3353,709585758,6-17-24 19:28,720.59,OutgoingTransfer,Bank Transfer,14003.34
3354,709585758,6-20-24 23:28,578.55,OutgoingTransfer,Peer-to-Peer Transfer,13424.79
3355,709585758,6-21-24 13:28,902.93,OutgoingTransfer,Bank Transfer,12521.86
3356,709585758,6-22-24 11:28,763.41,Deposit,Check Deposit,13285.27
3357,709585758,6-23-24 21:28,878.81,OutgoingTransfer,Wire Transfer,12406.46
3358,709585758,6-25-24 15:28,545.9,Deposit,Check Deposit,12952.36
3359,709585758,6-25-24 23:28,806.67,OutgoingTransfer,Bank Transfer,12145.69
3360,709585758,6-30-24 10:28,220.14,Deposit,Cash Deposit,12365.83
3361,709585758,6-30-24 12:28,734.97,Deposit,Mobile Deposit,13100.8
3362,709585758,07-04-24 21:28,14150,IncomingTransfer,Salary,27250.8
3363,709585758,07-06-24 15:28,850.82,Payment,Bill Payment,26399.98
3364,709585758,07-07-24 10:28,635.62,Return,Best Buy Return,27035.6
3365,709585758,07-08-24 14:28,250.49,Deposit,Direct Deposit,27286.09
3366,709585758,07-08-24 23:28,576.19,OnlineShopping,Target,26709.9
3367,709585758,07-11-24 14:28,337.79,Withdrawal,Mobile App Withdrawal,26372.11
3368,709585758,07-11-24 20:28,595.27,OutgoingTransfer,International Transfer,25776.84
3369,709585758,7-13-24 15:28,777.21,Return,eBay Return,26554.05
3370,709585758,7-15-24 21:28,5900,Payment,Rent Payment,20654.05
3371,709722858,1-20-24 22:28,57.05,Withdrawal,Branch Withdrawal,702.2825244
3372,709722858,1-21-24 11:28,235.11,Return,Etsy Return,937.3925244
3373,709722858,1-22-24 16:28,355.97,Purchase,Restaurant,581.4225244
3374,709722858,1-26-24 14:28,357.36,Purchase,Pharmacy,224.0625244
3375,709722858,1-27-24 15:28,500.43,Payment,Mortgage Payment,-276.3674756
3376,709722858,1-27-24 20:28,156.83,Purchase,Home Improvement,-433.1974756
3377,709722858,1-27-24 21:28,272.48,Return,Best Buy Return,-160.7174756
3378,709722858,1-30-24 22:28,226.3,Payment,Mortgage Payment,-387.0174756
3379,709722858,02-02-24 21:28,6000,IncomingTransfer,Salary,5612.982524
3380,709722858,02-07-24 21:28,1500,Payment,Credit Card Payment,4112.982524
3381,709722858,02-08-24 13:28,198.09,OnlineShopping,Target,3914.892524
3382,709722858,02-08-24 16:28,60.57,Deposit,Mobile Deposit,3975.462524
3383,709722858,02-09-24 10:28,517.84,OutgoingTransfer,International Transfer,3457.622524
3384,709722858,2-14-24 19:28,272.57,Return,Best Buy Return,3730.192524
3385,709722858,2-16-24 22:28,306.1,Payment,Loan Payment,3424.092524
3386,709722858,2-17-24 21:28,1900,Payment,Insurance Payment,1524.092524
3387,709722858,2-22-24 18:28,57.36,OnlineShopping,Target,1466.732524
3388,709722858,2-24-24 12:28,190.02,Deposit,Direct Deposit,1656.752524
3389,709722858,03-01-24 21:28,6000,IncomingTransfer,Salary,7656.752524
3390,709722858,03-01-24 23:28,509.22,OnlineShopping,AliExpress,7147.532524
3391,709722858,03-02-24 13:28,356.84,Withdrawal,Branch Withdrawal,6790.692524
3392,709722858,03-03-24 14:28,397.8,IncomingTransfer,Freelance Payment,7188.492524
3393,709722858,03-05-24 11:28,390.11,OnlineShopping,Walmart,6798.382524
3394,709722858,03-06-24 21:28,1700,Payment,Credit Card Payment,5098.382524
3395,709722858,03-07-24 17:28,404.92,Purchase,Pharmacy,4693.462524
3396,709722858,03-11-24 23:28,479.42,Purchase,Clothing,4214.042524
3397,709722858,03-12-24 18:28,389.77,Deposit,Mobile Deposit,4603.812524
3398,709722858,3-14-24 21:28,2600,Payment,Subscription Payment,2003.812524
3399,709722858,3-15-24 10:28,315.68,OutgoingTransfer,Bank Transfer,1688.132524
3400,709722858,3-20-24 19:28,83.34,Purchase,Travel,1604.792524
3401,709722858,3-23-24 18:28,360.52,OutgoingTransfer,Peer-to-Peer Transfer,1244.272524
3402,709722858,3-23-24 19:28,449.19,Purchase,Furniture,795.0825244
3403,709722858,3-27-24 11:28,477.32,Payment,Mortgage Payment,317.7625244
3404,709722858,3-27-24 16:28,349.22,Withdrawal,ATM Withdrawal,-31.45747563
3405,709722858,3-30-24 21:28,495.7,Deposit,Check Deposit,464.2425244
3406,709722858,04-01-24 15:28,329.99,Purchase,Clothing,134.2525244
3407,709722858,04-03-24 10:28,105.89,Purchase,Furniture,28.36252437
3408,709722858,04-03-24 21:28,6000,IncomingTransfer,Salary,6028.362524
3409,709722858,04-04-24 13:28,346.7,Deposit,Cash Deposit,6375.062524
3410,709722858,04-05-24 10:28,262.11,Withdrawal,Branch Withdrawal,6112.952524
3411,709722858,04-08-24 13:28,115.84,OnlineShopping,Etsy,5997.112524
3412,709722858,04-08-24 21:28,1700,Payment,Credit Card Payment,4297.112524
3413,709722858,04-10-24 17:28,321.12,Purchase,Electronics,3975.992524
3414,709722858,04-10-24 21:28,1500,Payment,Installment Payment,2475.992524
3415,709722858,04-12-24 9:28,329.42,Deposit,Mobile Deposit,2805.412524
3416,709722858,4-17-24 14:28,348.19,Deposit,Cash Deposit,3153.602524
3417,709722858,4-17-24 21:28,321.23,Withdrawal,ATM Withdrawal,2832.372524
3418,709722858,4-22-24 10:28,86.25,Purchase,Home Improvement,2746.122524
3419,709722858,4-24-24 23:28,341.81,Withdrawal,Mobile App Withdrawal,2404.312524
3420,709722858,4-25-24 12:28,233.92,Purchase,Gas,2170.392524
3421,709722858,4-30-24 11:28,423.38,Purchase,Entertainment,1747.012524
3422,709722858,4-30-24 20:28,540.91,Purchase,Pharmacy,1206.102524
3423,709722858,4-30-24 21:28,263.94,OutgoingTransfer,Peer-to-Peer Transfer,942.1625244
3424,709722858,05-02-24 13:28,239.75,Deposit,Check Deposit,1181.912524
3425,709722858,05-02-24 21:28,6000,IncomingTransfer,Salary,7181.912524
3426,709722858,05-07-24 21:28,1800,Payment,Credit Card Payment,5381.912524
3427,709722858,05-07-24 23:28,255.79,OnlineShopping,AliExpress,5126.122524
3428,709722858,05-09-24 9:28,305.34,Deposit,Check Deposit,5431.462524
3429,709722858,05-10-24 10:28,353.02,Payment,Mortgage Payment,5078.442524
3430,709722858,05-12-24 19:28,209.98,Deposit,Mobile Deposit,5288.422524
3431,709722858,5-13-24 10:28,359.5,Purchase,Restaurant,4928.922524
3432,709722858,5-15-24 21:28,2000,Payment,Installment Payment,2928.922524
3433,709722858,5-18-24 17:28,506.31,Return,Amazon Return,3435.232524
3434,709722858,5-19-24 17:28,505.02,IncomingTransfer,Freelance Payment,3940.252524
3435,709722858,5-20-24 21:28,185.37,Return,Best Buy Return,4125.622524
3436,709722858,5-21-24 19:28,109.34,Withdrawal,ATM Withdrawal,4016.282524
3437,709722858,5-23-24 14:28,125.68,Payment,Mortgage Payment,3890.602524
3438,709722858,5-26-24 20:28,293.46,Deposit,Cash Deposit,4184.062524
3439,709722858,5-26-24 21:28,232.55,Withdrawal,ATM Withdrawal,3951.512524
3440,709722858,5-26-24 22:28,420.34,Deposit,Direct Deposit,4371.852524
3441,709722858,5-30-24 20:28,237.56,Deposit,Check Deposit,4609.412524
3442,709722858,5-31-24 13:28,386.49,IncomingTransfer,Freelance Payment,4995.902524
3443,709722858,06-01-24 22:28,97.46,Withdrawal,Branch Withdrawal,4898.442524
3444,709722858,06-02-24 22:28,335.31,Purchase,Furniture,4563.132524
3445,709722858,06-03-24 10:28,135.13,IncomingTransfer,Freelance Payment,4698.262524
3446,709722858,06-03-24 17:28,509.65,Withdrawal,ATM Withdrawal,4188.612524
3447,709722858,06-04-24 9:28,367.33,Purchase,Travel,3821.282524
3448,709722858,06-04-24 11:28,421.33,Purchase,Restaurant,3399.952524
3449,709722858,06-04-24 20:28,186.68,Purchase,Grocery,3213.272524
3450,709722858,06-05-24 21:28,6000,IncomingTransfer,Salary,9213.272524
3451,709722858,06-05-24 21:28,421.07,Deposit,Direct Deposit,9634.342524
3452,709722858,06-07-24 17:28,84.84,Payment,Mortgage Payment,9549.502524
3453,709722858,06-09-24 15:28,285.09,Withdrawal,Mobile App Withdrawal,9264.412524
3454,709722858,06-10-24 21:28,1600,Payment,Credit Card Payment,7664.412524
3455,709722858,06-11-24 12:28,282.99,Payment,Bill Payment,7381.422524
3456,709722858,06-12-24 15:28,426.81,Payment,Loan Payment,6954.612524
3457,709722858,6-13-24 21:28,2000,Payment,Insurance Payment,4954.612524
3458,709722858,6-13-24 23:28,394.28,Withdrawal,Mobile App Withdrawal,4560.332524
3459,709722858,6-14-24 22:28,289.89,Withdrawal,ATM Withdrawal,4270.442524
3460,709722858,6-20-24 20:28,430.23,Purchase,Pharmacy,3840.212524
3461,709722858,6-21-24 15:28,155.81,Deposit,Direct Deposit,3996.022524
3462,709722858,6-23-24 19:28,86.09,IncomingTransfer,Freelance Payment,4082.112524
3463,709722858,6-25-24 21:28,341.12,OutgoingTransfer,Wire Transfer,3740.992524
3464,709722858,6-29-24 16:28,415.4,Purchase,Electronics,3325.592524
3465,709722858,6-30-24 22:28,335.01,Payment,Bill Payment,2990.582524
3466,709722858,07-01-24 21:28,6000,IncomingTransfer,Salary,8990.582524
3467,709722858,07-02-24 23:28,473.87,Return,Store Return,9464.452524
3468,709722858,07-03-24 13:28,448.7,Deposit,Cash Deposit,9913.152524
3469,709722858,07-04-24 19:28,428.54,OutgoingTransfer,Peer-to-Peer Transfer,9484.612524
3470,709722858,07-04-24 23:28,323.57,IncomingTransfer,Freelance Payment,9808.182524
3471,709722858,07-05-24 10:28,411.42,Purchase,Pharmacy,9396.762524
3472,709722858,07-06-24 21:28,1500,Payment,Credit Card Payment,7896.762524
3473,709722858,07-08-24 14:28,499.78,IncomingTransfer,Freelance Payment,8396.542524
3474,709722858,07-08-24 23:28,184.19,Deposit,Mobile Deposit,8580.732524
3475,709722858,7-13-24 20:28,80.1,Withdrawal,Mobile App Withdrawal,8500.632524
3476,709722858,7-17-24 21:28,1900,Payment,Installment Payment,6600.632524
3477,709787733,1-20-24 13:28,61.66,Purchase,Pharmacy,925.0721857
3478,709787733,1-21-24 22:28,401.37,Deposit,Check Deposit,1326.442186
3479,709787733,1-23-24 11:28,78.41,Withdrawal,ATM Withdrawal,1248.032186
3480,709787733,1-23-24 19:28,87.9,Purchase,Gas,1160.132186
3481,709787733,1-24-24 13:28,150.78,IncomingTransfer,Freelance Payment,1310.912186
3482,709787733,1-25-24 17:28,449.93,Purchase,Home Improvement,860.9821857
3483,709787733,02-02-24 21:28,3100,IncomingTransfer,Salary,3960.982186
3484,709787733,02-03-24 13:28,121.56,Purchase,Furniture,3839.422186
3485,709787733,02-03-24 15:28,110.63,Purchase,Furniture,3728.792186
3486,709787733,02-04-24 21:28,412.56,Payment,Loan Payment,3316.232186
3487,709787733,02-07-24 21:28,1900,Payment,Credit Card Payment,1416.232186
3488,709787733,02-08-24 16:28,417.96,OnlineShopping,AliExpress,998.2721857
3489,709787733,02-09-24 13:28,337.6,Withdrawal,Branch Withdrawal,660.6721857
3490,709787733,02-10-24 21:28,1200,Payment,Insurance Payment,-539.3278143
3491,709787733,2-16-24 22:28,218.13,Withdrawal,ATM Withdrawal,-757.4578143
3492,709787733,2-18-24 11:28,458.65,Return,Walmart Return,-298.8078143
3493,709787733,2-18-24 17:28,58.63,Withdrawal,Mobile App Withdrawal,-357.4378143
3494,709787733,2-19-24 10:28,442.94,Payment,Mortgage Payment,-800.3778143
3495,709787733,2-19-24 21:28,55.48,OutgoingTransfer,International Transfer,-855.8578143
3496,709787733,2-21-24 13:28,106.03,Deposit,Mobile Deposit,-749.8278143
3497,709787733,2-21-24 22:28,496.7,Deposit,Mobile Deposit,-253.1278143
3498,709787733,2-21-24 23:28,443.83,Withdrawal,Mobile App Withdrawal,-696.9578143
3499,709787733,2-25-24 16:28,302.42,OutgoingTransfer,Wire Transfer,-999.3778143
3500,709787733,2-26-24 9:28,47.31,Payment,Mortgage Payment,-1046.687814
3501,709787733,2-26-24 17:28,285.48,IncomingTransfer,Freelance Payment,-761.2078143
3502,709787733,2-27-24 14:28,49.82,Payment,Bill Payment,-811.0278143
3503,709787733,03-02-24 11:28,391.43,Purchase,Home Improvement,-1202.457814
3504,709787733,03-04-24 9:28,493.57,Deposit,Check Deposit,-708.8878143
3505,709787733,03-04-24 21:28,3100,IncomingTransfer,Salary,2391.112186
3506,709787733,03-07-24 14:28,355.26,Payment,Mortgage Payment,2035.852186
3507,709787733,03-09-24 21:28,1600,Payment,Credit Card Payment,435.8521857
3508,709787733,03-12-24 21:28,1000,Payment,Installment Payment,-564.1478143
3509,709787733,3-15-24 23:28,114.06,Withdrawal,Mobile App Withdrawal,-678.2078143
3510,709787733,3-17-24 12:28,126.1,Return,Etsy Return,-552.1078143
3511,709787733,3-18-24 13:28,351.93,Purchase,Clothing,-904.0378143
3512,709787733,3-23-24 15:28,147.45,OutgoingTransfer,Peer-to-Peer Transfer,-1051.487814
3513,709787733,3-24-24 16:28,105.7,IncomingTransfer,Freelance Payment,-945.7878143
3514,709787733,3-28-24 16:28,69.36,Purchase,Entertainment,-1015.147814
3515,709787733,3-30-24 19:28,338.11,Withdrawal,Mobile App Withdrawal,-1353.257814
3516,709787733,04-01-24 19:28,22.06,Payment,Mortgage Payment,-1375.317814
3517,709787733,04-03-24 21:28,3100,IncomingTransfer,Salary,1724.682186
3518,709787733,04-04-24 21:28,333.51,Purchase,Electronics,1391.172186
3519,709787733,04-08-24 17:28,241.38,Return,eBay Return,1632.552186
3520,709787733,04-08-24 21:28,1400,Payment,Credit Card Payment,232.5521857
3521,709787733,04-09-24 9:28,42.63,OutgoingTransfer,Wire Transfer,189.9221857
3522,709787733,04-11-24 16:28,392.94,Deposit,Check Deposit,582.8621857
3523,709787733,04-12-24 10:28,353.86,Withdrawal,ATM Withdrawal,229.0021857
3524,709787733,04-12-24 17:28,296.72,Payment,Loan Payment,-67.71781427
3525,709787733,4-14-24 13:28,213.2,Return,Store Return,145.4821857
3526,709787733,4-14-24 18:28,152.77,Deposit,Mobile Deposit,298.2521857
3527,709787733,4-14-24 21:28,1200,Payment,Installment Payment,-901.7478143
3528,709787733,4-20-24 22:28,255.84,Payment,Mortgage Payment,-1157.587814
3529,709787733,4-25-24 11:28,251.71,OnlineShopping,eBay,-1409.297814
3530,709787733,4-27-24 12:28,250.65,Payment,Loan Payment,-1659.947814
3531,709787733,05-03-24 21:28,3100,IncomingTransfer,Salary,1440.052186
3532,709787733,05-04-24 18:28,117.13,OutgoingTransfer,Wire Transfer,1322.922186
3533,709787733,05-08-24 12:28,472.25,Deposit,Mobile Deposit,1795.172186
3534,709787733,05-08-24 21:28,1900,Payment,Credit Card Payment,-104.8278143
3535,709787733,05-09-24 17:28,464.39,IncomingTransfer,Freelance Payment,359.5621857
3536,709787733,05-10-24 18:28,126.58,OnlineShopping,Walmart,232.9821857
3537,709787733,05-12-24 21:28,78.04,OnlineShopping,Best Buy,154.9421857
3538,709787733,5-13-24 21:28,900,Payment,Subscription Payment,-745.0578143
3539,709787733,5-14-24 14:28,249.59,Return,Etsy Return,-495.4678143
3540,709787733,5-14-24 16:28,149.52,Withdrawal,Branch Withdrawal,-644.9878143
3541,709787733,5-14-24 20:28,403.02,Withdrawal,Mobile App Withdrawal,-1048.007814
3542,709787733,5-19-24 12:28,448.94,Return,Walmart Return,-599.0678143
3543,709787733,5-22-24 13:28,280.17,Purchase,Clothing,-879.2378143
3544,709787733,5-25-24 12:28,177.69,Withdrawal,Branch Withdrawal,-1056.927814
3545,709787733,5-31-24 12:28,299.84,Purchase,Entertainment,-1356.767814
3546,709787733,06-01-24 10:28,51.08,Payment,Mortgage Payment,-1407.847814
3547,709787733,06-01-24 20:28,480.4,OutgoingTransfer,Wire Transfer,-1888.247814
3548,709787733,06-02-24 21:28,3100,IncomingTransfer,Salary,1211.752186
3549,709787733,06-04-24 22:28,274.84,Purchase,Electronics,936.9121857
3550,709787733,06-07-24 21:28,1500,Payment,Credit Card Payment,-563.0878143
3551,709787733,06-08-24 11:28,322.46,Deposit,Check Deposit,-240.6278143
3552,709787733,06-11-24 19:28,333.74,Withdrawal,Mobile App Withdrawal,-574.3678143
3553,709787733,6-14-24 21:28,1000,Payment,Installment Payment,-1574.367814
3554,709787733,6-15-24 15:28,438.89,OnlineShopping,Etsy,-2013.257814
3555,709787733,6-22-24 16:28,90.21,Deposit,Check Deposit,-1923.047814
3556,709787733,6-23-24 18:28,350.48,OnlineShopping,Target,-2273.527814
3557,709787733,6-25-24 10:28,396.7,Withdrawal,ATM Withdrawal,-2670.227814
3558,709787733,6-28-24 19:28,146.83,OutgoingTransfer,Peer-to-Peer Transfer,-2817.057814
3559,709787733,6-30-24 15:28,268.33,Payment,Loan Payment,-3085.387814
3560,709787733,6-30-24 20:28,154.21,Purchase,Electronics,-3239.597814
3561,709787733,07-01-24 10:28,226.23,Payment,Mortgage Payment,-3465.827814
3562,709787733,07-01-24 21:28,3100,IncomingTransfer,Salary,-365.8278143
3563,709787733,07-05-24 17:28,366.62,Purchase,Electronics,-732.4478143
3564,709787733,07-06-24 21:28,1700,Payment,Credit Card Payment,-2432.447814
3565,709787733,07-07-24 13:28,129.73,Deposit,Mobile Deposit,-2302.717814
3566,709787733,07-08-24 20:28,66.99,Purchase,Electronics,-2369.707814
3567,709787733,07-10-24 12:28,309.65,IncomingTransfer,Freelance Payment,-2060.057814
3568,709787733,07-10-24 12:28,153.9,Withdrawal,Mobile App Withdrawal,-2213.957814
3569,709787733,07-10-24 12:28,260.98,Return,Store Return,-1952.977814
3570,709787733,7-15-24 21:28,1300,Payment,Installment Payment,-3252.977814
3571,709790058,1-20-24 15:28,686.61,Withdrawal,ATM Withdrawal,238.9033211
3572,709790058,1-20-24 20:28,393.01,Purchase,Electronics,-154.1066789
3573,709790058,1-21-24 14:28,579.57,Withdrawal,Mobile App Withdrawal,-733.6766789
3574,709790058,1-24-24 12:28,792.08,Deposit,Mobile Deposit,58.40332112
3575,709790058,1-24-24 12:28,696.23,Deposit,Mobile Deposit,754.6333211
3576,709790058,1-25-24 22:28,909.74,Payment,Bill Payment,-155.1066789
3577,709790058,1-26-24 18:28,448.32,Purchase,Clothing,-603.4266789
3578,709790058,1-28-24 14:28,647.23,Withdrawal,Mobile App Withdrawal,-1250.656679
3579,709790058,1-29-24 12:28,734.14,Return,Target Return,-516.5166789
3580,709790058,1-29-24 16:28,359.48,Payment,Bill Payment,-875.9966789
3581,709790058,1-31-24 17:28,490.1,Purchase,Pharmacy,-1366.096679
3582,709790058,02-01-24 13:28,845.03,Withdrawal,Mobile App Withdrawal,-2211.126679
3583,709790058,02-01-24 21:28,13200,IncomingTransfer,Salary,10988.87332
3584,709790058,02-04-24 20:28,439.41,Deposit,Direct Deposit,11428.28332
3585,709790058,02-06-24 21:28,2200,Payment,Credit Card Payment,9228.283321
3586,709790058,02-09-24 14:28,509.88,Purchase,Furniture,8718.403321
3587,709790058,2-14-24 21:28,3700,Payment,Insurance Payment,5018.403321
3588,709790058,2-14-24 22:28,684.24,Payment,Loan Payment,4334.163321
3589,709790058,2-15-24 15:28,601.28,Deposit,Mobile Deposit,4935.443321
3590,709790058,2-20-24 10:28,916.57,Return,Amazon Return,5852.013321
3591,709790058,2-21-24 17:28,427.74,OnlineShopping,AliExpress,5424.273321
3592,709790058,2-22-24 23:28,685.32,Deposit,Direct Deposit,6109.593321
3593,709790058,2-24-24 10:28,362.39,Deposit,Cash Deposit,6471.983321
3594,709790058,2-25-24 17:28,515.76,Return,Amazon Return,6987.743321
3595,709790058,2-27-24 14:28,600,OutgoingTransfer,Peer-to-Peer Transfer,6387.743321
3596,709790058,2-28-24 10:28,219.38,Purchase,Home Improvement,6168.363321
3597,709790058,2-29-24 9:28,343.03,Payment,Mortgage Payment,5825.333321
3598,709790058,03-01-24 21:28,732.88,Withdrawal,Mobile App Withdrawal,5092.453321
3599,709790058,03-02-24 21:28,13200,IncomingTransfer,Salary,18292.45332
3600,709790058,03-06-24 11:28,821.78,Deposit,Cash Deposit,19114.23332
3601,709790058,03-07-24 15:28,558.29,Withdrawal,Branch Withdrawal,18555.94332
3602,709790058,03-07-24 21:28,1600,Payment,Credit Card Payment,16955.94332
3603,709790058,03-09-24 17:28,236.45,IncomingTransfer,Freelance Payment,17192.39332
3604,709790058,03-10-24 20:28,484.05,OnlineShopping,Walmart,16708.34332
3605,709790058,3-13-24 21:28,3300,Payment,Subscription Payment,13408.34332
3606,709790058,3-18-24 11:28,723.15,Deposit,Cash Deposit,14131.49332
3607,709790058,3-18-24 16:28,879.04,OutgoingTransfer,Wire Transfer,13252.45332
3608,709790058,3-20-24 9:28,554.41,Deposit,Mobile Deposit,13806.86332
3609,709790058,3-22-24 10:28,357.01,Withdrawal,Branch Withdrawal,13449.85332
3610,709790058,3-22-24 22:28,582.53,OnlineShopping,Amazon,12867.32332
3611,709790058,3-26-24 23:28,267.1,Purchase,Grocery,12600.22332
3612,709790058,3-27-24 11:28,297.36,OutgoingTransfer,Wire Transfer,12302.86332
3613,709790058,3-29-24 18:28,824.59,Return,Etsy Return,13127.45332
3614,709790058,04-01-24 21:28,13200,IncomingTransfer,Salary,26327.45332
3615,709790058,04-04-24 9:28,274.18,OnlineShopping,eBay,26053.27332
3616,709790058,04-04-24 20:28,654.16,OutgoingTransfer,Peer-to-Peer Transfer,25399.11332
3617,709790058,04-04-24 21:28,853.71,Return,Target Return,26252.82332
3618,709790058,04-06-24 19:28,367.65,Purchase,Electronics,25885.17332
3619,709790058,04-06-24 21:28,2000,Payment,Credit Card Payment,23885.17332
3620,709790058,04-08-24 12:28,546.44,OutgoingTransfer,International Transfer,23338.73332
3621,709790058,04-09-24 13:28,364.48,Return,Etsy Return,23703.21332
3622,709790058,04-09-24 20:28,609.35,Purchase,Entertainment,23093.86332
3623,709790058,04-10-24 13:28,406.5,Deposit,Cash Deposit,23500.36332
3624,709790058,4-15-24 21:28,3400,Payment,Subscription Payment,20100.36332
3625,709790058,4-19-24 19:28,314.69,Deposit,Direct Deposit,20415.05332
3626,709790058,4-22-24 12:28,274.58,Purchase,Grocery,20140.47332
3627,709790058,4-22-24 18:28,604.72,Return,Amazon Return,20745.19332
3628,709790058,4-23-24 18:28,255.29,Purchase,Grocery,20489.90332
3629,709790058,4-26-24 13:28,527.37,OutgoingTransfer,Wire Transfer,19962.53332
3630,709790058,4-26-24 15:28,660.97,Purchase,Electronics,19301.56332
3631,709790058,4-27-24 17:28,684.85,Deposit,Mobile Deposit,19986.41332
3632,709790058,4-28-24 18:28,292.05,Deposit,Check Deposit,20278.46332
3633,709790058,05-04-24 14:28,920.79,OnlineShopping,Walmart,19357.67332
3634,709790058,05-04-24 21:28,13200,IncomingTransfer,Salary,32557.67332
3635,709790058,05-08-24 11:28,348.81,Withdrawal,Branch Withdrawal,32208.86332
3636,709790058,05-09-24 21:28,2200,Payment,Credit Card Payment,30008.86332
3637,709790058,5-13-24 16:28,574.8,Deposit,Direct Deposit,30583.66332
3638,709790058,5-14-24 14:28,862.78,Return,AliExpress Return,31446.44332
3639,709790058,5-16-24 9:28,462.9,OutgoingTransfer,Wire Transfer,30983.54332
3640,709790058,5-17-24 21:28,3700,Payment,Subscription Payment,27283.54332
3641,709790058,5-18-24 22:28,422.88,OnlineShopping,eBay,26860.66332
3642,709790058,5-24-24 20:28,217.49,Purchase,Home Improvement,26643.17332
3643,709790058,5-25-24 14:28,830.9,OnlineShopping,eBay,25812.27332
3644,709790058,5-27-24 21:28,592.78,Deposit,Direct Deposit,26405.05332
3645,709790058,5-29-24 11:28,264.82,Withdrawal,Mobile App Withdrawal,26140.23332
3646,709790058,06-02-24 13:28,322.23,Deposit,Direct Deposit,26462.46332
3647,709790058,06-02-24 22:28,242.87,Purchase,Restaurant,26219.59332
3648,709790058,06-04-24 21:28,13200,IncomingTransfer,Salary,39419.59332
3649,709790058,06-05-24 10:28,377.32,Purchase,Clothing,39042.27332
3650,709790058,06-05-24 16:28,757.35,OnlineShopping,eBay,38284.92332
3651,709790058,06-09-24 11:28,389.17,Deposit,Check Deposit,38674.09332
3652,709790058,06-09-24 21:28,2200,Payment,Credit Card Payment,36474.09332
3653,709790058,6-15-24 18:28,931.75,OnlineShopping,Etsy,35542.34332
3654,709790058,6-17-24 11:28,254,Return,Amazon Return,35796.34332
3655,709790058,6-17-24 21:28,5700,Payment,Subscription Payment,30096.34332
3656,709790058,6-18-24 19:28,823.64,Return,eBay Return,30919.98332
3657,709790058,6-18-24 22:28,608.68,Return,AliExpress Return,31528.66332
3658,709790058,6-19-24 17:28,377.69,OnlineShopping,Walmart,31150.97332
3659,709790058,6-21-24 23:28,578.07,Withdrawal,Mobile App Withdrawal,30572.90332
3660,709790058,6-21-24 23:28,366.51,Withdrawal,Branch Withdrawal,30206.39332
3661,709790058,6-24-24 20:28,789.86,Purchase,Restaurant,29416.53332
3662,709790058,6-28-24 10:28,683.1,Purchase,Pharmacy,28733.43332
3663,709790058,07-01-24 9:28,301.98,Return,Amazon Return,29035.41332
3664,709790058,07-01-24 10:28,846.76,Return,eBay Return,29882.17332
3665,709790058,07-01-24 20:28,936.76,Withdrawal,Mobile App Withdrawal,28945.41332
3666,709790058,07-02-24 10:28,713.1,OutgoingTransfer,Bank Transfer,28232.31332
3667,709790058,07-03-24 10:28,623.1,Withdrawal,Mobile App Withdrawal,27609.21332
3668,709790058,07-04-24 21:28,13200,IncomingTransfer,Salary,40809.21332
3669,709790058,07-09-24 12:28,455.62,Deposit,Mobile Deposit,41264.83332
3670,709790058,07-09-24 17:28,889.94,OutgoingTransfer,Bank Transfer,40374.89332
3671,709790058,07-09-24 21:28,1500,Payment,Credit Card Payment,38874.89332
3672,709790058,07-12-24 21:28,3800,Payment,Insurance Payment,35074.89332
3673,709790058,7-14-24 13:28,327.01,Deposit,Direct Deposit,35401.90332
3674,709790058,7-15-24 15:28,218.02,Purchase,Pharmacy,35183.88332
3675,709790058,7-17-24 15:28,785,IncomingTransfer,Freelance Payment,35968.88332
3676,709814883,1-24-24 11:28,222.21,Return,AliExpress Return,1805.780327
3677,709814883,1-27-24 16:28,238.84,Purchase,Grocery,1566.940327
3678,709814883,1-29-24 11:28,72,Purchase,Furniture,1494.940327
3679,709814883,1-30-24 21:28,110.83,Deposit,Check Deposit,1605.770327
3680,709814883,02-01-24 21:28,2000,IncomingTransfer,Salary,3605.770327
3681,709814883,02-02-24 17:28,74.3,Purchase,Entertainment,3531.470327
3682,709814883,02-03-24 16:28,175.35,IncomingTransfer,Freelance Payment,3706.820327
3683,709814883,02-04-24 14:28,128.4,Purchase,Gas,3578.420327
3684,709814883,02-05-24 16:28,28.62,Payment,Mortgage Payment,3549.800327
3685,709814883,02-05-24 18:28,84.3,Deposit,Cash Deposit,3634.100327
3686,709814883,02-05-24 23:28,98.76,Purchase,Gas,3535.340327
3687,709814883,02-06-24 21:28,3300,Payment,Credit Card Payment,235.3403268
3688,709814883,02-07-24 23:28,210.68,OutgoingTransfer,International Transfer,24.66032681
3689,709814883,02-07-24 23:28,44.23,OnlineShopping,eBay,-19.56967319
3690,709814883,02-08-24 18:28,84.33,Deposit,Direct Deposit,64.76032681
3691,709814883,02-08-24 23:28,147.13,Return,AliExpress Return,211.8903268
3692,709814883,02-10-24 14:28,12.59,Return,Etsy Return,224.4803268
3693,709814883,02-11-24 15:28,49.6,IncomingTransfer,Freelance Payment,274.0803268
3694,709814883,2-14-24 21:28,1200,Payment,Rent Payment,-925.9196732
3695,709814883,2-16-24 21:28,37.74,Return,Target Return,-888.1796732
3696,709814883,2-17-24 18:28,222.84,Return,Target Return,-665.3396732
3697,709814883,2-20-24 12:28,113.66,Purchase,Furniture,-778.9996732
3698,709814883,2-21-24 23:28,127.34,IncomingTransfer,Freelance Payment,-651.6596732
3699,709814883,2-22-24 15:28,241.26,Withdrawal,Branch Withdrawal,-892.9196732
3700,709814883,2-24-24 13:28,18.36,OutgoingTransfer,International Transfer,-911.2796732
3701,709814883,2-24-24 20:28,44.8,Withdrawal,Mobile App Withdrawal,-956.0796732
3702,709814883,2-25-24 13:28,218.74,Withdrawal,Mobile App Withdrawal,-1174.819673
3703,709814883,2-26-24 17:28,218.1,Purchase,Restaurant,-1392.919673
3704,709814883,03-05-24 21:28,2000,IncomingTransfer,Salary,607.0803268
3705,709814883,03-06-24 20:28,128.91,Withdrawal,Branch Withdrawal,478.1703268
3706,709814883,03-06-24 23:28,49.61,IncomingTransfer,Freelance Payment,527.7803268
3707,709814883,03-08-24 12:28,84.31,Return,Store Return,612.0903268
3708,709814883,03-09-24 20:28,156.4,Deposit,Check Deposit,768.4903268
3709,709814883,03-10-24 12:28,100.95,OutgoingTransfer,Bank Transfer,667.5403268
3710,709814883,03-10-24 16:28,38.52,Deposit,Direct Deposit,706.0603268
3711,709814883,03-10-24 17:28,71.51,Purchase,Gas,634.5503268
3712,709814883,03-10-24 21:28,3400,Payment,Credit Card Payment,-2765.449673
3713,709814883,03-11-24 14:28,95.87,Deposit,Direct Deposit,-2669.579673
3714,709814883,03-11-24 21:28,900,Payment,Rent Payment,-3569.579673
3715,709814883,03-12-24 13:28,75.51,Deposit,Mobile Deposit,-3494.069673
3716,709814883,3-13-24 9:28,64.32,Purchase,Grocery,-3558.389673
3717,709814883,3-15-24 11:28,87.68,Payment,Loan Payment,-3646.069673
3718,709814883,3-15-24 19:28,248.21,Payment,Bill Payment,-3894.279673
3719,709814883,3-16-24 21:28,217.82,Payment,Loan Payment,-4112.099673
3720,709814883,3-18-24 17:28,64.58,OnlineShopping,eBay,-4176.679673
3721,709814883,3-19-24 10:28,172.42,Purchase,Furniture,-4349.099673
3722,709814883,3-19-24 15:28,247.99,Payment,Bill Payment,-4597.089673
3723,709814883,3-19-24 16:28,136.75,Payment,Loan Payment,-4733.839673
3724,709814883,3-19-24 20:28,113.98,OnlineShopping,Target,-4847.819673
3725,709814883,3-20-24 16:28,115.69,Deposit,Check Deposit,-4732.129673
3726,709814883,3-23-24 14:28,193.09,Purchase,Gas,-4925.219673
3727,709814883,3-23-24 16:28,166.49,Deposit,Direct Deposit,-4758.729673
3728,709814883,3-24-24 21:28,23.04,Payment,Loan Payment,-4781.769673
3729,709814883,3-27-24 15:28,89.32,Deposit,Check Deposit,-4692.449673
3730,709814883,04-01-24 9:28,35.13,Purchase,Electronics,-4727.579673
3731,709814883,04-01-24 13:28,28.88,Purchase,Restaurant,-4756.459673
3732,709814883,04-02-24 15:28,236.62,OutgoingTransfer,International Transfer,-4993.079673
3733,709814883,04-02-24 15:28,117.78,Payment,Mortgage Payment,-5110.859673
3734,709814883,04-03-24 21:28,2000,IncomingTransfer,Salary,-3110.859673
3735,709814883,04-04-24 15:28,110.42,Return,Amazon Return,-3000.439673
3736,709814883,04-05-24 13:28,119.5,Purchase,Restaurant,-3119.939673
3737,709814883,04-06-24 20:28,221.19,Deposit,Check Deposit,-2898.749673
3738,709814883,04-07-24 11:28,74.49,Payment,Loan Payment,-2973.239673
3739,709814883,04-07-24 17:28,83.31,Purchase,Grocery,-3056.549673
3740,709814883,04-07-24 18:28,225.3,Payment,Loan Payment,-3281.849673
3741,709814883,04-08-24 16:28,244.53,Purchase,Restaurant,-3526.379673
3742,709814883,04-08-24 21:28,3300,Payment,Credit Card Payment,-6826.379673
3743,709814883,04-10-24 14:28,98.94,OutgoingTransfer,Wire Transfer,-6925.319673
3744,709814883,04-11-24 21:28,1100,Payment,Rent Payment,-8025.319673
3745,709814883,4-15-24 15:28,25.2,Purchase,Clothing,-8050.519673
3746,709814883,4-16-24 23:28,71.86,Purchase,Home Improvement,-8122.379673
3747,709814883,4-18-24 13:28,144.85,Deposit,Mobile Deposit,-7977.529673
3748,709814883,4-19-24 10:28,245.35,Deposit,Cash Deposit,-7732.179673
3749,709814883,4-19-24 13:28,235.08,IncomingTransfer,Freelance Payment,-7497.099673
3750,709814883,4-19-24 22:28,246.82,Withdrawal,Mobile App Withdrawal,-7743.919673
3751,709814883,4-23-24 22:28,104.81,Withdrawal,Mobile App Withdrawal,-7848.729673
3752,709814883,4-24-24 13:28,167.03,Payment,Bill Payment,-8015.759673
3753,709814883,4-25-24 17:28,26.54,OutgoingTransfer,International Transfer,-8042.299673
3754,709814883,4-26-24 23:28,86.63,Purchase,Pharmacy,-8128.929673
3755,709814883,4-27-24 11:28,156.22,Withdrawal,Branch Withdrawal,-8285.149673
3756,709814883,4-28-24 10:28,34,Purchase,Furniture,-8319.149673
3757,709814883,05-01-24 19:28,56.07,Purchase,Restaurant,-8375.219673
3758,709814883,05-03-24 14:28,132.11,Withdrawal,Mobile App Withdrawal,-8507.329673
3759,709814883,05-03-24 21:28,2000,IncomingTransfer,Salary,-6507.329673
3760,709814883,05-04-24 13:28,56.76,Withdrawal,Branch Withdrawal,-6564.089673
3761,709814883,05-08-24 10:28,147.03,OutgoingTransfer,International Transfer,-6711.119673
3762,709814883,05-08-24 21:28,2300,Payment,Credit Card Payment,-9011.119673
3763,709814883,05-09-24 9:28,175.83,Deposit,Mobile Deposit,-8835.289673
3764,709814883,05-09-24 16:28,56.77,Return,AliExpress Return,-8778.519673
3765,709814883,05-12-24 12:28,147.55,Return,Best Buy Return,-8630.969673
3766,709814883,05-12-24 14:28,98.93,Deposit,Direct Deposit,-8532.039673
3767,709814883,5-14-24 21:28,700,Payment,Rent Payment,-9232.039673
3768,709814883,5-14-24 23:28,232.77,Withdrawal,Mobile App Withdrawal,-9464.809673
3769,709814883,5-15-24 20:28,131.19,Purchase,Travel,-9595.999673
3770,709814883,5-16-24 22:28,143.68,OnlineShopping,Etsy,-9739.679673
3771,709814883,5-18-24 15:28,91.83,Deposit,Direct Deposit,-9647.849673
3772,709814883,5-18-24 22:28,143.54,Withdrawal,Mobile App Withdrawal,-9791.389673
3773,709814883,5-20-24 18:28,235.04,Deposit,Cash Deposit,-9556.349673
3774,709814883,5-21-24 18:28,94.99,Purchase,Entertainment,-9651.339673
3775,709814883,5-21-24 23:28,29.84,Withdrawal,Branch Withdrawal,-9681.179673
3776,709814883,5-22-24 19:28,179.4,Payment,Loan Payment,-9860.579673
3777,709814883,5-23-24 9:28,246.05,Purchase,Electronics,-10106.62967
3778,709814883,5-28-24 9:28,247.8,Deposit,Check Deposit,-9858.829673
3779,709814883,5-30-24 10:28,174.06,Deposit,Check Deposit,-9684.769673
3780,709814883,5-30-24 22:28,17.34,OnlineShopping,eBay,-9702.109673
3781,709814883,5-31-24 12:28,149.72,Withdrawal,Branch Withdrawal,-9851.829673
3782,709814883,06-01-24 21:28,94.14,Return,Store Return,-9757.689673
3783,709814883,06-02-24 13:28,101.52,Payment,Mortgage Payment,-9859.209673
3784,709814883,06-02-24 21:28,2000,IncomingTransfer,Salary,-7859.209673
3785,709814883,06-06-24 9:28,247.38,Purchase,Travel,-8106.589673
3786,709814883,06-07-24 21:28,3000,Payment,Credit Card Payment,-11106.58967
3787,709814883,06-10-24 16:28,157.38,Payment,Bill Payment,-11263.96967
3788,709814883,06-10-24 17:28,195.36,Deposit,Mobile Deposit,-11068.60967
3789,709814883,6-15-24 21:28,600,Payment,Rent Payment,-11668.60967
3790,709814883,6-16-24 19:28,232.5,Deposit,Cash Deposit,-11436.10967
3791,709814883,6-17-24 18:28,135.82,Withdrawal,Mobile App Withdrawal,-11571.92967
3792,709814883,6-19-24 15:28,179.86,OnlineShopping,Etsy,-11751.78967
3793,709814883,6-20-24 14:28,230.89,IncomingTransfer,Freelance Payment,-11520.89967
3794,709814883,6-20-24 21:28,240.6,Deposit,Direct Deposit,-11280.29967
3795,709814883,6-21-24 11:28,88.61,IncomingTransfer,Freelance Payment,-11191.68967
3796,709814883,6-24-24 21:28,126.54,Deposit,Direct Deposit,-11065.14967
3797,709814883,6-25-24 9:28,129,Return,AliExpress Return,-10936.14967
3798,709814883,6-25-24 14:28,160.13,OnlineShopping,AliExpress,-11096.27967
3799,709814883,6-25-24 19:28,64.65,Deposit,Cash Deposit,-11031.62967
3800,709814883,6-27-24 17:28,117.27,Purchase,Grocery,-11148.89967
3801,709814883,6-28-24 22:28,72.21,Payment,Loan Payment,-11221.10967
3802,709814883,6-29-24 22:28,105.63,OutgoingTransfer,Bank Transfer,-11326.73967
3803,709814883,6-30-24 17:28,83.06,Purchase,Gas,-11409.79967
3804,709814883,6-30-24 22:28,174.3,Deposit,Check Deposit,-11235.49967
3805,709814883,07-02-24 21:28,2000,IncomingTransfer,Salary,-9235.499673
3806,709814883,07-03-24 9:28,21.37,IncomingTransfer,Freelance Payment,-9214.129673
3807,709814883,07-03-24 18:28,212.3,IncomingTransfer,Freelance Payment,-9001.829673
3808,709814883,07-05-24 18:28,90.29,Deposit,Cash Deposit,-8911.539673
3809,709814883,07-06-24 11:28,110.08,Purchase,Grocery,-9021.619673
3810,709814883,07-07-24 21:28,3000,Payment,Credit Card Payment,-12021.61967
3811,709814883,07-09-24 15:28,53.01,Withdrawal,ATM Withdrawal,-12074.62967
3812,709814883,07-10-24 18:28,126.54,OutgoingTransfer,Peer-to-Peer Transfer,-12201.16967
3813,709814883,07-10-24 23:28,216.05,Deposit,Mobile Deposit,-11985.11967
3814,709814883,07-11-24 15:28,73.8,Deposit,Cash Deposit,-11911.31967
3815,709814883,07-12-24 11:28,210.5,OutgoingTransfer,Peer-to-Peer Transfer,-12121.81967
3816,709814883,07-12-24 16:28,13.36,Withdrawal,Mobile App Withdrawal,-12135.17967
3817,709814883,07-12-24 21:28,107.89,Deposit,Check Deposit,-12027.28967
3818,709814883,7-14-24 16:28,50.46,Return,Store Return,-11976.82967
3819,709814883,7-15-24 21:28,600,Payment,Rent Payment,-12576.82967
3820,709814883,7-17-24 19:28,170.79,Return,Best Buy Return,-12406.03967
3821,709831983,1-20-24 20:28,523.18,OutgoingTransfer,Peer-to-Peer Transfer,232.6775579
3822,709831983,1-21-24 11:28,479.28,OnlineShopping,AliExpress,-246.6024421
3823,709831983,1-21-24 16:28,213.08,OutgoingTransfer,Peer-to-Peer Transfer,-459.6824421
3824,709831983,1-21-24 18:28,946.05,Deposit,Cash Deposit,486.3675579
3825,709831983,1-22-24 12:28,921.09,OutgoingTransfer,International Transfer,-434.7224421
3826,709831983,1-23-24 18:28,583.64,Purchase,Travel,-1018.362442
3827,709831983,1-24-24 20:28,560.77,Payment,Bill Payment,-1579.132442
3828,709831983,1-30-24 22:28,481.15,Withdrawal,ATM Withdrawal,-2060.282442
3829,709831983,02-02-24 14:28,861.86,IncomingTransfer,Freelance Payment,-1198.422442
3830,709831983,02-05-24 12:28,943.87,Deposit,Direct Deposit,-254.5524421
3831,709831983,02-05-24 21:28,15800,IncomingTransfer,Salary,15545.44756
3832,709831983,02-08-24 12:28,283.26,Deposit,Cash Deposit,15828.70756
3833,709831983,02-08-24 23:28,832.18,Withdrawal,ATM Withdrawal,14996.52756
3834,709831983,02-09-24 10:28,618.29,OutgoingTransfer,Peer-to-Peer Transfer,14378.23756
3835,709831983,02-10-24 19:28,603.67,Withdrawal,Mobile App Withdrawal,13774.56756
3836,709831983,02-10-24 21:28,1400,Payment,Credit Card Payment,12374.56756
3837,709831983,2-14-24 19:28,777.73,Return,Etsy Return,13152.29756
3838,709831983,2-18-24 21:28,5500,Payment,Rent Payment,7652.297558
3839,709831983,2-19-24 12:28,395.65,Return,Store Return,8047.947558
3840,709831983,2-19-24 18:28,728.18,Withdrawal,Mobile App Withdrawal,7319.767558
3841,709831983,2-20-24 15:28,442.51,OutgoingTransfer,Peer-to-Peer Transfer,6877.257558
3842,709831983,2-20-24 17:28,677.36,Purchase,Electronics,6199.897558
3843,709831983,2-22-24 19:28,397.51,Withdrawal,ATM Withdrawal,5802.387558
3844,709831983,2-22-24 19:28,702.24,Return,Target Return,6504.627558
3845,709831983,2-22-24 22:28,906.25,OutgoingTransfer,Peer-to-Peer Transfer,5598.377558
3846,709831983,2-23-24 21:28,723.08,Withdrawal,ATM Withdrawal,4875.297558
3847,709831983,2-26-24 19:28,491.56,OutgoingTransfer,Wire Transfer,4383.737558
3848,709831983,2-28-24 10:28,528.17,OnlineShopping,AliExpress,3855.567558
3849,709831983,2-28-24 21:28,540.84,Withdrawal,Branch Withdrawal,3314.727558
3850,709831983,2-29-24 13:28,337.89,Purchase,Pharmacy,2976.837558
3851,709831983,2-29-24 21:28,501.61,Withdrawal,Branch Withdrawal,2475.227558
3852,709831983,03-01-24 9:28,292.46,Purchase,Restaurant,2182.767558
3853,709831983,03-02-24 14:28,241.49,Purchase,Travel,1941.277558
3854,709831983,03-02-24 21:28,15800,IncomingTransfer,Salary,17741.27756
3855,709831983,03-07-24 21:28,1700,Payment,Credit Card Payment,16041.27756
3856,709831983,03-09-24 14:28,879.82,Return,AliExpress Return,16921.09756
3857,709831983,03-11-24 14:28,311.32,Purchase,Entertainment,16609.77756
3858,709831983,03-12-24 15:28,576.69,Payment,Bill Payment,16033.08756
3859,709831983,03-12-24 18:28,325.97,OnlineShopping,Walmart,15707.11756
3860,709831983,3-13-24 12:28,333.46,Deposit,Direct Deposit,16040.57756
3861,709831983,3-14-24 10:28,607.3,Purchase,Home Improvement,15433.27756
3862,709831983,3-15-24 23:28,863.36,Purchase,Clothing,14569.91756
3863,709831983,3-16-24 19:28,837.13,Withdrawal,Branch Withdrawal,13732.78756
3864,709831983,3-16-24 21:28,612.94,Purchase,Furniture,13119.84756
3865,709831983,3-17-24 11:28,816.07,Return,Target Return,13935.91756
3866,709831983,3-17-24 15:28,735.26,OutgoingTransfer,Peer-to-Peer Transfer,13200.65756
3867,709831983,3-18-24 17:28,761.45,IncomingTransfer,Freelance Payment,13962.10756
3868,709831983,3-18-24 21:28,7500,Payment,Rent Payment,6462.107558
3869,709831983,3-20-24 18:28,687.57,IncomingTransfer,Freelance Payment,7149.677558
3870,709831983,3-21-24 12:28,520.31,OutgoingTransfer,Peer-to-Peer Transfer,6629.367558
3871,709831983,3-23-24 22:28,629.94,OutgoingTransfer,Peer-to-Peer Transfer,5999.427558
3872,709831983,3-24-24 18:28,547.23,Purchase,Pharmacy,5452.197558
3873,709831983,3-29-24 13:28,788.38,OnlineShopping,Best Buy,4663.817558
3874,709831983,3-30-24 21:28,891.63,Purchase,Restaurant,3772.187558
3875,709831983,3-31-24 13:28,389.55,Purchase,Electronics,3382.637558
3876,709831983,04-01-24 22:28,323.06,Deposit,Check Deposit,3705.697558
3877,709831983,04-01-24 23:28,429.57,Purchase,Travel,3276.127558
3878,709831983,04-02-24 11:28,220.46,Deposit,Cash Deposit,3496.587558
3879,709831983,04-02-24 21:28,15800,IncomingTransfer,Salary,19296.58756
3880,709831983,04-06-24 21:28,882.21,OnlineShopping,Amazon,18414.37756
3881,709831983,04-07-24 21:28,1400,Payment,Credit Card Payment,17014.37756
3882,709831983,04-09-24 13:28,495.27,Purchase,Grocery,16519.10756
3883,709831983,04-10-24 18:28,914.57,OutgoingTransfer,International Transfer,15604.53756
3884,709831983,04-12-24 21:28,9700,Payment,Rent Payment,5904.537558
3885,709831983,4-13-24 19:28,736.7,Purchase,Clothing,5167.837558
3886,709831983,4-14-24 17:28,699.72,Purchase,Clothing,4468.117558
3887,709831983,4-15-24 15:28,295.3,Payment,Bill Payment,4172.817558
3888,709831983,4-16-24 17:28,237.31,Return,Best Buy Return,4410.127558
3889,709831983,4-17-24 20:28,291.63,Withdrawal,Branch Withdrawal,4118.497558
3890,709831983,4-18-24 11:28,312.28,Purchase,Travel,3806.217558
3891,709831983,4-19-24 19:28,835.51,Withdrawal,Branch Withdrawal,2970.707558
3892,709831983,4-20-24 21:28,698.06,Deposit,Cash Deposit,3668.767558
3893,709831983,4-25-24 10:28,571.21,Deposit,Mobile Deposit,4239.977558
3894,709831983,4-25-24 23:28,772.88,Purchase,Grocery,3467.097558
3895,709831983,4-26-24 10:28,463.13,Return,Target Return,3930.227558
3896,709831983,4-26-24 22:28,716.8,Purchase,Travel,3213.427558
3897,709831983,4-26-24 22:28,443.99,OnlineShopping,Target,2769.437558
3898,709831983,4-27-24 14:28,301.26,Withdrawal,Mobile App Withdrawal,2468.177558
3899,709831983,4-27-24 19:28,431.51,Purchase,Entertainment,2036.667558
3900,709831983,4-29-24 12:28,468.07,Purchase,Entertainment,1568.597558
3901,709831983,05-03-24 23:28,875.17,Return,AliExpress Return,2443.767558
3902,709831983,05-04-24 21:28,15800,IncomingTransfer,Salary,18243.76756
3903,709831983,05-09-24 21:28,1800,Payment,Credit Card Payment,16443.76756
3904,709831983,05-10-24 10:28,566.4,Withdrawal,Mobile App Withdrawal,15877.36756
3905,709831983,05-11-24 17:28,203.25,Purchase,Electronics,15674.11756
3906,709831983,05-12-24 15:28,375.67,Return,Best Buy Return,16049.78756
3907,709831983,5-13-24 19:28,828.85,OutgoingTransfer,Bank Transfer,15220.93756
3908,709831983,5-14-24 14:28,696.58,Withdrawal,Branch Withdrawal,14524.35756
3909,709831983,5-14-24 20:28,890.22,Deposit,Cash Deposit,15414.57756
3910,709831983,5-16-24 19:28,901.44,Deposit,Direct Deposit,16316.01756
3911,709831983,5-17-24 20:28,338.78,Payment,Mortgage Payment,15977.23756
3912,709831983,5-18-24 11:28,901.81,Withdrawal,Mobile App Withdrawal,15075.42756
3913,709831983,5-18-24 14:28,642.3,Purchase,Electronics,14433.12756
3914,709831983,5-18-24 20:28,682.49,Return,AliExpress Return,15115.61756
3915,709831983,5-18-24 21:28,6300,Payment,Rent Payment,8815.617558
3916,709831983,5-19-24 22:28,485.61,Deposit,Mobile Deposit,9301.227558
3917,709831983,5-21-24 21:28,797.38,Payment,Mortgage Payment,8503.847558
3918,709831983,5-22-24 22:28,489.33,Return,Etsy Return,8993.177558
3919,709831983,5-23-24 10:28,856.26,Payment,Bill Payment,8136.917558
3920,709831983,5-24-24 21:28,702.44,OnlineShopping,eBay,7434.477558
3921,709831983,5-25-24 10:28,896.36,Deposit,Check Deposit,8330.837558
3922,709831983,5-29-24 14:28,231.72,Purchase,Restaurant,8099.117558
3923,709831983,5-30-24 19:28,715.89,Withdrawal,Mobile App Withdrawal,7383.227558
3924,709831983,5-31-24 9:28,602.7,OnlineShopping,Best Buy,6780.527558
3925,709831983,06-01-24 14:28,402.86,Return,Best Buy Return,7183.387558
3926,709831983,06-04-24 10:28,459.24,IncomingTransfer,Freelance Payment,7642.627558
3927,709831983,06-04-24 21:28,15800,IncomingTransfer,Salary,23442.62756
3928,709831983,06-04-24 22:28,580.91,Payment,Mortgage Payment,22861.71756
3929,709831983,06-05-24 14:28,704.27,Payment,Mortgage Payment,22157.44756
3930,709831983,06-06-24 17:28,523.21,Purchase,Furniture,21634.23756
3931,709831983,06-07-24 11:28,219.45,IncomingTransfer,Freelance Payment,21853.68756
3932,709831983,06-09-24 21:28,1700,Payment,Credit Card Payment,20153.68756
3933,709831983,06-11-24 10:28,425.96,Purchase,Entertainment,19727.72756
3934,709831983,06-11-24 19:28,396.56,Return,Walmart Return,20124.28756
3935,709831983,6-13-24 18:28,259.62,Return,Store Return,20383.90756
3936,709831983,6-14-24 16:28,605.53,Purchase,Furniture,19778.37756
3937,709831983,6-16-24 21:28,5900,Payment,Rent Payment,13878.37756
3938,709831983,6-19-24 11:28,206.32,IncomingTransfer,Freelance Payment,14084.69756
3939,709831983,6-22-24 16:28,621.92,Purchase,Grocery,13462.77756
3940,709831983,6-25-24 10:28,848.95,Withdrawal,Branch Withdrawal,12613.82756
3941,709831983,6-25-24 10:28,486.12,OnlineShopping,Walmart,12127.70756
3942,709831983,6-25-24 17:28,343.46,Withdrawal,Branch Withdrawal,11784.24756
3943,709831983,6-25-24 23:28,633.21,IncomingTransfer,Freelance Payment,12417.45756
3944,709831983,6-26-24 14:28,244.98,Withdrawal,ATM Withdrawal,12172.47756
3945,709831983,6-26-24 15:28,549.43,OnlineShopping,Amazon,11623.04756
3946,709831983,6-26-24 23:28,414.75,Withdrawal,Branch Withdrawal,11208.29756
3947,709831983,6-27-24 21:28,896.81,IncomingTransfer,Freelance Payment,12105.10756
3948,709831983,6-28-24 11:28,737.61,Deposit,Cash Deposit,12842.71756
3949,709831983,6-28-24 17:28,350.74,Withdrawal,ATM Withdrawal,12491.97756
3950,709831983,6-28-24 18:28,484.24,Return,Etsy Return,12976.21756
3951,709831983,6-28-24 21:28,858.74,IncomingTransfer,Freelance Payment,13834.95756
3952,709831983,07-02-24 14:28,559.45,Purchase,Travel,13275.50756
3953,709831983,07-04-24 21:28,15800,IncomingTransfer,Salary,29075.50756
3954,709831983,07-06-24 21:28,555.56,Return,Etsy Return,29631.06756
3955,709831983,07-08-24 9:28,692.48,Purchase,Furniture,28938.58756
3956,709831983,07-09-24 11:28,305.09,Return,Amazon Return,29243.67756
3957,709831983,07-09-24 21:28,1400,Payment,Credit Card Payment,27843.67756
3958,709831983,07-10-24 21:28,303.98,OutgoingTransfer,International Transfer,27539.69756
3959,709831983,07-11-24 12:28,931.4,Withdrawal,Mobile App Withdrawal,26608.29756
3960,709831983,07-12-24 16:28,792.36,OnlineShopping,Target,25815.93756
3961,709831983,7-13-24 10:28,930.62,OutgoingTransfer,Peer-to-Peer Transfer,24885.31756
3962,709831983,7-13-24 21:28,4700,Payment,Rent Payment,20185.31756
3963,709831983,7-14-24 20:28,373.51,Withdrawal,Branch Withdrawal,19811.80756
3964,709831983,7-15-24 13:28,319.67,Withdrawal,Mobile App Withdrawal,19492.13756
3965,709957158,1-23-24 23:28,21.3,Return,Target Return,1723.37034
3966,709957158,02-03-24 15:28,90.05,Purchase,Entertainment,1633.32034
3967,709957158,02-05-24 21:28,4150,IncomingTransfer,Salary,5783.32034
3968,709957158,02-08-24 10:28,389.35,Purchase,Furniture,5393.97034
3969,709957158,02-10-24 18:28,76.54,Withdrawal,Branch Withdrawal,5317.43034
3970,709957158,02-10-24 21:28,2500,Payment,Credit Card Payment,2817.43034
3971,709957158,2-13-24 21:28,1500,Payment,Subscription Payment,1317.43034
3972,709957158,2-14-24 15:28,349.15,Deposit,Mobile Deposit,1666.58034
3973,709957158,2-15-24 21:28,366.82,Payment,Mortgage Payment,1299.76034
3974,709957158,2-20-24 10:28,86.01,Deposit,Cash Deposit,1385.77034
3975,709957158,2-21-24 16:28,30.71,OutgoingTransfer,Peer-to-Peer Transfer,1355.06034
3976,709957158,2-27-24 22:28,347.7,Withdrawal,Mobile App Withdrawal,1007.36034
3977,709957158,2-29-24 22:28,95.32,Withdrawal,Mobile App Withdrawal,912.0403403
3978,709957158,03-01-24 19:28,33.02,Withdrawal,Mobile App Withdrawal,879.0203403
3979,709957158,03-03-24 21:28,4150,IncomingTransfer,Salary,5029.02034
3980,709957158,03-04-24 13:28,115.93,Deposit,Check Deposit,5144.95034
3981,709957158,03-08-24 21:28,3100,Payment,Credit Card Payment,2044.95034
3982,709957158,3-13-24 21:28,1800,Payment,Subscription Payment,244.9503403
3983,709957158,3-15-24 17:28,206.36,Withdrawal,ATM Withdrawal,38.59034026
3984,709957158,3-17-24 17:28,201.61,Return,Store Return,240.2003403
3985,709957158,3-18-24 22:28,128.91,IncomingTransfer,Freelance Payment,369.1103403
3986,709957158,3-19-24 21:28,101.44,Purchase,Electronics,267.6703403
3987,709957158,3-24-24 21:28,184.76,OnlineShopping,Amazon,82.91034026
3988,709957158,3-25-24 9:28,129.05,Withdrawal,Mobile App Withdrawal,-46.13965974
3989,709957158,04-01-24 20:28,233.04,Deposit,Mobile Deposit,186.9003403
3990,709957158,04-04-24 11:28,144.03,Payment,Loan Payment,42.87034026
3991,709957158,04-05-24 21:28,4150,IncomingTransfer,Salary,4192.87034
3992,709957158,04-10-24 21:28,2800,Payment,Credit Card Payment,1392.87034
3993,709957158,04-11-24 19:28,267.88,Return,Etsy Return,1660.75034
3994,709957158,04-11-24 21:28,1400,Payment,Installment Payment,260.7503403
3995,709957158,04-12-24 19:28,135.5,OutgoingTransfer,Wire Transfer,125.2503403
3996,709957158,4-19-24 18:28,350.9,Deposit,Cash Deposit,476.1503403
3997,709957158,4-21-24 13:28,223.56,Purchase,Gas,252.5903403
3998,709957158,05-02-24 21:28,4150,IncomingTransfer,Salary,4402.59034
3999,709957158,05-07-24 11:28,75.26,Return,Target Return,4477.85034
4000,709957158,05-07-24 21:28,2900,Payment,Credit Card Payment,1577.85034
4001,709957158,5-13-24 17:28,243.32,OnlineShopping,Best Buy,1334.53034
4002,709957158,5-14-24 21:28,1300,Payment,Installment Payment,34.53034026
4003,709957158,5-17-24 20:28,92.32,Deposit,Cash Deposit,126.8503403
4004,709957158,5-20-24 13:28,180.79,Deposit,Cash Deposit,307.6403403
4005,709957158,5-22-24 10:28,219.27,Deposit,Direct Deposit,526.9103403
4006,709957158,5-23-24 23:28,267.23,Deposit,Check Deposit,794.1403403
4007,709957158,5-24-24 16:28,59,Purchase,Electronics,735.1403403
4008,709957158,5-24-24 22:28,287.54,Purchase,Furniture,447.6003403
4009,709957158,5-25-24 11:28,93.31,OnlineShopping,Amazon,354.2903403
4010,709957158,5-25-24 18:28,178.21,Payment,Bill Payment,176.0803403
4011,709957158,5-27-24 12:28,37.17,IncomingTransfer,Freelance Payment,213.2503403
4012,709957158,5-27-24 18:28,190.55,Return,Amazon Return,403.8003403
4013,709957158,5-29-24 23:28,199.51,OnlineShopping,AliExpress,204.2903403
4014,709957158,5-30-24 20:28,235.72,Withdrawal,Mobile App Withdrawal,-31.42965974
4015,709957158,5-30-24 23:28,117.98,Payment,Mortgage Payment,-149.4096597
4016,709957158,06-01-24 19:28,160.32,Deposit,Direct Deposit,10.91034026
4017,709957158,06-01-24 21:28,4150,IncomingTransfer,Salary,4160.91034
4018,709957158,06-04-24 9:28,208.85,Purchase,Grocery,3952.06034
4019,709957158,06-06-24 21:28,2600,Payment,Credit Card Payment,1352.06034
4020,709957158,06-10-24 19:28,154.43,Withdrawal,Mobile App Withdrawal,1197.63034
4021,709957158,06-11-24 15:28,26.91,Return,Etsy Return,1224.54034
4022,709957158,06-11-24 21:28,35.37,OnlineShopping,AliExpress,1189.17034
4023,709957158,06-12-24 18:28,354.48,OnlineShopping,Etsy,834.6903403
4024,709957158,6-13-24 13:28,244.24,Purchase,Furniture,590.4503403
4025,709957158,6-14-24 12:28,184.86,OnlineShopping,Amazon,405.5903403
4026,709957158,6-14-24 21:28,1800,Payment,Installment Payment,-1394.40966
4027,709957158,6-19-24 9:28,192.88,Deposit,Mobile Deposit,-1201.52966
4028,709957158,6-19-24 16:28,299.59,OutgoingTransfer,Wire Transfer,-1501.11966
4029,709957158,6-20-24 12:28,135.51,Purchase,Electronics,-1636.62966
4030,709957158,6-23-24 21:28,135.28,OutgoingTransfer,Wire Transfer,-1771.90966
4031,709957158,6-23-24 21:28,120.19,Withdrawal,Branch Withdrawal,-1892.09966
4032,709957158,6-24-24 11:28,84.81,Purchase,Grocery,-1976.90966
4033,709957158,6-26-24 12:28,133.57,Deposit,Cash Deposit,-1843.33966
4034,709957158,6-28-24 13:28,25.45,Deposit,Direct Deposit,-1817.88966
4035,709957158,07-01-24 23:28,336.8,IncomingTransfer,Freelance Payment,-1481.08966
4036,709957158,07-02-24 14:28,360.28,Withdrawal,Mobile App Withdrawal,-1841.36966
4037,709957158,07-02-24 16:28,380.63,Return,Best Buy Return,-1460.73966
4038,709957158,07-02-24 23:28,45.1,OnlineShopping,Target,-1505.83966
4039,709957158,07-03-24 21:28,4150,IncomingTransfer,Salary,2644.16034
4040,709957158,07-08-24 10:28,169.2,Deposit,Mobile Deposit,2813.36034
4041,709957158,07-08-24 21:28,3300,Payment,Credit Card Payment,-486.6396597
4042,709957158,07-08-24 23:28,103.68,Purchase,Home Improvement,-590.3196597
4043,709957158,07-09-24 12:28,268.71,Purchase,Clothing,-859.0296597
4044,709957158,07-09-24 16:28,176.75,Withdrawal,Branch Withdrawal,-1035.77966
4045,709957158,07-12-24 21:28,1400,Payment,Insurance Payment,-2435.77966
4046,709957158,7-15-24 9:28,262.84,OnlineShopping,Etsy,-2698.61966
4047,709957158,7-17-24 11:28,40.98,Deposit,Cash Deposit,-2657.63966
4048,709986633,1-24-24 14:28,349.64,Return,Best Buy Return,349.64
4049,709986633,1-25-24 11:28,52.9,Purchase,Home Improvement,296.74
4050,709986633,02-04-24 15:28,393.94,Purchase,Travel,-97.2
4051,709986633,02-04-24 21:28,4800,IncomingTransfer,Salary,4702.8
4052,709986633,2-14-24 21:28,2900,Payment,Rent Payment,1802.8
4053,709986633,2-20-24 14:28,246.75,OnlineShopping,eBay,1556.05
4054,709986633,2-23-24 14:28,373.6,OutgoingTransfer,International Transfer,1182.45
4055,709986633,2-29-24 18:28,43.93,Deposit,Direct Deposit,1226.38
4056,709986633,03-03-24 17:28,181.3,Deposit,Direct Deposit,1407.68
4057,709986633,03-05-24 21:28,4800,IncomingTransfer,Salary,6207.68
4058,709986633,03-08-24 15:28,312.79,Purchase,Gas,5894.89
4059,709986633,3-13-24 21:28,2300,Payment,Rent Payment,3594.89
4060,709986633,3-14-24 16:28,32.8,Payment,Mortgage Payment,3562.09
4061,709986633,3-19-24 10:28,262.33,Purchase,Home Improvement,3299.76
4062,709986633,3-24-24 18:28,275.65,IncomingTransfer,Freelance Payment,3575.41
4063,709986633,3-27-24 10:28,344.45,Withdrawal,Mobile App Withdrawal,3230.96
4064,709986633,3-27-24 15:28,341.99,IncomingTransfer,Freelance Payment,3572.95
4065,709986633,04-02-24 21:28,4800,IncomingTransfer,Salary,8372.95
4066,709986633,04-04-24 21:28,264.75,Deposit,Check Deposit,8637.7
4067,709986633,4-14-24 22:28,298.75,Payment,Bill Payment,8338.95
4068,709986633,4-15-24 17:28,59.18,OnlineShopping,Walmart,8279.77
4069,709986633,4-15-24 21:28,1400,Payment,Rent Payment,6879.77
4070,709986633,4-25-24 18:28,150.36,Deposit,Check Deposit,7030.13
4071,709986633,05-02-24 21:28,4800,IncomingTransfer,Salary,11830.13
4072,709986633,05-04-24 19:28,373.33,OutgoingTransfer,Peer-to-Peer Transfer,11456.8
4073,709986633,05-07-24 17:28,185.04,Purchase,Furniture,11271.76
4074,709986633,05-08-24 13:28,29.77,Purchase,Furniture,11241.99
4075,709986633,05-11-24 14:28,66.99,IncomingTransfer,Freelance Payment,11308.98
4076,709986633,05-12-24 22:28,164.14,Withdrawal,ATM Withdrawal,11144.84
4077,709986633,5-14-24 21:28,2300,Payment,Rent Payment,8844.84
4078,709986633,5-15-24 11:28,206.76,Purchase,Pharmacy,8638.08
4079,709986633,5-20-24 17:28,42.82,Purchase,Home Improvement,8595.26
4080,709986633,5-24-24 22:28,381.67,Deposit,Direct Deposit,8976.93
4081,709986633,5-25-24 16:28,102.4,Deposit,Direct Deposit,9079.33
4082,709986633,5-28-24 14:28,364.19,Withdrawal,Branch Withdrawal,8715.14
4083,709986633,5-31-24 10:28,312.13,Withdrawal,Branch Withdrawal,8403.01
4084,709986633,06-02-24 14:28,284.31,Return,Best Buy Return,8687.32
4085,709986633,06-03-24 18:28,39.27,Purchase,Pharmacy,8648.05
4086,709986633,06-05-24 21:28,4800,IncomingTransfer,Salary,13448.05
4087,709986633,06-07-24 14:28,62.89,Deposit,Cash Deposit,13510.94
4088,709986633,6-13-24 17:28,27.28,Purchase,Pharmacy,13483.66
4089,709986633,6-14-24 13:28,178,OutgoingTransfer,Wire Transfer,13305.66
4090,709986633,6-16-24 17:28,197.39,OnlineShopping,Etsy,13108.27
4091,709986633,6-16-24 18:28,60.84,IncomingTransfer,Freelance Payment,13169.11
4092,709986633,6-16-24 21:28,2300,Payment,Rent Payment,10869.11
4093,709986633,6-17-24 14:28,244.97,OnlineShopping,Amazon,10624.14
4094,709986633,6-17-24 18:28,372.69,Deposit,Mobile Deposit,10996.83
4095,709986633,6-20-24 12:28,393.99,Purchase,Grocery,10602.84
4096,709986633,6-24-24 19:28,367.22,OutgoingTransfer,International Transfer,10235.62
4097,709986633,07-04-24 21:28,4800,IncomingTransfer,Salary,15035.62
4098,709986633,07-06-24 15:28,190.78,Payment,Mortgage Payment,14844.84
4099,709986633,7-17-24 15:28,391.49,Payment,Loan Payment,14453.35
4100,709986633,7-18-24 21:28,1400,Payment,Rent Payment,13053.35
4101,710014683,1-27-24 15:28,116.21,OnlineShopping,Etsy,410.7410502
4102,710014683,1-27-24 16:28,240.34,Deposit,Mobile Deposit,651.0810502
4103,710014683,02-02-24 21:28,2600,IncomingTransfer,Salary,3251.08105
4104,710014683,02-07-24 21:28,800,Payment,Credit Card Payment,2451.08105
4105,710014683,02-09-24 15:28,181.11,Withdrawal,ATM Withdrawal,2269.97105
4106,710014683,02-12-24 13:28,68.73,Return,AliExpress Return,2338.70105
4107,710014683,2-14-24 10:28,212.12,Deposit,Mobile Deposit,2550.82105
4108,710014683,2-16-24 21:28,1300,Payment,Rent Payment,1250.82105
4109,710014683,2-24-24 12:28,219.45,Purchase,Furniture,1031.37105
4110,710014683,2-28-24 20:28,197.66,Return,Walmart Return,1229.03105
4111,710014683,03-02-24 21:28,2600,IncomingTransfer,Salary,3829.03105
4112,710014683,03-05-24 10:28,173.94,OutgoingTransfer,International Transfer,3655.09105
4113,710014683,03-05-24 14:28,215.87,Deposit,Check Deposit,3870.96105
4114,710014683,03-07-24 21:28,800,Payment,Credit Card Payment,3070.96105
4115,710014683,03-08-24 22:28,227.83,Purchase,Grocery,2843.13105
4116,710014683,03-10-24 21:28,1400,Payment,Rent Payment,1443.13105
4117,710014683,3-13-24 22:28,37.36,Withdrawal,Mobile App Withdrawal,1405.77105
4118,710014683,3-17-24 17:28,56.29,OutgoingTransfer,Bank Transfer,1349.48105
4119,710014683,3-18-24 16:28,211.83,Deposit,Mobile Deposit,1561.31105
4120,710014683,3-19-24 16:28,100.99,Return,Etsy Return,1662.30105
4121,710014683,3-25-24 17:28,81.85,OnlineShopping,Best Buy,1580.45105
4122,710014683,3-28-24 12:28,52.17,Deposit,Cash Deposit,1632.62105
4123,710014683,3-30-24 11:28,65.78,OutgoingTransfer,Peer-to-Peer Transfer,1566.84105
4124,710014683,3-31-24 13:28,203.27,Withdrawal,Branch Withdrawal,1363.57105
4125,710014683,04-01-24 23:28,48.73,Payment,Bill Payment,1314.84105
4126,710014683,04-02-24 21:28,2600,IncomingTransfer,Salary,3914.84105
4127,710014683,04-03-24 18:28,94.32,Deposit,Check Deposit,4009.16105
4128,710014683,04-05-24 19:28,172.41,Purchase,Home Improvement,3836.75105
4129,710014683,04-07-24 21:28,900,Payment,Credit Card Payment,2936.75105
4130,710014683,04-09-24 9:28,222.46,Purchase,Clothing,2714.29105
4131,710014683,04-09-24 14:28,169.36,Purchase,Grocery,2544.93105
4132,710014683,04-10-24 19:28,152.17,Purchase,Grocery,2392.76105
4133,710014683,04-10-24 21:28,154.71,OutgoingTransfer,Bank Transfer,2238.05105
4134,710014683,04-11-24 21:28,1100,Payment,Rent Payment,1138.05105
4135,710014683,4-13-24 11:28,156.46,Deposit,Check Deposit,1294.51105
4136,710014683,4-14-24 10:28,70.7,Deposit,Mobile Deposit,1365.21105
4137,710014683,4-16-24 15:28,129.81,Purchase,Entertainment,1235.40105
4138,710014683,4-16-24 18:28,198.68,Deposit,Direct Deposit,1434.08105
4139,710014683,4-17-24 13:28,128.22,Withdrawal,ATM Withdrawal,1305.86105
4140,710014683,4-18-24 14:28,86.25,Deposit,Mobile Deposit,1392.11105
4141,710014683,4-25-24 14:28,98.14,Payment,Bill Payment,1293.97105
4142,710014683,4-27-24 22:28,186.7,Purchase,Pharmacy,1107.27105
4143,710014683,4-29-24 15:28,122.9,Return,Etsy Return,1230.17105
4144,710014683,05-01-24 10:28,234.81,Payment,Loan Payment,995.3610502
4145,710014683,05-02-24 9:28,100.67,OutgoingTransfer,International Transfer,894.6910502
4146,710014683,05-02-24 21:28,2600,IncomingTransfer,Salary,3494.69105
4147,710014683,05-04-24 14:28,71.66,Deposit,Direct Deposit,3566.35105
4148,710014683,05-05-24 10:28,212.04,Deposit,Direct Deposit,3778.39105
4149,710014683,05-05-24 13:28,156.12,OnlineShopping,Best Buy,3622.27105
4150,710014683,05-07-24 9:28,122.1,OnlineShopping,Walmart,3500.17105
4151,710014683,05-07-24 21:28,1100,Payment,Credit Card Payment,2400.17105
4152,710014683,05-10-24 17:28,132.89,Purchase,Travel,2267.28105
4153,710014683,5-15-24 21:28,800,Payment,Rent Payment,1467.28105
4154,710014683,5-19-24 10:28,79.48,Payment,Bill Payment,1387.80105
4155,710014683,5-19-24 14:28,130.98,OutgoingTransfer,International Transfer,1256.82105
4156,710014683,5-28-24 17:28,137.18,OnlineShopping,Best Buy,1119.64105
4157,710014683,06-01-24 12:28,144.16,OutgoingTransfer,International Transfer,975.4810502
4158,710014683,06-02-24 11:28,245.9,Withdrawal,ATM Withdrawal,729.5810502
4159,710014683,06-02-24 14:28,122.57,Payment,Mortgage Payment,607.0110502
4160,710014683,06-03-24 12:28,185.27,Purchase,Travel,421.7410502
4161,710014683,06-03-24 21:28,2600,IncomingTransfer,Salary,3021.74105
4162,710014683,06-08-24 18:28,199.64,OutgoingTransfer,Bank Transfer,2822.10105
4163,710014683,06-08-24 21:28,1100,Payment,Credit Card Payment,1722.10105
4164,710014683,06-09-24 19:28,25.62,Payment,Mortgage Payment,1696.48105
4165,710014683,06-09-24 20:28,51.26,Purchase,Gas,1645.22105
4166,710014683,06-10-24 9:28,41.36,Deposit,Mobile Deposit,1686.58105
4167,710014683,06-10-24 21:28,1300,Payment,Rent Payment,386.5810502
4168,710014683,6-13-24 22:28,230.07,Payment,Loan Payment,156.5110502
4169,710014683,6-15-24 13:28,44.73,Withdrawal,Mobile App Withdrawal,111.7810502
4170,710014683,6-20-24 22:28,47.34,OutgoingTransfer,Peer-to-Peer Transfer,64.44105019
4171,710014683,6-21-24 13:28,34.89,Return,Target Return,99.33105019
4172,710014683,6-21-24 23:28,187.43,Deposit,Direct Deposit,286.7610502
4173,710014683,6-22-24 12:28,126.25,OutgoingTransfer,Bank Transfer,160.5110502
4174,710014683,6-28-24 23:28,153.08,Return,AliExpress Return,313.5910502
4175,710014683,07-04-24 11:28,44.71,OnlineShopping,Amazon,268.8810502
4176,710014683,07-04-24 21:28,2600,IncomingTransfer,Salary,2868.88105
4177,710014683,07-05-24 17:28,139.24,IncomingTransfer,Freelance Payment,3008.12105
4178,710014683,07-08-24 12:28,21.3,Purchase,Entertainment,2986.82105
4179,710014683,07-09-24 17:28,149.53,Return,Target Return,3136.35105
4180,710014683,07-09-24 21:28,900,Payment,Credit Card Payment,2236.35105
4181,710014683,07-11-24 13:28,35.57,Purchase,Gas,2200.78105
4182,710014683,07-11-24 14:28,168.56,Withdrawal,Mobile App Withdrawal,2032.22105
4183,710014683,7-15-24 21:28,1600,Payment,Rent Payment,432.2210502
4184,710027508,1-29-24 13:28,257.13,Withdrawal,Mobile App Withdrawal,359.7081768
4185,710027508,02-02-24 22:28,492.3,Return,Walmart Return,852.0081768
4186,710027508,02-03-24 21:28,5450,IncomingTransfer,Salary,6302.008177
4187,710027508,02-08-24 21:28,1500,Payment,Credit Card Payment,4802.008177
4188,710027508,2-17-24 21:28,3200,Payment,Rent Payment,1602.008177
4189,710027508,2-29-24 10:28,158.39,Purchase,Grocery,1443.618177
4190,710027508,03-01-24 21:28,5450,IncomingTransfer,Salary,6893.618177
4191,710027508,03-01-24 23:28,354.6,Deposit,Check Deposit,7248.218177
4192,710027508,03-06-24 21:28,1400,Payment,Credit Card Payment,5848.218177
4193,710027508,03-08-24 13:28,219.52,Payment,Loan Payment,5628.698177
4194,710027508,03-08-24 16:28,473.48,OutgoingTransfer,International Transfer,5155.218177
4195,710027508,3-14-24 10:28,505.39,Deposit,Mobile Deposit,5660.608177
4196,710027508,3-14-24 21:28,2000,Payment,Rent Payment,3660.608177
4197,710027508,3-19-24 22:28,453.34,Deposit,Check Deposit,4113.948177
4198,710027508,3-22-24 19:28,285.51,Deposit,Check Deposit,4399.458177
4199,710027508,04-03-24 12:28,129.73,Withdrawal,Mobile App Withdrawal,4269.728177
4200,710027508,04-03-24 21:28,5450,IncomingTransfer,Salary,9719.728177
4201,710027508,04-08-24 21:28,1100,Payment,Credit Card Payment,8619.728177
4202,710027508,4-13-24 21:28,2700,Payment,Rent Payment,5919.728177
4203,710027508,4-24-24 21:28,302.99,Payment,Mortgage Payment,5616.738177
4204,710027508,05-02-24 21:28,5450,IncomingTransfer,Salary,11066.73818
4205,710027508,05-07-24 21:28,1100,Payment,Credit Card Payment,9966.738177
4206,710027508,05-08-24 20:28,415.89,Deposit,Cash Deposit,10382.62818
4207,710027508,05-09-24 16:28,97.17,Withdrawal,ATM Withdrawal,10285.45818
4208,710027508,05-11-24 21:28,2500,Payment,Rent Payment,7785.458177
4209,710027508,5-16-24 14:28,530.38,Purchase,Furniture,7255.078177
4210,710027508,5-16-24 15:28,198.37,OutgoingTransfer,Wire Transfer,7056.708177
4211,710027508,5-17-24 22:28,474.42,Return,eBay Return,7531.128177
4212,710027508,5-18-24 10:28,397.16,Deposit,Check Deposit,7928.288177
4213,710027508,5-25-24 13:28,367.55,Purchase,Electronics,7560.738177
4214,710027508,5-25-24 17:28,56.3,Return,AliExpress Return,7617.038177
4215,710027508,5-29-24 12:28,104.8,Withdrawal,ATM Withdrawal,7512.238177
4216,710027508,5-31-24 23:28,111.49,Return,Store Return,7623.728177
4217,710027508,06-03-24 21:28,5450,IncomingTransfer,Salary,13073.72818
4218,710027508,06-08-24 21:28,1100,Payment,Credit Card Payment,11973.72818
4219,710027508,06-11-24 23:28,262.49,Deposit,Cash Deposit,12236.21818
4220,710027508,06-12-24 9:28,269.35,Purchase,Home Improvement,11966.86818
4221,710027508,6-14-24 21:28,2900,Payment,Rent Payment,9066.868177
4222,710027508,6-14-24 23:28,156.75,Withdrawal,Branch Withdrawal,8910.118177
4223,710027508,6-15-24 16:28,471.73,Withdrawal,Branch Withdrawal,8438.388177
4224,710027508,6-18-24 12:28,113.82,Deposit,Check Deposit,8552.208177
4225,710027508,6-18-24 13:28,386.45,Deposit,Cash Deposit,8938.658177
4226,710027508,6-28-24 20:28,188.77,Purchase,Grocery,8749.888177
4227,710027508,07-02-24 17:28,403.76,Deposit,Cash Deposit,9153.648177
4228,710027508,07-02-24 21:28,5450,IncomingTransfer,Salary,14603.64818
4229,710027508,07-03-24 13:28,389.39,Return,AliExpress Return,14993.03818
4230,710027508,07-06-24 17:28,464.35,Purchase,Entertainment,14528.68818
4231,710027508,07-07-24 21:28,1500,Payment,Credit Card Payment,13028.68818
4232,710027508,07-10-24 21:28,1800,Payment,Rent Payment,11228.68818
4233,710027508,07-11-24 9:28,198.39,OnlineShopping,Etsy,11030.29818
4234,710027508,7-13-24 10:28,342.47,Payment,Mortgage Payment,10687.82818
4235,710032608,1-20-24 18:28,136.53,Return,AliExpress Return,1736.765315
4236,710032608,02-01-24 15:28,193.32,Purchase,Home Improvement,1543.445315
4237,710032608,02-03-24 12:28,200.2,Deposit,Cash Deposit,1743.645315
4238,710032608,02-04-24 16:28,121.35,Payment,Loan Payment,1622.295315
4239,710032608,02-04-24 21:28,3200,IncomingTransfer,Salary,4822.295315
4240,710032608,02-09-24 21:28,2700,Payment,Credit Card Payment,2122.295315
4241,710032608,02-11-24 13:28,134.73,Payment,Mortgage Payment,1987.565315
4242,710032608,02-11-24 21:28,1400,Payment,Insurance Payment,587.5653149
4243,710032608,03-01-24 21:28,3200,IncomingTransfer,Salary,3787.565315
4244,710032608,03-03-24 15:28,238.25,OutgoingTransfer,Peer-to-Peer Transfer,3549.315315
4245,710032608,03-06-24 19:28,206.81,Deposit,Cash Deposit,3756.125315
4246,710032608,03-06-24 21:28,2800,Payment,Credit Card Payment,956.1253149
4247,710032608,03-07-24 12:28,238.81,Return,Store Return,1194.935315
4248,710032608,03-08-24 15:28,179.88,OnlineShopping,Target,1015.055315
4249,710032608,03-08-24 17:28,240.87,Purchase,Restaurant,774.1853149
4250,710032608,3-13-24 9:28,76.45,IncomingTransfer,Freelance Payment,850.6353149
4251,710032608,3-15-24 21:28,1400,Payment,Installment Payment,-549.3646851
4252,710032608,3-17-24 14:28,39.42,OutgoingTransfer,International Transfer,-588.7846851
4253,710032608,04-03-24 23:28,13.06,Deposit,Direct Deposit,-575.7246851
4254,710032608,04-04-24 21:28,3200,IncomingTransfer,Salary,2624.275315
4255,710032608,04-05-24 21:28,92.99,Deposit,Mobile Deposit,2717.265315
4256,710032608,04-05-24 22:28,75.12,OutgoingTransfer,Wire Transfer,2642.145315
4257,710032608,04-08-24 14:28,43.23,Deposit,Cash Deposit,2685.375315
4258,710032608,04-09-24 21:28,3100,Payment,Credit Card Payment,-414.6246851
4259,710032608,4-14-24 19:28,229.34,OutgoingTransfer,Bank Transfer,-643.9646851
4260,710032608,4-14-24 22:28,53.54,Purchase,Home Improvement,-697.5046851
4261,710032608,4-15-24 21:28,1400,Payment,Installment Payment,-2097.504685
4262,710032608,4-24-24 11:28,56.26,Purchase,Grocery,-2153.764685
4263,710032608,4-27-24 11:28,20.86,Withdrawal,Mobile App Withdrawal,-2174.624685
4264,710032608,05-01-24 21:28,3200,IncomingTransfer,Salary,1025.375315
4265,710032608,05-03-24 14:28,238.37,Payment,Loan Payment,787.0053149
4266,710032608,05-03-24 15:28,222.15,Deposit,Check Deposit,1009.155315
4267,710032608,05-05-24 15:28,195.35,Purchase,Restaurant,813.8053149
4268,710032608,05-06-24 21:28,3000,Payment,Credit Card Payment,-2186.194685
4269,710032608,05-09-24 12:28,71.68,Purchase,Gas,-2257.874685
4270,710032608,05-11-24 22:28,47.95,Deposit,Direct Deposit,-2209.924685
4271,710032608,05-12-24 13:28,188.99,IncomingTransfer,Freelance Payment,-2020.934685
4272,710032608,5-16-24 21:28,1000,Payment,Insurance Payment,-3020.934685
4273,710032608,5-20-24 17:28,58.62,Withdrawal,ATM Withdrawal,-3079.554685
4274,710032608,5-21-24 12:28,21.76,Deposit,Check Deposit,-3057.794685
4275,710032608,5-22-24 11:28,245.65,Withdrawal,Mobile App Withdrawal,-3303.444685
4276,710032608,5-23-24 19:28,109.46,Payment,Loan Payment,-3412.904685
4277,710032608,5-24-24 18:28,76.09,Payment,Bill Payment,-3488.994685
4278,710032608,06-02-24 21:28,3200,IncomingTransfer,Salary,-288.9946851
4279,710032608,06-05-24 22:28,141.19,Withdrawal,Branch Withdrawal,-430.1846851
4280,710032608,06-07-24 21:28,3400,Payment,Credit Card Payment,-3830.184685
4281,710032608,06-08-24 13:28,28.72,Payment,Loan Payment,-3858.904685
4282,710032608,06-11-24 21:28,1400,Payment,Subscription Payment,-5258.904685
4283,710032608,06-12-24 9:28,78.23,Withdrawal,Mobile App Withdrawal,-5337.134685
4284,710032608,06-12-24 12:28,82.19,OutgoingTransfer,Bank Transfer,-5419.324685
4285,710032608,06-12-24 13:28,148.25,Purchase,Furniture,-5567.574685
4286,710032608,6-15-24 17:28,46.61,OnlineShopping,eBay,-5614.184685
4287,710032608,6-18-24 23:28,58.03,Payment,Bill Payment,-5672.214685
4288,710032608,6-19-24 9:28,142.33,Payment,Bill Payment,-5814.544685
4289,710032608,6-21-24 17:28,234.47,IncomingTransfer,Freelance Payment,-5580.074685
4290,710032608,6-24-24 9:28,165.02,Deposit,Check Deposit,-5415.054685
4291,710032608,6-26-24 17:28,41.56,Payment,Mortgage Payment,-5456.614685
4292,710032608,6-29-24 18:28,141.87,Withdrawal,ATM Withdrawal,-5598.484685
4293,710032608,07-01-24 21:28,3200,IncomingTransfer,Salary,-2398.484685
4294,710032608,07-05-24 22:28,76.41,Withdrawal,Mobile App Withdrawal,-2474.894685
4295,710032608,07-06-24 16:28,244.44,Deposit,Check Deposit,-2230.454685
4296,710032608,07-06-24 21:28,2400,Payment,Credit Card Payment,-4630.454685
4297,710032608,7-13-24 21:28,1200,Payment,Insurance Payment,-5830.454685
4298,710032608,7-16-24 11:28,121.13,Deposit,Cash Deposit,-5709.324685
4299,710045058,1-24-24 11:28,365.85,OutgoingTransfer,Peer-to-Peer Transfer,984.3224559
4300,710045058,1-25-24 22:28,318.34,Payment,Mortgage Payment,665.9824559
4301,710045058,1-27-24 15:28,131.41,OutgoingTransfer,Wire Transfer,534.5724559
4302,710045058,1-30-24 10:28,239.92,Payment,Loan Payment,294.6524559
4303,710045058,1-30-24 18:28,277.31,Deposit,Check Deposit,571.9624559
4304,710045058,02-02-24 10:28,301.84,Return,Store Return,873.8024559
4305,710045058,02-02-24 21:28,4950,IncomingTransfer,Salary,5823.802456
4306,710045058,02-05-24 23:28,301.91,OutgoingTransfer,Bank Transfer,5521.892456
4307,710045058,02-07-24 21:28,2800,Payment,Credit Card Payment,2721.892456
4308,710045058,02-10-24 21:28,2100,Payment,Insurance Payment,621.8924559
4309,710045058,02-12-24 13:28,273.23,Return,eBay Return,895.1224559
4310,710045058,2-13-24 21:28,228.88,Deposit,Mobile Deposit,1124.002456
4311,710045058,2-17-24 14:28,48.37,Withdrawal,Branch Withdrawal,1075.632456
4312,710045058,2-22-24 22:28,31.68,Return,Store Return,1107.312456
4313,710045058,03-01-24 21:28,4950,IncomingTransfer,Salary,6057.312456
4314,710045058,03-05-24 14:28,128.17,Purchase,Pharmacy,5929.142456
4315,710045058,03-06-24 21:28,3200,Payment,Credit Card Payment,2729.142456
4316,710045058,3-16-24 12:28,103.62,Deposit,Cash Deposit,2832.762456
4317,710045058,3-16-24 21:28,1800,Payment,Subscription Payment,1032.762456
4318,710045058,3-22-24 16:28,214.28,Withdrawal,Branch Withdrawal,818.4824559
4319,710045058,3-28-24 12:28,134.44,IncomingTransfer,Freelance Payment,952.9224559
4320,710045058,04-01-24 10:28,46.74,OutgoingTransfer,Wire Transfer,906.1824559
4321,710045058,04-04-24 21:28,4950,IncomingTransfer,Salary,5856.182456
4322,710045058,04-05-24 10:28,388.6,Return,AliExpress Return,6244.782456
4323,710045058,04-08-24 14:28,320.99,Deposit,Cash Deposit,6565.772456
4324,710045058,04-09-24 21:28,2300,Payment,Credit Card Payment,4265.772456
4325,710045058,04-11-24 12:28,143.02,Withdrawal,ATM Withdrawal,4122.752456
4326,710045058,4-13-24 21:28,1600,Payment,Subscription Payment,2522.752456
4327,710045058,4-22-24 23:28,232.95,IncomingTransfer,Freelance Payment,2755.702456
4328,710045058,4-22-24 23:28,86.69,Payment,Mortgage Payment,2669.012456
4329,710045058,4-26-24 20:28,287.74,Deposit,Direct Deposit,2956.752456
4330,710045058,4-30-24 18:28,392.05,Deposit,Mobile Deposit,3348.802456
4331,710045058,05-01-24 21:28,4950,IncomingTransfer,Salary,8298.802456
4332,710045058,05-06-24 21:28,2700,Payment,Credit Card Payment,5598.802456
4333,710045058,05-07-24 18:28,235.82,OnlineShopping,eBay,5362.982456
4334,710045058,05-09-24 9:28,328.09,Return,eBay Return,5691.072456
4335,710045058,5-13-24 17:28,188.36,Purchase,Clothing,5502.712456
4336,710045058,5-14-24 21:28,1600,Payment,Insurance Payment,3902.712456
4337,710045058,5-17-24 9:28,296.29,Return,AliExpress Return,4199.002456
4338,710045058,5-27-24 18:28,56.57,OutgoingTransfer,Peer-to-Peer Transfer,4142.432456
4339,710045058,5-31-24 22:28,185.94,OutgoingTransfer,Wire Transfer,3956.492456
4340,710045058,06-01-24 21:28,4950,IncomingTransfer,Salary,8906.492456
4341,710045058,06-03-24 18:28,369.17,OnlineShopping,Amazon,8537.322456
4342,710045058,06-05-24 18:28,55.12,IncomingTransfer,Freelance Payment,8592.442456
4343,710045058,06-05-24 23:28,151.54,Purchase,Furniture,8440.902456
4344,710045058,06-06-24 21:28,2600,Payment,Credit Card Payment,5840.902456
4345,710045058,06-10-24 21:28,2000,Payment,Subscription Payment,3840.902456
4346,710045058,6-13-24 18:28,365.09,Deposit,Check Deposit,4205.992456
4347,710045058,6-21-24 22:28,362.39,Withdrawal,ATM Withdrawal,3843.602456
4348,710045058,6-22-24 11:28,390.65,Return,AliExpress Return,4234.252456
4349,710045058,6-24-24 13:28,343.83,Deposit,Cash Deposit,4578.082456
4350,710045058,6-24-24 22:28,281.09,Deposit,Mobile Deposit,4859.172456
4351,710045058,6-28-24 15:28,176.57,Purchase,Electronics,4682.602456
4352,710045058,07-05-24 21:28,4950,IncomingTransfer,Salary,9632.602456
4353,710045058,07-08-24 14:28,210.33,Purchase,Furniture,9422.272456
4354,710045058,07-10-24 21:28,3000,Payment,Credit Card Payment,6422.272456
4355,710045058,07-10-24 21:28,1500,Payment,Subscription Payment,4922.272456
4356,710045058,07-11-24 16:28,99.12,Purchase,Grocery,4823.152456
4357,710056758,1-21-24 15:28,317.43,OnlineShopping,Amazon,1194.524374
4358,710056758,1-23-24 20:28,31.56,Withdrawal,Branch Withdrawal,1162.964374
4359,710056758,1-23-24 21:28,178.75,Purchase,Grocery,984.2143736
4360,710056758,1-24-24 14:28,132.53,IncomingTransfer,Freelance Payment,1116.744374
4361,710056758,1-26-24 21:28,77.87,Withdrawal,Mobile App Withdrawal,1038.874374
4362,710056758,1-27-24 19:28,109.84,OnlineShopping,Amazon,929.0343736
4363,710056758,1-30-24 20:28,331.47,Deposit,Mobile Deposit,1260.504374
4364,710056758,1-31-24 15:28,362.04,OutgoingTransfer,Wire Transfer,898.4643736
4365,710056758,02-01-24 21:28,4100,IncomingTransfer,Salary,4998.464374
4366,710056758,02-02-24 20:28,210.92,Purchase,Electronics,4787.544374
4367,710056758,02-04-24 21:28,360.32,Withdrawal,Branch Withdrawal,4427.224374
4368,710056758,02-04-24 21:28,291.42,Deposit,Direct Deposit,4718.644374
4369,710056758,02-06-24 21:28,2100,Payment,Credit Card Payment,2618.644374
4370,710056758,02-08-24 12:28,287.84,Withdrawal,Mobile App Withdrawal,2330.804374
4371,710056758,02-09-24 11:28,268.53,Deposit,Cash Deposit,2599.334374
4372,710056758,02-09-24 15:28,391.06,Withdrawal,Branch Withdrawal,2208.274374
4373,710056758,02-09-24 22:28,193.96,IncomingTransfer,Freelance Payment,2402.234374
4374,710056758,02-11-24 11:28,214.6,Return,eBay Return,2616.834374
4375,710056758,02-11-24 19:28,178.14,OutgoingTransfer,Peer-to-Peer Transfer,2438.694374
4376,710056758,02-12-24 9:28,124.07,OnlineShopping,Target,2314.624374
4377,710056758,02-12-24 15:28,117.81,Return,Walmart Return,2432.434374
4378,710056758,2-13-24 11:28,100.53,Withdrawal,Mobile App Withdrawal,2331.904374
4379,710056758,2-13-24 13:28,175.17,Payment,Bill Payment,2156.734374
4380,710056758,2-14-24 17:28,235.22,OutgoingTransfer,Wire Transfer,1921.514374
4381,710056758,2-15-24 11:28,228.26,Withdrawal,ATM Withdrawal,1693.254374
4382,710056758,2-15-24 14:28,89.12,IncomingTransfer,Freelance Payment,1782.374374
4383,710056758,2-15-24 20:28,373.24,Deposit,Direct Deposit,2155.614374
4384,710056758,2-15-24 21:28,1900,Payment,Rent Payment,255.6143736
4385,710056758,2-16-24 14:28,120.65,Deposit,Mobile Deposit,376.2643736
4386,710056758,2-17-24 15:28,351.26,Purchase,Furniture,25.00437357
4387,710056758,2-23-24 19:28,106.67,Purchase,Home Improvement,-81.66562643
4388,710056758,2-26-24 16:28,199.11,Return,eBay Return,117.4443736
4389,710056758,2-26-24 22:28,277.19,OutgoingTransfer,Peer-to-Peer Transfer,-159.7456264
4390,710056758,2-27-24 17:28,107.36,Withdrawal,Branch Withdrawal,-267.1056264
4391,710056758,03-03-24 13:28,183.49,Payment,Mortgage Payment,-450.5956264
4392,710056758,03-03-24 21:28,166.05,OnlineShopping,Etsy,-616.6456264
4393,710056758,03-04-24 17:28,326.25,Payment,Bill Payment,-942.8956264
4394,710056758,03-04-24 21:28,4100,IncomingTransfer,Salary,3157.104374
4395,710056758,03-04-24 23:28,80.81,Deposit,Mobile Deposit,3237.914374
4396,710056758,03-05-24 18:28,356.4,Withdrawal,Mobile App Withdrawal,2881.514374
4397,710056758,03-07-24 22:28,140.61,Purchase,Electronics,2740.904374
4398,710056758,03-09-24 21:28,2500,Payment,Credit Card Payment,240.9043736
4399,710056758,03-10-24 21:28,45.51,Withdrawal,Branch Withdrawal,195.3943736
4400,710056758,03-11-24 20:28,86.3,Payment,Bill Payment,109.0943736
4401,710056758,03-11-24 21:28,1600,Payment,Rent Payment,-1490.905626
4402,710056758,3-16-24 16:28,281.65,Withdrawal,ATM Withdrawal,-1772.555626
4403,710056758,3-19-24 23:28,266.1,Withdrawal,ATM Withdrawal,-2038.655626
4404,710056758,3-21-24 23:28,389.02,IncomingTransfer,Freelance Payment,-1649.635626
4405,710056758,3-22-24 10:28,55.69,Deposit,Mobile Deposit,-1593.945626
4406,710056758,3-23-24 11:28,20.43,Withdrawal,ATM Withdrawal,-1614.375626
4407,710056758,3-24-24 15:28,157.19,IncomingTransfer,Freelance Payment,-1457.185626
4408,710056758,3-25-24 17:28,340.2,Purchase,Pharmacy,-1797.385626
4409,710056758,3-27-24 12:28,304.65,Payment,Loan Payment,-2102.035626
4410,710056758,3-27-24 14:28,60.13,Deposit,Mobile Deposit,-2041.905626
4411,710056758,04-02-24 14:28,167.61,Deposit,Check Deposit,-1874.295626
4412,710056758,04-03-24 9:28,82.64,Deposit,Cash Deposit,-1791.655626
4413,710056758,04-03-24 21:28,4100,IncomingTransfer,Salary,2308.344374
4414,710056758,04-04-24 17:28,374.84,Deposit,Check Deposit,2683.184374
4415,710056758,04-05-24 18:28,387.48,OutgoingTransfer,Wire Transfer,2295.704374
4416,710056758,04-05-24 22:28,40.99,OnlineShopping,eBay,2254.714374
4417,710056758,04-06-24 12:28,243.06,OnlineShopping,Amazon,2011.654374
4418,710056758,04-08-24 21:28,2200,Payment,Credit Card Payment,-188.3456264
4419,710056758,04-12-24 13:28,216.85,IncomingTransfer,Freelance Payment,28.50437357
4420,710056758,4-13-24 21:28,1900,Payment,Rent Payment,-1871.495626
4421,710056758,4-14-24 22:28,110.17,Purchase,Pharmacy,-1981.665626
4422,710056758,4-15-24 19:28,376.49,Payment,Loan Payment,-2358.155626
4423,710056758,4-18-24 10:28,318.76,IncomingTransfer,Freelance Payment,-2039.395626
4424,710056758,4-18-24 18:28,282.59,OutgoingTransfer,Bank Transfer,-2321.985626
4425,710056758,4-18-24 19:28,369.5,OutgoingTransfer,Bank Transfer,-2691.485626
4426,710056758,4-18-24 22:28,196.32,OnlineShopping,eBay,-2887.805626
4427,710056758,4-20-24 12:28,257.48,Return,Amazon Return,-2630.325626
4428,710056758,4-21-24 13:28,352.41,Deposit,Direct Deposit,-2277.915626
4429,710056758,4-25-24 22:28,320.92,Purchase,Restaurant,-2598.835626
4430,710056758,4-25-24 22:28,116.85,OutgoingTransfer,International Transfer,-2715.685626
4431,710056758,4-25-24 23:28,133.16,IncomingTransfer,Freelance Payment,-2582.525626
4432,710056758,4-28-24 14:28,74.59,OnlineShopping,Etsy,-2657.115626
4433,710056758,4-30-24 11:28,89.64,Withdrawal,Branch Withdrawal,-2746.755626
4434,710056758,4-30-24 18:28,63.89,Deposit,Check Deposit,-2682.865626
4435,710056758,4-30-24 19:28,56.05,Deposit,Cash Deposit,-2626.815626
4436,710056758,05-03-24 9:28,107.62,Deposit,Mobile Deposit,-2519.195626
4437,710056758,05-03-24 21:28,4100,IncomingTransfer,Salary,1580.804374
4438,710056758,05-04-24 16:28,292.92,Payment,Bill Payment,1287.884374
4439,710056758,05-07-24 15:28,22.62,Deposit,Mobile Deposit,1310.504374
4440,710056758,05-07-24 16:28,308.37,OutgoingTransfer,Bank Transfer,1002.134374
4441,710056758,05-08-24 21:28,2500,Payment,Credit Card Payment,-1497.865626
4442,710056758,05-08-24 23:28,282.77,Deposit,Check Deposit,-1215.095626
4443,710056758,05-09-24 12:28,23.59,Deposit,Direct Deposit,-1191.505626
4444,710056758,05-10-24 18:28,340.35,Purchase,Gas,-1531.855626
4445,710056758,05-11-24 21:28,1100,Payment,Rent Payment,-2631.855626
4446,710056758,5-14-24 17:28,312.55,Return,Walmart Return,-2319.305626
4447,710056758,5-15-24 11:28,43.45,OnlineShopping,Walmart,-2362.755626
4448,710056758,5-15-24 17:28,48.67,Withdrawal,Branch Withdrawal,-2411.425626
4449,710056758,5-15-24 19:28,387.45,Return,Amazon Return,-2023.975626
4450,710056758,5-16-24 18:28,100.44,Payment,Mortgage Payment,-2124.415626
4451,710056758,5-16-24 22:28,237.08,Deposit,Check Deposit,-1887.335626
4452,710056758,5-19-24 22:28,27.18,Withdrawal,Branch Withdrawal,-1914.515626
4453,710056758,5-21-24 18:28,315.33,Withdrawal,Mobile App Withdrawal,-2229.845626
4454,710056758,5-22-24 9:28,219.26,Return,Amazon Return,-2010.585626
4455,710056758,5-23-24 9:28,311.68,OutgoingTransfer,Wire Transfer,-2322.265626
4456,710056758,5-24-24 9:28,81.42,Purchase,Electronics,-2403.685626
4457,710056758,5-28-24 21:28,26.5,Payment,Loan Payment,-2430.185626
4458,710056758,06-01-24 21:28,4100,IncomingTransfer,Salary,1669.814374
4459,710056758,06-06-24 21:28,2300,Payment,Credit Card Payment,-630.1856264
4460,710056758,06-12-24 11:28,337.02,IncomingTransfer,Freelance Payment,-293.1656264
4461,710056758,06-12-24 21:28,1900,Payment,Rent Payment,-2193.165626
4462,710056758,06-12-24 23:28,308.68,Deposit,Direct Deposit,-1884.485626
4463,710056758,6-14-24 19:28,133.34,Deposit,Direct Deposit,-1751.145626
4464,710056758,6-16-24 19:28,69.53,Withdrawal,Branch Withdrawal,-1820.675626
4465,710056758,6-20-24 22:28,274.59,Deposit,Mobile Deposit,-1546.085626
4466,710056758,6-21-24 15:28,313.88,Payment,Mortgage Payment,-1859.965626
4467,710056758,6-22-24 13:28,31.98,Payment,Mortgage Payment,-1891.945626
4468,710056758,6-22-24 19:28,387.05,Purchase,Clothing,-2278.995626
4469,710056758,6-22-24 19:28,102.08,Payment,Bill Payment,-2381.075626
4470,710056758,6-23-24 19:28,28.59,OutgoingTransfer,Bank Transfer,-2409.665626
4471,710056758,6-26-24 21:28,235.7,Withdrawal,Mobile App Withdrawal,-2645.365626
4472,710056758,6-28-24 12:28,365.86,IncomingTransfer,Freelance Payment,-2279.505626
4473,710056758,6-29-24 21:28,84.52,Purchase,Clothing,-2364.025626
4474,710056758,07-01-24 13:28,275.1,Deposit,Cash Deposit,-2088.925626
4475,710056758,07-01-24 21:28,4100,IncomingTransfer,Salary,2011.074374
4476,710056758,07-03-24 10:28,206.99,Purchase,Restaurant,1804.084374
4477,710056758,07-03-24 12:28,381.48,Withdrawal,Branch Withdrawal,1422.604374
4478,710056758,07-04-24 19:28,235.03,Deposit,Mobile Deposit,1657.634374
4479,710056758,07-04-24 19:28,274.4,Purchase,Clothing,1383.234374
4480,710056758,07-04-24 20:28,165.04,Deposit,Check Deposit,1548.274374
4481,710056758,07-06-24 21:28,2200,Payment,Credit Card Payment,-651.7256264
4482,710056758,07-07-24 17:28,179.12,OnlineShopping,AliExpress,-830.8456264
4483,710056758,07-08-24 17:28,347.03,Return,Walmart Return,-483.8156264
4484,710056758,07-08-24 18:28,206.1,Deposit,Cash Deposit,-277.7156264
4485,710056758,07-09-24 20:28,233.37,Deposit,Cash Deposit,-44.34562643
4486,710056758,07-10-24 18:28,366.87,Purchase,Travel,-411.2156264
4487,710056758,07-10-24 23:28,386.17,Return,Walmart Return,-25.04562643
4488,710056758,7-13-24 22:28,195.63,Purchase,Furniture,-220.6756264
4489,710056758,7-14-24 21:28,2300,Payment,Rent Payment,-2520.675626
4490,710056758,7-16-24 19:28,178.1,Purchase,Travel,-2698.775626
4491,710180958,1-26-24 19:28,292.12,Deposit,Mobile Deposit,2537.069527
4492,710180958,02-01-24 21:28,4000,IncomingTransfer,Salary,6537.069527
4493,710180958,02-06-24 21:28,3200,Payment,Credit Card Payment,3337.069527
4494,710180958,02-09-24 16:28,369.88,Withdrawal,Branch Withdrawal,2967.189527
4495,710180958,2-16-24 21:28,2200,Payment,Rent Payment,767.1895269
4496,710180958,2-23-24 11:28,367.05,OutgoingTransfer,International Transfer,400.1395269
4497,710180958,2-29-24 9:28,381.15,Deposit,Cash Deposit,781.2895269
4498,710180958,03-04-24 21:28,4000,IncomingTransfer,Salary,4781.289527
4499,710180958,03-09-24 21:28,2600,Payment,Credit Card Payment,2181.289527
4500,710180958,03-11-24 17:28,107.15,Deposit,Mobile Deposit,2288.439527
4501,710180958,03-12-24 21:28,1400,Payment,Rent Payment,888.4395269
4502,710180958,3-14-24 22:28,140.65,OnlineShopping,Etsy,747.7895269
4503,710180958,3-22-24 16:28,95.53,Purchase,Travel,652.2595269
4504,710180958,3-29-24 12:28,399.67,Deposit,Direct Deposit,1051.929527
4505,710180958,04-03-24 21:28,4000,IncomingTransfer,Salary,5051.929527
4506,710180958,04-04-24 22:28,365.78,Purchase,Home Improvement,4686.149527
4507,710180958,04-05-24 22:28,24.6,Deposit,Mobile Deposit,4710.749527
4508,710180958,04-06-24 19:28,246.37,Return,AliExpress Return,4957.119527
4509,710180958,04-08-24 14:28,246.67,Payment,Bill Payment,4710.449527
4510,710180958,04-08-24 21:28,3200,Payment,Credit Card Payment,1510.449527
4511,710180958,4-16-24 9:28,331.18,Deposit,Direct Deposit,1841.629527
4512,710180958,4-17-24 21:28,2300,Payment,Rent Payment,-458.3704731
4513,710180958,4-20-24 11:28,241.17,Withdrawal,ATM Withdrawal,-699.5404731
4514,710180958,4-24-24 23:28,330.79,OutgoingTransfer,Peer-to-Peer Transfer,-1030.330473
4515,710180958,4-27-24 19:28,151.8,Deposit,Direct Deposit,-878.5304731
4516,710180958,05-01-24 21:28,4000,IncomingTransfer,Salary,3121.469527
4517,710180958,05-04-24 11:28,98.2,Deposit,Check Deposit,3219.669527
4518,710180958,05-06-24 14:28,226.69,Withdrawal,Mobile App Withdrawal,2992.979527
4519,710180958,05-06-24 21:28,3000,Payment,Credit Card Payment,-7.020473138
4520,710180958,05-09-24 9:28,57.67,OutgoingTransfer,Peer-to-Peer Transfer,-64.69047314
4521,710180958,5-15-24 21:28,1100,Payment,Rent Payment,-1164.690473
4522,710180958,5-15-24 21:28,114.9,Payment,Mortgage Payment,-1279.590473
4523,710180958,5-18-24 14:28,330.66,Deposit,Mobile Deposit,-948.9304731
4524,710180958,5-25-24 17:28,200.54,Deposit,Mobile Deposit,-748.3904731
4525,710180958,5-25-24 17:28,302.08,OnlineShopping,Best Buy,-1050.470473
4526,710180958,06-02-24 12:28,112.91,Purchase,Home Improvement,-1163.380473
4527,710180958,06-03-24 21:28,4000,IncomingTransfer,Salary,2836.619527
4528,710180958,06-08-24 21:28,3200,Payment,Credit Card Payment,-363.3804731
4529,710180958,06-11-24 21:28,1400,Payment,Rent Payment,-1763.380473
4530,710180958,6-16-24 11:28,142.59,OnlineShopping,eBay,-1905.970473
4531,710180958,6-17-24 21:28,142.14,OutgoingTransfer,Bank Transfer,-2048.110473
4532,710180958,6-20-24 12:28,293.14,Purchase,Travel,-2341.250473
4533,710180958,6-21-24 23:28,33.34,Withdrawal,Branch Withdrawal,-2374.590473
4534,710180958,6-28-24 15:28,168.94,Withdrawal,Branch Withdrawal,-2543.530473
4535,710180958,07-04-24 21:28,4000,IncomingTransfer,Salary,1456.469527
4536,710180958,07-06-24 17:28,149.55,Deposit,Check Deposit,1606.019527
4537,710180958,07-09-24 21:28,3100,Payment,Credit Card Payment,-1493.980473
4538,710180958,07-11-24 10:28,304.2,Withdrawal,Branch Withdrawal,-1798.180473
4539,710180958,7-13-24 21:28,1600,Payment,Rent Payment,-3398.180473
4540,710197308,1-20-24 13:28,62.5,Return,AliExpress Return,62.5
4541,710197308,1-25-24 10:28,103.32,Purchase,Furniture,-40.82
4542,710197308,1-26-24 10:28,170.6,OutgoingTransfer,Bank Transfer,-211.42
4543,710197308,1-30-24 16:28,201.04,OnlineShopping,Best Buy,-412.46
4544,710197308,1-31-24 15:28,51.59,Withdrawal,ATM Withdrawal,-464.05
4545,710197308,02-05-24 21:28,1750,IncomingTransfer,Salary,1285.95
4546,710197308,02-08-24 20:28,50.61,Withdrawal,Mobile App Withdrawal,1235.34
4547,710197308,02-10-24 13:28,181.83,Withdrawal,ATM Withdrawal,1053.51
4548,710197308,02-10-24 20:28,242.85,Purchase,Home Improvement,810.66
4549,710197308,02-10-24 21:28,800,Payment,Insurance Payment,10.66
4550,710197308,02-11-24 21:28,27.23,IncomingTransfer,Freelance Payment,37.89
4551,710197308,02-12-24 21:28,88.51,Purchase,Home Improvement,-50.62
4552,710197308,2-14-24 22:28,146.61,Deposit,Direct Deposit,95.99
4553,710197308,2-16-24 9:28,245.48,Payment,Bill Payment,-149.49
4554,710197308,2-17-24 10:28,142.51,Purchase,Furniture,-292
4555,710197308,2-20-24 12:28,15.84,Withdrawal,Branch Withdrawal,-307.84
4556,710197308,2-21-24 15:28,109.06,Payment,Bill Payment,-416.9
4557,710197308,03-02-24 21:28,1750,IncomingTransfer,Salary,1333.1
4558,710197308,03-03-24 11:28,63.57,OutgoingTransfer,Wire Transfer,1269.53
4559,710197308,03-05-24 22:28,87.43,IncomingTransfer,Freelance Payment,1356.96
4560,710197308,03-06-24 20:28,52.45,Return,Store Return,1409.41
4561,710197308,03-06-24 21:28,243.02,Deposit,Cash Deposit,1652.43
4562,710197308,03-11-24 11:28,33.36,Deposit,Direct Deposit,1685.79
4563,710197308,03-12-24 13:28,172.43,Deposit,Cash Deposit,1858.22
4564,710197308,3-14-24 9:28,226.53,Deposit,Mobile Deposit,2084.75
4565,710197308,3-16-24 21:28,600,Payment,Subscription Payment,1484.75
4566,710197308,3-16-24 21:28,125.18,Withdrawal,ATM Withdrawal,1359.57
4567,710197308,3-19-24 15:28,137.72,Purchase,Entertainment,1221.85
4568,710197308,3-20-24 22:28,249.86,Withdrawal,Branch Withdrawal,971.99
4569,710197308,3-25-24 13:28,133.85,Withdrawal,Mobile App Withdrawal,838.14
4570,710197308,3-25-24 21:28,232.63,OnlineShopping,Amazon,605.51
4571,710197308,3-26-24 18:28,216.22,Withdrawal,ATM Withdrawal,389.29
4572,710197308,3-28-24 18:28,246.83,Purchase,Travel,142.46
4573,710197308,3-28-24 19:28,99.35,Purchase,Grocery,43.11
4574,710197308,3-29-24 12:28,143.01,Deposit,Direct Deposit,186.12
4575,710197308,3-29-24 17:28,51.72,Withdrawal,Branch Withdrawal,134.4
4576,710197308,04-01-24 21:28,1750,IncomingTransfer,Salary,1884.4
4577,710197308,04-03-24 22:28,127.64,Deposit,Mobile Deposit,2012.04
4578,710197308,04-08-24 15:28,50.73,OnlineShopping,Amazon,1961.31
4579,710197308,04-09-24 10:28,28.5,Withdrawal,Mobile App Withdrawal,1932.81
4580,710197308,04-09-24 13:28,200.94,Deposit,Cash Deposit,2133.75
4581,710197308,04-09-24 17:28,52.78,Payment,Mortgage Payment,2080.97
4582,710197308,04-11-24 13:28,63.01,Payment,Loan Payment,2017.96
4583,710197308,04-12-24 21:28,500,Payment,Installment Payment,1517.96
4584,710197308,4-16-24 18:28,164.02,Return,AliExpress Return,1681.98
4585,710197308,4-16-24 23:28,226.66,Return,Walmart Return,1908.64
4586,710197308,4-19-24 23:28,18.48,OnlineShopping,Amazon,1890.16
4587,710197308,4-19-24 23:28,180.02,Withdrawal,Mobile App Withdrawal,1710.14
4588,710197308,4-25-24 9:28,136.21,OutgoingTransfer,International Transfer,1573.93
4589,710197308,4-25-24 20:28,114.33,Return,Store Return,1688.26
4590,710197308,4-29-24 17:28,207.62,Deposit,Mobile Deposit,1895.88
4591,710197308,4-30-24 17:28,125.89,Return,Amazon Return,2021.77
4592,710197308,05-01-24 23:28,22.5,Purchase,Gas,1999.27
4593,710197308,05-02-24 20:28,189.14,Purchase,Entertainment,1810.13
4594,710197308,05-04-24 21:28,1750,IncomingTransfer,Salary,3560.13
4595,710197308,05-08-24 9:28,37.36,Payment,Loan Payment,3522.77
4596,710197308,05-08-24 22:28,226.94,Deposit,Cash Deposit,3749.71
4597,710197308,05-10-24 18:28,76.24,Withdrawal,Mobile App Withdrawal,3673.47
4598,710197308,05-12-24 14:28,36.34,OnlineShopping,Best Buy,3637.13
4599,710197308,05-12-24 18:28,23.96,Withdrawal,Mobile App Withdrawal,3613.17
4600,710197308,05-12-24 21:28,700,Payment,Installment Payment,2913.17
4601,710197308,5-20-24 17:28,94.2,Purchase,Clothing,2818.97
4602,710197308,5-23-24 14:28,20.32,Withdrawal,Mobile App Withdrawal,2798.65
4603,710197308,5-26-24 13:28,121.51,Deposit,Mobile Deposit,2920.16
4604,710197308,06-01-24 14:28,164.83,Withdrawal,ATM Withdrawal,2755.33
4605,710197308,06-04-24 21:28,1750,IncomingTransfer,Salary,4505.33
4606,710197308,06-06-24 23:28,30.12,Return,Etsy Return,4535.45
4607,710197308,06-09-24 16:28,215.23,Payment,Bill Payment,4320.22
4608,710197308,06-12-24 21:28,183.14,Deposit,Check Deposit,4503.36
4609,710197308,6-13-24 21:28,500,Payment,Installment Payment,4003.36
4610,710197308,6-17-24 18:28,243.71,Purchase,Travel,3759.65
4611,710197308,6-20-24 12:28,45.58,Withdrawal,Mobile App Withdrawal,3714.07
4612,710197308,6-28-24 9:28,217.71,Withdrawal,Branch Withdrawal,3496.36
4613,710197308,6-28-24 23:28,201.14,OutgoingTransfer,International Transfer,3295.22
4614,710197308,6-29-24 19:28,99.56,IncomingTransfer,Freelance Payment,3394.78
4615,710197308,6-30-24 16:28,121.36,Deposit,Check Deposit,3516.14
4616,710197308,07-02-24 20:28,76.44,Deposit,Mobile Deposit,3592.58
4617,710197308,07-02-24 22:28,115.61,Return,Target Return,3708.19
4618,710197308,07-03-24 21:28,1750,IncomingTransfer,Salary,5458.19
4619,710197308,07-05-24 20:28,244.38,Deposit,Mobile Deposit,5702.57
4620,710197308,07-09-24 16:28,245.87,OutgoingTransfer,Wire Transfer,5456.7
4621,710197308,07-10-24 20:28,50.12,Withdrawal,ATM Withdrawal,5406.58
4622,710197308,07-10-24 21:28,600,Payment,Installment Payment,4806.58
4623,710197308,7-16-24 10:28,232.66,Return,AliExpress Return,5039.24
4624,710197308,7-16-24 20:28,134.38,Purchase,Gas,4904.86
4625,710229333,1-20-24 12:28,368.78,Deposit,Direct Deposit,1212.111418
4626,710229333,1-21-24 11:28,236.45,Purchase,Grocery,975.6614177
4627,710229333,1-22-24 22:28,260.39,Purchase,Entertainment,715.2714177
4628,710229333,1-25-24 22:28,214.42,OnlineShopping,Target,500.8514177
4629,710229333,1-29-24 13:28,283.56,Purchase,Pharmacy,217.2914177
4630,710229333,1-31-24 17:28,355.3,OnlineShopping,Target,-138.0085823
4631,710229333,02-01-24 21:28,3750,IncomingTransfer,Salary,3611.991418
4632,710229333,02-06-24 21:28,1500,Payment,Credit Card Payment,2111.991418
4633,710229333,02-10-24 15:28,183.79,Payment,Loan Payment,1928.201418
4634,710229333,02-10-24 21:28,1100,Payment,Subscription Payment,828.2014177
4635,710229333,02-10-24 22:28,41.58,OutgoingTransfer,International Transfer,786.6214177
4636,710229333,2-13-24 9:28,385.41,Deposit,Mobile Deposit,1172.031418
4637,710229333,2-14-24 22:28,55.05,Deposit,Cash Deposit,1227.081418
4638,710229333,2-18-24 10:28,256.56,Withdrawal,Branch Withdrawal,970.5214177
4639,710229333,2-19-24 16:28,267.1,Deposit,Cash Deposit,1237.621418
4640,710229333,2-22-24 10:28,208.87,Purchase,Gas,1028.751418
4641,710229333,2-24-24 17:28,370.51,Purchase,Home Improvement,658.2414177
4642,710229333,2-25-24 15:28,391.32,OutgoingTransfer,Bank Transfer,266.9214177
4643,710229333,03-04-24 13:28,60.4,Deposit,Cash Deposit,327.3214177
4644,710229333,03-04-24 14:28,310.57,Payment,Mortgage Payment,16.75141774
4645,710229333,03-05-24 21:28,3750,IncomingTransfer,Salary,3766.751418
4646,710229333,03-08-24 12:28,228.06,OutgoingTransfer,Peer-to-Peer Transfer,3538.691418
4647,710229333,03-08-24 14:28,327.23,Purchase,Travel,3211.461418
4648,710229333,03-10-24 12:28,109.51,Deposit,Check Deposit,3320.971418
4649,710229333,03-10-24 21:28,1400,Payment,Credit Card Payment,1920.971418
4650,710229333,03-11-24 11:28,257.53,Payment,Bill Payment,1663.441418
4651,710229333,3-14-24 18:28,379.26,Purchase,Entertainment,1284.181418
4652,710229333,3-16-24 12:28,75.83,Deposit,Mobile Deposit,1360.011418
4653,710229333,3-16-24 21:28,1100,Payment,Subscription Payment,260.0114177
4654,710229333,3-18-24 19:28,80.02,Purchase,Grocery,179.9914177
4655,710229333,3-20-24 9:28,199.83,OutgoingTransfer,Bank Transfer,-19.83858226
4656,710229333,3-27-24 9:28,247.03,OnlineShopping,Etsy,-266.8685823
4657,710229333,3-27-24 15:28,24.99,Purchase,Grocery,-291.8585823
4658,710229333,3-28-24 18:28,77.52,Payment,Bill Payment,-369.3785823
4659,710229333,3-29-24 23:28,301.43,OnlineShopping,eBay,-670.8085823
4660,710229333,04-01-24 21:28,3750,IncomingTransfer,Salary,3079.191418
4661,710229333,04-03-24 15:28,307.55,Deposit,Direct Deposit,3386.741418
4662,710229333,04-03-24 22:28,147.23,Deposit,Cash Deposit,3533.971418
4663,710229333,04-05-24 20:28,231.19,Deposit,Cash Deposit,3765.161418
4664,710229333,04-06-24 21:28,1800,Payment,Credit Card Payment,1965.161418
4665,710229333,04-07-24 12:28,174.57,Withdrawal,Mobile App Withdrawal,1790.591418
4666,710229333,04-07-24 21:28,378.66,Purchase,Entertainment,1411.931418
4667,710229333,04-10-24 11:28,59.75,OnlineShopping,Best Buy,1352.181418
4668,710229333,04-10-24 13:28,162.17,Purchase,Restaurant,1190.011418
4669,710229333,4-13-24 15:28,168.87,Purchase,Pharmacy,1021.141418
4670,710229333,4-14-24 21:28,1700,Payment,Installment Payment,-678.8585823
4671,710229333,4-15-24 10:28,352.26,Return,eBay Return,-326.5985823
4672,710229333,4-18-24 12:28,27.85,Purchase,Furniture,-354.4485823
4673,710229333,4-24-24 12:28,391.62,Withdrawal,Mobile App Withdrawal,-746.0685823
4674,710229333,05-01-24 22:28,254.39,IncomingTransfer,Freelance Payment,-491.6785823
4675,710229333,05-02-24 21:28,3750,IncomingTransfer,Salary,3258.321418
4676,710229333,05-07-24 17:28,285.98,Withdrawal,Mobile App Withdrawal,2972.341418
4677,710229333,05-07-24 21:28,1700,Payment,Credit Card Payment,1272.341418
4678,710229333,05-09-24 23:28,342.24,Purchase,Travel,930.1014177
4679,710229333,05-09-24 23:28,30.86,Deposit,Direct Deposit,960.9614177
4680,710229333,05-12-24 21:28,1400,Payment,Insurance Payment,-439.0385823
4681,710229333,5-15-24 16:28,46.7,Withdrawal,ATM Withdrawal,-485.7385823
4682,710229333,5-24-24 20:28,260,Withdrawal,Branch Withdrawal,-745.7385823
4683,710229333,5-27-24 14:28,76.97,IncomingTransfer,Freelance Payment,-668.7685823
4684,710229333,5-27-24 16:28,228.92,Deposit,Direct Deposit,-439.8485823
4685,710229333,06-01-24 21:28,3750,IncomingTransfer,Salary,3310.151418
4686,710229333,06-01-24 22:28,269.71,Deposit,Check Deposit,3579.861418
4687,710229333,06-02-24 20:28,143.66,Deposit,Mobile Deposit,3723.521418
4688,710229333,06-05-24 14:28,128.65,Return,Target Return,3852.171418
4689,710229333,06-06-24 21:28,1600,Payment,Credit Card Payment,2252.171418
4690,710229333,06-10-24 23:28,96.17,Purchase,Entertainment,2156.001418
4691,710229333,06-11-24 13:28,131.32,Deposit,Check Deposit,2287.321418
4692,710229333,06-12-24 10:28,383.35,Purchase,Entertainment,1903.971418
4693,710229333,6-14-24 17:28,240.62,OnlineShopping,Target,1663.351418
4694,710229333,6-18-24 21:28,1400,Payment,Subscription Payment,263.3514177
4695,710229333,6-20-24 23:28,150.11,Deposit,Cash Deposit,413.4614177
4696,710229333,6-23-24 15:28,46.42,Return,Amazon Return,459.8814177
4697,710229333,6-26-24 14:28,312.78,IncomingTransfer,Freelance Payment,772.6614177
4698,710229333,6-28-24 23:28,106.35,OnlineShopping,Target,666.3114177
4699,710229333,6-30-24 17:28,242.21,Purchase,Restaurant,424.1014177
4700,710229333,07-01-24 12:28,290.79,Return,Best Buy Return,714.8914177
4701,710229333,07-03-24 16:28,293.42,Purchase,Pharmacy,421.4714177
4702,710229333,07-03-24 21:28,3750,IncomingTransfer,Salary,4171.471418
4703,710229333,07-08-24 21:28,1800,Payment,Credit Card Payment,2371.471418
4704,710229333,7-15-24 21:28,1600,Payment,Subscription Payment,771.4714177
4705,710229333,7-16-24 18:28,134.27,Deposit,Direct Deposit,905.7414177
4706,710229333,7-16-24 21:28,297.41,Return,Best Buy Return,1203.151418
4707,710295858,1-24-24 12:28,528.12,Purchase,Furniture,505.1176448
4708,710295858,1-25-24 9:28,302.66,Withdrawal,Branch Withdrawal,202.4576448
4709,710295858,1-25-24 11:28,576.16,Deposit,Direct Deposit,778.6176448
4710,710295858,1-25-24 22:28,400.57,Deposit,Direct Deposit,1179.187645
4711,710295858,1-29-24 15:28,237.48,Withdrawal,Mobile App Withdrawal,941.7076448
4712,710295858,1-29-24 21:28,654.73,Return,Best Buy Return,1596.437645
4713,710295858,1-30-24 15:28,400.89,Return,Best Buy Return,1997.327645
4714,710295858,02-01-24 11:28,277.71,OnlineShopping,Walmart,1719.617645
4715,710295858,02-02-24 16:28,617.08,Withdrawal,Mobile App Withdrawal,1102.537645
4716,710295858,02-04-24 21:28,9200,IncomingTransfer,Salary,10302.53764
4717,710295858,02-04-24 22:28,660.74,OutgoingTransfer,Peer-to-Peer Transfer,9641.797645
4718,710295858,02-05-24 12:28,351.78,Return,Etsy Return,9993.577645
4719,710295858,02-05-24 19:28,612.92,Return,eBay Return,10606.49764
4720,710295858,02-06-24 20:28,563.6,OutgoingTransfer,International Transfer,10042.89764
4721,710295858,02-07-24 13:28,509.52,Return,AliExpress Return,10552.41764
4722,710295858,02-09-24 17:28,437.98,Return,Etsy Return,10990.39764
4723,710295858,02-09-24 21:28,1900,Payment,Credit Card Payment,9090.397645
4724,710295858,02-10-24 22:28,301.38,Deposit,Cash Deposit,9391.777645
4725,710295858,2-13-24 21:28,215.53,Withdrawal,Branch Withdrawal,9176.247645
4726,710295858,2-14-24 10:28,373.55,Purchase,Pharmacy,8802.697645
4727,710295858,2-15-24 16:28,674.79,OnlineShopping,Best Buy,8127.907645
4728,710295858,2-16-24 9:28,543.08,Deposit,Check Deposit,8670.987645
4729,710295858,2-17-24 14:28,135.66,Purchase,Entertainment,8535.327645
4730,710295858,2-17-24 21:28,4900,Payment,Rent Payment,3635.327645
4731,710295858,2-20-24 15:28,533.16,OnlineShopping,Amazon,3102.167645
4732,710295858,2-27-24 21:28,309.45,Withdrawal,Branch Withdrawal,2792.717645
4733,710295858,03-01-24 18:28,371.49,Deposit,Mobile Deposit,3164.207645
4734,710295858,03-03-24 21:28,9200,IncomingTransfer,Salary,12364.20764
4735,710295858,03-08-24 16:28,223.71,Deposit,Direct Deposit,12587.91764
4736,710295858,03-08-24 21:28,1900,Payment,Credit Card Payment,10687.91764
4737,710295858,03-10-24 13:28,182.61,Payment,Loan Payment,10505.30764
4738,710295858,03-11-24 21:28,3400,Payment,Rent Payment,7105.307645
4739,710295858,03-12-24 18:28,702.63,OutgoingTransfer,Peer-to-Peer Transfer,6402.677645
4740,710295858,3-13-24 9:28,207.83,Withdrawal,ATM Withdrawal,6194.847645
4741,710295858,3-15-24 15:28,683.92,Payment,Bill Payment,5510.927645
4742,710295858,3-20-24 14:28,531.69,Withdrawal,Branch Withdrawal,4979.237645
4743,710295858,3-20-24 16:28,253.12,Return,Walmart Return,5232.357645
4744,710295858,3-22-24 16:28,433.71,Deposit,Cash Deposit,5666.067645
4745,710295858,3-23-24 17:28,708.29,OutgoingTransfer,Wire Transfer,4957.777645
4746,710295858,3-27-24 14:28,398.88,OutgoingTransfer,Bank Transfer,4558.897645
4747,710295858,3-28-24 19:28,160.19,Payment,Loan Payment,4398.707645
4748,710295858,3-31-24 22:28,446.3,Withdrawal,Branch Withdrawal,3952.407645
4749,710295858,04-02-24 10:28,184.77,Return,Etsy Return,4137.177645
4750,710295858,04-03-24 21:28,9200,IncomingTransfer,Salary,13337.17764
4751,710295858,04-04-24 19:28,487.84,Purchase,Gas,12849.33764
4752,710295858,04-04-24 22:28,648.48,Return,AliExpress Return,13497.81764
4753,710295858,04-07-24 17:28,350.04,Deposit,Check Deposit,13847.85764
4754,710295858,04-07-24 18:28,453.53,Purchase,Clothing,13394.32764
4755,710295858,04-07-24 22:28,549.78,OutgoingTransfer,International Transfer,12844.54764
4756,710295858,04-08-24 21:28,2000,Payment,Credit Card Payment,10844.54764
4757,710295858,04-09-24 10:28,235.54,OnlineShopping,Etsy,10609.00764
4758,710295858,04-09-24 10:28,145.08,IncomingTransfer,Freelance Payment,10754.08764
4759,710295858,04-12-24 21:28,4800,Payment,Rent Payment,5954.087645
4760,710295858,4-13-24 11:28,644.13,Deposit,Check Deposit,6598.217645
4761,710295858,4-13-24 15:28,232.45,Purchase,Gas,6365.767645
4762,710295858,4-15-24 20:28,407.01,Payment,Bill Payment,5958.757645
4763,710295858,4-16-24 19:28,378.39,Purchase,Grocery,5580.367645
4764,710295858,4-22-24 22:28,169.09,Deposit,Mobile Deposit,5749.457645
4765,710295858,4-22-24 23:28,152.25,OutgoingTransfer,Bank Transfer,5597.207645
4766,710295858,4-23-24 23:28,150.76,Payment,Mortgage Payment,5446.447645
4767,710295858,4-24-24 19:28,222.67,Return,Store Return,5669.117645
4768,710295858,4-25-24 19:28,508.24,Withdrawal,ATM Withdrawal,5160.877645
4769,710295858,4-28-24 22:28,527.57,Deposit,Cash Deposit,5688.447645
4770,710295858,05-04-24 21:28,9200,IncomingTransfer,Salary,14888.44764
4771,710295858,05-05-24 20:28,737.01,IncomingTransfer,Freelance Payment,15625.45764
4772,710295858,05-06-24 18:28,515.75,Purchase,Home Improvement,15109.70764
4773,710295858,05-08-24 15:28,575.62,Purchase,Pharmacy,14534.08764
4774,710295858,05-08-24 23:28,740.24,OnlineShopping,Target,13793.84764
4775,710295858,05-09-24 11:28,616.2,Deposit,Cash Deposit,14410.04764
4776,710295858,05-09-24 21:28,2100,Payment,Credit Card Payment,12310.04764
4777,710295858,05-10-24 10:28,508.8,OutgoingTransfer,Wire Transfer,11801.24764
4778,710295858,05-11-24 16:28,192.09,Purchase,Pharmacy,11609.15764
4779,710295858,05-12-24 17:28,198.31,Deposit,Cash Deposit,11807.46764
4780,710295858,5-13-24 14:28,429.76,Purchase,Entertainment,11377.70764
4781,710295858,5-14-24 21:28,673.54,Withdrawal,Branch Withdrawal,10704.16764
4782,710295858,5-17-24 21:28,5800,Payment,Rent Payment,4904.167645
4783,710295858,5-19-24 17:28,453.17,OutgoingTransfer,Wire Transfer,4450.997645
4784,710295858,5-28-24 11:28,447.87,Purchase,Clothing,4003.127645
4785,710295858,06-01-24 22:28,281.99,OnlineShopping,Target,3721.137645
4786,710295858,06-02-24 21:28,9200,IncomingTransfer,Salary,12921.13764
4787,710295858,06-06-24 21:28,337.05,Purchase,Pharmacy,12584.08764
4788,710295858,06-07-24 21:28,2400,Payment,Credit Card Payment,10184.08764
4789,710295858,06-12-24 9:28,740.45,Purchase,Gas,9443.637645
4790,710295858,06-12-24 21:28,4000,Payment,Rent Payment,5443.637645
4791,710295858,6-15-24 13:28,207.06,Withdrawal,ATM Withdrawal,5236.577645
4792,710295858,6-15-24 20:28,206.2,Purchase,Entertainment,5030.377645
4793,710295858,6-20-24 19:28,207.6,Deposit,Cash Deposit,5237.977645
4794,710295858,6-21-24 18:28,250.24,Withdrawal,Branch Withdrawal,4987.737645
4795,710295858,6-30-24 11:28,385.75,Deposit,Check Deposit,5373.487645
4796,710295858,6-30-24 21:28,507.9,Deposit,Direct Deposit,5881.387645
4797,710295858,07-03-24 21:28,9200,IncomingTransfer,Salary,15081.38764
4798,710295858,07-05-24 21:28,738.74,Deposit,Mobile Deposit,15820.12764
4799,710295858,07-06-24 12:28,671.88,Payment,Bill Payment,15148.24764
4800,710295858,07-07-24 21:28,148.12,OnlineShopping,Best Buy,15000.12764
4801,710295858,07-08-24 21:28,1800,Payment,Credit Card Payment,13200.12764
4802,710295858,07-10-24 19:28,243.81,Return,AliExpress Return,13443.93764
4803,710295858,07-11-24 18:28,421.69,Purchase,Travel,13022.24764
4804,710295858,7-13-24 16:28,120.7,IncomingTransfer,Freelance Payment,13142.94764
4805,710295858,7-13-24 18:28,612.24,Return,eBay Return,13755.18764
4806,710295858,7-13-24 21:28,575.88,Return,Best Buy Return,14331.06764
4807,710295858,7-16-24 9:28,440.09,Purchase,Travel,13890.97764
4808,710295858,7-18-24 21:28,4300,Payment,Rent Payment,9590.977645
4809,710364258,1-20-24 16:28,399.31,OnlineShopping,Amazon,297.3213096
4810,710364258,1-25-24 18:28,220.95,Purchase,Home Improvement,76.3713096
4811,710364258,02-01-24 13:28,302.79,Deposit,Mobile Deposit,379.1613096
4812,710364258,02-05-24 21:28,5600,IncomingTransfer,Salary,5979.16131
4813,710364258,02-09-24 14:28,80.44,Payment,Mortgage Payment,5898.72131
4814,710364258,02-09-24 20:28,463.33,Deposit,Direct Deposit,6362.05131
4815,710364258,02-10-24 11:28,300.6,Return,Best Buy Return,6662.65131
4816,710364258,02-10-24 21:28,1400,Payment,Credit Card Payment,5262.65131
4817,710364258,02-10-24 21:28,2300,Payment,Rent Payment,2962.65131
4818,710364258,2-14-24 19:28,216.17,Purchase,Gas,2746.48131
4819,710364258,2-16-24 21:28,162.19,IncomingTransfer,Freelance Payment,2908.67131
4820,710364258,2-17-24 19:28,110.46,Payment,Mortgage Payment,2798.21131
4821,710364258,2-19-24 19:28,24.33,IncomingTransfer,Freelance Payment,2822.54131
4822,710364258,2-24-24 17:28,124.42,Payment,Loan Payment,2698.12131
4823,710364258,03-01-24 15:28,246.61,Payment,Bill Payment,2451.51131
4824,710364258,03-01-24 21:28,5600,IncomingTransfer,Salary,8051.51131
4825,710364258,03-06-24 21:28,1400,Payment,Credit Card Payment,6651.51131
4826,710364258,03-07-24 9:28,433.29,Deposit,Direct Deposit,7084.80131
4827,710364258,03-07-24 22:28,351.68,OnlineShopping,Best Buy,6733.12131
4828,710364258,03-09-24 18:28,476.06,Return,Etsy Return,7209.18131
4829,710364258,3-16-24 21:28,3000,Payment,Rent Payment,4209.18131
4830,710364258,3-17-24 12:28,493.5,Return,Walmart Return,4702.68131
4831,710364258,3-20-24 21:28,404.68,OutgoingTransfer,Bank Transfer,4298.00131
4832,710364258,3-22-24 10:28,149.87,IncomingTransfer,Freelance Payment,4447.87131
4833,710364258,3-23-24 10:28,480.18,Withdrawal,ATM Withdrawal,3967.69131
4834,710364258,3-23-24 20:28,308.35,Purchase,Furniture,3659.34131
4835,710364258,3-27-24 15:28,206.76,Withdrawal,ATM Withdrawal,3452.58131
4836,710364258,3-29-24 16:28,52.58,Deposit,Check Deposit,3505.16131
4837,710364258,3-30-24 14:28,323.62,Payment,Mortgage Payment,3181.54131
4838,710364258,04-04-24 21:28,5600,IncomingTransfer,Salary,8781.54131
4839,710364258,04-05-24 13:28,249.12,Deposit,Check Deposit,9030.66131
4840,710364258,04-06-24 14:28,93.32,Withdrawal,Branch Withdrawal,8937.34131
4841,710364258,04-07-24 18:28,35.65,Withdrawal,Branch Withdrawal,8901.69131
4842,710364258,04-09-24 21:28,1400,Payment,Credit Card Payment,7501.69131
4843,710364258,04-12-24 21:28,2500,Payment,Rent Payment,5001.69131
4844,710364258,4-15-24 16:28,178.46,Purchase,Gas,4823.23131
4845,710364258,4-19-24 23:28,308.29,Purchase,Clothing,4514.94131
4846,710364258,4-28-24 20:28,149.12,Purchase,Pharmacy,4365.82131
4847,710364258,05-01-24 10:28,118.13,Withdrawal,Branch Withdrawal,4247.69131
4848,710364258,05-02-24 21:28,5600,IncomingTransfer,Salary,9847.69131
4849,710364258,05-03-24 21:28,270.49,Purchase,Electronics,9577.20131
4850,710364258,05-06-24 10:28,194.62,Deposit,Cash Deposit,9771.82131
4851,710364258,05-07-24 21:28,1300,Payment,Credit Card Payment,8471.82131
4852,710364258,5-13-24 21:28,2400,Payment,Rent Payment,6071.82131
4853,710364258,5-25-24 15:28,468.09,Deposit,Direct Deposit,6539.91131
4854,710364258,5-25-24 20:28,45.82,IncomingTransfer,Freelance Payment,6585.73131
4855,710364258,5-27-24 16:28,430.96,Withdrawal,Branch Withdrawal,6154.77131
4856,710364258,06-02-24 21:28,5600,IncomingTransfer,Salary,11754.77131
4857,710364258,06-04-24 14:28,493.43,Purchase,Clothing,11261.34131
4858,710364258,06-04-24 20:28,228.47,Withdrawal,Branch Withdrawal,11032.87131
4859,710364258,06-06-24 18:28,247.54,Withdrawal,ATM Withdrawal,10785.33131
4860,710364258,06-07-24 21:28,1700,Payment,Credit Card Payment,9085.33131
4861,710364258,6-13-24 21:28,3500,Payment,Rent Payment,5585.33131
4862,710364258,6-17-24 21:28,479.1,Deposit,Mobile Deposit,6064.43131
4863,710364258,6-19-24 15:28,490.67,Payment,Bill Payment,5573.76131
4864,710364258,07-02-24 12:28,158.96,Purchase,Travel,5414.80131
4865,710364258,07-02-24 21:28,5600,IncomingTransfer,Salary,11014.80131
4866,710364258,07-04-24 21:28,202.15,Deposit,Cash Deposit,11216.95131
4867,710364258,07-07-24 21:28,1500,Payment,Credit Card Payment,9716.95131
4868,710364258,07-07-24 22:28,56.68,Withdrawal,Mobile App Withdrawal,9660.27131
4869,710364258,07-08-24 17:28,45.76,IncomingTransfer,Freelance Payment,9706.03131
4870,710364258,07-08-24 20:28,441.03,Return,AliExpress Return,10147.06131
4871,710364258,07-10-24 20:28,343.43,Payment,Mortgage Payment,9803.63131
4872,710364258,07-10-24 21:28,1700,Payment,Rent Payment,8103.63131
4873,710364258,7-13-24 17:28,161.82,Deposit,Check Deposit,8265.45131
4874,710364258,7-14-24 11:28,426.44,IncomingTransfer,Freelance Payment,8691.89131
4875,710424408,1-30-24 14:28,245.36,Deposit,Cash Deposit,1154.188607
4876,710424408,02-03-24 21:28,2250,IncomingTransfer,Salary,3404.188607
4877,710424408,02-03-24 21:28,134.46,Purchase,Pharmacy,3269.728607
4878,710424408,02-05-24 20:28,248.54,OnlineShopping,Target,3021.188607
4879,710424408,02-07-24 11:28,47.68,Purchase,Electronics,2973.508607
4880,710424408,02-08-24 21:28,2600,Payment,Credit Card Payment,373.5086071
4881,710424408,02-12-24 21:28,700,Payment,Rent Payment,-326.4913929
4882,710424408,2-23-24 22:28,191.98,Payment,Bill Payment,-518.4713929
4883,710424408,03-04-24 21:28,2250,IncomingTransfer,Salary,1731.528607
4884,710424408,03-05-24 15:28,74.77,Deposit,Mobile Deposit,1806.298607
4885,710424408,03-07-24 21:28,56.2,OnlineShopping,Best Buy,1750.098607
4886,710424408,03-09-24 21:28,1900,Payment,Credit Card Payment,-149.9013929
4887,710424408,03-11-24 11:28,37.53,OnlineShopping,Best Buy,-187.4313929
4888,710424408,03-11-24 21:28,191.76,Deposit,Check Deposit,4.328607063
4889,710424408,3-15-24 21:28,1400,Payment,Rent Payment,-1395.671393
4890,710424408,3-16-24 12:28,235.68,Purchase,Restaurant,-1631.351393
4891,710424408,3-29-24 14:28,72.06,OutgoingTransfer,Wire Transfer,-1703.411393
4892,710424408,04-02-24 15:28,196.36,Purchase,Clothing,-1899.771393
4893,710424408,04-02-24 21:28,2250,IncomingTransfer,Salary,350.2286071
4894,710424408,04-07-24 21:28,2500,Payment,Credit Card Payment,-2149.771393
4895,710424408,4-14-24 21:28,900,Payment,Rent Payment,-3049.771393
4896,710424408,4-15-24 12:28,182.85,Withdrawal,Mobile App Withdrawal,-3232.621393
4897,710424408,05-04-24 21:28,2250,IncomingTransfer,Salary,-982.6213929
4898,710424408,05-06-24 16:28,71.18,Return,Store Return,-911.4413929
4899,710424408,05-08-24 15:28,149.17,Deposit,Mobile Deposit,-762.2713929
4900,710424408,05-09-24 21:28,2200,Payment,Credit Card Payment,-2962.271393
4901,710424408,05-12-24 12:28,68.85,OnlineShopping,Etsy,-3031.121393
4902,710424408,5-18-24 21:28,1400,Payment,Rent Payment,-4431.121393
4903,710424408,5-24-24 16:28,151.84,Purchase,Restaurant,-4582.961393
4904,710424408,5-26-24 15:28,184.85,Deposit,Check Deposit,-4398.111393
4905,710424408,5-29-24 10:28,48.68,Payment,Mortgage Payment,-4446.791393
4906,710424408,06-03-24 21:28,2250,IncomingTransfer,Salary,-2196.791393
4907,710424408,06-08-24 21:28,2200,Payment,Credit Card Payment,-4396.791393
4908,710424408,06-10-24 10:28,194.22,Purchase,Entertainment,-4591.011393
4909,710424408,6-13-24 15:28,220.82,OnlineShopping,Best Buy,-4811.831393
4910,710424408,6-15-24 21:28,1400,Payment,Rent Payment,-6211.831393
4911,710424408,6-16-24 16:28,238.75,Deposit,Check Deposit,-5973.081393
4912,710424408,6-25-24 9:28,237.24,Purchase,Restaurant,-6210.321393
4913,710424408,6-29-24 11:28,130.68,OutgoingTransfer,Peer-to-Peer Transfer,-6341.001393
4914,710424408,07-02-24 13:28,108.88,Purchase,Furniture,-6449.881393
4915,710424408,07-04-24 21:28,2250,IncomingTransfer,Salary,-4199.881393
4916,710424408,07-09-24 21:28,2300,Payment,Credit Card Payment,-6499.881393
4917,710424408,07-12-24 21:28,1200,Payment,Rent Payment,-7699.881393
4918,710431158,1-24-24 19:28,222.48,Withdrawal,Branch Withdrawal,714.0443985
4919,710431158,1-24-24 19:28,88.85,Deposit,Cash Deposit,802.8943985
4920,710431158,1-29-24 14:28,138.8,Purchase,Clothing,664.0943985
4921,710431158,1-29-24 20:28,286.85,Payment,Loan Payment,377.2443985
4922,710431158,02-02-24 18:28,302.78,OutgoingTransfer,Bank Transfer,74.46439846
4923,710431158,02-03-24 22:28,95.79,Withdrawal,Mobile App Withdrawal,-21.32560154
4924,710431158,02-05-24 21:28,4850,IncomingTransfer,Salary,4828.674398
4925,710431158,02-06-24 11:28,344.6,OutgoingTransfer,Bank Transfer,4484.074398
4926,710431158,02-10-24 18:28,373.61,Withdrawal,Mobile App Withdrawal,4110.464398
4927,710431158,02-10-24 21:28,1900,Payment,Credit Card Payment,2210.464398
4928,710431158,2-13-24 10:28,158.09,Deposit,Mobile Deposit,2368.554398
4929,710431158,2-14-24 21:28,2400,Payment,Rent Payment,-31.44560154
4930,710431158,2-15-24 18:28,225.76,IncomingTransfer,Freelance Payment,194.3143985
4931,710431158,2-18-24 14:28,243.24,Deposit,Cash Deposit,437.5543985
4932,710431158,2-18-24 17:28,416.41,OnlineShopping,AliExpress,21.14439846
4933,710431158,2-18-24 21:28,438.55,Return,Etsy Return,459.6943985
4934,710431158,2-20-24 13:28,109.07,Withdrawal,Mobile App Withdrawal,350.6243985
4935,710431158,2-20-24 18:28,234.36,OnlineShopping,Target,116.2643985
4936,710431158,2-22-24 23:28,238.62,OutgoingTransfer,Peer-to-Peer Transfer,-122.3556015
4937,710431158,2-27-24 18:28,66.6,OnlineShopping,Target,-188.9556015
4938,710431158,2-28-24 10:28,409.82,Withdrawal,Mobile App Withdrawal,-598.7756015
4939,710431158,2-29-24 15:28,405.32,Purchase,Travel,-1004.095602
4940,710431158,2-29-24 21:28,257.28,Deposit,Direct Deposit,-746.8156015
4941,710431158,2-29-24 23:28,475.04,Withdrawal,ATM Withdrawal,-1221.855602
4942,710431158,03-02-24 17:28,121.78,OutgoingTransfer,Wire Transfer,-1343.635602
4943,710431158,03-02-24 17:28,53.15,Purchase,Travel,-1396.785602
4944,710431158,03-03-24 21:28,4850,IncomingTransfer,Salary,3453.214398
4945,710431158,03-04-24 14:28,286.66,OutgoingTransfer,Bank Transfer,3166.554398
4946,710431158,03-06-24 18:28,63.94,Withdrawal,ATM Withdrawal,3102.614398
4947,710431158,03-08-24 21:28,1700,Payment,Credit Card Payment,1402.614398
4948,710431158,3-15-24 20:28,191.32,Payment,Loan Payment,1211.294398
4949,710431158,3-16-24 21:28,2000,Payment,Rent Payment,-788.7056015
4950,710431158,3-17-24 11:28,171.58,Deposit,Check Deposit,-617.1256015
4951,710431158,3-19-24 14:28,59.94,OutgoingTransfer,Bank Transfer,-677.0656015
4952,710431158,3-19-24 21:28,79.02,Deposit,Check Deposit,-598.0456015
4953,710431158,3-24-24 22:28,174.22,Payment,Mortgage Payment,-772.2656015
4954,710431158,3-25-24 20:28,246.63,Purchase,Furniture,-1018.895602
4955,710431158,3-27-24 12:28,285.01,IncomingTransfer,Freelance Payment,-733.8856015
4956,710431158,3-30-24 15:28,347.59,Withdrawal,Mobile App Withdrawal,-1081.475602
4957,710431158,04-01-24 15:28,60.23,OnlineShopping,Walmart,-1141.705602
4958,710431158,04-01-24 17:28,48.61,IncomingTransfer,Freelance Payment,-1093.095602
4959,710431158,04-02-24 21:28,4850,IncomingTransfer,Salary,3756.904398
4960,710431158,04-02-24 23:28,201.46,OnlineShopping,Walmart,3555.444398
4961,710431158,04-07-24 10:28,434.2,Withdrawal,ATM Withdrawal,3121.244398
4962,710431158,04-07-24 21:28,2300,Payment,Credit Card Payment,821.2443985
4963,710431158,04-09-24 23:28,360.74,Purchase,Clothing,460.5043985
4964,710431158,04-11-24 10:28,89.5,OnlineShopping,Best Buy,371.0043985
4965,710431158,04-12-24 17:28,382.33,Payment,Mortgage Payment,-11.32560154
4966,710431158,4-14-24 16:28,275.23,Withdrawal,Mobile App Withdrawal,-286.5556015
4967,710431158,4-16-24 21:28,1700,Payment,Rent Payment,-1986.555602
4968,710431158,4-17-24 16:28,77.91,Return,Best Buy Return,-1908.645602
4969,710431158,4-18-24 16:28,220.81,Return,Target Return,-1687.835602
4970,710431158,4-18-24 18:28,384.41,IncomingTransfer,Freelance Payment,-1303.425602
4971,710431158,4-24-24 14:28,473.96,Payment,Bill Payment,-1777.385602
4972,710431158,4-26-24 12:28,366.91,OnlineShopping,eBay,-2144.295602
4973,710431158,05-03-24 19:28,314.29,Deposit,Cash Deposit,-1830.005602
4974,710431158,05-04-24 21:28,4850,IncomingTransfer,Salary,3019.994398
4975,710431158,05-09-24 21:28,2100,Payment,Credit Card Payment,919.9943985
4976,710431158,05-11-24 16:28,179.97,OutgoingTransfer,Peer-to-Peer Transfer,740.0243985
4977,710431158,5-13-24 17:28,329.66,Purchase,Restaurant,410.3643985
4978,710431158,5-13-24 18:28,440.75,Purchase,Furniture,-30.38560154
4979,710431158,5-13-24 23:28,144.37,Return,Walmart Return,113.9843985
4980,710431158,5-14-24 11:28,394.86,Purchase,Grocery,-280.8756015
4981,710431158,5-14-24 19:28,294.52,Purchase,Grocery,-575.3956015
4982,710431158,5-16-24 12:28,471.68,OnlineShopping,Target,-1047.075602
4983,710431158,5-17-24 21:28,178.62,Purchase,Restaurant,-1225.695602
4984,710431158,5-18-24 21:28,2200,Payment,Rent Payment,-3425.695602
4985,710431158,5-21-24 22:28,49.87,OnlineShopping,Etsy,-3475.565602
4986,710431158,5-22-24 11:28,457.36,Purchase,Gas,-3932.925602
4987,710431158,5-26-24 17:28,382.14,IncomingTransfer,Freelance Payment,-3550.785602
4988,710431158,5-29-24 18:28,400.65,Payment,Mortgage Payment,-3951.435602
4989,710431158,06-03-24 10:28,329.57,OnlineShopping,Etsy,-4281.005602
4990,710431158,06-04-24 21:28,4850,IncomingTransfer,Salary,568.9943985
4991,710431158,06-06-24 11:28,476.22,Deposit,Cash Deposit,1045.214398
4992,710431158,06-09-24 21:28,1800,Payment,Credit Card Payment,-754.7856015
4993,710431158,06-10-24 22:28,294.76,OutgoingTransfer,Wire Transfer,-1049.545602
4994,710431158,6-17-24 21:28,2300,Payment,Rent Payment,-3349.545602
4995,710431158,6-25-24 16:28,340.66,Deposit,Mobile Deposit,-3008.885602
4996,710431158,6-30-24 18:28,413.75,Withdrawal,Mobile App Withdrawal,-3422.635602
4997,710431158,07-03-24 21:28,4850,IncomingTransfer,Salary,1427.364398
4998,710431158,07-05-24 22:28,307.14,Withdrawal,ATM Withdrawal,1120.224398
4999,710431158,07-08-24 9:28,455.53,Return,Walmart Return,1575.754398
5000,710431158,07-08-24 21:28,2000,Payment,Credit Card Payment,-424.2456015
5001,710431158,07-09-24 13:28,434.31,Payment,Loan Payment,-858.5556015
5002,710431158,7-14-24 21:28,481.46,OnlineShopping,Best Buy,-1340.015602
5003,710431158,7-15-24 21:28,2400,Payment,Rent Payment,-3740.015602
5004,710431158,7-15-24 21:28,232.72,Deposit,Cash Deposit,-3507.295602
5005,710431158,7-17-24 10:28,414.67,Return,Target Return,-3092.625602
5006,710538183,1-20-24 17:28,235.64,Purchase,Electronics,102.8785232
5007,710538183,1-22-24 17:28,135.89,Return,AliExpress Return,238.7685232
5008,710538183,1-22-24 18:28,216.47,Purchase,Home Improvement,22.29852321
5009,710538183,1-26-24 17:28,160.06,OnlineShopping,Target,-137.7614768
5010,710538183,1-28-24 21:28,146.03,Return,Best Buy Return,8.268523213
5011,710538183,1-31-24 11:28,48.87,Payment,Loan Payment,-40.60147679
5012,710538183,02-02-24 13:28,17.37,Purchase,Entertainment,-57.97147679
5013,710538183,02-02-24 19:28,237.18,Purchase,Restaurant,-295.1514768
5014,710538183,02-04-24 21:28,3050,IncomingTransfer,Salary,2754.848523
5015,710538183,02-06-24 11:28,241.49,OnlineShopping,eBay,2513.358523
5016,710538183,02-06-24 22:28,110.78,OutgoingTransfer,Bank Transfer,2402.578523
5017,710538183,02-09-24 21:28,800,Payment,Credit Card Payment,1602.578523
5018,710538183,02-09-24 21:28,53.86,Deposit,Direct Deposit,1656.438523
5019,710538183,2-13-24 12:28,233.9,Deposit,Cash Deposit,1890.338523
5020,710538183,2-13-24 14:28,87.82,OnlineShopping,Amazon,1802.518523
5021,710538183,2-16-24 21:28,800,Payment,Installment Payment,1002.518523
5022,710538183,2-23-24 9:28,81.1,OnlineShopping,Walmart,921.4185232
5023,710538183,2-24-24 16:28,228.39,OnlineShopping,Amazon,693.0285232
5024,710538183,2-28-24 20:28,65.35,OnlineShopping,Walmart,627.6785232
5025,710538183,2-29-24 9:28,84.9,Withdrawal,Branch Withdrawal,542.7785232
5026,710538183,03-05-24 21:28,3050,IncomingTransfer,Salary,3592.778523
5027,710538183,03-07-24 13:28,15.9,Purchase,Restaurant,3576.878523
5028,710538183,03-10-24 21:28,600,Payment,Credit Card Payment,2976.878523
5029,710538183,03-12-24 12:28,49.6,Deposit,Cash Deposit,3026.478523
5030,710538183,3-15-24 21:28,1100,Payment,Installment Payment,1926.478523
5031,710538183,3-16-24 10:28,53.33,OutgoingTransfer,International Transfer,1873.148523
5032,710538183,3-17-24 11:28,125.76,Withdrawal,Branch Withdrawal,1747.388523
5033,710538183,3-17-24 19:28,70.75,OutgoingTransfer,Peer-to-Peer Transfer,1676.638523
5034,710538183,3-21-24 15:28,141.19,OnlineShopping,Etsy,1535.448523
5035,710538183,3-21-24 22:28,108.3,Deposit,Check Deposit,1643.748523
5036,710538183,3-22-24 10:28,152.24,Withdrawal,ATM Withdrawal,1491.508523
5037,710538183,3-24-24 16:28,141.91,Payment,Loan Payment,1349.598523
5038,710538183,3-25-24 21:28,122.24,Payment,Bill Payment,1227.358523
5039,710538183,3-27-24 17:28,22.42,Purchase,Clothing,1204.938523
5040,710538183,3-28-24 14:28,56.07,Purchase,Home Improvement,1148.868523
5041,710538183,3-29-24 14:28,242.77,Payment,Loan Payment,906.0985232
5042,710538183,3-29-24 18:28,211.48,Deposit,Cash Deposit,1117.578523
5043,710538183,04-02-24 10:28,87.13,OnlineShopping,Walmart,1030.448523
5044,710538183,04-02-24 21:28,3050,IncomingTransfer,Salary,4080.448523
5045,710538183,04-03-24 9:28,54.64,Payment,Loan Payment,4025.808523
5046,710538183,04-04-24 21:28,64.93,OnlineShopping,Best Buy,3960.878523
5047,710538183,04-06-24 16:28,92.5,Payment,Loan Payment,3868.378523
5048,710538183,04-07-24 10:28,232.75,Payment,Mortgage Payment,3635.628523
5049,710538183,04-07-24 21:28,800,Payment,Credit Card Payment,2835.628523
5050,710538183,04-09-24 14:28,215.47,Payment,Bill Payment,2620.158523
5051,710538183,04-11-24 20:28,106.27,Deposit,Check Deposit,2726.428523
5052,710538183,04-11-24 23:28,21.12,Payment,Loan Payment,2705.308523
5053,710538183,04-12-24 21:28,1300,Payment,Installment Payment,1405.308523
5054,710538183,4-13-24 11:28,104.97,OnlineShopping,Etsy,1300.338523
5055,710538183,4-18-24 16:28,149.26,Purchase,Entertainment,1151.078523
5056,710538183,4-19-24 11:28,148.17,Return,Walmart Return,1299.248523
5057,710538183,4-21-24 17:28,171.59,OutgoingTransfer,International Transfer,1127.658523
5058,710538183,4-25-24 11:28,116.1,Deposit,Cash Deposit,1243.758523
5059,710538183,4-25-24 20:28,151.88,OnlineShopping,Walmart,1091.878523
5060,710538183,4-28-24 15:28,34.25,Withdrawal,Branch Withdrawal,1057.628523
5061,710538183,4-29-24 19:28,203.48,Return,Amazon Return,1261.108523
5062,710538183,05-03-24 21:28,3050,IncomingTransfer,Salary,4311.108523
5063,710538183,05-05-24 10:28,240.05,Payment,Loan Payment,4071.058523
5064,710538183,05-05-24 19:28,161.64,Purchase,Home Improvement,3909.418523
5065,710538183,05-05-24 19:28,227.69,Deposit,Cash Deposit,4137.108523
5066,710538183,05-07-24 17:28,29.83,Payment,Mortgage Payment,4107.278523
5067,710538183,05-08-24 21:28,700,Payment,Credit Card Payment,3407.278523
5068,710538183,05-09-24 20:28,200.29,Purchase,Electronics,3206.988523
5069,710538183,05-09-24 23:28,95.66,Payment,Loan Payment,3111.328523
5070,710538183,05-10-24 16:28,206.14,Return,eBay Return,3317.468523
5071,710538183,05-12-24 12:28,153.56,Purchase,Electronics,3163.908523
5072,710538183,5-15-24 20:28,169.08,Withdrawal,ATM Withdrawal,2994.828523
5073,710538183,5-16-24 21:28,235.61,Return,Etsy Return,3230.438523
5074,710538183,5-18-24 14:28,32.12,Purchase,Entertainment,3198.318523
5075,710538183,5-18-24 21:28,900,Payment,Installment Payment,2298.318523
5076,710538183,5-19-24 17:28,13.4,OutgoingTransfer,International Transfer,2284.918523
5077,710538183,5-20-24 18:28,124.4,Withdrawal,ATM Withdrawal,2160.518523
5078,710538183,5-23-24 9:28,203.55,Payment,Mortgage Payment,1956.968523
5079,710538183,5-25-24 13:28,64.12,Purchase,Furniture,1892.848523
5080,710538183,5-25-24 16:28,63.56,Payment,Bill Payment,1829.288523
5081,710538183,5-28-24 10:28,203.83,Payment,Mortgage Payment,1625.458523
5082,710538183,06-01-24 22:28,190.13,Return,Amazon Return,1815.588523
5083,710538183,06-02-24 16:28,227.04,OutgoingTransfer,Peer-to-Peer Transfer,1588.548523
5084,710538183,06-02-24 20:28,131.86,Purchase,Grocery,1456.688523
5085,710538183,06-02-24 21:28,3050,IncomingTransfer,Salary,4506.688523
5086,710538183,06-07-24 21:28,600,Payment,Credit Card Payment,3906.688523
5087,710538183,06-09-24 13:28,189.26,Withdrawal,ATM Withdrawal,3717.428523
5088,710538183,6-14-24 9:28,172.45,Deposit,Mobile Deposit,3889.878523
5089,710538183,6-17-24 21:28,1000,Payment,Subscription Payment,2889.878523
5090,710538183,6-20-24 11:28,167.95,OnlineShopping,Target,2721.928523
5091,710538183,6-22-24 15:28,39.42,OutgoingTransfer,Peer-to-Peer Transfer,2682.508523
5092,710538183,6-23-24 19:28,72.06,Withdrawal,ATM Withdrawal,2610.448523
5093,710538183,6-23-24 21:28,34.34,Withdrawal,Branch Withdrawal,2576.108523
5094,710538183,6-24-24 18:28,190.53,Payment,Loan Payment,2385.578523
5095,710538183,6-26-24 11:28,146.99,OnlineShopping,AliExpress,2238.588523
5096,710538183,6-28-24 16:28,27.71,Purchase,Home Improvement,2210.878523
5097,710538183,6-30-24 16:28,170.16,Return,eBay Return,2381.038523
5098,710538183,6-30-24 21:28,178.83,Purchase,Restaurant,2202.208523
5099,710538183,07-03-24 13:28,19.6,OutgoingTransfer,Peer-to-Peer Transfer,2182.608523
5100,710538183,07-03-24 21:28,3050,IncomingTransfer,Salary,5232.608523
5101,710538183,07-04-24 19:28,208.45,Withdrawal,Mobile App Withdrawal,5024.158523
5102,710538183,07-07-24 20:28,54.08,IncomingTransfer,Freelance Payment,5078.238523
5103,710538183,07-08-24 21:28,600,Payment,Credit Card Payment,4478.238523
5104,710538183,07-10-24 18:28,27.5,Withdrawal,Branch Withdrawal,4450.738523
5105,710538183,07-10-24 21:28,1200,Payment,Installment Payment,3250.738523
5106,710538183,07-11-24 13:28,153.85,Purchase,Electronics,3096.888523
5107,710595783,1-20-24 14:28,171.51,Purchase,Electronics,1658.410032
5108,710595783,1-29-24 13:28,87.12,Withdrawal,Branch Withdrawal,1571.290032
5109,710595783,02-01-24 21:28,3350,IncomingTransfer,Salary,4921.290032
5110,710595783,02-05-24 21:28,137.08,Return,Target Return,5058.370032
5111,710595783,02-06-24 21:28,2900,Payment,Credit Card Payment,2158.370032
5112,710595783,02-08-24 10:28,487.25,Purchase,Travel,1671.120032
5113,710595783,02-08-24 13:28,23.16,Return,Target Return,1694.280032
5114,710595783,02-09-24 12:28,446.26,Purchase,Clothing,1248.020032
5115,710595783,02-10-24 21:28,1100,Payment,Rent Payment,148.0200323
5116,710595783,02-10-24 21:28,92.79,Payment,Mortgage Payment,55.23003229
5117,710595783,02-11-24 19:28,402.23,Payment,Mortgage Payment,-346.9999677
5118,710595783,2-13-24 17:28,101.88,Return,Store Return,-245.1199677
5119,710595783,2-14-24 9:28,380.67,Purchase,Pharmacy,-625.7899677
5120,710595783,2-14-24 16:28,268.22,Deposit,Check Deposit,-357.5699677
5121,710595783,2-15-24 20:28,199.16,Return,Target Return,-158.4099677
5122,710595783,2-26-24 15:28,489.23,Return,Etsy Return,330.8200323
5123,710595783,03-02-24 15:28,67.58,Purchase,Gas,263.2400323
5124,710595783,03-02-24 19:28,69.65,OutgoingTransfer,Wire Transfer,193.5900323
5125,710595783,03-04-24 21:28,3350,IncomingTransfer,Salary,3543.590032
5126,710595783,03-06-24 9:28,144.69,Deposit,Cash Deposit,3688.280032
5127,710595783,03-09-24 21:28,2700,Payment,Credit Card Payment,988.2800323
5128,710595783,03-09-24 21:28,464.46,Withdrawal,ATM Withdrawal,523.8200323
5129,710595783,03-11-24 10:28,133.22,Withdrawal,Branch Withdrawal,390.6000323
5130,710595783,03-11-24 20:28,345.35,Payment,Bill Payment,45.25003229
5131,710595783,03-11-24 23:28,177.51,Payment,Loan Payment,-132.2599677
5132,710595783,3-13-24 23:28,242.32,Deposit,Mobile Deposit,110.0600323
5133,710595783,3-15-24 21:28,1100,Payment,Rent Payment,-989.9399677
5134,710595783,3-16-24 14:28,382.92,Return,Best Buy Return,-607.0199677
5135,710595783,3-19-24 14:28,37.7,OutgoingTransfer,Bank Transfer,-644.7199677
5136,710595783,3-22-24 11:28,446.74,OnlineShopping,Target,-1091.459968
5137,710595783,3-22-24 12:28,166.55,Withdrawal,Branch Withdrawal,-1258.009968
5138,710595783,3-22-24 15:28,464.3,Purchase,Grocery,-1722.309968
5139,710595783,3-24-24 15:28,104.28,IncomingTransfer,Freelance Payment,-1618.029968
5140,710595783,3-28-24 14:28,361.47,Return,Walmart Return,-1256.559968
5141,710595783,3-28-24 15:28,349.43,Deposit,Mobile Deposit,-907.1299677
5142,710595783,04-01-24 21:28,3350,IncomingTransfer,Salary,2442.870032
5143,710595783,04-04-24 12:28,476.62,Payment,Bill Payment,1966.250032
5144,710595783,04-04-24 19:28,391.08,Purchase,Electronics,1575.170032
5145,710595783,04-05-24 19:28,344.63,Purchase,Furniture,1230.540032
5146,710595783,04-06-24 21:28,2300,Payment,Credit Card Payment,-1069.459968
5147,710595783,04-08-24 15:28,133.3,Deposit,Mobile Deposit,-936.1599677
5148,710595783,4-13-24 21:28,2000,Payment,Rent Payment,-2936.159968
5149,710595783,4-19-24 10:28,498.88,OnlineShopping,eBay,-3435.039968
5150,710595783,4-20-24 20:28,266.91,Return,Amazon Return,-3168.129968
5151,710595783,4-26-24 21:28,454.29,Purchase,Entertainment,-3622.419968
5152,710595783,05-04-24 21:28,188.99,Deposit,Direct Deposit,-3433.429968
5153,710595783,05-05-24 21:28,3350,IncomingTransfer,Salary,-83.42996771
5154,710595783,05-07-24 11:28,285.02,Purchase,Gas,-368.4499677
5155,710595783,05-08-24 16:28,262.83,Deposit,Cash Deposit,-105.6199677
5156,710595783,05-08-24 17:28,466.24,Return,eBay Return,360.6200323
5157,710595783,05-09-24 23:28,116.93,Withdrawal,ATM Withdrawal,243.6900323
5158,710595783,05-10-24 18:28,39.74,Purchase,Entertainment,203.9500323
5159,710595783,05-10-24 21:28,2900,Payment,Credit Card Payment,-2696.049968
5160,710595783,05-11-24 17:28,177.27,Withdrawal,Mobile App Withdrawal,-2873.319968
5161,710595783,05-12-24 17:28,388.36,Payment,Loan Payment,-3261.679968
5162,710595783,05-12-24 21:28,1100,Payment,Rent Payment,-4361.679968
5163,710595783,5-13-24 11:28,446.75,Deposit,Mobile Deposit,-3914.929968
5164,710595783,5-18-24 12:28,101.59,OutgoingTransfer,Peer-to-Peer Transfer,-4016.519968
5165,710595783,5-20-24 9:28,51.49,Purchase,Clothing,-4068.009968
5166,710595783,5-20-24 11:28,353.34,Deposit,Cash Deposit,-3714.669968
5167,710595783,5-21-24 20:28,470.27,Purchase,Pharmacy,-4184.939968
5168,710595783,5-23-24 16:28,378.32,Deposit,Direct Deposit,-3806.619968
5169,710595783,5-26-24 13:28,116.64,OutgoingTransfer,Wire Transfer,-3923.259968
5170,710595783,5-31-24 12:28,81.22,Purchase,Grocery,-4004.479968
5171,710595783,5-31-24 13:28,363.65,Deposit,Check Deposit,-3640.829968
5172,710595783,06-01-24 21:28,3350,IncomingTransfer,Salary,-290.8299677
5173,710595783,06-06-24 17:28,202.38,Payment,Mortgage Payment,-493.2099677
5174,710595783,06-06-24 21:28,2500,Payment,Credit Card Payment,-2993.209968
5175,710595783,06-08-24 16:28,306.88,Payment,Loan Payment,-3300.089968
5176,710595783,06-09-24 14:28,88.25,Deposit,Mobile Deposit,-3211.839968
5177,710595783,06-10-24 21:28,1700,Payment,Rent Payment,-4911.839968
5178,710595783,06-11-24 10:28,280.16,Purchase,Restaurant,-5191.999968
5179,710595783,06-11-24 20:28,495,OnlineShopping,eBay,-5686.999968
5180,710595783,06-12-24 22:28,447.36,Purchase,Home Improvement,-6134.359968
5181,710595783,6-14-24 15:28,62.6,Purchase,Entertainment,-6196.959968
5182,710595783,6-15-24 14:28,71.64,Payment,Bill Payment,-6268.599968
5183,710595783,6-17-24 20:28,40.36,OnlineShopping,eBay,-6308.959968
5184,710595783,6-20-24 19:28,288.41,Return,Amazon Return,-6020.549968
5185,710595783,6-20-24 19:28,427.29,Purchase,Gas,-6447.839968
5186,710595783,6-21-24 15:28,334.2,Purchase,Clothing,-6782.039968
5187,710595783,6-21-24 20:28,430.93,OnlineShopping,Walmart,-7212.969968
5188,710595783,6-23-24 20:28,249.5,Purchase,Travel,-7462.469968
5189,710595783,6-23-24 21:28,218.49,Withdrawal,Mobile App Withdrawal,-7680.959968
5190,710595783,6-25-24 21:28,78.92,Withdrawal,Branch Withdrawal,-7759.879968
5191,710595783,6-26-24 19:28,195.41,Deposit,Mobile Deposit,-7564.469968
5192,710595783,07-02-24 21:28,176.59,Purchase,Home Improvement,-7741.059968
5193,710595783,07-05-24 21:28,3350,IncomingTransfer,Salary,-4391.059968
5194,710595783,07-07-24 22:28,248.09,Deposit,Direct Deposit,-4142.969968
5195,710595783,07-09-24 13:28,187.5,Withdrawal,Branch Withdrawal,-4330.469968
5196,710595783,07-09-24 13:28,317.86,OnlineShopping,Amazon,-4648.329968
5197,710595783,07-09-24 19:28,227.78,Deposit,Mobile Deposit,-4420.549968
5198,710595783,07-10-24 21:28,2400,Payment,Credit Card Payment,-6820.549968
5199,710595783,07-11-24 21:28,1600,Payment,Rent Payment,-8420.549968
5200,710595783,7-14-24 22:28,103.17,Purchase,Entertainment,-8523.719968
5201,710639658,1-20-24 12:28,79.21,IncomingTransfer,Freelance Payment,665.637067
5202,710639658,1-20-24 20:28,200.54,OnlineShopping,Amazon,465.097067
5203,710639658,1-23-24 10:28,105.77,OnlineShopping,Best Buy,359.327067
5204,710639658,1-23-24 20:28,454.36,Payment,Bill Payment,-95.03293304
5205,710639658,1-24-24 21:28,506.74,Payment,Loan Payment,-601.772933
5206,710639658,1-25-24 15:28,72.12,Withdrawal,Branch Withdrawal,-673.892933
5207,710639658,1-29-24 11:28,425.39,Purchase,Grocery,-1099.282933
5208,710639658,1-29-24 16:28,424.5,Purchase,Gas,-1523.782933
5209,710639658,1-30-24 10:28,114.74,Deposit,Direct Deposit,-1409.042933
5210,710639658,1-30-24 21:28,425.78,Return,Store Return,-983.262933
5211,710639658,02-02-24 10:28,515.52,Deposit,Direct Deposit,-467.742933
5212,710639658,02-02-24 21:28,5600,IncomingTransfer,Salary,5132.257067
5213,710639658,02-03-24 14:28,66.62,IncomingTransfer,Freelance Payment,5198.877067
5214,710639658,02-05-24 21:28,428.68,Withdrawal,Branch Withdrawal,4770.197067
5215,710639658,02-05-24 23:28,462.27,OutgoingTransfer,Wire Transfer,4307.927067
5216,710639658,02-07-24 21:28,1100,Payment,Credit Card Payment,3207.927067
5217,710639658,02-09-24 22:28,370.24,Return,Best Buy Return,3578.167067
5218,710639658,02-10-24 11:28,230.73,Purchase,Restaurant,3347.437067
5219,710639658,02-12-24 21:28,2000,Payment,Insurance Payment,1347.437067
5220,710639658,2-19-24 14:28,274.39,Purchase,Home Improvement,1073.047067
5221,710639658,2-23-24 20:28,128.83,Deposit,Check Deposit,1201.877067
5222,710639658,2-24-24 17:28,535.11,Purchase,Furniture,666.767067
5223,710639658,2-26-24 20:28,366.27,Deposit,Direct Deposit,1033.037067
5224,710639658,03-01-24 21:28,536.12,Purchase,Grocery,496.917067
5225,710639658,03-04-24 21:28,5600,IncomingTransfer,Salary,6096.917067
5226,710639658,03-05-24 21:28,161.21,Deposit,Cash Deposit,6258.127067
5227,710639658,03-07-24 13:28,133.28,Payment,Loan Payment,6124.847067
5228,710639658,03-07-24 14:28,406.11,Return,Walmart Return,6530.957067
5229,710639658,03-08-24 16:28,186.77,Purchase,Restaurant,6344.187067
5230,710639658,03-09-24 21:28,1200,Payment,Credit Card Payment,5144.187067
5231,710639658,3-14-24 21:28,1800,Payment,Subscription Payment,3344.187067
5232,710639658,3-19-24 14:28,405.2,Deposit,Cash Deposit,3749.387067
5233,710639658,3-20-24 9:28,269.12,OutgoingTransfer,Wire Transfer,3480.267067
5234,710639658,3-20-24 10:28,208.27,Withdrawal,ATM Withdrawal,3271.997067
5235,710639658,3-25-24 12:28,284.02,Deposit,Mobile Deposit,3556.017067
5236,710639658,3-27-24 20:28,175.27,Withdrawal,ATM Withdrawal,3380.747067
5237,710639658,3-30-24 10:28,361.41,Withdrawal,ATM Withdrawal,3019.337067
5238,710639658,04-01-24 12:28,139.33,Deposit,Cash Deposit,3158.667067
5239,710639658,04-02-24 9:28,519.04,Purchase,Grocery,2639.627067
5240,710639658,04-03-24 10:28,374.59,Payment,Bill Payment,2265.037067
5241,710639658,04-05-24 17:28,320.46,OnlineShopping,Best Buy,1944.577067
5242,710639658,04-05-24 21:28,5600,IncomingTransfer,Salary,7544.577067
5243,710639658,04-06-24 20:28,126.64,IncomingTransfer,Freelance Payment,7671.217067
5244,710639658,04-07-24 22:28,482.19,IncomingTransfer,Freelance Payment,8153.407067
5245,710639658,04-09-24 18:28,464.09,Deposit,Check Deposit,8617.497067
5246,710639658,04-10-24 21:28,1200,Payment,Credit Card Payment,7417.497067
5247,710639658,04-11-24 20:28,315.31,Payment,Mortgage Payment,7102.187067
5248,710639658,04-11-24 21:28,1700,Payment,Installment Payment,5402.187067
5249,710639658,4-15-24 15:28,361.11,OutgoingTransfer,Wire Transfer,5041.077067
5250,710639658,4-16-24 19:28,520.13,Deposit,Mobile Deposit,5561.207067
5251,710639658,4-19-24 14:28,442.99,Payment,Mortgage Payment,5118.217067
5252,710639658,4-24-24 12:28,237.46,Deposit,Check Deposit,5355.677067
5253,710639658,4-25-24 22:28,225.52,Deposit,Mobile Deposit,5581.197067
5254,710639658,4-29-24 22:28,403.66,OnlineShopping,Etsy,5177.537067
5255,710639658,4-29-24 23:28,251.05,Withdrawal,Mobile App Withdrawal,4926.487067
5256,710639658,4-30-24 15:28,450.12,Purchase,Home Improvement,4476.367067
5257,710639658,05-01-24 15:28,309.23,Deposit,Check Deposit,4785.597067
5258,710639658,05-02-24 15:28,267.93,OutgoingTransfer,Wire Transfer,4517.667067
5259,710639658,05-05-24 21:28,5600,IncomingTransfer,Salary,10117.66707
5260,710639658,05-08-24 10:28,542.33,Deposit,Mobile Deposit,10659.99707
5261,710639658,05-08-24 12:28,396.75,OnlineShopping,Target,10263.24707
5262,710639658,05-10-24 21:28,1100,Payment,Credit Card Payment,9163.247067
5263,710639658,05-11-24 22:28,264.09,Withdrawal,Mobile App Withdrawal,8899.157067
5264,710639658,5-16-24 10:28,168.28,Deposit,Cash Deposit,9067.437067
5265,710639658,5-17-24 12:28,443.96,Deposit,Cash Deposit,9511.397067
5266,710639658,5-17-24 12:28,72.97,Deposit,Cash Deposit,9584.367067
5267,710639658,5-17-24 21:28,1400,Payment,Subscription Payment,8184.367067
5268,710639658,5-20-24 11:28,303.04,Withdrawal,Branch Withdrawal,7881.327067
5269,710639658,5-20-24 19:28,122.24,Deposit,Check Deposit,8003.567067
5270,710639658,5-22-24 21:28,266.16,OutgoingTransfer,Peer-to-Peer Transfer,7737.407067
5271,710639658,5-28-24 17:28,512.49,Purchase,Entertainment,7224.917067
5272,710639658,5-30-24 10:28,185.3,Deposit,Mobile Deposit,7410.217067
5273,710639658,06-01-24 17:28,365.99,Deposit,Check Deposit,7776.207067
5274,710639658,06-01-24 21:28,5600,IncomingTransfer,Salary,13376.20707
5275,710639658,06-03-24 15:28,354,Deposit,Mobile Deposit,13730.20707
5276,710639658,06-03-24 18:28,293.18,Deposit,Check Deposit,14023.38707
5277,710639658,06-04-24 21:28,295.56,OnlineShopping,Amazon,13727.82707
5278,710639658,06-06-24 21:28,1100,Payment,Credit Card Payment,12627.82707
5279,710639658,06-07-24 22:28,353.95,OnlineShopping,Amazon,12273.87707
5280,710639658,06-08-24 12:28,295.45,Payment,Loan Payment,11978.42707
5281,710639658,6-16-24 21:28,1900,Payment,Installment Payment,10078.42707
5282,710639658,6-29-24 21:28,520.64,Purchase,Travel,9557.787067
5283,710639658,07-01-24 14:28,532.34,IncomingTransfer,Freelance Payment,10090.12707
5284,710639658,07-01-24 14:28,193.96,Return,Etsy Return,10284.08707
5285,710639658,07-02-24 21:28,5600,IncomingTransfer,Salary,15884.08707
5286,710639658,07-04-24 14:28,73.71,Return,eBay Return,15957.79707
5287,710639658,07-04-24 20:28,488.53,Purchase,Clothing,15469.26707
5288,710639658,07-07-24 21:28,1100,Payment,Credit Card Payment,14369.26707
5289,710639658,07-08-24 13:28,524.54,OutgoingTransfer,Bank Transfer,13844.72707
5290,710639658,07-09-24 13:28,58.51,IncomingTransfer,Freelance Payment,13903.23707
5291,710639658,07-11-24 14:28,456.21,OutgoingTransfer,Wire Transfer,13447.02707
5292,710639658,07-12-24 16:28,416.69,Payment,Loan Payment,13030.33707
5293,710639658,07-12-24 18:28,342.2,Purchase,Entertainment,12688.13707
5294,710639658,7-14-24 12:28,495.47,Payment,Loan Payment,12192.66707
5295,710639658,7-14-24 15:28,482.78,OutgoingTransfer,Wire Transfer,11709.88707
5296,710639658,7-16-24 21:28,1500,Payment,Subscription Payment,10209.88707
5297,710773533,1-21-24 18:28,44.67,Withdrawal,Branch Withdrawal,1380.291833
5298,710773533,1-23-24 10:28,79.69,Withdrawal,Branch Withdrawal,1300.601833
5299,710773533,1-23-24 13:28,126.18,IncomingTransfer,Freelance Payment,1426.781833
5300,710773533,1-24-24 14:28,168.92,Deposit,Direct Deposit,1595.701833
5301,710773533,1-30-24 15:28,112.63,Purchase,Pharmacy,1483.071833
5302,710773533,1-31-24 13:28,87.05,Purchase,Restaurant,1396.021833
5303,710773533,02-02-24 21:28,3250,IncomingTransfer,Salary,4646.021833
5304,710773533,02-03-24 13:28,171.38,Deposit,Mobile Deposit,4817.401833
5305,710773533,02-05-24 10:28,14.38,Return,Walmart Return,4831.781833
5306,710773533,02-05-24 21:28,244.3,Purchase,Restaurant,4587.481833
5307,710773533,02-07-24 19:28,60.78,Payment,Loan Payment,4526.701833
5308,710773533,02-07-24 21:28,1700,Payment,Credit Card Payment,2826.701833
5309,710773533,02-08-24 14:28,184.81,IncomingTransfer,Freelance Payment,3011.511833
5310,710773533,02-09-24 18:28,101.15,OutgoingTransfer,International Transfer,2910.361833
5311,710773533,02-10-24 21:28,1100,Payment,Rent Payment,1810.361833
5312,710773533,2-15-24 20:28,233.86,Purchase,Electronics,1576.501833
5313,710773533,2-20-24 10:28,220.56,Deposit,Check Deposit,1797.061833
5314,710773533,2-22-24 17:28,125.86,OutgoingTransfer,Bank Transfer,1671.201833
5315,710773533,2-27-24 19:28,120.18,Withdrawal,Branch Withdrawal,1551.021833
5316,710773533,2-28-24 15:28,233.55,Payment,Loan Payment,1317.471833
5317,710773533,2-29-24 12:28,156.96,OnlineShopping,AliExpress,1160.511833
5318,710773533,03-01-24 22:28,225.03,Deposit,Cash Deposit,1385.541833
5319,710773533,03-02-24 10:28,115.43,IncomingTransfer,Freelance Payment,1500.971833
5320,710773533,03-03-24 14:28,119.61,Deposit,Cash Deposit,1620.581833
5321,710773533,03-04-24 21:28,3250,IncomingTransfer,Salary,4870.581833
5322,710773533,03-09-24 21:28,2200,Payment,Credit Card Payment,2670.581833
5323,710773533,03-12-24 14:28,98.64,Withdrawal,Mobile App Withdrawal,2571.941833
5324,710773533,3-15-24 12:28,190.31,Purchase,Gas,2381.631833
5325,710773533,3-15-24 21:28,1900,Payment,Rent Payment,481.6318325
5326,710773533,3-17-24 18:28,54.81,Deposit,Check Deposit,536.4418325
5327,710773533,3-27-24 12:28,75.88,Payment,Bill Payment,460.5618325
5328,710773533,3-27-24 17:28,195.1,Purchase,Restaurant,265.4618325
5329,710773533,3-28-24 14:28,71.27,Payment,Mortgage Payment,194.1918325
5330,710773533,3-28-24 20:28,130.74,Payment,Mortgage Payment,63.45183252
5331,710773533,3-29-24 11:28,239.08,Purchase,Entertainment,-175.6281675
5332,710773533,3-29-24 22:28,159.53,OnlineShopping,AliExpress,-335.1581675
5333,710773533,3-30-24 18:28,98.65,Deposit,Cash Deposit,-236.5081675
5334,710773533,04-02-24 15:28,78.16,Return,Target Return,-158.3481675
5335,710773533,04-03-24 21:28,3250,IncomingTransfer,Salary,3091.651833
5336,710773533,04-04-24 9:28,60.32,Purchase,Home Improvement,3031.331833
5337,710773533,04-05-24 17:28,161.51,Payment,Loan Payment,2869.821833
5338,710773533,04-05-24 22:28,134.87,Deposit,Direct Deposit,3004.691833
5339,710773533,04-08-24 11:28,20.86,Purchase,Gas,2983.831833
5340,710773533,04-08-24 19:28,119.26,Withdrawal,Mobile App Withdrawal,2864.571833
5341,710773533,04-08-24 21:28,2300,Payment,Credit Card Payment,564.5718325
5342,710773533,04-09-24 18:28,104.75,OnlineShopping,eBay,459.8218325
5343,710773533,04-09-24 18:28,174.97,Withdrawal,Mobile App Withdrawal,284.8518325
5344,710773533,04-10-24 16:28,189.2,Withdrawal,ATM Withdrawal,95.65183252
5345,710773533,4-15-24 22:28,231,Deposit,Mobile Deposit,326.6518325
5346,710773533,4-18-24 21:28,1600,Payment,Rent Payment,-1273.348167
5347,710773533,4-22-24 15:28,197.12,Withdrawal,Mobile App Withdrawal,-1470.468167
5348,710773533,4-26-24 22:28,124.51,IncomingTransfer,Freelance Payment,-1345.958167
5349,710773533,4-27-24 22:28,176.23,OutgoingTransfer,Wire Transfer,-1522.188167
5350,710773533,05-01-24 14:28,69.94,Deposit,Mobile Deposit,-1452.248167
5351,710773533,05-01-24 22:28,91.22,Return,Store Return,-1361.028167
5352,710773533,05-02-24 21:28,3250,IncomingTransfer,Salary,1888.971833
5353,710773533,05-03-24 17:28,138.48,Purchase,Grocery,1750.491833
5354,710773533,05-06-24 12:28,147.31,Deposit,Check Deposit,1897.801833
5355,710773533,05-07-24 21:28,1800,Payment,Credit Card Payment,97.80183252
5356,710773533,05-08-24 23:28,135.42,Purchase,Grocery,-37.61816748
5357,710773533,05-09-24 18:28,142.07,IncomingTransfer,Freelance Payment,104.4518325
5358,710773533,05-11-24 11:28,94.23,OutgoingTransfer,Peer-to-Peer Transfer,10.22183252
5359,710773533,5-15-24 21:28,1300,Payment,Rent Payment,-1289.778167
5360,710773533,5-16-24 13:28,174.65,Purchase,Pharmacy,-1464.428167
5361,710773533,5-16-24 14:28,118,OutgoingTransfer,Wire Transfer,-1582.428167
5362,710773533,5-16-24 23:28,15.89,Payment,Mortgage Payment,-1598.318167
5363,710773533,5-17-24 23:28,226.58,Deposit,Cash Deposit,-1371.738167
5364,710773533,5-22-24 23:28,118.95,Purchase,Clothing,-1490.688167
5365,710773533,5-23-24 12:28,39.41,Payment,Loan Payment,-1530.098167
5366,710773533,5-25-24 10:28,126.6,OnlineShopping,eBay,-1656.698167
5367,710773533,5-26-24 18:28,20.25,Purchase,Gas,-1676.948167
5368,710773533,5-26-24 21:28,183.61,IncomingTransfer,Freelance Payment,-1493.338167
5369,710773533,5-28-24 12:28,68.64,Purchase,Gas,-1561.978167
5370,710773533,5-30-24 16:28,73.4,Deposit,Check Deposit,-1488.578167
5371,710773533,06-01-24 21:28,3250,IncomingTransfer,Salary,1761.421833
5372,710773533,06-03-24 16:28,62.48,Payment,Loan Payment,1698.941833
5373,710773533,06-05-24 11:28,101.69,Deposit,Cash Deposit,1800.631833
5374,710773533,06-06-24 13:28,135.81,Deposit,Mobile Deposit,1936.441833
5375,710773533,06-06-24 21:28,1600,Payment,Credit Card Payment,336.4418325
5376,710773533,06-08-24 11:28,244.52,OutgoingTransfer,Bank Transfer,91.92183252
5377,710773533,06-08-24 18:28,106.42,Purchase,Electronics,-14.49816748
5378,710773533,6-13-24 16:28,138.92,Purchase,Grocery,-153.4181675
5379,710773533,6-14-24 21:28,1000,Payment,Rent Payment,-1153.418167
5380,710773533,6-20-24 12:28,178.63,Withdrawal,ATM Withdrawal,-1332.048167
5381,710773533,6-22-24 11:28,92.61,Withdrawal,ATM Withdrawal,-1424.658167
5382,710773533,6-23-24 11:28,113.24,Deposit,Check Deposit,-1311.418167
5383,710773533,6-23-24 13:28,202.97,Deposit,Direct Deposit,-1108.448167
5384,710773533,6-23-24 13:28,139.89,Return,Target Return,-968.5581675
5385,710773533,6-26-24 12:28,218.02,IncomingTransfer,Freelance Payment,-750.5381675
5386,710773533,6-28-24 12:28,46.49,IncomingTransfer,Freelance Payment,-704.0481675
5387,710773533,6-29-24 19:28,60.59,Payment,Loan Payment,-764.6381675
5388,710773533,07-01-24 13:28,222.48,Payment,Bill Payment,-987.1181675
5389,710773533,07-01-24 16:28,96.94,Return,eBay Return,-890.1781675
5390,710773533,07-01-24 21:28,3250,IncomingTransfer,Salary,2359.821833
5391,710773533,07-05-24 13:28,75.58,Return,Best Buy Return,2435.401833
5392,710773533,07-06-24 21:28,2200,Payment,Credit Card Payment,235.4018325
5393,710773533,07-07-24 16:28,133.31,Purchase,Clothing,102.0918325
5394,710773533,07-07-24 20:28,114.4,Purchase,Restaurant,-12.30816748
5395,710773533,07-07-24 21:28,83.04,Payment,Loan Payment,-95.34816748
5396,710773533,07-08-24 14:28,54.34,Deposit,Check Deposit,-41.00816748
5397,710773533,07-09-24 15:28,171.78,Withdrawal,Mobile App Withdrawal,-212.7881675
5398,710773533,07-09-24 18:28,217.1,Purchase,Restaurant,-429.8881675
5399,710773533,07-10-24 20:28,239.7,OutgoingTransfer,Wire Transfer,-669.5881675
5400,710773533,07-11-24 17:28,63.4,OutgoingTransfer,International Transfer,-732.9881675
5401,710773533,7-13-24 21:28,2000,Payment,Rent Payment,-2732.988167
5402,710773533,7-16-24 16:28,131.53,Deposit,Mobile Deposit,-2601.458167
5403,710831133,1-22-24 19:28,629.62,Withdrawal,ATM Withdrawal,479.6273324
5404,710831133,1-24-24 12:28,306.44,Deposit,Mobile Deposit,786.0673324
5405,710831133,1-25-24 13:28,362.05,Payment,Bill Payment,424.0173324
5406,710831133,1-28-24 13:28,331.2,Deposit,Direct Deposit,755.2173324
5407,710831133,1-28-24 17:28,734.52,OutgoingTransfer,Bank Transfer,20.69733236
5408,710831133,02-01-24 21:28,7850,IncomingTransfer,Salary,7870.697332
5409,710831133,02-03-24 10:28,268.68,OutgoingTransfer,Bank Transfer,7602.017332
5410,710831133,02-05-24 21:28,602.3,Return,Target Return,8204.317332
5411,710831133,02-06-24 21:28,1900,Payment,Credit Card Payment,6304.317332
5412,710831133,02-10-24 21:28,2400,Payment,Rent Payment,3904.317332
5413,710831133,2-17-24 12:28,509,Withdrawal,Branch Withdrawal,3395.317332
5414,710831133,2-24-24 18:28,712.86,Withdrawal,Mobile App Withdrawal,2682.457332
5415,710831133,2-27-24 19:28,284.43,Payment,Bill Payment,2398.027332
5416,710831133,03-03-24 21:28,7850,IncomingTransfer,Salary,10248.02733
5417,710831133,03-04-24 10:28,242.36,Payment,Mortgage Payment,10005.66733
5418,710831133,03-04-24 11:28,672.03,OutgoingTransfer,Bank Transfer,9333.637332
5419,710831133,03-08-24 21:28,1700,Payment,Credit Card Payment,7633.637332
5420,710831133,03-10-24 15:28,729.77,Return,eBay Return,8363.407332
5421,710831133,3-13-24 21:28,3600,Payment,Rent Payment,4763.407332
5422,710831133,3-15-24 9:28,400.26,Purchase,Restaurant,4363.147332
5423,710831133,3-17-24 20:28,293.99,OnlineShopping,Best Buy,4069.157332
5424,710831133,3-20-24 17:28,534.43,OutgoingTransfer,Wire Transfer,3534.727332
5425,710831133,3-30-24 18:28,122.49,OutgoingTransfer,Bank Transfer,3412.237332
5426,710831133,04-02-24 9:28,317.6,Payment,Loan Payment,3094.637332
5427,710831133,04-03-24 21:28,7850,IncomingTransfer,Salary,10944.63733
5428,710831133,04-04-24 20:28,281.24,OnlineShopping,Best Buy,10663.39733
5429,710831133,04-05-24 11:28,546.89,Purchase,Gas,10116.50733
5430,710831133,04-08-24 21:28,1900,Payment,Credit Card Payment,8216.507332
5431,710831133,04-12-24 19:28,246.03,Withdrawal,Branch Withdrawal,7970.477332
5432,710831133,4-13-24 16:28,701.6,Payment,Loan Payment,7268.877332
5433,710831133,4-15-24 13:28,604.18,Withdrawal,Mobile App Withdrawal,6664.697332
5434,710831133,4-15-24 21:28,4300,Payment,Rent Payment,2364.697332
5435,710831133,4-20-24 19:28,205.31,Return,Amazon Return,2570.007332
5436,710831133,4-21-24 18:28,432.21,Purchase,Entertainment,2137.797332
5437,710831133,4-24-24 17:28,676.77,Return,eBay Return,2814.567332
5438,710831133,05-03-24 23:28,434.91,Purchase,Electronics,2379.657332
5439,710831133,05-05-24 21:28,7850,IncomingTransfer,Salary,10229.65733
5440,710831133,05-08-24 11:28,306.93,Return,AliExpress Return,10536.58733
5441,710831133,05-10-24 21:28,2000,Payment,Credit Card Payment,8536.587332
5442,710831133,05-10-24 21:28,2400,Payment,Rent Payment,6136.587332
5443,710831133,05-12-24 22:28,418.17,OnlineShopping,Walmart,5718.417332
5444,710831133,5-17-24 20:28,532,Withdrawal,ATM Withdrawal,5186.417332
5445,710831133,5-20-24 13:28,164.56,Purchase,Grocery,5021.857332
5446,710831133,5-26-24 20:28,177.41,Purchase,Furniture,4844.447332
5447,710831133,5-31-24 18:28,464.76,Withdrawal,Branch Withdrawal,4379.687332
5448,710831133,06-01-24 15:28,340.13,Deposit,Cash Deposit,4719.817332
5449,710831133,06-04-24 9:28,243.62,Withdrawal,Branch Withdrawal,4476.197332
5450,710831133,06-05-24 21:28,7850,IncomingTransfer,Salary,12326.19733
5451,710831133,06-06-24 16:28,576.58,Return,eBay Return,12902.77733
5452,710831133,06-06-24 22:28,230.2,IncomingTransfer,Freelance Payment,13132.97733
5453,710831133,06-09-24 14:28,195.91,Deposit,Cash Deposit,13328.88733
5454,710831133,06-10-24 21:28,1700,Payment,Credit Card Payment,11628.88733
5455,710831133,06-10-24 21:28,2000,Payment,Rent Payment,9628.887332
5456,710831133,6-15-24 16:28,243.53,OnlineShopping,Etsy,9385.357332
5457,710831133,6-21-24 19:28,101.13,Deposit,Direct Deposit,9486.487332
5458,710831133,6-27-24 14:28,586.13,Withdrawal,Branch Withdrawal,8900.357332
5459,710831133,6-29-24 14:28,411,OutgoingTransfer,International Transfer,8489.357332
5460,710831133,07-03-24 14:28,224.72,Purchase,Grocery,8264.637332
5461,710831133,07-04-24 21:28,7850,IncomingTransfer,Salary,16114.63733
5462,710831133,07-07-24 22:28,566.54,Deposit,Check Deposit,16681.17733
5463,710831133,07-09-24 21:28,1900,Payment,Credit Card Payment,14781.17733
5464,710831133,07-09-24 21:28,659.55,OnlineShopping,Amazon,14121.62733
5465,710831133,07-11-24 21:28,232.82,Purchase,Travel,13888.80733
5466,710831133,7-13-24 22:28,651.17,Payment,Bill Payment,13237.63733
5467,710831133,7-14-24 21:28,2800,Payment,Rent Payment,10437.63733
5468,710845308,1-20-24 17:28,598.15,OutgoingTransfer,Peer-to-Peer Transfer,426.8435156
5469,710845308,1-21-24 15:28,156.33,Payment,Loan Payment,270.5135156
5470,710845308,1-23-24 21:28,297.16,Deposit,Check Deposit,567.6735156
5471,710845308,1-24-24 10:28,113.97,Deposit,Mobile Deposit,681.6435156
5472,710845308,1-25-24 20:28,366.97,Withdrawal,Branch Withdrawal,314.6735156
5473,710845308,1-31-24 14:28,544.92,IncomingTransfer,Freelance Payment,859.5935156
5474,710845308,02-02-24 15:28,293.83,Withdrawal,ATM Withdrawal,565.7635156
5475,710845308,02-03-24 22:28,140.48,Purchase,Grocery,425.2835156
5476,710845308,02-04-24 21:28,8900,IncomingTransfer,Salary,9325.283516
5477,710845308,02-07-24 19:28,303.61,Withdrawal,Mobile App Withdrawal,9021.673516
5478,710845308,02-09-24 21:28,1700,Payment,Credit Card Payment,7321.673516
5479,710845308,02-09-24 21:28,410.93,Return,Best Buy Return,7732.603516
5480,710845308,02-09-24 21:28,389.47,Return,Amazon Return,8122.073516
5481,710845308,02-11-24 19:28,683.04,Deposit,Mobile Deposit,8805.113516
5482,710845308,2-15-24 21:28,5800,Payment,Rent Payment,3005.113516
5483,710845308,2-19-24 9:28,471.31,Deposit,Check Deposit,3476.423516
5484,710845308,2-20-24 21:28,282.11,OutgoingTransfer,Wire Transfer,3194.313516
5485,710845308,2-21-24 10:28,151.1,Deposit,Direct Deposit,3345.413516
5486,710845308,2-21-24 12:28,212.98,OnlineShopping,Walmart,3132.433516
5487,710845308,2-23-24 20:28,603.08,Return,Best Buy Return,3735.513516
5488,710845308,2-24-24 11:28,254.09,Purchase,Home Improvement,3481.423516
5489,710845308,2-24-24 13:28,454.41,IncomingTransfer,Freelance Payment,3935.833516
5490,710845308,2-27-24 22:28,320.04,Payment,Bill Payment,3615.793516
5491,710845308,2-28-24 16:28,369.35,OutgoingTransfer,International Transfer,3246.443516
5492,710845308,2-29-24 12:28,167.54,Deposit,Cash Deposit,3413.983516
5493,710845308,2-29-24 22:28,404.47,Purchase,Restaurant,3009.513516
5494,710845308,03-01-24 16:28,691.69,Payment,Loan Payment,2317.823516
5495,710845308,03-03-24 15:28,214.76,IncomingTransfer,Freelance Payment,2532.583516
5496,710845308,03-05-24 20:28,208.78,Purchase,Gas,2323.803516
5497,710845308,03-05-24 21:28,8900,IncomingTransfer,Salary,11223.80352
5498,710845308,03-05-24 22:28,415.96,OnlineShopping,Walmart,10807.84352
5499,710845308,03-09-24 14:28,351.52,Deposit,Mobile Deposit,11159.36352
5500,710845308,03-09-24 16:28,599.56,Return,Amazon Return,11758.92352
5501,710845308,03-10-24 21:28,1600,Payment,Credit Card Payment,10158.92352
5502,710845308,03-12-24 11:28,701.64,OutgoingTransfer,International Transfer,9457.283516
5503,710845308,3-13-24 11:28,715.48,OnlineShopping,Etsy,8741.803516
5504,710845308,3-13-24 11:28,317.25,IncomingTransfer,Freelance Payment,9059.053516
5505,710845308,3-15-24 9:28,352.93,Purchase,Furniture,8706.123516
5506,710845308,3-16-24 11:28,435.7,Return,Etsy Return,9141.823516
5507,710845308,3-16-24 19:28,625.6,Return,Etsy Return,9767.423516
5508,710845308,3-17-24 21:28,5600,Payment,Rent Payment,4167.423516
5509,710845308,3-18-24 15:28,578.28,Purchase,Gas,3589.143516
5510,710845308,3-21-24 14:28,199.36,OnlineShopping,eBay,3389.783516
5511,710845308,3-22-24 12:28,619.15,OnlineShopping,AliExpress,2770.633516
5512,710845308,3-23-24 19:28,624.15,Payment,Loan Payment,2146.483516
5513,710845308,3-26-24 13:28,680.2,Deposit,Direct Deposit,2826.683516
5514,710845308,3-28-24 20:28,517.96,Withdrawal,ATM Withdrawal,2308.723516
5515,710845308,04-01-24 21:28,8900,IncomingTransfer,Salary,11208.72352
5516,710845308,04-06-24 21:28,1800,Payment,Credit Card Payment,9408.723516
5517,710845308,04-07-24 20:28,686,Deposit,Direct Deposit,10094.72352
5518,710845308,04-08-24 21:28,265.38,Withdrawal,ATM Withdrawal,9829.343516
5519,710845308,04-10-24 11:28,513.91,Deposit,Direct Deposit,10343.25352
5520,710845308,04-10-24 12:28,203.45,OutgoingTransfer,Bank Transfer,10139.80352
5521,710845308,04-10-24 20:28,316.17,Withdrawal,ATM Withdrawal,9823.633516
5522,710845308,04-11-24 21:28,254.96,Deposit,Mobile Deposit,10078.59352
5523,710845308,4-16-24 9:28,265.61,Withdrawal,Branch Withdrawal,9812.983516
5524,710845308,4-16-24 22:28,504.06,Return,Store Return,10317.04352
5525,710845308,4-17-24 17:28,548.78,Deposit,Check Deposit,10865.82352
5526,710845308,4-17-24 19:28,346.72,Withdrawal,ATM Withdrawal,10519.10352
5527,710845308,4-17-24 21:28,4000,Payment,Rent Payment,6519.103516
5528,710845308,4-18-24 14:28,340.13,OutgoingTransfer,Bank Transfer,6178.973516
5529,710845308,4-18-24 21:28,610.43,OnlineShopping,eBay,5568.543516
5530,710845308,4-20-24 13:28,383.65,Purchase,Gas,5184.893516
5531,710845308,4-20-24 22:28,172.34,Purchase,Electronics,5012.553516
5532,710845308,4-21-24 12:28,161.34,Deposit,Check Deposit,5173.893516
5533,710845308,4-22-24 15:28,594.8,Deposit,Direct Deposit,5768.693516
5534,710845308,4-23-24 19:28,223.99,Deposit,Cash Deposit,5992.683516
5535,710845308,4-24-24 19:28,443.2,Purchase,Pharmacy,5549.483516
5536,710845308,4-25-24 9:28,486.55,Withdrawal,Branch Withdrawal,5062.933516
5537,710845308,05-02-24 14:28,407.1,Deposit,Cash Deposit,5470.033516
5538,710845308,05-03-24 11:28,343.82,Payment,Mortgage Payment,5126.213516
5539,710845308,05-04-24 14:28,172.84,IncomingTransfer,Freelance Payment,5299.053516
5540,710845308,05-05-24 21:28,8900,IncomingTransfer,Salary,14199.05352
5541,710845308,05-07-24 14:28,598.77,Return,Amazon Return,14797.82352
5542,710845308,05-07-24 18:28,255.81,Return,Walmart Return,15053.63352
5543,710845308,05-09-24 21:28,603.28,IncomingTransfer,Freelance Payment,15656.91352
5544,710845308,05-10-24 15:28,486.99,Deposit,Mobile Deposit,16143.90352
5545,710845308,05-10-24 21:28,1700,Payment,Credit Card Payment,14443.90352
5546,710845308,5-13-24 13:28,685.37,OnlineShopping,AliExpress,13758.53352
5547,710845308,5-14-24 21:28,3300,Payment,Rent Payment,10458.53352
5548,710845308,5-16-24 23:28,187.95,Withdrawal,Mobile App Withdrawal,10270.58352
5549,710845308,5-17-24 22:28,285.39,Deposit,Cash Deposit,10555.97352
5550,710845308,5-19-24 10:28,427.08,Return,Best Buy Return,10983.05352
5551,710845308,5-19-24 13:28,239.94,Return,Etsy Return,11222.99352
5552,710845308,5-19-24 21:28,327.05,Payment,Loan Payment,10895.94352
5553,710845308,5-20-24 14:28,724.82,Withdrawal,Mobile App Withdrawal,10171.12352
5554,710845308,5-20-24 23:28,260.26,Payment,Mortgage Payment,9910.863516
5555,710845308,5-21-24 18:28,199.43,Deposit,Cash Deposit,10110.29352
5556,710845308,5-24-24 18:28,320.17,Return,Amazon Return,10430.46352
5557,710845308,5-26-24 22:28,364.72,Withdrawal,ATM Withdrawal,10065.74352
5558,710845308,06-01-24 15:28,566.2,Withdrawal,Mobile App Withdrawal,9499.543516
5559,710845308,06-02-24 18:28,672.04,Withdrawal,Branch Withdrawal,8827.503516
5560,710845308,06-04-24 21:28,8900,IncomingTransfer,Salary,17727.50352
5561,710845308,06-05-24 16:28,242.43,Withdrawal,Branch Withdrawal,17485.07352
5562,710845308,06-06-24 20:28,541.46,Payment,Mortgage Payment,16943.61352
5563,710845308,06-07-24 14:28,509.57,Withdrawal,Mobile App Withdrawal,16434.04352
5564,710845308,06-08-24 10:28,729.35,Withdrawal,Mobile App Withdrawal,15704.69352
5565,710845308,06-09-24 21:28,1600,Payment,Credit Card Payment,14104.69352
5566,710845308,06-10-24 9:28,266.26,OutgoingTransfer,Bank Transfer,13838.43352
5567,710845308,06-10-24 14:28,261.63,Withdrawal,Branch Withdrawal,13576.80352
5568,710845308,06-11-24 10:28,133.33,Withdrawal,ATM Withdrawal,13443.47352
5569,710845308,06-11-24 11:28,286.73,Withdrawal,Mobile App Withdrawal,13156.74352
5570,710845308,06-12-24 22:28,294.04,Deposit,Direct Deposit,13450.78352
5571,710845308,6-13-24 11:28,273.45,IncomingTransfer,Freelance Payment,13724.23352
5572,710845308,6-14-24 11:28,334.53,Purchase,Home Improvement,13389.70352
5573,710845308,6-15-24 14:28,203.16,Return,eBay Return,13592.86352
5574,710845308,6-17-24 21:28,3100,Payment,Rent Payment,10492.86352
5575,710845308,6-19-24 20:28,569.87,Return,Store Return,11062.73352
5576,710845308,6-22-24 10:28,230.94,Withdrawal,Branch Withdrawal,10831.79352
5577,710845308,6-24-24 10:28,576.02,Purchase,Furniture,10255.77352
5578,710845308,6-27-24 21:28,136.79,Deposit,Direct Deposit,10392.56352
5579,710845308,6-29-24 16:28,521.73,Deposit,Check Deposit,10914.29352
5580,710845308,6-30-24 14:28,691.14,Purchase,Furniture,10223.15352
5581,710845308,6-30-24 21:28,351.98,Deposit,Check Deposit,10575.13352
5582,710845308,07-02-24 10:28,145.22,Deposit,Mobile Deposit,10720.35352
5583,710845308,07-02-24 12:28,694.51,Purchase,Clothing,10025.84352
5584,710845308,07-02-24 14:28,493.61,Deposit,Mobile Deposit,10519.45352
5585,710845308,07-02-24 23:28,732.84,OnlineShopping,Target,9786.613516
5586,710845308,07-04-24 13:28,186.84,Deposit,Cash Deposit,9973.453516
5587,710845308,07-04-24 21:28,8900,IncomingTransfer,Salary,18873.45352
5588,710845308,07-05-24 9:28,372.15,Purchase,Grocery,18501.30352
5589,710845308,07-09-24 11:28,631.61,Payment,Mortgage Payment,17869.69352
5590,710845308,07-09-24 13:28,606.58,Withdrawal,Branch Withdrawal,17263.11352
5591,710845308,07-09-24 17:28,636.18,Deposit,Check Deposit,17899.29352
5592,710845308,07-09-24 21:28,1400,Payment,Credit Card Payment,16499.29352
5593,710845308,07-11-24 14:28,302.92,Purchase,Furniture,16196.37352
5594,710845308,07-12-24 18:28,605.31,Return,eBay Return,16801.68352
5595,710845308,07-12-24 21:28,3600,Payment,Rent Payment,13201.68352
5596,710845308,07-12-24 23:28,421.59,Withdrawal,ATM Withdrawal,12780.09352
5597,710845308,7-14-24 14:28,108.94,Withdrawal,Branch Withdrawal,12671.15352
5598,710845308,7-16-24 14:28,494.05,Withdrawal,ATM Withdrawal,12177.10352
5599,710854008,1-21-24 12:28,197.3,Withdrawal,Mobile App Withdrawal,719.8446832
5600,710854008,1-22-24 23:28,112.86,Purchase,Entertainment,606.9846832
5601,710854008,1-25-24 11:28,155.74,Withdrawal,ATM Withdrawal,451.2446832
5602,710854008,02-01-24 10:28,261.2,Purchase,Home Improvement,190.0446832
5603,710854008,02-02-24 9:28,86.75,Purchase,Home Improvement,103.2946832
5604,710854008,02-03-24 21:28,4600,IncomingTransfer,Salary,4703.294683
5605,710854008,02-03-24 21:28,184.51,Withdrawal,Mobile App Withdrawal,4518.784683
5606,710854008,02-04-24 19:28,282.24,Deposit,Check Deposit,4801.024683
5607,710854008,02-08-24 20:28,97.55,Deposit,Check Deposit,4898.574683
5608,710854008,02-08-24 21:28,1500,Payment,Credit Card Payment,3398.574683
5609,710854008,02-12-24 22:28,302.38,Payment,Loan Payment,3096.194683
5610,710854008,2-14-24 19:28,326.29,Purchase,Clothing,2769.904683
5611,710854008,2-14-24 21:28,2100,Payment,Rent Payment,669.9046832
5612,710854008,2-22-24 10:28,259.82,Withdrawal,Mobile App Withdrawal,410.0846832
5613,710854008,2-25-24 17:28,225.96,Purchase,Electronics,184.1246832
5614,710854008,03-02-24 20:28,45.64,Return,Store Return,229.7646832
5615,710854008,03-04-24 21:28,4600,IncomingTransfer,Salary,4829.764683
5616,710854008,03-05-24 18:28,73.05,Purchase,Entertainment,4756.714683
5617,710854008,03-07-24 17:28,365.27,Withdrawal,Mobile App Withdrawal,4391.444683
5618,710854008,03-08-24 19:28,21.47,Deposit,Cash Deposit,4412.914683
5619,710854008,03-09-24 21:28,1600,Payment,Credit Card Payment,2812.914683
5620,710854008,03-09-24 22:28,370.45,Purchase,Clothing,2442.464683
5621,710854008,03-10-24 21:28,45.73,OnlineShopping,Etsy,2396.734683
5622,710854008,3-13-24 9:28,99.17,Payment,Loan Payment,2297.564683
5623,710854008,3-16-24 11:28,98.57,Deposit,Direct Deposit,2396.134683
5624,710854008,3-18-24 21:28,1400,Payment,Rent Payment,996.1346832
5625,710854008,3-19-24 15:28,102.5,Withdrawal,Branch Withdrawal,893.6346832
5626,710854008,3-20-24 20:28,67.94,Payment,Bill Payment,825.6946832
5627,710854008,3-20-24 23:28,24.49,Purchase,Home Improvement,801.2046832
5628,710854008,3-22-24 20:28,214.47,IncomingTransfer,Freelance Payment,1015.674683
5629,710854008,3-25-24 14:28,381.54,Withdrawal,Mobile App Withdrawal,634.1346832
5630,710854008,3-25-24 17:28,141.77,OutgoingTransfer,Peer-to-Peer Transfer,492.3646832
5631,710854008,04-02-24 17:28,59.13,Deposit,Check Deposit,551.4946832
5632,710854008,04-03-24 13:28,57.28,Purchase,Electronics,494.2146832
5633,710854008,04-04-24 23:28,290.32,Payment,Mortgage Payment,203.8946832
5634,710854008,04-05-24 21:28,4600,IncomingTransfer,Salary,4803.894683
5635,710854008,04-08-24 16:28,267.42,Purchase,Restaurant,4536.474683
5636,710854008,04-10-24 21:28,1100,Payment,Credit Card Payment,3436.474683
5637,710854008,4-15-24 17:28,264.45,Deposit,Direct Deposit,3700.924683
5638,710854008,4-15-24 21:28,2700,Payment,Rent Payment,1000.924683
5639,710854008,4-21-24 18:28,179.01,Withdrawal,ATM Withdrawal,821.9146832
5640,710854008,4-22-24 20:28,135.17,Payment,Loan Payment,686.7446832
5641,710854008,4-25-24 22:28,386.07,OutgoingTransfer,Wire Transfer,300.6746832
5642,710854008,4-25-24 22:28,107.66,Withdrawal,Branch Withdrawal,193.0146832
5643,710854008,4-26-24 11:28,256.08,Withdrawal,Mobile App Withdrawal,-63.06531683
5644,710854008,4-26-24 23:28,191.26,Purchase,Home Improvement,-254.3253168
5645,710854008,05-04-24 11:28,226.26,Deposit,Mobile Deposit,-28.06531683
5646,710854008,05-04-24 22:28,306.87,Deposit,Direct Deposit,278.8046832
5647,710854008,05-05-24 14:28,327.64,Purchase,Home Improvement,-48.83531683
5648,710854008,05-05-24 21:28,4600,IncomingTransfer,Salary,4551.164683
5649,710854008,05-06-24 21:28,29.18,Deposit,Cash Deposit,4580.344683
5650,710854008,05-09-24 12:28,395.44,Withdrawal,ATM Withdrawal,4184.904683
5651,710854008,05-09-24 16:28,162.43,Purchase,Electronics,4022.474683
5652,710854008,05-09-24 18:28,199.01,Withdrawal,Branch Withdrawal,3823.464683
5653,710854008,05-10-24 21:28,1200,Payment,Credit Card Payment,2623.464683
5654,710854008,5-13-24 21:28,1500,Payment,Rent Payment,1123.464683
5655,710854008,5-16-24 18:28,180.75,Withdrawal,Branch Withdrawal,942.7146832
5656,710854008,5-18-24 20:28,335.68,Purchase,Travel,607.0346832
5657,710854008,5-22-24 13:28,195.7,Return,Target Return,802.7346832
5658,710854008,5-26-24 15:28,200.03,Return,Best Buy Return,1002.764683
5659,710854008,5-31-24 17:28,226.29,Withdrawal,Mobile App Withdrawal,776.4746832
5660,710854008,06-03-24 18:28,134.25,Withdrawal,ATM Withdrawal,642.2246832
5661,710854008,06-03-24 21:28,4600,IncomingTransfer,Salary,5242.224683
5662,710854008,06-06-24 17:28,98.3,Return,Store Return,5340.524683
5663,710854008,06-08-24 21:28,1400,Payment,Credit Card Payment,3940.524683
5664,710854008,06-10-24 15:28,77.21,Return,Amazon Return,4017.734683
5665,710854008,06-10-24 21:28,2800,Payment,Rent Payment,1217.734683
5666,710854008,6-15-24 19:28,254.84,Purchase,Entertainment,962.8946832
5667,710854008,6-18-24 20:28,134.81,OutgoingTransfer,Bank Transfer,828.0846832
5668,710854008,6-19-24 22:28,234.34,Deposit,Mobile Deposit,1062.424683
5669,710854008,6-20-24 15:28,47.12,IncomingTransfer,Freelance Payment,1109.544683
5670,710854008,6-22-24 13:28,61.9,IncomingTransfer,Freelance Payment,1171.444683
5671,710854008,6-22-24 15:28,205.85,Payment,Bill Payment,965.5946832
5672,710854008,6-22-24 19:28,345.35,Withdrawal,Mobile App Withdrawal,620.2446832
5673,710854008,07-01-24 21:28,129.01,Deposit,Direct Deposit,749.2546832
5674,710854008,07-05-24 21:28,4600,IncomingTransfer,Salary,5349.254683
5675,710854008,07-10-24 21:28,1200,Payment,Credit Card Payment,4149.254683
5676,710854008,07-12-24 17:28,39.23,Withdrawal,ATM Withdrawal,4110.024683
5677,710854008,07-12-24 19:28,100.8,Payment,Mortgage Payment,4009.224683
5678,710854008,7-17-24 20:28,124.35,Deposit,Check Deposit,4133.574683
5679,710854008,7-18-24 21:28,1800,Payment,Rent Payment,2333.574683
5680,710897133,1-23-24 23:28,203.46,OnlineShopping,Etsy,739.7745712
5681,710897133,1-25-24 20:28,167.64,Payment,Mortgage Payment,572.1345712
5682,710897133,1-27-24 19:28,214.37,OnlineShopping,Walmart,357.7645712
5683,710897133,1-29-24 16:28,40.01,Purchase,Home Improvement,317.7545712
5684,710897133,1-29-24 18:28,244.78,OnlineShopping,Etsy,72.9745712
5685,710897133,1-30-24 21:28,107.07,Return,eBay Return,180.0445712
5686,710897133,02-04-24 13:28,217.79,Withdrawal,Mobile App Withdrawal,-37.7454288
5687,710897133,02-04-24 18:28,150,OnlineShopping,Target,-187.7454288
5688,710897133,02-05-24 21:28,1900,IncomingTransfer,Salary,1712.254571
5689,710897133,02-09-24 13:28,154.78,Purchase,Clothing,1557.474571
5690,710897133,02-09-24 17:28,118.21,Payment,Bill Payment,1439.264571
5691,710897133,02-10-24 21:28,1700,Payment,Credit Card Payment,-260.7354288
5692,710897133,02-10-24 21:28,700,Payment,Insurance Payment,-960.7354288
5693,710897133,02-11-24 17:28,134.21,Return,AliExpress Return,-826.5254288
5694,710897133,02-12-24 17:28,163.28,Return,Etsy Return,-663.2454288
5695,710897133,2-17-24 12:28,116.06,Return,Store Return,-547.1854288
5696,710897133,2-19-24 15:28,240.65,OnlineShopping,Amazon,-787.8354288
5697,710897133,2-23-24 16:28,35.66,OutgoingTransfer,Wire Transfer,-823.4954288
5698,710897133,2-23-24 23:28,13.83,OutgoingTransfer,Peer-to-Peer Transfer,-837.3254288
5699,710897133,2-28-24 21:28,249.72,Purchase,Electronics,-1087.045429
5700,710897133,03-01-24 9:28,184.49,Deposit,Direct Deposit,-902.5554288
5701,710897133,03-01-24 21:28,1900,IncomingTransfer,Salary,997.4445712
5702,710897133,03-02-24 13:28,127.33,Withdrawal,Branch Withdrawal,870.1145712
5703,710897133,03-02-24 19:28,12.16,Deposit,Cash Deposit,882.2745712
5704,710897133,03-06-24 21:28,1700,Payment,Credit Card Payment,-817.7254288
5705,710897133,03-08-24 12:28,198.33,OutgoingTransfer,Peer-to-Peer Transfer,-1016.055429
5706,710897133,03-08-24 12:28,71.13,Return,Etsy Return,-944.9254288
5707,710897133,03-09-24 13:28,211.45,Deposit,Direct Deposit,-733.4754288
5708,710897133,03-10-24 21:28,500,Payment,Insurance Payment,-1233.475429
5709,710897133,03-12-24 15:28,73.6,OutgoingTransfer,Wire Transfer,-1307.075429
5710,710897133,03-12-24 18:28,45.36,Withdrawal,Branch Withdrawal,-1352.435429
5711,710897133,03-12-24 21:28,33.66,Purchase,Pharmacy,-1386.095429
5712,710897133,3-13-24 9:28,207.55,OutgoingTransfer,Bank Transfer,-1593.645429
5713,710897133,3-15-24 22:28,149.08,Return,eBay Return,-1444.565429
5714,710897133,3-18-24 23:28,92.94,Deposit,Direct Deposit,-1351.625429
5715,710897133,3-19-24 17:28,223.35,Purchase,Travel,-1574.975429
5716,710897133,3-19-24 18:28,241.43,Deposit,Check Deposit,-1333.545429
5717,710897133,3-22-24 9:28,133.98,Deposit,Direct Deposit,-1199.565429
5718,710897133,3-25-24 10:28,101.81,OutgoingTransfer,Wire Transfer,-1301.375429
5719,710897133,3-30-24 12:28,27.95,Deposit,Cash Deposit,-1273.425429
5720,710897133,3-31-24 15:28,185.54,Deposit,Mobile Deposit,-1087.885429
5721,710897133,04-01-24 14:28,184.89,Purchase,Restaurant,-1272.775429
5722,710897133,04-02-24 18:28,207.41,Purchase,Home Improvement,-1480.185429
5723,710897133,04-02-24 21:28,1900,IncomingTransfer,Salary,419.8145712
5724,710897133,04-03-24 13:28,110.79,Withdrawal,Branch Withdrawal,309.0245712
5725,710897133,04-03-24 23:28,141.67,Purchase,Restaurant,167.3545712
5726,710897133,04-07-24 21:28,1700,Payment,Credit Card Payment,-1532.645429
5727,710897133,04-11-24 20:28,169.71,Deposit,Cash Deposit,-1362.935429
5728,710897133,04-11-24 21:28,600,Payment,Installment Payment,-1962.935429
5729,710897133,4-13-24 11:28,37.65,Payment,Loan Payment,-2000.585429
5730,710897133,4-16-24 21:28,132.86,OnlineShopping,Amazon,-2133.445429
5731,710897133,4-18-24 10:28,73.24,OnlineShopping,Best Buy,-2206.685429
5732,710897133,4-20-24 13:28,43.13,OnlineShopping,AliExpress,-2249.815429
5733,710897133,4-20-24 20:28,206.55,OutgoingTransfer,Wire Transfer,-2456.365429
5734,710897133,4-26-24 11:28,59.44,OnlineShopping,Amazon,-2515.805429
5735,710897133,4-29-24 14:28,210.56,OnlineShopping,AliExpress,-2726.365429
5736,710897133,4-29-24 14:28,157.22,Deposit,Direct Deposit,-2569.145429
5737,710897133,05-01-24 13:28,162.13,OnlineShopping,eBay,-2731.275429
5738,710897133,05-01-24 15:28,229.92,Payment,Loan Payment,-2961.195429
5739,710897133,05-02-24 12:28,201.63,OnlineShopping,Walmart,-3162.825429
5740,710897133,05-04-24 16:28,93.2,OutgoingTransfer,International Transfer,-3256.025429
5741,710897133,05-04-24 21:28,1900,IncomingTransfer,Salary,-1356.025429
5742,710897133,05-06-24 9:28,164.81,OnlineShopping,Best Buy,-1520.835429
5743,710897133,05-08-24 11:28,96.67,Payment,Mortgage Payment,-1617.505429
5744,710897133,05-09-24 9:28,46.27,Payment,Bill Payment,-1663.775429
5745,710897133,05-09-24 21:28,1600,Payment,Credit Card Payment,-3263.775429
5746,710897133,05-10-24 12:28,226.66,Deposit,Cash Deposit,-3037.115429
5747,710897133,05-11-24 21:28,600,Payment,Installment Payment,-3637.115429
5748,710897133,05-12-24 19:28,154.44,Withdrawal,ATM Withdrawal,-3791.555429
5749,710897133,5-14-24 13:28,232.03,Deposit,Mobile Deposit,-3559.525429
5750,710897133,5-27-24 12:28,200.8,Withdrawal,Branch Withdrawal,-3760.325429
5751,710897133,5-28-24 20:28,87.25,IncomingTransfer,Freelance Payment,-3673.075429
5752,710897133,5-30-24 18:28,110.16,Deposit,Direct Deposit,-3562.915429
5753,710897133,5-31-24 17:28,26.54,OnlineShopping,Etsy,-3589.455429
5754,710897133,5-31-24 21:28,107.53,Payment,Loan Payment,-3696.985429
5755,710897133,5-31-24 21:28,65.12,OnlineShopping,Amazon,-3762.105429
5756,710897133,06-03-24 21:28,1900,IncomingTransfer,Salary,-1862.105429
5757,710897133,06-05-24 13:28,23.11,OnlineShopping,Walmart,-1885.215429
5758,710897133,06-05-24 14:28,165.77,Deposit,Check Deposit,-1719.445429
5759,710897133,06-06-24 14:28,76.22,Purchase,Furniture,-1795.665429
5760,710897133,06-08-24 21:28,1600,Payment,Credit Card Payment,-3395.665429
5761,710897133,06-09-24 10:28,150.88,Return,Target Return,-3244.785429
5762,710897133,06-09-24 20:28,198.04,Deposit,Direct Deposit,-3046.745429
5763,710897133,06-11-24 17:28,201.35,Deposit,Mobile Deposit,-2845.395429
5764,710897133,6-13-24 15:28,139.6,Deposit,Check Deposit,-2705.795429
5765,710897133,6-13-24 20:28,55.76,Deposit,Cash Deposit,-2650.035429
5766,710897133,6-14-24 22:28,120.91,Payment,Loan Payment,-2770.945429
5767,710897133,6-15-24 21:28,600,Payment,Insurance Payment,-3370.945429
5768,710897133,6-17-24 10:28,200.68,Return,Target Return,-3170.265429
5769,710897133,6-17-24 13:28,158.84,Withdrawal,Branch Withdrawal,-3329.105429
5770,710897133,6-20-24 10:28,149.09,Return,Etsy Return,-3180.015429
5771,710897133,6-20-24 16:28,187.76,Return,Store Return,-2992.255429
5772,710897133,6-22-24 22:28,204.78,OutgoingTransfer,Bank Transfer,-3197.035429
5773,710897133,6-30-24 11:28,120.61,Return,Best Buy Return,-3076.425429
5774,710897133,07-04-24 9:28,241.62,OnlineShopping,Amazon,-3318.045429
5775,710897133,07-04-24 15:28,157.9,Withdrawal,Branch Withdrawal,-3475.945429
5776,710897133,07-05-24 21:28,1900,IncomingTransfer,Salary,-1575.945429
5777,710897133,07-10-24 9:28,101.5,OnlineShopping,Target,-1677.445429
5778,710897133,07-10-24 21:28,1700,Payment,Credit Card Payment,-3377.445429
5779,710897133,7-13-24 21:28,500,Payment,Subscription Payment,-3877.445429
5780,710897133,7-14-24 10:28,243.17,Purchase,Electronics,-4120.615429
5781,710897133,7-16-24 9:28,99.58,Deposit,Direct Deposit,-4021.035429
5782,710897133,7-17-24 21:28,137.97,Withdrawal,Branch Withdrawal,-4159.005429
5783,711069483,1-22-24 23:28,217.53,OnlineShopping,Walmart,-217.53
5784,711069483,1-24-24 11:28,171.67,OnlineShopping,Target,-389.2
5785,711069483,1-26-24 13:28,199.59,IncomingTransfer,Freelance Payment,-189.61
5786,711069483,1-27-24 15:28,108.92,OnlineShopping,Target,-298.53
5787,711069483,1-28-24 15:28,249.57,IncomingTransfer,Freelance Payment,-48.96
5788,711069483,1-29-24 15:28,190.44,OutgoingTransfer,Wire Transfer,-239.4
5789,711069483,02-04-24 18:28,13.98,OnlineShopping,Etsy,-253.38
5790,711069483,02-07-24 9:28,99.26,OutgoingTransfer,Peer-to-Peer Transfer,-352.64
5791,711069483,02-07-24 11:28,225.25,OutgoingTransfer,Bank Transfer,-577.89
5792,711069483,02-07-24 12:28,70.26,Purchase,Entertainment,-648.15
5793,711069483,2-14-24 12:28,149.55,Withdrawal,ATM Withdrawal,-797.7
5794,711069483,2-14-24 19:28,109.03,Payment,Loan Payment,-906.73
5795,711069483,2-15-24 11:28,166.15,Payment,Mortgage Payment,-1072.88
5796,711069483,2-16-24 17:28,74.37,IncomingTransfer,Freelance Payment,-998.51
5797,711069483,2-20-24 17:28,186.65,OnlineShopping,Target,-1185.16
5798,711069483,2-25-24 16:28,137.39,OnlineShopping,Etsy,-1322.55
5799,711069483,2-26-24 13:28,170.22,Payment,Bill Payment,-1492.77
5800,711069483,2-27-24 11:28,85.49,OutgoingTransfer,Wire Transfer,-1578.26
5801,711069483,2-29-24 20:28,114.7,Withdrawal,Branch Withdrawal,-1692.96
5802,711069483,03-03-24 18:28,139.14,Deposit,Mobile Deposit,-1553.82
5803,711069483,03-04-24 17:28,245.96,Purchase,Travel,-1799.78
5804,711069483,03-05-24 18:28,189.93,Return,Walmart Return,-1609.85
5805,711069483,03-07-24 19:28,134.64,OutgoingTransfer,International Transfer,-1744.49
5806,711069483,03-08-24 20:28,48.25,Purchase,Pharmacy,-1792.74
5807,711069483,03-09-24 16:28,87.76,OutgoingTransfer,Wire Transfer,-1880.5
5808,711069483,03-10-24 16:28,249.51,Deposit,Check Deposit,-1630.99
5809,711069483,3-13-24 11:28,231.21,Deposit,Mobile Deposit,-1399.78
5810,711069483,3-13-24 13:28,44.22,OutgoingTransfer,Bank Transfer,-1444
5811,711069483,3-14-24 14:28,201.74,Deposit,Check Deposit,-1242.26
5812,711069483,3-14-24 19:28,196.6,OutgoingTransfer,Peer-to-Peer Transfer,-1438.86
5813,711069483,3-16-24 19:28,243.45,Payment,Bill Payment,-1682.31
5814,711069483,3-23-24 16:28,182.87,Withdrawal,ATM Withdrawal,-1865.18
5815,711069483,3-24-24 21:28,89.16,Deposit,Check Deposit,-1776.02
5816,711069483,3-24-24 22:28,194.59,IncomingTransfer,Freelance Payment,-1581.43
5817,711069483,3-26-24 9:28,135.18,Return,Store Return,-1446.25
5818,711069483,3-26-24 16:28,111.56,OutgoingTransfer,Bank Transfer,-1557.81
5819,711069483,3-28-24 17:28,247.59,IncomingTransfer,Freelance Payment,-1310.22
5820,711069483,04-07-24 14:28,223.16,OutgoingTransfer,International Transfer,-1533.38
5821,711069483,04-11-24 21:28,53.17,Withdrawal,ATM Withdrawal,-1586.55
5822,711069483,04-12-24 14:28,197.7,Purchase,Entertainment,-1784.25
5823,711069483,4-13-24 18:28,144.45,OutgoingTransfer,Bank Transfer,-1928.7
5824,711069483,4-16-24 14:28,158.59,Payment,Bill Payment,-2087.29
5825,711069483,4-16-24 22:28,242.67,Deposit,Check Deposit,-1844.62
5826,711069483,4-18-24 23:28,119.79,Payment,Mortgage Payment,-1964.41
5827,711069483,4-20-24 16:28,98.56,Payment,Mortgage Payment,-2062.97
5828,711069483,4-20-24 21:28,160.31,Return,Target Return,-1902.66
5829,711069483,4-21-24 16:28,116.08,OutgoingTransfer,International Transfer,-2018.74
5830,711069483,4-22-24 15:28,45.97,Deposit,Cash Deposit,-1972.77
5831,711069483,4-24-24 18:28,70.78,IncomingTransfer,Freelance Payment,-1901.99
5832,711069483,4-25-24 17:28,117.18,Purchase,Grocery,-2019.17
5833,711069483,4-27-24 13:28,35.79,OutgoingTransfer,Wire Transfer,-2054.96
5834,711069483,05-03-24 13:28,73.96,OnlineShopping,Best Buy,-2128.92
5835,711069483,05-04-24 10:28,107.64,Purchase,Electronics,-2236.56
5836,711069483,05-05-24 10:28,68.68,Purchase,Pharmacy,-2305.24
5837,711069483,05-07-24 13:28,10.39,Purchase,Entertainment,-2315.63
5838,711069483,5-16-24 11:28,144.61,Deposit,Cash Deposit,-2171.02
5839,711069483,5-18-24 13:28,231.91,Withdrawal,Branch Withdrawal,-2402.93
5840,711069483,06-02-24 20:28,196.23,Purchase,Travel,-2599.16
5841,711069483,06-05-24 17:28,187.93,OnlineShopping,Walmart,-2787.09
5842,711069483,06-05-24 23:28,56.57,Deposit,Cash Deposit,-2730.52
5843,711069483,06-07-24 22:28,192.78,Deposit,Cash Deposit,-2537.74
5844,711069483,06-08-24 17:28,71.34,Deposit,Cash Deposit,-2466.4
5845,711069483,6-13-24 17:28,36.92,OnlineShopping,eBay,-2503.32
5846,711069483,6-15-24 21:28,130.9,OnlineShopping,Best Buy,-2634.22
5847,711069483,6-17-24 10:28,187.5,Payment,Loan Payment,-2821.72
5848,711069483,6-19-24 13:28,152.27,OutgoingTransfer,Peer-to-Peer Transfer,-2973.99
5849,711069483,6-25-24 10:28,224.91,Purchase,Clothing,-3198.9
5850,711069483,6-25-24 20:28,152.47,Payment,Bill Payment,-3351.37
5851,711069483,6-30-24 10:28,157.25,Withdrawal,Branch Withdrawal,-3508.62
5852,711069483,6-30-24 13:28,157.17,OutgoingTransfer,International Transfer,-3665.79
5853,711069483,07-03-24 11:28,132.65,Payment,Loan Payment,-3798.44
5854,711069483,07-04-24 20:28,35.75,Purchase,Gas,-3834.19
5855,711069483,07-05-24 14:28,119.78,Payment,Mortgage Payment,-3953.97
5856,711069483,07-09-24 12:28,84.67,Deposit,Direct Deposit,-3869.3
5857,711069483,07-09-24 16:28,115.08,Purchase,Grocery,-3984.38
5858,711069483,07-12-24 12:28,160.2,Payment,Bill Payment,-4144.58
5859,711069483,7-14-24 21:28,205.43,Deposit,Mobile Deposit,-3939.15
5860,711069483,7-16-24 23:28,125.12,Deposit,Mobile Deposit,-3814.03
5861,711069483,7-17-24 17:28,91.19,OutgoingTransfer,Wire Transfer,-3905.22
5862,711080358,1-24-24 12:28,885.21,Purchase,Furniture,223.8729717
5863,711080358,1-27-24 13:28,454.4,Deposit,Direct Deposit,678.2729717
5864,711080358,1-29-24 13:28,727.81,Withdrawal,ATM Withdrawal,-49.53702835
5865,711080358,02-04-24 21:28,10950,IncomingTransfer,Salary,10900.46297
5866,711080358,02-06-24 9:28,740.5,Withdrawal,Mobile App Withdrawal,10159.96297
5867,711080358,02-09-24 21:28,2700,Payment,Credit Card Payment,7459.962972
5868,711080358,02-10-24 21:28,5800,Payment,Rent Payment,1659.962972
5869,711080358,2-18-24 22:28,848.12,Payment,Bill Payment,811.8429717
5870,711080358,2-23-24 14:28,332.73,Deposit,Cash Deposit,1144.572972
5871,711080358,2-23-24 18:28,655.1,Withdrawal,Mobile App Withdrawal,489.4729717
5872,711080358,2-27-24 20:28,601.23,Deposit,Check Deposit,1090.702972
5873,711080358,2-28-24 19:28,441.32,OnlineShopping,AliExpress,649.3829717
5874,711080358,03-02-24 11:28,634.15,Withdrawal,Branch Withdrawal,15.23297165
5875,711080358,03-02-24 20:28,419.83,Payment,Bill Payment,-404.5970283
5876,711080358,03-02-24 21:28,878.33,Purchase,Restaurant,-1282.927028
5877,711080358,03-03-24 12:28,276.7,Purchase,Grocery,-1559.627028
5878,711080358,03-05-24 21:28,10950,IncomingTransfer,Salary,9390.372972
5879,711080358,03-10-24 21:28,2200,Payment,Credit Card Payment,7190.372972
5880,711080358,03-11-24 14:28,701.78,OnlineShopping,Target,6488.592972
5881,711080358,03-12-24 21:28,5500,Payment,Rent Payment,988.5929717
5882,711080358,3-15-24 12:28,765.11,Return,Amazon Return,1753.702972
5883,711080358,3-15-24 19:28,481.92,Deposit,Mobile Deposit,2235.622972
5884,711080358,3-21-24 13:28,605.73,Withdrawal,ATM Withdrawal,1629.892972
5885,711080358,3-22-24 9:28,231.53,Deposit,Check Deposit,1861.422972
5886,711080358,3-25-24 16:28,536.83,OnlineShopping,eBay,1324.592972
5887,711080358,3-28-24 10:28,855.65,Purchase,Grocery,468.9429717
5888,711080358,3-30-24 14:28,375.96,Withdrawal,Branch Withdrawal,92.98297165
5889,711080358,3-31-24 19:28,906.78,IncomingTransfer,Freelance Payment,999.7629717
5890,711080358,04-04-24 14:28,727.78,Deposit,Direct Deposit,1727.542972
5891,711080358,04-04-24 21:28,10950,IncomingTransfer,Salary,12677.54297
5892,711080358,04-04-24 21:28,546.72,IncomingTransfer,Freelance Payment,13224.26297
5893,711080358,04-05-24 18:28,227.34,Purchase,Travel,12996.92297
5894,711080358,04-07-24 11:28,646.76,OnlineShopping,Etsy,12350.16297
5895,711080358,04-08-24 13:28,489.69,Purchase,Travel,11860.47297
5896,711080358,04-09-24 21:28,2300,Payment,Credit Card Payment,9560.472972
5897,711080358,04-11-24 16:28,846.27,IncomingTransfer,Freelance Payment,10406.74297
5898,711080358,4-14-24 14:28,406.07,Deposit,Check Deposit,10812.81297
5899,711080358,4-16-24 21:28,6000,Payment,Rent Payment,4812.812972
5900,711080358,4-17-24 14:28,558.72,Return,AliExpress Return,5371.532972
5901,711080358,4-23-24 17:28,433.08,Purchase,Pharmacy,4938.452972
5902,711080358,4-27-24 12:28,359.74,Return,Amazon Return,5298.192972
5903,711080358,4-28-24 18:28,266.39,Return,AliExpress Return,5564.582972
5904,711080358,4-30-24 18:28,728.92,Deposit,Check Deposit,6293.502972
5905,711080358,05-01-24 21:28,10950,IncomingTransfer,Salary,17243.50297
5906,711080358,05-04-24 18:28,559.34,Return,Amazon Return,17802.84297
5907,711080358,05-06-24 21:28,2700,Payment,Credit Card Payment,15102.84297
5908,711080358,05-07-24 23:28,805.69,Deposit,Cash Deposit,15908.53297
5909,711080358,05-08-24 21:28,949.12,Purchase,Entertainment,14959.41297
5910,711080358,05-11-24 21:28,6100,Payment,Rent Payment,8859.412972
5911,711080358,05-12-24 11:28,553,Withdrawal,Branch Withdrawal,8306.412972
5912,711080358,5-14-24 9:28,771.96,Purchase,Home Improvement,7534.452972
5913,711080358,5-16-24 19:28,629.41,Purchase,Clothing,6905.042972
5914,711080358,5-16-24 20:28,336.7,OutgoingTransfer,International Transfer,6568.342972
5915,711080358,5-21-24 12:28,576.8,Deposit,Cash Deposit,7145.142972
5916,711080358,5-21-24 17:28,846.5,OutgoingTransfer,International Transfer,6298.642972
5917,711080358,5-22-24 13:28,848.07,Withdrawal,Mobile App Withdrawal,5450.572972
5918,711080358,5-23-24 20:28,288.69,Purchase,Clothing,5161.882972
5919,711080358,5-27-24 10:28,253.44,Withdrawal,Branch Withdrawal,4908.442972
5920,711080358,5-28-24 17:28,205.77,Deposit,Cash Deposit,5114.212972
5921,711080358,06-01-24 10:28,528.56,Withdrawal,Branch Withdrawal,4585.652972
5922,711080358,06-02-24 20:28,202.99,Withdrawal,ATM Withdrawal,4382.662972
5923,711080358,06-02-24 21:28,10950,IncomingTransfer,Salary,15332.66297
5924,711080358,06-06-24 11:28,239.14,Purchase,Home Improvement,15093.52297
5925,711080358,06-07-24 17:28,934.31,OnlineShopping,Best Buy,14159.21297
5926,711080358,06-07-24 21:28,3300,Payment,Credit Card Payment,10859.21297
5927,711080358,06-11-24 16:28,728.04,Withdrawal,Branch Withdrawal,10131.17297
5928,711080358,6-13-24 16:28,644.39,Purchase,Furniture,9486.782972
5929,711080358,6-14-24 21:28,776.98,OnlineShopping,Walmart,8709.802972
5930,711080358,6-15-24 16:28,699.2,Withdrawal,ATM Withdrawal,8010.602972
5931,711080358,6-17-24 13:28,736.96,Payment,Bill Payment,7273.642972
5932,711080358,6-17-24 16:28,554.87,Withdrawal,ATM Withdrawal,6718.772972
5933,711080358,6-18-24 21:28,4200,Payment,Rent Payment,2518.772972
5934,711080358,6-23-24 11:28,775.05,Withdrawal,Mobile App Withdrawal,1743.722972
5935,711080358,6-29-24 11:28,909.85,Deposit,Direct Deposit,2653.572972
5936,711080358,07-02-24 21:28,10950,IncomingTransfer,Salary,13603.57297
5937,711080358,07-07-24 21:28,3200,Payment,Credit Card Payment,10403.57297
5938,711080358,07-09-24 13:28,812.17,OnlineShopping,Target,9591.402972
5939,711080358,07-12-24 11:28,225.48,Deposit,Cash Deposit,9816.882972
5940,711080358,7-13-24 10:28,696.9,Purchase,Clothing,9119.982972
5941,711080358,7-13-24 21:28,7100,Payment,Rent Payment,2019.982972
5942,711080358,7-14-24 11:28,592.93,OutgoingTransfer,Bank Transfer,1427.052972
5943,711080358,7-15-24 13:28,492.43,Withdrawal,ATM Withdrawal,934.6229717
5944,711080358,7-15-24 14:28,923.11,Purchase,Restaurant,11.51297165
5945,711080358,7-17-24 9:28,267.66,Deposit,Direct Deposit,279.1729717
5946,711232608,1-25-24 23:28,192.77,Deposit,Direct Deposit,192.77
5947,711232608,1-26-24 11:28,31.41,Payment,Mortgage Payment,161.36
5948,711232608,1-27-24 16:28,63.69,Purchase,Travel,97.67
5949,711232608,02-01-24 21:28,2250,IncomingTransfer,Salary,2347.67
5950,711232608,02-02-24 19:28,115.16,Withdrawal,Mobile App Withdrawal,2232.51
5951,711232608,02-08-24 16:28,131.78,Deposit,Cash Deposit,2364.29
5952,711232608,02-10-24 14:28,21.75,OnlineShopping,Walmart,2342.54
5953,711232608,02-11-24 13:28,224.06,Return,Walmart Return,2566.6
5954,711232608,02-11-24 21:28,1000,Payment,Subscription Payment,1566.6
5955,711232608,2-19-24 16:28,192.69,Withdrawal,Mobile App Withdrawal,1373.91
5956,711232608,2-22-24 19:28,171.54,Purchase,Grocery,1202.37
5957,711232608,03-03-24 21:28,2250,IncomingTransfer,Salary,3452.37
5958,711232608,03-04-24 22:28,195.32,Purchase,Furniture,3257.05
5959,711232608,03-07-24 10:28,151.21,Purchase,Gas,3105.84
5960,711232608,3-13-24 10:28,126.37,Payment,Loan Payment,2979.47
5961,711232608,3-17-24 21:28,800,Payment,Insurance Payment,2179.47
5962,711232608,3-28-24 17:28,44.76,Withdrawal,Branch Withdrawal,2134.71
5963,711232608,3-30-24 17:28,222.56,Purchase,Entertainment,1912.15
5964,711232608,04-03-24 21:28,2250,IncomingTransfer,Salary,4162.15
5965,711232608,04-06-24 10:28,50.08,Purchase,Entertainment,4112.07
5966,711232608,04-08-24 12:28,67.37,Purchase,Clothing,4044.7
5967,711232608,04-11-24 11:28,223.86,IncomingTransfer,Freelance Payment,4268.56
5968,711232608,04-11-24 21:28,1000,Payment,Installment Payment,3268.56
5969,711232608,4-20-24 10:28,76.44,Deposit,Check Deposit,3345
5970,711232608,4-20-24 17:28,44.5,Return,Best Buy Return,3389.5
5971,711232608,4-28-24 20:28,99.72,Deposit,Check Deposit,3489.22
5972,711232608,05-02-24 21:28,2250,IncomingTransfer,Salary,5739.22
5973,711232608,05-08-24 19:28,12.64,Return,Best Buy Return,5751.86
5974,711232608,05-10-24 17:28,87.25,Return,Amazon Return,5839.11
5975,711232608,5-13-24 9:28,12.35,Deposit,Cash Deposit,5851.46
5976,711232608,5-13-24 21:28,1000,Payment,Installment Payment,4851.46
5977,711232608,5-15-24 15:28,196.22,Deposit,Check Deposit,5047.68
5978,711232608,5-17-24 9:28,174.37,Return,Store Return,5222.05
5979,711232608,5-18-24 14:28,190.21,Purchase,Grocery,5031.84
5980,711232608,5-21-24 19:28,60.05,Payment,Mortgage Payment,4971.79
5981,711232608,5-25-24 12:28,162.64,Withdrawal,ATM Withdrawal,4809.15
5982,711232608,5-26-24 10:28,238.38,Payment,Bill Payment,4570.77
5983,711232608,5-26-24 12:28,170.22,Return,Target Return,4740.99
5984,711232608,5-28-24 15:28,52.71,Deposit,Mobile Deposit,4793.7
5985,711232608,5-29-24 23:28,34.87,Return,Best Buy Return,4828.57
5986,711232608,06-04-24 21:28,2250,IncomingTransfer,Salary,7078.57
5987,711232608,6-16-24 21:28,700,Payment,Subscription Payment,6378.57
5988,711232608,6-19-24 18:28,221.57,Withdrawal,ATM Withdrawal,6157
5989,711232608,6-22-24 16:28,105.78,Purchase,Furniture,6051.22
5990,711232608,6-30-24 18:28,180.91,IncomingTransfer,Freelance Payment,6232.13
5991,711232608,07-01-24 21:28,2250,IncomingTransfer,Salary,8482.13
5992,711232608,07-11-24 21:28,1000,Payment,Subscription Payment,7482.13
5993,711263058,1-24-24 19:28,240.31,Purchase,Grocery,1161.599261
5994,711263058,1-24-24 23:28,207.03,OnlineShopping,Amazon,954.5692613
5995,711263058,1-25-24 9:28,55.65,Withdrawal,Mobile App Withdrawal,898.9192613
5996,711263058,1-25-24 11:28,21.4,Withdrawal,ATM Withdrawal,877.5192613
5997,711263058,1-27-24 16:28,17.77,Deposit,Cash Deposit,895.2892613
5998,711263058,1-31-24 13:28,68.81,Return,AliExpress Return,964.0992613
5999,711263058,02-01-24 17:28,18.12,Deposit,Check Deposit,982.2192613
6000,711263058,02-01-24 23:28,165.04,Return,AliExpress Return,1147.259261
6001,711263058,02-03-24 16:28,219.48,Deposit,Check Deposit,1366.739261
6002,711263058,02-04-24 11:28,211.96,IncomingTransfer,Freelance Payment,1578.699261
6003,711263058,02-04-24 21:28,1750,IncomingTransfer,Salary,3328.699261
6004,711263058,02-06-24 16:28,241.18,Withdrawal,ATM Withdrawal,3087.519261
6005,711263058,02-07-24 10:28,146.52,Return,eBay Return,3234.039261
6006,711263058,02-09-24 21:28,2400,Payment,Credit Card Payment,834.0392613
6007,711263058,2-13-24 21:28,132.26,Withdrawal,ATM Withdrawal,701.7792613
6008,711263058,2-14-24 19:28,71.52,Return,eBay Return,773.2992613
6009,711263058,2-15-24 17:28,59.33,IncomingTransfer,Freelance Payment,832.6292613
6010,711263058,2-16-24 9:28,221.17,Withdrawal,Mobile App Withdrawal,611.4592613
6011,711263058,2-18-24 21:28,600,Payment,Rent Payment,11.4592613
6012,711263058,2-20-24 17:28,30.41,Purchase,Restaurant,-18.9507387
6013,711263058,2-20-24 18:28,68.11,Return,Target Return,49.1592613
6014,711263058,2-26-24 20:28,155.4,IncomingTransfer,Freelance Payment,204.5592613
6015,711263058,2-28-24 19:28,243.3,OutgoingTransfer,Wire Transfer,-38.7407387
6016,711263058,03-01-24 14:28,13.69,OutgoingTransfer,Bank Transfer,-52.4307387
6017,711263058,03-02-24 21:28,1750,IncomingTransfer,Salary,1697.569261
6018,711263058,03-07-24 14:28,77.75,Purchase,Grocery,1619.819261
6019,711263058,03-07-24 21:28,2000,Payment,Credit Card Payment,-380.1807387
6020,711263058,03-10-24 15:28,48.99,OnlineShopping,Target,-429.1707387
6021,711263058,03-11-24 15:28,113.92,Purchase,Gas,-543.0907387
6022,711263058,03-11-24 21:28,1000,Payment,Rent Payment,-1543.090739
6023,711263058,3-14-24 10:28,233.54,OnlineShopping,AliExpress,-1776.630739
6024,711263058,3-17-24 19:28,107.04,Withdrawal,ATM Withdrawal,-1883.670739
6025,711263058,3-20-24 17:28,18.81,Deposit,Direct Deposit,-1864.860739
6026,711263058,3-24-24 18:28,94.37,Withdrawal,Mobile App Withdrawal,-1959.230739
6027,711263058,3-26-24 12:28,41.06,Payment,Loan Payment,-2000.290739
6028,711263058,3-27-24 9:28,182.32,OutgoingTransfer,Wire Transfer,-2182.610739
6029,711263058,3-28-24 14:28,227.67,Payment,Bill Payment,-2410.280739
6030,711263058,3-30-24 10:28,55.49,Purchase,Electronics,-2465.770739
6031,711263058,04-04-24 20:28,152.48,Deposit,Check Deposit,-2313.290739
6032,711263058,04-05-24 21:28,1750,IncomingTransfer,Salary,-563.2907387
6033,711263058,04-07-24 20:28,186.76,Withdrawal,Mobile App Withdrawal,-750.0507387
6034,711263058,04-09-24 20:28,19.67,Payment,Mortgage Payment,-769.7207387
6035,711263058,04-10-24 9:28,174.11,Return,AliExpress Return,-595.6107387
6036,711263058,04-10-24 21:28,2300,Payment,Credit Card Payment,-2895.610739
6037,711263058,04-11-24 15:28,19.98,IncomingTransfer,Freelance Payment,-2875.630739
6038,711263058,04-12-24 21:28,600,Payment,Rent Payment,-3475.630739
6039,711263058,4-13-24 11:28,151.47,Return,Amazon Return,-3324.160739
6040,711263058,4-16-24 22:28,195.92,Withdrawal,ATM Withdrawal,-3520.080739
6041,711263058,4-19-24 15:28,63.13,OutgoingTransfer,Bank Transfer,-3583.210739
6042,711263058,4-22-24 13:28,34.96,Withdrawal,Branch Withdrawal,-3618.170739
6043,711263058,4-25-24 13:28,139.83,Withdrawal,Branch Withdrawal,-3758.000739
6044,711263058,4-26-24 19:28,234.88,Purchase,Restaurant,-3992.880739
6045,711263058,4-27-24 11:28,196.58,Deposit,Cash Deposit,-3796.300739
6046,711263058,4-29-24 18:28,11.73,Deposit,Direct Deposit,-3784.570739
6047,711263058,4-30-24 20:28,42.16,Purchase,Furniture,-3826.730739
6048,711263058,05-01-24 19:28,22.89,Return,Walmart Return,-3803.840739
6049,711263058,05-02-24 21:28,1750,IncomingTransfer,Salary,-2053.840739
6050,711263058,05-03-24 22:28,41.25,Payment,Bill Payment,-2095.090739
6051,711263058,05-07-24 21:28,2000,Payment,Credit Card Payment,-4095.090739
6052,711263058,05-09-24 17:28,104.73,Return,eBay Return,-3990.360739
6053,711263058,05-10-24 21:28,600,Payment,Rent Payment,-4590.360739
6054,711263058,5-13-24 9:28,234.55,Return,AliExpress Return,-4355.810739
6055,711263058,5-14-24 18:28,108.72,OnlineShopping,eBay,-4464.530739
6056,711263058,5-15-24 21:28,173.02,OutgoingTransfer,International Transfer,-4637.550739
6057,711263058,5-19-24 22:28,157.57,Withdrawal,Branch Withdrawal,-4795.120739
6058,711263058,5-22-24 14:28,86.8,Purchase,Entertainment,-4881.920739
6059,711263058,5-24-24 12:28,211.69,OutgoingTransfer,Bank Transfer,-5093.610739
6060,711263058,5-29-24 12:28,125.81,Purchase,Travel,-5219.420739
6061,711263058,5-29-24 21:28,109.94,Withdrawal,ATM Withdrawal,-5329.360739
6062,711263058,5-29-24 22:28,175.6,Return,eBay Return,-5153.760739
6063,711263058,5-30-24 15:28,212.11,OutgoingTransfer,Bank Transfer,-5365.870739
6064,711263058,5-30-24 20:28,124.83,Return,Store Return,-5241.040739
6065,711263058,5-31-24 21:28,78.81,OnlineShopping,Target,-5319.850739
6066,711263058,06-04-24 21:28,1750,IncomingTransfer,Salary,-3569.850739
6067,711263058,06-06-24 11:28,42.09,IncomingTransfer,Freelance Payment,-3527.760739
6068,711263058,06-09-24 21:28,2300,Payment,Credit Card Payment,-5827.760739
6069,711263058,06-11-24 17:28,76.81,Purchase,Grocery,-5904.570739
6070,711263058,06-11-24 22:28,192.85,Purchase,Electronics,-6097.420739
6071,711263058,06-12-24 23:28,247.79,Deposit,Mobile Deposit,-5849.630739
6072,711263058,6-14-24 11:28,126.37,Return,Best Buy Return,-5723.260739
6073,711263058,6-14-24 21:28,700,Payment,Rent Payment,-6423.260739
6074,711263058,6-19-24 16:28,200.21,Payment,Bill Payment,-6623.470739
6075,711263058,6-22-24 18:28,41.71,Deposit,Cash Deposit,-6581.760739
6076,711263058,6-23-24 20:28,28.48,Withdrawal,Branch Withdrawal,-6610.240739
6077,711263058,6-24-24 19:28,48.14,Purchase,Pharmacy,-6658.380739
6078,711263058,6-29-24 14:28,234.79,Deposit,Cash Deposit,-6423.590739
6079,711263058,6-30-24 11:28,249.39,Deposit,Direct Deposit,-6174.200739
6080,711263058,6-30-24 12:28,159.32,Return,Etsy Return,-6014.880739
6081,711263058,07-02-24 14:28,126.09,Purchase,Pharmacy,-6140.970739
6082,711263058,07-03-24 13:28,77.79,Withdrawal,ATM Withdrawal,-6218.760739
6083,711263058,07-03-24 17:28,226.82,Return,Target Return,-5991.940739
6084,711263058,07-04-24 15:28,92.31,Deposit,Cash Deposit,-5899.630739
6085,711263058,07-04-24 21:28,1750,IncomingTransfer,Salary,-4149.630739
6086,711263058,07-05-24 13:28,218.02,Deposit,Mobile Deposit,-3931.610739
6087,711263058,07-09-24 21:28,2300,Payment,Credit Card Payment,-6231.610739
6088,711263058,7-13-24 13:28,27.04,Return,Best Buy Return,-6204.570739
6089,711263058,7-14-24 21:28,500,Payment,Rent Payment,-6704.570739
6090,711263058,7-15-24 11:28,126.9,Return,Best Buy Return,-6577.670739
6091,711275433,1-27-24 16:28,277.31,OutgoingTransfer,Peer-to-Peer Transfer,-277.31
6092,711275433,1-28-24 18:28,50.65,OnlineShopping,Walmart,-327.96
6093,711275433,02-03-24 22:28,15.35,Withdrawal,ATM Withdrawal,-343.31
6094,711275433,02-04-24 21:28,4700,IncomingTransfer,Salary,4356.69
6095,711275433,02-09-24 22:28,237.2,Return,Walmart Return,4593.89
6096,711275433,02-10-24 21:28,1600,Payment,Rent Payment,2993.89
6097,711275433,2-16-24 20:28,447.21,Deposit,Direct Deposit,3441.1
6098,711275433,03-02-24 21:28,4700,IncomingTransfer,Salary,8141.1
6099,711275433,03-04-24 17:28,186.3,Purchase,Clothing,7954.8
6100,711275433,03-08-24 17:28,167.95,Purchase,Travel,7786.85
6101,711275433,03-11-24 14:28,30.92,Deposit,Mobile Deposit,7817.77
6102,711275433,3-13-24 15:28,443.74,Purchase,Gas,7374.03
6103,711275433,3-15-24 10:28,286.32,Purchase,Electronics,7087.71
6104,711275433,3-15-24 21:28,1500,Payment,Rent Payment,5587.71
6105,711275433,3-17-24 16:28,285.34,OutgoingTransfer,Peer-to-Peer Transfer,5302.37
6106,711275433,3-19-24 12:28,297.02,OutgoingTransfer,Peer-to-Peer Transfer,5005.35
6107,711275433,3-22-24 11:28,251.62,Withdrawal,Mobile App Withdrawal,4753.73
6108,711275433,3-28-24 21:28,213.35,Purchase,Entertainment,4540.38
6109,711275433,04-01-24 21:28,4700,IncomingTransfer,Salary,9240.38
6110,711275433,04-02-24 10:28,446.63,Payment,Bill Payment,8793.75
6111,711275433,04-03-24 15:28,187.02,Return,eBay Return,8980.77
6112,711275433,04-03-24 17:28,50.92,IncomingTransfer,Freelance Payment,9031.69
6113,711275433,04-11-24 9:28,38.18,Withdrawal,ATM Withdrawal,8993.51
6114,711275433,04-11-24 21:28,2600,Payment,Rent Payment,6393.51
6115,711275433,4-16-24 10:28,180.4,Purchase,Restaurant,6213.11
6116,711275433,4-24-24 10:28,115.67,Return,Walmart Return,6328.78
6117,711275433,4-29-24 9:28,442.82,OnlineShopping,Walmart,5885.96
6118,711275433,05-03-24 13:28,257.26,Payment,Loan Payment,5628.7
6119,711275433,05-04-24 14:28,104.07,OutgoingTransfer,Bank Transfer,5524.63
6120,711275433,05-04-24 21:28,4700,IncomingTransfer,Salary,10224.63
6121,711275433,05-09-24 22:28,342.1,Deposit,Direct Deposit,10566.73
6122,711275433,5-17-24 21:28,1200,Payment,Rent Payment,9366.73
6123,711275433,5-23-24 9:28,372.61,Withdrawal,Mobile App Withdrawal,8994.12
6124,711275433,5-24-24 16:28,120.27,Purchase,Entertainment,8873.85
6125,711275433,5-26-24 22:28,490.74,Withdrawal,Branch Withdrawal,8383.11
6126,711275433,5-29-24 10:28,349.28,Payment,Bill Payment,8033.83
6127,711275433,06-04-24 21:28,4700,IncomingTransfer,Salary,12733.83
6128,711275433,06-06-24 20:28,67.19,Withdrawal,Branch Withdrawal,12666.64
6129,711275433,06-08-24 17:28,200.87,IncomingTransfer,Freelance Payment,12867.51
6130,711275433,06-12-24 21:28,2800,Payment,Rent Payment,10067.51
6131,711275433,6-15-24 21:28,256.74,OnlineShopping,Walmart,9810.77
6132,711275433,6-17-24 9:28,63.18,Withdrawal,ATM Withdrawal,9747.59
6133,711275433,6-29-24 14:28,73.4,Payment,Loan Payment,9674.19
6134,711275433,07-01-24 21:28,4700,IncomingTransfer,Salary,14374.19
6135,711275433,07-03-24 22:28,184.47,IncomingTransfer,Freelance Payment,14558.66
6136,711275433,07-11-24 21:28,1700,Payment,Rent Payment,12858.66
6137,711275433,7-14-24 10:28,386.85,Deposit,Check Deposit,13245.51
6138,711275433,7-14-24 21:28,272.36,Deposit,Check Deposit,13517.87
6139,711275433,7-16-24 11:28,410.75,Withdrawal,ATM Withdrawal,13107.12
6140,711275433,7-16-24 22:28,325.32,Purchase,Pharmacy,12781.8
6141,711283008,1-20-24 21:28,237.48,Purchase,Travel,-237.48
6142,711283008,1-22-24 12:28,135.53,OutgoingTransfer,Bank Transfer,-373.01
6143,711283008,1-24-24 14:28,749.15,OutgoingTransfer,Peer-to-Peer Transfer,-1122.16
6144,711283008,1-24-24 19:28,257.9,OnlineShopping,Etsy,-1380.06
6145,711283008,1-25-24 9:28,715.79,Purchase,Restaurant,-2095.85
6146,711283008,1-26-24 20:28,471.37,Withdrawal,Mobile App Withdrawal,-2567.22
6147,711283008,1-28-24 15:28,512.44,IncomingTransfer,Freelance Payment,-2054.78
6148,711283008,1-29-24 10:28,676.45,Deposit,Direct Deposit,-1378.33
6149,711283008,1-30-24 12:28,603.34,OnlineShopping,Best Buy,-1981.67
6150,711283008,1-31-24 15:28,743.06,Purchase,Electronics,-2724.73
6151,711283008,1-31-24 21:28,147.42,Withdrawal,ATM Withdrawal,-2872.15
6152,711283008,02-02-24 13:28,568.39,Deposit,Direct Deposit,-2303.76
6153,711283008,02-02-24 15:28,108.01,Withdrawal,ATM Withdrawal,-2411.77
6154,711283008,02-02-24 16:28,716.52,OnlineShopping,Amazon,-3128.29
6155,711283008,02-02-24 21:28,8900,IncomingTransfer,Salary,5771.71
6156,711283008,02-02-24 21:28,696.7,Return,Amazon Return,6468.41
6157,711283008,02-03-24 22:28,146.78,Purchase,Entertainment,6321.63
6158,711283008,02-07-24 13:28,709.8,OutgoingTransfer,Bank Transfer,5611.83
6159,711283008,02-10-24 20:28,415.63,Payment,Bill Payment,5196.2
6160,711283008,2-18-24 21:28,4000,Payment,Rent Payment,1196.2
6161,711283008,2-20-24 21:28,535.09,Purchase,Grocery,661.11
6162,711283008,2-21-24 21:28,278.83,OnlineShopping,Target,382.28
6163,711283008,2-24-24 12:28,436.58,Deposit,Cash Deposit,818.86
6164,711283008,2-26-24 9:28,216.47,Purchase,Restaurant,602.39
6165,711283008,2-27-24 15:28,404.64,Deposit,Mobile Deposit,1007.03
6166,711283008,03-02-24 13:28,191.15,Deposit,Mobile Deposit,1198.18
6167,711283008,03-04-24 21:28,8900,IncomingTransfer,Salary,10098.18
6168,711283008,03-06-24 13:28,332.83,Withdrawal,Branch Withdrawal,9765.35
6169,711283008,03-11-24 11:28,600.8,Deposit,Mobile Deposit,10366.15
6170,711283008,03-11-24 13:28,395.03,IncomingTransfer,Freelance Payment,10761.18
6171,711283008,03-11-24 22:28,476.81,Deposit,Cash Deposit,11237.99
6172,711283008,3-14-24 10:28,160.04,Payment,Mortgage Payment,11077.95
6173,711283008,3-14-24 21:28,3200,Payment,Rent Payment,7877.95
6174,711283008,3-15-24 22:28,249.45,Deposit,Cash Deposit,8127.4
6175,711283008,3-17-24 15:28,612.47,Purchase,Clothing,7514.93
6176,711283008,3-19-24 14:28,395.36,Return,Target Return,7910.29
6177,711283008,3-22-24 14:28,260.03,Deposit,Cash Deposit,8170.32
6178,711283008,3-24-24 10:28,441,Withdrawal,Mobile App Withdrawal,7729.32
6179,711283008,3-27-24 15:28,305.86,OnlineShopping,Amazon,7423.46
6180,711283008,04-02-24 21:28,8900,IncomingTransfer,Salary,16323.46
6181,711283008,04-03-24 14:28,589.66,Purchase,Gas,15733.8
6182,711283008,04-08-24 12:28,139.58,Payment,Bill Payment,15594.22
6183,711283008,04-11-24 9:28,362.58,Purchase,Furniture,15231.64
6184,711283008,4-15-24 9:28,435.69,Deposit,Cash Deposit,15667.33
6185,711283008,4-17-24 9:28,668.05,OutgoingTransfer,Bank Transfer,14999.28
6186,711283008,4-17-24 19:28,441.39,Deposit,Direct Deposit,15440.67
6187,711283008,4-18-24 18:28,312.6,Withdrawal,Branch Withdrawal,15128.07
6188,711283008,4-18-24 21:28,3000,Payment,Rent Payment,12128.07
6189,711283008,4-20-24 11:28,562.56,Withdrawal,Mobile App Withdrawal,11565.51
6190,711283008,4-20-24 12:28,609.52,Purchase,Clothing,10955.99
6191,711283008,4-29-24 13:28,449.58,Deposit,Check Deposit,11405.57
6192,711283008,4-30-24 17:28,138.1,Deposit,Mobile Deposit,11543.67
6193,711283008,05-02-24 9:28,434.47,OutgoingTransfer,International Transfer,11109.2
6194,711283008,05-02-24 23:28,389.19,Purchase,Clothing,10720.01
6195,711283008,05-03-24 21:28,8900,IncomingTransfer,Salary,19620.01
6196,711283008,05-05-24 18:28,621.09,Withdrawal,Branch Withdrawal,18998.92
6197,711283008,05-06-24 10:28,205.71,Deposit,Check Deposit,19204.63
6198,711283008,05-08-24 9:28,581.99,Return,Store Return,19786.62
6199,711283008,05-08-24 16:28,749.96,Withdrawal,Branch Withdrawal,19036.66
6200,711283008,05-10-24 12:28,444.66,Return,Walmart Return,19481.32
6201,711283008,05-11-24 14:28,231.49,Payment,Mortgage Payment,19249.83
6202,711283008,05-11-24 22:28,486.92,Deposit,Mobile Deposit,19736.75
6203,711283008,05-12-24 19:28,372.46,OnlineShopping,Etsy,19364.29
6204,711283008,5-14-24 21:28,4500,Payment,Rent Payment,14864.29
6205,711283008,5-16-24 9:28,408.3,Deposit,Check Deposit,15272.59
6206,711283008,5-17-24 14:28,714.18,Deposit,Check Deposit,15986.77
6207,711283008,5-18-24 12:28,406.75,OutgoingTransfer,International Transfer,15580.02
6208,711283008,5-18-24 14:28,178.13,Payment,Bill Payment,15401.89
6209,711283008,5-19-24 14:28,644.29,Payment,Bill Payment,14757.6
6210,711283008,5-24-24 17:28,333.72,Withdrawal,Mobile App Withdrawal,14423.88
6211,711283008,5-25-24 11:28,110.69,OutgoingTransfer,Wire Transfer,14313.19
6212,711283008,5-26-24 13:28,580.05,Deposit,Mobile Deposit,14893.24
6213,711283008,5-28-24 19:28,236.54,Purchase,Restaurant,14656.7
6214,711283008,5-29-24 10:28,132.63,Deposit,Direct Deposit,14789.33
6215,711283008,5-30-24 14:28,143.61,Return,Best Buy Return,14932.94
6216,711283008,5-31-24 22:28,531.88,IncomingTransfer,Freelance Payment,15464.82
6217,711283008,06-01-24 16:28,539.72,Deposit,Mobile Deposit,16004.54
6218,711283008,06-04-24 13:28,313.76,Purchase,Entertainment,15690.78
6219,711283008,06-04-24 13:28,512.18,Deposit,Check Deposit,16202.96
6220,711283008,06-04-24 19:28,441.04,Purchase,Furniture,15761.92
6221,711283008,06-04-24 21:28,8900,IncomingTransfer,Salary,24661.92
6222,711283008,06-05-24 15:28,446.02,IncomingTransfer,Freelance Payment,25107.94
6223,711283008,06-06-24 11:28,478.35,Deposit,Cash Deposit,25586.29
6224,711283008,06-07-24 10:28,193.46,Return,AliExpress Return,25779.75
6225,711283008,06-07-24 16:28,516.98,OnlineShopping,Etsy,25262.77
6226,711283008,06-08-24 11:28,470.95,Deposit,Direct Deposit,25733.72
6227,711283008,06-10-24 15:28,181.3,Return,Amazon Return,25915.02
6228,711283008,6-13-24 15:28,430.3,Purchase,Clothing,25484.72
6229,711283008,6-14-24 13:28,255.77,Deposit,Direct Deposit,25740.49
6230,711283008,6-15-24 19:28,680.2,Withdrawal,Mobile App Withdrawal,25060.29
6231,711283008,6-15-24 21:28,4800,Payment,Rent Payment,20260.29
6232,711283008,6-16-24 20:28,630.21,OutgoingTransfer,Bank Transfer,19630.08
6233,711283008,6-20-24 11:28,387.75,Purchase,Grocery,19242.33
6234,711283008,6-21-24 13:28,139.85,Purchase,Electronics,19102.48
6235,711283008,6-23-24 13:28,433.99,Purchase,Electronics,18668.49
6236,711283008,6-28-24 21:28,332.34,OnlineShopping,AliExpress,18336.15
6237,711283008,07-02-24 21:28,8900,IncomingTransfer,Salary,27236.15
6238,711283008,07-02-24 23:28,596.29,Purchase,Restaurant,26639.86
6239,711283008,07-02-24 23:28,266.35,Deposit,Check Deposit,26906.21
6240,711283008,07-03-24 9:28,285.35,Purchase,Entertainment,26620.86
6241,711283008,07-03-24 20:28,573.74,IncomingTransfer,Freelance Payment,27194.6
6242,711283008,07-05-24 17:28,127.04,Deposit,Cash Deposit,27321.64
6243,711283008,07-05-24 23:28,649.05,Purchase,Clothing,26672.59
6244,711283008,07-08-24 15:28,565.57,Deposit,Cash Deposit,27238.16
6245,711283008,07-08-24 23:28,382.84,OutgoingTransfer,Peer-to-Peer Transfer,26855.32
6246,711283008,07-09-24 12:28,433.07,Deposit,Cash Deposit,27288.39
6247,711283008,07-09-24 15:28,660.5,Withdrawal,Mobile App Withdrawal,26627.89
6248,711283008,07-10-24 14:28,130.3,IncomingTransfer,Freelance Payment,26758.19
6249,711283008,07-11-24 21:28,4400,Payment,Rent Payment,22358.19
6250,711283008,07-12-24 23:28,627.12,Withdrawal,ATM Withdrawal,21731.07
6251,711283008,07-12-24 23:28,194.1,OnlineShopping,AliExpress,21536.97
6252,711283008,7-14-24 13:28,743.36,Deposit,Check Deposit,22280.33
6253,711283008,7-15-24 11:28,662.8,Return,Amazon Return,22943.13
6254,711283008,7-15-24 21:28,446.93,Deposit,Mobile Deposit,23390.06
6255,711283008,7-16-24 19:28,700.36,Purchase,Pharmacy,22689.7
6256,711283008,7-17-24 17:28,388.43,Deposit,Cash Deposit,23078.13
6257,711283008,7-17-24 20:28,139.87,Withdrawal,Mobile App Withdrawal,22938.26
6258,711286533,1-21-24 19:28,299.99,IncomingTransfer,Freelance Payment,299.99
6259,711286533,1-22-24 13:28,409.47,Purchase,Entertainment,-109.48
6260,711286533,1-23-24 22:28,414.76,Purchase,Restaurant,-524.24
6261,711286533,1-26-24 21:28,214.74,Purchase,Electronics,-738.98
6262,711286533,1-30-24 9:28,233.66,Purchase,Entertainment,-972.64
6263,711286533,02-02-24 12:28,380.76,Payment,Mortgage Payment,-1353.4
6264,711286533,02-03-24 12:28,219.21,Return,AliExpress Return,-1134.19
6265,711286533,02-04-24 21:28,5800,IncomingTransfer,Salary,4665.81
6266,711286533,02-11-24 19:28,516.22,Payment,Loan Payment,4149.59
6267,711286533,2-14-24 21:28,1600,Payment,Insurance Payment,2549.59
6268,711286533,2-16-24 19:28,493.48,OutgoingTransfer,Bank Transfer,2056.11
6269,711286533,2-19-24 10:28,506.29,OnlineShopping,Best Buy,1549.82
6270,711286533,2-20-24 13:28,273.88,Withdrawal,Mobile App Withdrawal,1275.94
6271,711286533,2-20-24 14:28,102.91,Purchase,Gas,1173.03
6272,711286533,2-21-24 15:28,360.31,Return,Etsy Return,1533.34
6273,711286533,2-22-24 18:28,440.9,Return,eBay Return,1974.24
6274,711286533,2-22-24 23:28,180.27,Purchase,Pharmacy,1793.97
6275,711286533,2-27-24 11:28,325.12,Deposit,Check Deposit,2119.09
6276,711286533,03-02-24 15:28,500.23,Return,Best Buy Return,2619.32
6277,711286533,03-02-24 18:28,106.36,Deposit,Check Deposit,2725.68
6278,711286533,03-02-24 18:28,209.23,Return,Etsy Return,2934.91
6279,711286533,03-02-24 21:28,5800,IncomingTransfer,Salary,8734.91
6280,711286533,03-07-24 15:28,548.94,Purchase,Clothing,8185.97
6281,711286533,03-09-24 12:28,86.72,OutgoingTransfer,Bank Transfer,8099.25
6282,711286533,03-10-24 21:28,2600,Payment,Subscription Payment,5499.25
6283,711286533,03-11-24 9:28,131.58,Purchase,Home Improvement,5367.67
6284,711286533,03-11-24 20:28,281.65,Purchase,Travel,5086.02
6285,711286533,3-20-24 9:28,421.96,Payment,Loan Payment,4664.06
6286,711286533,3-20-24 19:28,507.43,Deposit,Mobile Deposit,5171.49
6287,711286533,3-26-24 10:28,345.99,OnlineShopping,Etsy,4825.5
6288,711286533,3-29-24 18:28,471.56,OutgoingTransfer,Peer-to-Peer Transfer,4353.94
6289,711286533,04-01-24 19:28,316.3,Withdrawal,Branch Withdrawal,4037.64
6290,711286533,04-04-24 11:28,233.99,OnlineShopping,Target,3803.65
6291,711286533,04-04-24 21:28,5800,IncomingTransfer,Salary,9603.65
6292,711286533,04-07-24 21:28,342.62,Deposit,Check Deposit,9946.27
6293,711286533,4-16-24 21:28,2300,Payment,Insurance Payment,7646.27
6294,711286533,4-17-24 9:28,195.51,Payment,Bill Payment,7450.76
6295,711286533,4-18-24 15:28,268.58,Withdrawal,Branch Withdrawal,7182.18
6296,711286533,4-19-24 18:28,425.52,IncomingTransfer,Freelance Payment,7607.7
6297,711286533,4-22-24 20:28,434.7,OutgoingTransfer,International Transfer,7173
6298,711286533,4-30-24 10:28,404.87,Deposit,Mobile Deposit,7577.87
6299,711286533,4-30-24 14:28,425.23,OnlineShopping,Etsy,7152.64
6300,711286533,05-04-24 21:28,5800,IncomingTransfer,Salary,12952.64
6301,711286533,05-06-24 15:28,302.51,OnlineShopping,Amazon,12650.13
6302,711286533,05-09-24 20:28,260.92,OnlineShopping,Target,12389.21
6303,711286533,05-10-24 21:28,2600,Payment,Insurance Payment,9789.21
6304,711286533,5-22-24 11:28,360.38,Withdrawal,ATM Withdrawal,9428.83
6305,711286533,5-22-24 16:28,532.03,Payment,Mortgage Payment,8896.8
6306,711286533,5-24-24 13:28,354.41,Payment,Bill Payment,8542.39
6307,711286533,5-24-24 23:28,439.21,OutgoingTransfer,International Transfer,8103.18
6308,711286533,5-26-24 17:28,505.68,Deposit,Cash Deposit,8608.86
6309,711286533,5-27-24 10:28,62.19,Payment,Loan Payment,8546.67
6310,711286533,5-31-24 23:28,284.07,Payment,Bill Payment,8262.6
6311,711286533,06-01-24 21:28,5800,IncomingTransfer,Salary,14062.6
6312,711286533,06-05-24 15:28,52.85,Withdrawal,Mobile App Withdrawal,14009.75
6313,711286533,06-08-24 19:28,325.27,Withdrawal,ATM Withdrawal,13684.48
6314,711286533,06-11-24 14:28,85.75,IncomingTransfer,Freelance Payment,13770.23
6315,711286533,06-11-24 18:28,492.73,OutgoingTransfer,International Transfer,13277.5
6316,711286533,06-12-24 21:28,1900,Payment,Subscription Payment,11377.5
6317,711286533,6-13-24 16:28,168.91,Deposit,Direct Deposit,11546.41
6318,711286533,6-14-24 13:28,58.76,Withdrawal,ATM Withdrawal,11487.65
6319,711286533,6-15-24 16:28,243.29,OnlineShopping,Etsy,11244.36
6320,711286533,6-15-24 21:28,262.98,Withdrawal,Mobile App Withdrawal,10981.38
6321,711286533,6-18-24 12:28,330.49,Return,eBay Return,11311.87
6322,711286533,6-29-24 12:28,544.46,Purchase,Entertainment,10767.41
6323,711286533,07-01-24 13:28,125.7,Deposit,Mobile Deposit,10893.11
6324,711286533,07-02-24 16:28,51.25,Purchase,Clothing,10841.86
6325,711286533,07-03-24 21:28,5800,IncomingTransfer,Salary,16641.86
6326,711286533,07-11-24 12:28,464.48,Deposit,Direct Deposit,17106.34
6327,711286533,07-12-24 10:28,499.05,Withdrawal,Branch Withdrawal,16607.29
6328,711286533,07-12-24 15:28,101.91,Payment,Mortgage Payment,16505.38
6329,711286533,7-13-24 21:28,1600,Payment,Insurance Payment,14905.38
6330,711286533,7-14-24 19:28,386.3,Return,AliExpress Return,15291.68
6331,711286533,7-15-24 17:28,140.72,Deposit,Mobile Deposit,15432.4
6332,711379083,1-21-24 14:28,205.44,IncomingTransfer,Freelance Payment,1188.366813
6333,711379083,1-25-24 14:28,196.15,Deposit,Direct Deposit,1384.516813
6334,711379083,1-25-24 16:28,121.67,IncomingTransfer,Freelance Payment,1506.186813
6335,711379083,1-26-24 10:28,33.73,Purchase,Furniture,1472.456813
6336,711379083,1-28-24 14:28,69.76,OutgoingTransfer,Peer-to-Peer Transfer,1402.696813
6337,711379083,02-01-24 9:28,87.47,Deposit,Mobile Deposit,1490.166813
6338,711379083,02-01-24 21:28,2750,IncomingTransfer,Salary,4240.166813
6339,711379083,02-04-24 12:28,110.91,OnlineShopping,Target,4129.256813
6340,711379083,02-05-24 13:28,10.24,OnlineShopping,Amazon,4119.016813
6341,711379083,02-05-24 22:28,119.33,OnlineShopping,Amazon,3999.686813
6342,711379083,02-06-24 21:28,1600,Payment,Credit Card Payment,2399.686813
6343,711379083,02-10-24 13:28,183.6,Return,Walmart Return,2583.286813
6344,711379083,02-10-24 20:28,158.17,OnlineShopping,Walmart,2425.116813
6345,711379083,2-13-24 21:28,1100,Payment,Insurance Payment,1325.116813
6346,711379083,2-15-24 20:28,178.91,OnlineShopping,AliExpress,1146.206813
6347,711379083,2-18-24 22:28,116.97,OnlineShopping,eBay,1029.236813
6348,711379083,2-19-24 20:28,71.56,Withdrawal,Branch Withdrawal,957.6768134
6349,711379083,2-21-24 11:28,143.79,Payment,Bill Payment,813.8868134
6350,711379083,2-23-24 21:28,176.51,Purchase,Home Improvement,637.3768134
6351,711379083,03-02-24 21:28,170.02,Purchase,Travel,467.3568134
6352,711379083,03-03-24 10:28,113.02,Purchase,Home Improvement,354.3368134
6353,711379083,03-03-24 13:28,82.29,Return,Walmart Return,436.6268134
6354,711379083,03-03-24 21:28,2750,IncomingTransfer,Salary,3186.626813
6355,711379083,03-07-24 14:28,209.21,OutgoingTransfer,Bank Transfer,2977.416813
6356,711379083,03-07-24 22:28,165.22,Return,Walmart Return,3142.636813
6357,711379083,03-08-24 12:28,132.66,Purchase,Furniture,3009.976813
6358,711379083,03-08-24 20:28,175.14,Deposit,Direct Deposit,3185.116813
6359,711379083,03-08-24 21:28,1800,Payment,Credit Card Payment,1385.116813
6360,711379083,3-14-24 10:28,227.53,Return,AliExpress Return,1612.646813
6361,711379083,3-15-24 11:28,208.75,Payment,Bill Payment,1403.896813
6362,711379083,3-15-24 21:28,1200,Payment,Installment Payment,203.8968134
6363,711379083,3-18-24 15:28,227.12,Deposit,Direct Deposit,431.0168134
6364,711379083,3-19-24 12:28,93.91,Deposit,Direct Deposit,524.9268134
6365,711379083,3-29-24 19:28,213.68,Deposit,Direct Deposit,738.6068134
6366,711379083,3-30-24 13:28,109.84,Purchase,Restaurant,628.7668134
6367,711379083,3-31-24 15:28,169.68,Purchase,Restaurant,459.0868134
6368,711379083,04-02-24 21:28,2750,IncomingTransfer,Salary,3209.086813
6369,711379083,04-04-24 17:28,134.72,Withdrawal,Branch Withdrawal,3074.366813
6370,711379083,04-05-24 21:28,16.22,Deposit,Cash Deposit,3090.586813
6371,711379083,04-06-24 22:28,34.6,Purchase,Entertainment,3055.986813
6372,711379083,04-07-24 12:28,242.57,Deposit,Check Deposit,3298.556813
6373,711379083,04-07-24 21:28,2000,Payment,Credit Card Payment,1298.556813
6374,711379083,04-10-24 19:28,67.03,Deposit,Check Deposit,1365.586813
6375,711379083,04-11-24 9:28,169.72,Purchase,Pharmacy,1195.866813
6376,711379083,4-13-24 17:28,231.1,Withdrawal,ATM Withdrawal,964.7668134
6377,711379083,4-15-24 21:28,800,Payment,Subscription Payment,164.7668134
6378,711379083,4-15-24 23:28,191.46,OutgoingTransfer,Peer-to-Peer Transfer,-26.69318662
6379,711379083,4-16-24 16:28,97.26,OutgoingTransfer,International Transfer,-123.9531866
6380,711379083,4-23-24 22:28,156.34,Withdrawal,Branch Withdrawal,-280.2931866
6381,711379083,4-27-24 22:28,99.27,Purchase,Electronics,-379.5631866
6382,711379083,4-27-24 22:28,83.95,Payment,Bill Payment,-463.5131866
6383,711379083,4-28-24 14:28,202.48,OnlineShopping,eBay,-665.9931866
6384,711379083,05-05-24 11:28,117.83,OutgoingTransfer,Wire Transfer,-783.8231866
6385,711379083,05-05-24 21:28,2750,IncomingTransfer,Salary,1966.176813
6386,711379083,05-10-24 20:28,192.52,OutgoingTransfer,International Transfer,1773.656813
6387,711379083,05-10-24 21:28,2100,Payment,Credit Card Payment,-326.3431866
6388,711379083,5-13-24 23:28,240.47,Withdrawal,Mobile App Withdrawal,-566.8131866
6389,711379083,5-15-24 21:28,900,Payment,Subscription Payment,-1466.813187
6390,711379083,5-15-24 22:28,68,Return,Best Buy Return,-1398.813187
6391,711379083,5-17-24 16:28,181.42,Return,Etsy Return,-1217.393187
6392,711379083,5-21-24 11:28,10.31,Purchase,Pharmacy,-1227.703187
6393,711379083,5-23-24 20:28,55.05,Payment,Mortgage Payment,-1282.753187
6394,711379083,5-26-24 19:28,103.35,Purchase,Travel,-1386.103187
6395,711379083,06-02-24 22:28,227.06,Withdrawal,Branch Withdrawal,-1613.163187
6396,711379083,06-03-24 13:28,67.12,Purchase,Entertainment,-1680.283187
6397,711379083,06-03-24 22:28,60.71,Deposit,Check Deposit,-1619.573187
6398,711379083,06-04-24 18:28,27.86,Purchase,Clothing,-1647.433187
6399,711379083,06-04-24 21:28,2750,IncomingTransfer,Salary,1102.566813
6400,711379083,06-09-24 21:28,1800,Payment,Credit Card Payment,-697.4331866
6401,711379083,06-09-24 21:28,161.83,Return,Amazon Return,-535.6031866
6402,711379083,06-11-24 21:28,700,Payment,Installment Payment,-1235.603187
6403,711379083,6-16-24 11:28,141.94,Purchase,Grocery,-1377.543187
6404,711379083,6-16-24 14:28,49.76,OnlineShopping,Best Buy,-1427.303187
6405,711379083,6-19-24 16:28,50.45,Return,Target Return,-1376.853187
6406,711379083,6-19-24 21:28,220.93,Deposit,Direct Deposit,-1155.923187
6407,711379083,6-23-24 19:28,53.15,Purchase,Electronics,-1209.073187
6408,711379083,6-25-24 10:28,96.25,Purchase,Entertainment,-1305.323187
6409,711379083,6-25-24 19:28,91.34,Purchase,Entertainment,-1396.663187
6410,711379083,6-27-24 18:28,162.03,Withdrawal,Mobile App Withdrawal,-1558.693187
6411,711379083,6-29-24 10:28,49.12,Purchase,Clothing,-1607.813187
6412,711379083,07-01-24 21:28,2750,IncomingTransfer,Salary,1142.186813
6413,711379083,07-04-24 21:28,138.23,Withdrawal,Mobile App Withdrawal,1003.956813
6414,711379083,07-06-24 20:28,49.77,Purchase,Travel,954.1868134
6415,711379083,07-06-24 21:28,2100,Payment,Credit Card Payment,-1145.813187
6416,711379083,07-07-24 16:28,11.67,Purchase,Furniture,-1157.483187
6417,711379083,07-09-24 13:28,184.4,Withdrawal,Mobile App Withdrawal,-1341.883187
6418,711379083,07-11-24 12:28,49.7,Deposit,Direct Deposit,-1292.183187
6419,711379083,07-12-24 18:28,123.61,Deposit,Check Deposit,-1168.573187
6420,711379083,7-14-24 10:28,36.88,Purchase,Pharmacy,-1205.453187
6421,711379083,7-15-24 11:28,90.36,Deposit,Check Deposit,-1115.093187
6422,711379083,7-17-24 21:28,900,Payment,Subscription Payment,-2015.093187
6423,711379083,7-17-24 22:28,171.55,Payment,Mortgage Payment,-2186.643187
6424,711389358,1-25-24 9:28,289.04,Return,eBay Return,1655.249603
6425,711389358,1-26-24 12:28,300.71,IncomingTransfer,Freelance Payment,1955.959603
6426,711389358,1-28-24 14:28,320.05,Purchase,Restaurant,1635.909603
6427,711389358,1-29-24 22:28,341.11,Deposit,Direct Deposit,1977.019603
6428,711389358,02-01-24 10:28,321.41,OutgoingTransfer,Bank Transfer,1655.609603
6429,711389358,02-01-24 15:28,249.12,Purchase,Home Improvement,1406.489603
6430,711389358,02-01-24 22:28,382.47,Withdrawal,ATM Withdrawal,1024.019603
6431,711389358,02-02-24 21:28,4700,IncomingTransfer,Salary,5724.019603
6432,711389358,02-02-24 23:28,222.78,OnlineShopping,Walmart,5501.239603
6433,711389358,02-06-24 10:28,299.26,OnlineShopping,Amazon,5201.979603
6434,711389358,02-07-24 21:28,2700,Payment,Credit Card Payment,2501.979603
6435,711389358,02-09-24 12:28,257.41,IncomingTransfer,Freelance Payment,2759.389603
6436,711389358,02-10-24 21:28,56.45,Return,Walmart Return,2815.839603
6437,711389358,02-12-24 9:28,60.05,Purchase,Gas,2755.789603
6438,711389358,2-16-24 20:28,20.53,Deposit,Check Deposit,2776.319603
6439,711389358,2-18-24 17:28,56.32,OnlineShopping,Target,2719.999603
6440,711389358,2-18-24 19:28,87.41,Deposit,Mobile Deposit,2807.409603
6441,711389358,2-18-24 21:28,2300,Payment,Rent Payment,507.4096028
6442,711389358,2-20-24 15:28,210.97,Deposit,Direct Deposit,718.3796028
6443,711389358,2-24-24 15:28,342.56,OnlineShopping,Amazon,375.8196028
6444,711389358,2-25-24 11:28,323.69,Deposit,Mobile Deposit,699.5096028
6445,711389358,2-26-24 19:28,253.72,Purchase,Electronics,445.7896028
6446,711389358,2-28-24 19:28,345.35,Return,eBay Return,791.1396028
6447,711389358,03-01-24 18:28,40.47,OnlineShopping,Etsy,750.6696028
6448,711389358,03-01-24 21:28,4700,IncomingTransfer,Salary,5450.669603
6449,711389358,03-04-24 16:28,297.11,Deposit,Check Deposit,5747.779603
6450,711389358,03-05-24 12:28,24.66,Deposit,Direct Deposit,5772.439603
6451,711389358,03-06-24 13:28,159.54,OnlineShopping,Target,5612.899603
6452,711389358,03-06-24 21:28,2700,Payment,Credit Card Payment,2912.899603
6453,711389358,03-09-24 20:28,396.48,Deposit,Cash Deposit,3309.379603
6454,711389358,3-13-24 13:28,145.67,OutgoingTransfer,International Transfer,3163.709603
6455,711389358,3-16-24 10:28,332.5,Deposit,Cash Deposit,3496.209603
6456,711389358,3-17-24 21:28,2600,Payment,Rent Payment,896.2096028
6457,711389358,3-21-24 22:28,195.7,OnlineShopping,Target,700.5096028
6458,711389358,3-24-24 15:28,82.55,Deposit,Check Deposit,783.0596028
6459,711389358,3-30-24 21:28,136.92,Withdrawal,Mobile App Withdrawal,646.1396028
6460,711389358,04-01-24 21:28,4700,IncomingTransfer,Salary,5346.139603
6461,711389358,04-02-24 14:28,241.5,Purchase,Clothing,5104.639603
6462,711389358,04-04-24 10:28,210.12,Purchase,Entertainment,4894.519603
6463,711389358,04-04-24 14:28,342.28,OnlineShopping,Target,4552.239603
6464,711389358,04-04-24 23:28,342.24,Purchase,Restaurant,4209.999603
6465,711389358,04-06-24 21:28,3300,Payment,Credit Card Payment,909.9996028
6466,711389358,4-13-24 16:28,297.77,Deposit,Mobile Deposit,1207.769603
6467,711389358,4-13-24 21:28,2000,Payment,Rent Payment,-792.2303972
6468,711389358,4-14-24 21:28,176.12,Withdrawal,ATM Withdrawal,-968.3503972
6469,711389358,4-15-24 23:28,129.46,Deposit,Cash Deposit,-838.8903972
6470,711389358,4-17-24 19:28,379.39,OnlineShopping,Target,-1218.280397
6471,711389358,4-18-24 22:28,160.3,Withdrawal,Mobile App Withdrawal,-1378.580397
6472,711389358,4-23-24 12:28,21.51,Withdrawal,Mobile App Withdrawal,-1400.090397
6473,711389358,4-24-24 17:28,310.5,Return,Target Return,-1089.590397
6474,711389358,4-27-24 16:28,344.79,Withdrawal,ATM Withdrawal,-1434.380397
6475,711389358,4-28-24 14:28,77.62,Withdrawal,ATM Withdrawal,-1512.000397
6476,711389358,05-02-24 21:28,4700,IncomingTransfer,Salary,3187.999603
6477,711389358,05-03-24 18:28,368.98,Payment,Bill Payment,2819.019603
6478,711389358,05-07-24 21:28,3000,Payment,Credit Card Payment,-180.9803972
6479,711389358,05-07-24 22:28,378.79,Deposit,Check Deposit,197.8096028
6480,711389358,05-08-24 23:28,178.2,Deposit,Check Deposit,376.0096028
6481,711389358,05-09-24 22:28,245.01,IncomingTransfer,Freelance Payment,621.0196028
6482,711389358,05-11-24 20:28,115,OutgoingTransfer,Peer-to-Peer Transfer,506.0196028
6483,711389358,05-12-24 18:28,135.31,Purchase,Electronics,370.7096028
6484,711389358,5-15-24 21:28,1300,Payment,Rent Payment,-929.2903972
6485,711389358,5-25-24 12:28,76.96,Withdrawal,Mobile App Withdrawal,-1006.250397
6486,711389358,5-25-24 18:28,113.63,Withdrawal,ATM Withdrawal,-1119.880397
6487,711389358,5-29-24 12:28,298.63,Withdrawal,Mobile App Withdrawal,-1418.510397
6488,711389358,06-01-24 15:28,391.18,IncomingTransfer,Freelance Payment,-1027.330397
6489,711389358,06-01-24 21:28,4700,IncomingTransfer,Salary,3672.669603
6490,711389358,06-04-24 14:28,163.86,OnlineShopping,Walmart,3508.809603
6491,711389358,06-06-24 13:28,178.16,Return,Walmart Return,3686.969603
6492,711389358,06-06-24 16:28,117.42,Purchase,Home Improvement,3569.549603
6493,711389358,06-06-24 21:28,2600,Payment,Credit Card Payment,969.5496028
6494,711389358,6-13-24 10:28,345.36,OutgoingTransfer,Wire Transfer,624.1896028
6495,711389358,6-15-24 13:28,350.65,OnlineShopping,Target,273.5396028
6496,711389358,6-15-24 15:28,64.21,Deposit,Cash Deposit,337.7496028
6497,711389358,6-15-24 21:28,2400,Payment,Rent Payment,-2062.250397
6498,711389358,6-25-24 11:28,58.27,Purchase,Grocery,-2120.520397
6499,711389358,6-29-24 21:28,345.72,OutgoingTransfer,Bank Transfer,-2466.240397
6500,711389358,07-02-24 21:28,90.3,Purchase,Gas,-2556.540397
6501,711389358,07-04-24 21:28,4700,IncomingTransfer,Salary,2143.459603
6502,711389358,07-05-24 18:28,370.48,Purchase,Pharmacy,1772.979603
6503,711389358,07-06-24 16:28,298.14,Deposit,Cash Deposit,2071.119603
6504,711389358,07-09-24 21:28,2600,Payment,Credit Card Payment,-528.8803972
6505,711389358,7-13-24 21:28,1500,Payment,Rent Payment,-2028.880397
6506,711399408,1-21-24 12:28,59.2,Return,Amazon Return,59.2
6507,711399408,1-21-24 16:28,254.98,IncomingTransfer,Freelance Payment,314.18
6508,711399408,1-24-24 16:28,279.74,Deposit,Check Deposit,593.92
6509,711399408,1-30-24 19:28,388.64,Purchase,Grocery,205.28
6510,711399408,02-05-24 21:28,4350,IncomingTransfer,Salary,4555.28
6511,711399408,02-08-24 17:28,231.65,Withdrawal,ATM Withdrawal,4323.63
6512,711399408,2-13-24 15:28,402.67,Purchase,Pharmacy,3920.96
6513,711399408,2-14-24 23:28,125.55,OutgoingTransfer,Wire Transfer,3795.41
6514,711399408,2-17-24 14:28,24.68,Purchase,Clothing,3770.73
6515,711399408,2-18-24 17:28,478.93,Return,Store Return,4249.66
6516,711399408,2-18-24 21:28,1200,Payment,Rent Payment,3049.66
6517,711399408,2-20-24 12:28,185.56,Withdrawal,ATM Withdrawal,2864.1
6518,711399408,2-22-24 20:28,301.36,Deposit,Direct Deposit,3165.46
6519,711399408,03-01-24 21:28,4350,IncomingTransfer,Salary,7515.46
6520,711399408,03-05-24 20:28,162.83,OnlineShopping,Etsy,7352.63
6521,711399408,3-15-24 21:28,2100,Payment,Rent Payment,5252.63
6522,711399408,3-18-24 9:28,75.68,OutgoingTransfer,International Transfer,5176.95
6523,711399408,3-22-24 10:28,284.75,Withdrawal,ATM Withdrawal,4892.2
6524,711399408,3-24-24 21:28,329.61,Withdrawal,Mobile App Withdrawal,4562.59
6525,711399408,3-31-24 20:28,210.4,Withdrawal,ATM Withdrawal,4352.19
6526,711399408,04-02-24 13:28,43.86,Purchase,Clothing,4308.33
6527,711399408,04-03-24 21:28,4350,IncomingTransfer,Salary,8658.33
6528,711399408,04-05-24 18:28,115.04,Return,Amazon Return,8773.37
6529,711399408,04-09-24 20:28,133.34,OnlineShopping,Amazon,8640.03
6530,711399408,04-10-24 21:28,2000,Payment,Rent Payment,6640.03
6531,711399408,04-11-24 9:28,378.2,OutgoingTransfer,Peer-to-Peer Transfer,6261.83
6532,711399408,4-14-24 21:28,215.2,Payment,Bill Payment,6046.63
6533,711399408,4-18-24 22:28,275.9,Return,Best Buy Return,6322.53
6534,711399408,4-19-24 9:28,286,Withdrawal,Branch Withdrawal,6036.53
6535,711399408,05-03-24 9:28,293.87,Deposit,Direct Deposit,6330.4
6536,711399408,05-05-24 21:28,4350,IncomingTransfer,Salary,10680.4
6537,711399408,05-05-24 21:28,130.81,Withdrawal,Mobile App Withdrawal,10549.59
6538,711399408,05-07-24 13:28,178.74,OutgoingTransfer,Wire Transfer,10370.85
6539,711399408,05-11-24 18:28,66.17,Purchase,Travel,10304.68
6540,711399408,5-17-24 21:28,1900,Payment,Rent Payment,8404.68
6541,711399408,5-22-24 11:28,433.2,Deposit,Direct Deposit,8837.88
6542,711399408,5-25-24 12:28,169.56,Return,Etsy Return,9007.44
6543,711399408,5-25-24 14:28,29.75,Purchase,Travel,8977.69
6544,711399408,5-26-24 12:28,84.33,Purchase,Furniture,8893.36
6545,711399408,5-30-24 15:28,237.64,Payment,Mortgage Payment,8655.72
6546,711399408,06-02-24 21:28,4350,IncomingTransfer,Salary,13005.72
6547,711399408,06-07-24 11:28,387.69,Deposit,Direct Deposit,13393.41
6548,711399408,6-15-24 22:28,307.84,Return,Store Return,13701.25
6549,711399408,6-16-24 14:28,385.82,Deposit,Check Deposit,14087.07
6550,711399408,6-17-24 21:28,1300,Payment,Rent Payment,12787.07
6551,711399408,6-20-24 14:28,382.44,Return,eBay Return,13169.51
6552,711399408,6-20-24 18:28,182.6,Withdrawal,Mobile App Withdrawal,12986.91
6553,711399408,6-24-24 17:28,287.58,Withdrawal,Branch Withdrawal,12699.33
6554,711399408,07-05-24 21:28,4350,IncomingTransfer,Salary,17049.33
6555,711399408,07-05-24 22:28,355.77,Deposit,Check Deposit,17405.1
6556,711399408,07-11-24 17:28,431.42,Purchase,Gas,16973.68
6557,711399408,7-13-24 21:28,1900,Payment,Rent Payment,15073.68
6558,711423558,1-22-24 14:28,236.62,Withdrawal,Branch Withdrawal,-236.62
6559,711423558,1-24-24 9:28,358.72,Return,Best Buy Return,122.1
6560,711423558,1-30-24 18:28,262.91,Purchase,Travel,-140.81
6561,711423558,02-01-24 15:28,196.27,Purchase,Pharmacy,-337.08
6562,711423558,02-02-24 21:28,3800,IncomingTransfer,Salary,3462.92
6563,711423558,02-03-24 12:28,308.7,Purchase,Grocery,3154.22
6564,711423558,2-15-24 21:28,1300,Payment,Rent Payment,1854.22
6565,711423558,2-21-24 18:28,386.65,IncomingTransfer,Freelance Payment,2240.87
6566,711423558,2-22-24 15:28,46.99,OutgoingTransfer,Peer-to-Peer Transfer,2193.88
6567,711423558,2-26-24 9:28,102.73,Purchase,Furniture,2091.15
6568,711423558,2-26-24 10:28,280.09,Purchase,Entertainment,1811.06
6569,711423558,2-28-24 10:28,132.32,Withdrawal,Branch Withdrawal,1678.74
6570,711423558,2-29-24 12:28,143.2,Purchase,Furniture,1535.54
6571,711423558,03-02-24 21:28,3800,IncomingTransfer,Salary,5335.54
6572,711423558,03-04-24 14:28,219.7,Deposit,Cash Deposit,5555.24
6573,711423558,03-06-24 13:28,271.17,Purchase,Home Improvement,5284.07
6574,711423558,03-09-24 18:28,241.8,Payment,Loan Payment,5042.27
6575,711423558,03-10-24 14:28,322.98,Purchase,Clothing,4719.29
6576,711423558,03-11-24 15:28,373.76,Withdrawal,Mobile App Withdrawal,4345.53
6577,711423558,03-11-24 18:28,281.69,Deposit,Cash Deposit,4627.22
6578,711423558,3-13-24 21:28,2000,Payment,Rent Payment,2627.22
6579,711423558,3-16-24 21:28,322.2,Return,Store Return,2949.42
6580,711423558,3-18-24 14:28,369.9,IncomingTransfer,Freelance Payment,3319.32
6581,711423558,3-19-24 9:28,300.43,Return,Walmart Return,3619.75
6582,711423558,3-19-24 20:28,190.91,Deposit,Mobile Deposit,3810.66
6583,711423558,3-24-24 21:28,393.53,Payment,Bill Payment,3417.13
6584,711423558,3-25-24 9:28,268.51,Withdrawal,Branch Withdrawal,3148.62
6585,711423558,04-05-24 13:28,348.08,Return,Walmart Return,3496.7
6586,711423558,04-05-24 21:28,3800,IncomingTransfer,Salary,7296.7
6587,711423558,04-10-24 9:28,323.36,Withdrawal,Mobile App Withdrawal,6973.34
6588,711423558,04-10-24 22:28,278.21,Purchase,Entertainment,6695.13
6589,711423558,4-16-24 17:28,60.08,IncomingTransfer,Freelance Payment,6755.21
6590,711423558,4-16-24 21:28,2300,Payment,Rent Payment,4455.21
6591,711423558,4-21-24 19:28,197.08,Deposit,Mobile Deposit,4652.29
6592,711423558,4-23-24 12:28,129.54,Withdrawal,Mobile App Withdrawal,4522.75
6593,711423558,4-25-24 10:28,249.96,Deposit,Direct Deposit,4772.71
6594,711423558,4-29-24 16:28,276.87,Payment,Bill Payment,4495.84
6595,711423558,4-29-24 21:28,115.69,Withdrawal,Branch Withdrawal,4380.15
6596,711423558,05-02-24 21:28,3800,IncomingTransfer,Salary,8180.15
6597,711423558,05-02-24 21:28,374.11,IncomingTransfer,Freelance Payment,8554.26
6598,711423558,05-05-24 19:28,233.01,Deposit,Cash Deposit,8787.27
6599,711423558,05-07-24 14:28,177.91,Return,Store Return,8965.18
6600,711423558,05-08-24 16:28,330.8,Purchase,Grocery,8634.38
6601,711423558,05-10-24 13:28,139.26,Purchase,Home Improvement,8495.12
6602,711423558,05-10-24 22:28,243.21,OnlineShopping,Best Buy,8251.91
6603,711423558,5-17-24 21:28,2200,Payment,Rent Payment,6051.91
6604,711423558,5-19-24 21:28,114.43,Deposit,Mobile Deposit,6166.34
6605,711423558,5-21-24 17:28,377.79,Payment,Mortgage Payment,5788.55
6606,711423558,5-27-24 14:28,282.37,OnlineShopping,Best Buy,5506.18
6607,711423558,5-31-24 13:28,139.01,OnlineShopping,Walmart,5367.17
6608,711423558,5-31-24 23:28,71.56,Return,Target Return,5438.73
6609,711423558,06-01-24 17:28,27.07,OutgoingTransfer,International Transfer,5411.66
6610,711423558,06-02-24 21:28,3800,IncomingTransfer,Salary,9211.66
6611,711423558,06-05-24 20:28,229.86,Deposit,Cash Deposit,9441.52
6612,711423558,6-13-24 9:28,240.72,Purchase,Clothing,9200.8
6613,711423558,6-14-24 18:28,43.68,Deposit,Mobile Deposit,9244.48
6614,711423558,6-14-24 21:28,2000,Payment,Rent Payment,7244.48
6615,711423558,6-20-24 13:28,177.67,Withdrawal,ATM Withdrawal,7066.81
6616,711423558,6-22-24 19:28,298.94,IncomingTransfer,Freelance Payment,7365.75
6617,711423558,6-23-24 11:28,285.35,Purchase,Furniture,7080.4
6618,711423558,6-23-24 14:28,35.46,Purchase,Grocery,7044.94
6619,711423558,6-26-24 12:28,94.38,Purchase,Restaurant,6950.56
6620,711423558,6-26-24 19:28,260.27,Deposit,Direct Deposit,7210.83
6621,711423558,07-01-24 19:28,294.25,OutgoingTransfer,Wire Transfer,6916.58
6622,711423558,07-01-24 21:28,3800,IncomingTransfer,Salary,10716.58
6623,711423558,07-02-24 10:28,308.36,Payment,Mortgage Payment,10408.22
6624,711423558,07-04-24 15:28,173.21,Return,Best Buy Return,10581.43
6625,711423558,07-07-24 12:28,100.98,OutgoingTransfer,International Transfer,10480.45
6626,711423558,07-07-24 18:28,293.85,OnlineShopping,Etsy,10186.6
6627,711423558,07-09-24 10:28,398.31,Withdrawal,ATM Withdrawal,9788.29
6628,711423558,07-11-24 11:28,28.83,IncomingTransfer,Freelance Payment,9817.12
6629,711423558,07-11-24 16:28,206.89,Payment,Mortgage Payment,9610.23
6630,711423558,07-11-24 17:28,60.78,Withdrawal,ATM Withdrawal,9549.45
6631,711423558,07-11-24 21:28,2500,Payment,Rent Payment,7049.45
6632,711423558,7-14-24 10:28,297.3,Deposit,Cash Deposit,7346.75
6633,711445233,1-23-24 9:28,72.52,Return,Etsy Return,72.52
6634,711445233,1-24-24 11:28,93.14,Payment,Mortgage Payment,-20.62
6635,711445233,1-26-24 16:28,39.77,Deposit,Check Deposit,19.15
6636,711445233,1-27-24 15:28,233.24,Return,Target Return,252.39
6637,711445233,1-29-24 11:28,99.33,Payment,Bill Payment,153.06
6638,711445233,1-30-24 9:28,198.14,Deposit,Check Deposit,351.2
6639,711445233,1-31-24 9:28,61.54,Deposit,Mobile Deposit,412.74
6640,711445233,1-31-24 13:28,131.56,Withdrawal,ATM Withdrawal,281.18
6641,711445233,02-01-24 23:28,225.16,Return,Best Buy Return,506.34
6642,711445233,02-02-24 21:28,2550,IncomingTransfer,Salary,3056.34
6643,711445233,02-02-24 21:28,22.86,Purchase,Electronics,3033.48
6644,711445233,02-09-24 10:28,68.52,Purchase,Restaurant,2964.96
6645,711445233,02-11-24 18:28,184.78,OnlineShopping,eBay,2780.18
6646,711445233,02-11-24 21:28,1600,Payment,Rent Payment,1180.18
6647,711445233,2-14-24 17:28,169.13,Withdrawal,Mobile App Withdrawal,1011.05
6648,711445233,2-15-24 13:28,206.4,Deposit,Check Deposit,1217.45
6649,711445233,2-15-24 21:28,15.39,Deposit,Check Deposit,1232.84
6650,711445233,2-17-24 17:28,154.43,Deposit,Cash Deposit,1387.27
6651,711445233,2-18-24 21:28,214.62,OnlineShopping,AliExpress,1172.65
6652,711445233,2-21-24 9:28,109.73,Purchase,Pharmacy,1062.92
6653,711445233,03-01-24 20:28,11.56,Payment,Loan Payment,1051.36
6654,711445233,03-04-24 16:28,100.54,Payment,Mortgage Payment,950.82
6655,711445233,03-04-24 21:28,2550,IncomingTransfer,Salary,3500.82
6656,711445233,03-06-24 12:28,118.05,Withdrawal,Mobile App Withdrawal,3382.77
6657,711445233,03-10-24 21:28,700,Payment,Rent Payment,2682.77
6658,711445233,03-10-24 21:28,171.3,Return,eBay Return,2854.07
6659,711445233,3-13-24 9:28,241.64,Deposit,Check Deposit,3095.71
6660,711445233,3-17-24 14:28,42.38,Purchase,Restaurant,3053.33
6661,711445233,3-17-24 21:28,66.9,Withdrawal,Branch Withdrawal,2986.43
6662,711445233,3-21-24 11:28,207.37,Return,AliExpress Return,3193.8
6663,711445233,3-23-24 10:28,134.71,Purchase,Home Improvement,3059.09
6664,711445233,3-25-24 22:28,229.16,Purchase,Restaurant,2829.93
6665,711445233,3-29-24 20:28,24.93,OutgoingTransfer,Bank Transfer,2805
6666,711445233,04-03-24 17:28,161.01,Purchase,Clothing,2643.99
6667,711445233,04-03-24 21:28,2550,IncomingTransfer,Salary,5193.99
6668,711445233,04-04-24 16:28,44.46,Purchase,Entertainment,5149.53
6669,711445233,04-12-24 12:28,110.73,Deposit,Direct Deposit,5260.26
6670,711445233,4-13-24 19:28,165.79,Withdrawal,Branch Withdrawal,5094.47
6671,711445233,4-13-24 19:28,117.15,Payment,Loan Payment,4977.32
6672,711445233,4-16-24 21:28,97.09,Payment,Bill Payment,4880.23
6673,711445233,4-17-24 10:28,39.66,OnlineShopping,Etsy,4840.57
6674,711445233,4-17-24 15:28,194.41,Purchase,Electronics,4646.16
6675,711445233,4-17-24 18:28,128.57,Return,eBay Return,4774.73
6676,711445233,4-17-24 21:28,1400,Payment,Rent Payment,3374.73
6677,711445233,4-19-24 11:28,208.66,Deposit,Direct Deposit,3583.39
6678,711445233,4-21-24 15:28,91.35,Return,Best Buy Return,3674.74
6679,711445233,4-21-24 17:28,121.11,Purchase,Pharmacy,3553.63
6680,711445233,4-24-24 9:28,81.02,OnlineShopping,Etsy,3472.61
6681,711445233,4-26-24 12:28,80.39,Withdrawal,Mobile App Withdrawal,3392.22
6682,711445233,4-26-24 16:28,204.27,IncomingTransfer,Freelance Payment,3596.49
6683,711445233,4-26-24 18:28,11.68,Purchase,Restaurant,3584.81
6684,711445233,4-26-24 22:28,232.14,Return,AliExpress Return,3816.95
6685,711445233,4-26-24 22:28,137.07,OutgoingTransfer,Wire Transfer,3679.88
6686,711445233,4-27-24 14:28,131.1,Withdrawal,Branch Withdrawal,3548.78
6687,711445233,05-01-24 13:28,34.71,Purchase,Restaurant,3514.07
6688,711445233,05-04-24 21:28,2550,IncomingTransfer,Salary,6064.07
6689,711445233,05-05-24 15:28,67.75,Withdrawal,Mobile App Withdrawal,5996.32
6690,711445233,05-05-24 15:28,23.53,Withdrawal,ATM Withdrawal,5972.79
6691,711445233,5-14-24 9:28,41.3,Deposit,Check Deposit,6014.09
6692,711445233,5-14-24 16:28,243.86,Purchase,Restaurant,5770.23
6693,711445233,5-18-24 21:28,700,Payment,Rent Payment,5070.23
6694,711445233,5-19-24 16:28,79.14,OnlineShopping,Best Buy,4991.09
6695,711445233,5-21-24 17:28,243.82,OnlineShopping,eBay,4747.27
6696,711445233,5-21-24 18:28,35.7,OnlineShopping,Etsy,4711.57
6697,711445233,5-24-24 16:28,125.42,OutgoingTransfer,Wire Transfer,4586.15
6698,711445233,06-03-24 22:28,29.32,Deposit,Check Deposit,4615.47
6699,711445233,06-05-24 21:28,2550,IncomingTransfer,Salary,7165.47
6700,711445233,06-07-24 17:28,228.91,Withdrawal,ATM Withdrawal,6936.56
6701,711445233,06-08-24 20:28,162.43,Deposit,Mobile Deposit,7098.99
6702,711445233,06-09-24 13:28,240.85,OnlineShopping,Walmart,6858.14
6703,711445233,06-10-24 21:28,1500,Payment,Rent Payment,5358.14
6704,711445233,06-12-24 12:28,71.59,Withdrawal,Mobile App Withdrawal,5286.55
6705,711445233,6-16-24 10:28,196.13,OutgoingTransfer,Bank Transfer,5090.42
6706,711445233,6-17-24 13:28,14.53,OnlineShopping,eBay,5075.89
6707,711445233,6-17-24 23:28,30.09,OnlineShopping,Target,5045.8
6708,711445233,6-19-24 17:28,142.96,Deposit,Cash Deposit,5188.76
6709,711445233,6-21-24 23:28,24.37,Deposit,Direct Deposit,5213.13
6710,711445233,6-22-24 21:28,43.65,OnlineShopping,AliExpress,5169.48
6711,711445233,6-24-24 22:28,226.26,IncomingTransfer,Freelance Payment,5395.74
6712,711445233,6-25-24 13:28,81.73,Purchase,Grocery,5314.01
6713,711445233,6-26-24 19:28,14.08,Deposit,Cash Deposit,5328.09
6714,711445233,6-30-24 20:28,25.95,Purchase,Gas,5302.14
6715,711445233,07-01-24 22:28,198.19,Deposit,Cash Deposit,5500.33
6716,711445233,07-02-24 21:28,2550,IncomingTransfer,Salary,8050.33
6717,711445233,07-04-24 19:28,206.13,Payment,Bill Payment,7844.2
6718,711445233,07-07-24 10:28,20.98,Withdrawal,Branch Withdrawal,7823.22
6719,711445233,07-09-24 16:28,37.3,IncomingTransfer,Freelance Payment,7860.52
6720,711445233,07-09-24 17:28,178.92,OutgoingTransfer,International Transfer,7681.6
6721,711445233,7-15-24 22:28,169.34,Deposit,Cash Deposit,7850.94
6722,711445233,7-18-24 21:28,900,Payment,Rent Payment,6950.94
6723,711455133,1-21-24 21:28,462.18,Purchase,Restaurant,515.8361548
6724,711455133,1-27-24 19:28,446.06,Withdrawal,Mobile App Withdrawal,69.77615478
6725,711455133,1-29-24 12:28,420.07,OnlineShopping,eBay,-350.2938452
6726,711455133,02-01-24 12:28,915.06,Return,Walmart Return,564.7661548
6727,711455133,02-04-24 15:28,889.83,Purchase,Clothing,-325.0638452
6728,711455133,02-04-24 21:28,15150,IncomingTransfer,Salary,14824.93615
6729,711455133,02-08-24 14:28,901.19,Withdrawal,Branch Withdrawal,13923.74615
6730,711455133,02-09-24 21:28,2500,Payment,Credit Card Payment,11423.74615
6731,711455133,2-14-24 21:28,3800,Payment,Installment Payment,7623.746155
6732,711455133,2-20-24 14:28,929.42,Purchase,Furniture,6694.326155
6733,711455133,2-21-24 17:28,907.51,Payment,Loan Payment,5786.816155
6734,711455133,2-23-24 13:28,232.07,OutgoingTransfer,Peer-to-Peer Transfer,5554.746155
6735,711455133,2-23-24 21:28,332.32,Return,Best Buy Return,5887.066155
6736,711455133,2-27-24 22:28,608,OutgoingTransfer,Peer-to-Peer Transfer,5279.066155
6737,711455133,03-04-24 21:28,15150,IncomingTransfer,Salary,20429.06615
6738,711455133,03-09-24 13:28,282.49,Return,Store Return,20711.55615
6739,711455133,03-09-24 21:28,2500,Payment,Credit Card Payment,18211.55615
6740,711455133,03-11-24 21:28,4100,Payment,Subscription Payment,14111.55615
6741,711455133,3-23-24 17:28,581.89,Purchase,Clothing,13529.66615
6742,711455133,3-23-24 18:28,740.96,Purchase,Furniture,12788.70615
6743,711455133,3-26-24 15:28,679.06,OutgoingTransfer,International Transfer,12109.64615
6744,711455133,04-02-24 21:28,15150,IncomingTransfer,Salary,27259.64615
6745,711455133,04-04-24 11:28,927.51,Withdrawal,Branch Withdrawal,26332.13615
6746,711455133,04-07-24 21:28,2200,Payment,Credit Card Payment,24132.13615
6747,711455133,4-17-24 21:28,4000,Payment,Subscription Payment,20132.13615
6748,711455133,4-18-24 17:28,604.54,Purchase,Gas,19527.59615
6749,711455133,4-20-24 22:28,422.28,Withdrawal,ATM Withdrawal,19105.31615
6750,711455133,4-21-24 15:28,649,Deposit,Check Deposit,19754.31615
6751,711455133,4-25-24 9:28,348.54,IncomingTransfer,Freelance Payment,20102.85615
6752,711455133,4-26-24 14:28,475.47,Deposit,Direct Deposit,20578.32615
6753,711455133,4-26-24 16:28,495.47,IncomingTransfer,Freelance Payment,21073.79615
6754,711455133,4-30-24 19:28,492.82,IncomingTransfer,Freelance Payment,21566.61615
6755,711455133,05-02-24 23:28,248.48,Return,Store Return,21815.09615
6756,711455133,05-05-24 21:28,15150,IncomingTransfer,Salary,36965.09615
6757,711455133,05-07-24 22:28,524.94,IncomingTransfer,Freelance Payment,37490.03615
6758,711455133,05-10-24 21:28,2300,Payment,Credit Card Payment,35190.03615
6759,711455133,5-17-24 21:28,5300,Payment,Insurance Payment,29890.03615
6760,711455133,5-17-24 22:28,923.5,IncomingTransfer,Freelance Payment,30813.53615
6761,711455133,5-28-24 12:28,510.93,OnlineShopping,Target,30302.60615
6762,711455133,5-29-24 13:28,663.99,Purchase,Travel,29638.61615
6763,711455133,5-31-24 18:28,778.4,Purchase,Restaurant,28860.21615
6764,711455133,06-02-24 21:28,15150,IncomingTransfer,Salary,44010.21615
6765,711455133,06-05-24 16:28,918.54,Withdrawal,Branch Withdrawal,43091.67615
6766,711455133,06-07-24 14:28,612.47,Purchase,Entertainment,42479.20615
6767,711455133,06-07-24 21:28,2700,Payment,Credit Card Payment,39779.20615
6768,711455133,06-11-24 23:28,394.23,OutgoingTransfer,Peer-to-Peer Transfer,39384.97615
6769,711455133,6-14-24 13:28,741.07,Payment,Bill Payment,38643.90615
6770,711455133,6-17-24 12:28,891.87,Return,Amazon Return,39535.77615
6771,711455133,6-18-24 21:28,5900,Payment,Installment Payment,33635.77615
6772,711455133,6-21-24 10:28,218.46,OnlineShopping,Best Buy,33417.31615
6773,711455133,6-23-24 20:28,494.19,Purchase,Pharmacy,32923.12615
6774,711455133,6-24-24 23:28,336.64,IncomingTransfer,Freelance Payment,33259.76615
6775,711455133,6-29-24 13:28,841.45,Deposit,Direct Deposit,34101.21615
6776,711455133,07-04-24 21:28,15150,IncomingTransfer,Salary,49251.21615
6777,711455133,07-07-24 11:28,677.08,Purchase,Electronics,48574.13615
6778,711455133,07-09-24 21:28,2400,Payment,Credit Card Payment,46174.13615
6779,711455133,07-12-24 17:28,788.47,Purchase,Restaurant,45385.66615
6780,711455133,7-13-24 21:28,217.67,Deposit,Check Deposit,45603.33615
6781,711455133,7-17-24 17:28,620.93,Deposit,Direct Deposit,46224.26615
6782,711455133,7-18-24 21:28,6800,Payment,Installment Payment,39424.26615
6783,711474333,1-24-24 22:28,177.08,Payment,Bill Payment,-177.08
6784,711474333,1-28-24 16:28,235.48,Deposit,Direct Deposit,58.4
6785,711474333,02-01-24 20:28,11.1,OutgoingTransfer,Wire Transfer,47.3
6786,711474333,02-05-24 15:28,151.9,Return,Etsy Return,199.2
6787,711474333,02-06-24 18:28,10.31,Purchase,Clothing,188.89
6788,711474333,2-19-24 17:28,107.6,Purchase,Restaurant,81.29
6789,711474333,2-20-24 22:28,184.1,Withdrawal,Mobile App Withdrawal,-102.81
6790,711474333,2-21-24 19:28,158.86,Return,Amazon Return,56.05
6791,711474333,2-22-24 16:28,159.82,OutgoingTransfer,Bank Transfer,-103.77
6792,711474333,03-03-24 10:28,107.55,Purchase,Clothing,-211.32
6793,711474333,03-05-24 10:28,215.66,OutgoingTransfer,Wire Transfer,-426.98
6794,711474333,03-12-24 16:28,68.77,OutgoingTransfer,International Transfer,-495.75
6795,711474333,03-12-24 18:28,111.52,Withdrawal,ATM Withdrawal,-607.27
6796,711474333,3-16-24 11:28,181.72,Deposit,Cash Deposit,-425.55
6797,711474333,3-26-24 22:28,61.45,IncomingTransfer,Freelance Payment,-364.1
6798,711474333,3-27-24 20:28,247.6,Purchase,Restaurant,-611.7
6799,711474333,3-30-24 21:28,169.09,Withdrawal,Mobile App Withdrawal,-780.79
6800,711474333,04-07-24 11:28,187.13,Withdrawal,Mobile App Withdrawal,-967.92
6801,711474333,04-11-24 15:28,56.94,Purchase,Grocery,-1024.86
6802,711474333,4-14-24 14:28,165.37,Return,Target Return,-859.49
6803,711474333,4-15-24 21:28,141.62,Deposit,Direct Deposit,-717.87
6804,711474333,4-25-24 11:28,220.3,OnlineShopping,Etsy,-938.17
6805,711474333,4-25-24 19:28,96.04,Deposit,Direct Deposit,-842.13
6806,711474333,4-28-24 17:28,228.66,Purchase,Home Improvement,-1070.79
6807,711474333,4-30-24 17:28,12.32,Deposit,Mobile Deposit,-1058.47
6808,711474333,05-03-24 11:28,118.07,Withdrawal,ATM Withdrawal,-1176.54
6809,711474333,5-15-24 23:28,152.93,Payment,Loan Payment,-1329.47
6810,711474333,5-17-24 14:28,61.97,IncomingTransfer,Freelance Payment,-1267.5
6811,711474333,5-20-24 16:28,113.7,Purchase,Pharmacy,-1381.2
6812,711474333,5-21-24 12:28,150.57,Withdrawal,ATM Withdrawal,-1531.77
6813,711474333,06-08-24 10:28,236.32,Deposit,Cash Deposit,-1295.45
6814,711474333,06-11-24 9:28,34.7,Purchase,Entertainment,-1330.15
6815,711474333,6-16-24 14:28,76.02,Payment,Bill Payment,-1406.17
6816,711474333,6-21-24 14:28,190.24,Deposit,Check Deposit,-1215.93
6817,711474333,07-05-24 18:28,160.14,Withdrawal,ATM Withdrawal,-1376.07
6818,711474333,07-07-24 10:28,119.5,Deposit,Direct Deposit,-1256.57
6819,711474333,07-08-24 11:28,112,Deposit,Check Deposit,-1144.57
6820,711474333,07-08-24 21:28,203.82,Payment,Loan Payment,-1348.39
6821,711502908,1-20-24 21:28,206.28,Deposit,Direct Deposit,206.28
6822,711502908,1-21-24 16:28,293.33,Deposit,Direct Deposit,499.61
6823,711502908,1-22-24 13:28,112.12,Deposit,Mobile Deposit,611.73
6824,711502908,1-24-24 9:28,224.17,Deposit,Direct Deposit,835.9
6825,711502908,1-24-24 15:28,157.21,Deposit,Direct Deposit,993.11
6826,711502908,1-25-24 9:28,375.88,Return,Walmart Return,1368.99
6827,711502908,1-26-24 12:28,434.17,Purchase,Pharmacy,934.82
6828,711502908,1-29-24 15:28,493.46,Purchase,Electronics,441.36
6829,711502908,02-01-24 22:28,532.48,OnlineShopping,AliExpress,-91.12
6830,711502908,02-02-24 21:28,5600,IncomingTransfer,Salary,5508.88
6831,711502908,02-06-24 13:28,344.94,OnlineShopping,Amazon,5163.94
6832,711502908,02-10-24 13:28,433.52,Payment,Bill Payment,4730.42
6833,711502908,02-11-24 21:28,118.6,Withdrawal,Mobile App Withdrawal,4611.82
6834,711502908,2-13-24 16:28,203.5,Purchase,Electronics,4408.32
6835,711502908,2-14-24 21:28,2300,Payment,Subscription Payment,2108.32
6836,711502908,2-18-24 22:28,503.26,OutgoingTransfer,International Transfer,1605.06
6837,711502908,2-21-24 22:28,100.95,IncomingTransfer,Freelance Payment,1706.01
6838,711502908,2-25-24 16:28,423.21,Deposit,Cash Deposit,2129.22
6839,711502908,2-25-24 19:28,456.06,OnlineShopping,Amazon,1673.16
6840,711502908,2-27-24 10:28,278.6,Payment,Mortgage Payment,1394.56
6841,711502908,2-27-24 16:28,218.03,Withdrawal,Mobile App Withdrawal,1176.53
6842,711502908,2-29-24 13:28,491.33,Return,eBay Return,1667.86
6843,711502908,2-29-24 16:28,521.19,Purchase,Home Improvement,1146.67
6844,711502908,03-02-24 21:28,5600,IncomingTransfer,Salary,6746.67
6845,711502908,03-03-24 20:28,99.3,OnlineShopping,Walmart,6647.37
6846,711502908,03-04-24 17:28,107.26,OnlineShopping,Etsy,6540.11
6847,711502908,03-07-24 18:28,309.22,OutgoingTransfer,Peer-to-Peer Transfer,6230.89
6848,711502908,3-16-24 14:28,455.35,Return,Best Buy Return,6686.24
6849,711502908,3-18-24 21:28,2200,Payment,Installment Payment,4486.24
6850,711502908,3-20-24 17:28,515.45,OnlineShopping,AliExpress,3970.79
6851,711502908,3-21-24 9:28,362.88,OnlineShopping,eBay,3607.91
6852,711502908,3-27-24 16:28,129.39,Return,Walmart Return,3737.3
6853,711502908,3-29-24 17:28,72.08,Deposit,Cash Deposit,3809.38
6854,711502908,3-31-24 10:28,354.94,OutgoingTransfer,Peer-to-Peer Transfer,3454.44
6855,711502908,04-04-24 10:28,158.4,IncomingTransfer,Freelance Payment,3612.84
6856,711502908,04-05-24 21:28,5600,IncomingTransfer,Salary,9212.84
6857,711502908,04-06-24 15:28,456.44,Purchase,Restaurant,8756.4
6858,711502908,04-06-24 22:28,321.91,Withdrawal,Mobile App Withdrawal,8434.49
6859,711502908,04-08-24 10:28,61.93,Deposit,Cash Deposit,8496.42
6860,711502908,04-09-24 19:28,160.49,Purchase,Gas,8335.93
6861,711502908,04-12-24 9:28,454.57,Deposit,Cash Deposit,8790.5
6862,711502908,4-14-24 21:28,2400,Payment,Subscription Payment,6390.5
6863,711502908,4-18-24 19:28,434.88,OnlineShopping,eBay,5955.62
6864,711502908,4-20-24 15:28,70.67,IncomingTransfer,Freelance Payment,6026.29
6865,711502908,05-01-24 21:28,5600,IncomingTransfer,Salary,11626.29
6866,711502908,05-02-24 10:28,224.68,Deposit,Check Deposit,11850.97
6867,711502908,05-04-24 14:28,206.67,OnlineShopping,Best Buy,11644.3
6868,711502908,05-07-24 10:28,248.94,Payment,Bill Payment,11395.36
6869,711502908,05-10-24 15:28,143.89,Deposit,Direct Deposit,11539.25
6870,711502908,5-15-24 11:28,91.23,Payment,Loan Payment,11448.02
6871,711502908,5-16-24 21:28,2500,Payment,Insurance Payment,8948.02
6872,711502908,5-17-24 12:28,272.14,Deposit,Mobile Deposit,9220.16
6873,711502908,5-20-24 22:28,194.17,Return,AliExpress Return,9414.33
6874,711502908,5-25-24 11:28,483.32,Payment,Mortgage Payment,8931.01
6875,711502908,5-26-24 11:28,90.02,Withdrawal,Mobile App Withdrawal,8840.99
6876,711502908,5-29-24 23:28,53.23,Return,Best Buy Return,8894.22
6877,711502908,5-30-24 9:28,196.07,Payment,Bill Payment,8698.15
6878,711502908,06-02-24 14:28,203.3,Purchase,Travel,8494.85
6879,711502908,06-05-24 21:28,5600,IncomingTransfer,Salary,14094.85
6880,711502908,06-06-24 11:28,247.24,Payment,Mortgage Payment,13847.61
6881,711502908,06-06-24 12:28,407.35,Deposit,Check Deposit,14254.96
6882,711502908,06-09-24 14:28,437.08,Withdrawal,ATM Withdrawal,13817.88
6883,711502908,06-10-24 20:28,467.08,OnlineShopping,eBay,13350.8
6884,711502908,06-10-24 23:28,351.46,OutgoingTransfer,Wire Transfer,12999.34
6885,711502908,6-15-24 17:28,407.65,OutgoingTransfer,International Transfer,12591.69
6886,711502908,6-15-24 21:28,2000,Payment,Installment Payment,10591.69
6887,711502908,6-17-24 18:28,478.65,OnlineShopping,eBay,10113.04
6888,711502908,6-18-24 12:28,252,Deposit,Mobile Deposit,10365.04
6889,711502908,6-19-24 22:28,537.48,Purchase,Travel,9827.56
6890,711502908,6-22-24 17:28,300.68,Deposit,Mobile Deposit,10128.24
6891,711502908,6-29-24 18:28,513.86,Withdrawal,ATM Withdrawal,9614.38
6892,711502908,07-04-24 21:28,5600,IncomingTransfer,Salary,15214.38
6893,711502908,07-05-24 14:28,130.83,Purchase,Clothing,15083.55
6894,711502908,07-06-24 18:28,426.13,Withdrawal,ATM Withdrawal,14657.42
6895,711502908,07-06-24 22:28,483.8,OutgoingTransfer,International Transfer,14173.62
6896,711502908,07-09-24 14:28,454.31,IncomingTransfer,Freelance Payment,14627.93
6897,711502908,07-10-24 21:28,121.84,OutgoingTransfer,Bank Transfer,14506.09
6898,711502908,07-11-24 14:28,79.41,IncomingTransfer,Freelance Payment,14585.5
6899,711502908,7-16-24 21:28,2100,Payment,Insurance Payment,12485.5
6900,711502908,7-16-24 21:28,373.18,IncomingTransfer,Freelance Payment,12858.68
6901,711569433,1-21-24 22:28,178.63,OnlineShopping,Etsy,1463.342333
6902,711569433,1-25-24 14:28,20.86,OutgoingTransfer,Peer-to-Peer Transfer,1442.482333
6903,711569433,1-28-24 15:28,206.95,Deposit,Direct Deposit,1649.432333
6904,711569433,1-28-24 17:28,244.1,Return,Etsy Return,1893.532333
6905,711569433,1-28-24 19:28,111.6,Deposit,Cash Deposit,2005.132333
6906,711569433,02-02-24 10:28,52.15,OnlineShopping,Target,1952.982333
6907,711569433,02-03-24 21:28,2500,IncomingTransfer,Salary,4452.982333
6908,711569433,02-08-24 21:28,2100,Payment,Credit Card Payment,2352.982333
6909,711569433,02-11-24 21:28,900,Payment,Installment Payment,1452.982333
6910,711569433,2-16-24 20:28,64.62,Return,Target Return,1517.602333
6911,711569433,03-03-24 21:28,2500,IncomingTransfer,Salary,4017.602333
6912,711569433,03-08-24 21:28,2300,Payment,Credit Card Payment,1717.602333
6913,711569433,03-10-24 14:28,238.3,Deposit,Direct Deposit,1955.902333
6914,711569433,03-12-24 21:28,1100,Payment,Subscription Payment,855.9023334
6915,711569433,3-18-24 15:28,132.88,OnlineShopping,Etsy,723.0223334
6916,711569433,3-22-24 11:28,52.98,Deposit,Check Deposit,776.0023334
6917,711569433,04-02-24 20:28,130.4,Withdrawal,ATM Withdrawal,645.6023334
6918,711569433,04-05-24 21:28,2500,IncomingTransfer,Salary,3145.602333
6919,711569433,04-10-24 21:28,2100,Payment,Credit Card Payment,1045.602333
6920,711569433,4-13-24 20:28,212.65,Withdrawal,ATM Withdrawal,832.9523334
6921,711569433,4-13-24 21:28,248.42,Withdrawal,Mobile App Withdrawal,584.5323334
6922,711569433,4-18-24 21:28,1000,Payment,Subscription Payment,-415.4676666
6923,711569433,05-04-24 21:28,2500,IncomingTransfer,Salary,2084.532333
6924,711569433,05-08-24 16:28,242.01,Withdrawal,Mobile App Withdrawal,1842.522333
6925,711569433,05-09-24 21:28,2700,Payment,Credit Card Payment,-857.4776666
6926,711569433,05-11-24 13:28,165.89,Purchase,Travel,-1023.367667
6927,711569433,5-14-24 19:28,43.86,OnlineShopping,Best Buy,-1067.227667
6928,711569433,5-18-24 21:28,1000,Payment,Subscription Payment,-2067.227667
6929,711569433,06-01-24 21:28,2500,IncomingTransfer,Salary,432.7723334
6930,711569433,06-06-24 19:28,70.17,Purchase,Gas,362.6023334
6931,711569433,06-06-24 21:28,2800,Payment,Credit Card Payment,-2437.397667
6932,711569433,06-11-24 21:28,900,Payment,Insurance Payment,-3337.397667
6933,711569433,6-14-24 13:28,159.92,Payment,Mortgage Payment,-3497.317667
6934,711569433,6-19-24 10:28,168.18,Deposit,Check Deposit,-3329.137667
6935,711569433,6-22-24 18:28,59.24,Purchase,Furniture,-3388.377667
6936,711569433,6-30-24 18:28,158.92,Return,Best Buy Return,-3229.457667
6937,711569433,07-04-24 21:28,2500,IncomingTransfer,Salary,-729.4576666
6938,711569433,07-09-24 21:28,2800,Payment,Credit Card Payment,-3529.457667
6939,711569433,07-11-24 21:28,900,Payment,Subscription Payment,-4429.457667
6940,711569433,7-15-24 12:28,200.76,Purchase,Electronics,-4630.217667
6941,711583458,1-22-24 9:28,170.91,Purchase,Grocery,-170.91
6942,711583458,1-22-24 14:28,164.54,Deposit,Cash Deposit,-6.37
6943,711583458,1-23-24 19:28,176.07,Deposit,Mobile Deposit,169.7
6944,711583458,1-23-24 23:28,176.01,Deposit,Check Deposit,345.71
6945,711583458,1-25-24 9:28,16.81,Withdrawal,ATM Withdrawal,328.9
6946,711583458,1-28-24 19:28,44.46,Deposit,Direct Deposit,373.36
6947,711583458,1-29-24 15:28,33.44,OutgoingTransfer,Peer-to-Peer Transfer,339.92
6948,711583458,1-29-24 21:28,52.88,Deposit,Mobile Deposit,392.8
6949,711583458,02-04-24 21:28,2200,IncomingTransfer,Salary,2592.8
6950,711583458,02-06-24 18:28,101.96,Deposit,Cash Deposit,2694.76
6951,711583458,02-06-24 21:28,81.01,OnlineShopping,Walmart,2613.75
6952,711583458,02-10-24 20:28,206.11,OutgoingTransfer,Peer-to-Peer Transfer,2407.64
6953,711583458,2-17-24 21:28,108.36,Payment,Bill Payment,2299.28
6954,711583458,2-18-24 21:28,1100,Payment,Rent Payment,1199.28
6955,711583458,2-20-24 12:28,85.41,Payment,Loan Payment,1113.87
6956,711583458,2-26-24 9:28,114.36,Return,AliExpress Return,1228.23
6957,711583458,03-04-24 21:28,2200,IncomingTransfer,Salary,3428.23
6958,711583458,03-06-24 23:28,37.58,OutgoingTransfer,Bank Transfer,3390.65
6959,711583458,03-07-24 15:28,139.17,Payment,Loan Payment,3251.48
6960,711583458,03-08-24 10:28,160.49,Deposit,Check Deposit,3411.97
6961,711583458,03-09-24 22:28,184.11,Return,Etsy Return,3596.08
6962,711583458,3-13-24 9:28,22.39,Deposit,Cash Deposit,3618.47
6963,711583458,3-15-24 21:28,1200,Payment,Rent Payment,2418.47
6964,711583458,3-16-24 16:28,74.66,Withdrawal,Mobile App Withdrawal,2343.81
6965,711583458,3-20-24 16:28,23.46,Return,Best Buy Return,2367.27
6966,711583458,3-21-24 15:28,89.18,OutgoingTransfer,Bank Transfer,2278.09
6967,711583458,3-22-24 22:28,118.74,OnlineShopping,AliExpress,2159.35
6968,711583458,3-23-24 20:28,56.19,Withdrawal,Branch Withdrawal,2103.16
6969,711583458,3-23-24 22:28,62.49,Purchase,Home Improvement,2040.67
6970,711583458,3-24-24 10:28,157.37,OutgoingTransfer,International Transfer,1883.3
6971,711583458,3-25-24 11:28,203.57,OnlineShopping,eBay,1679.73
6972,711583458,3-26-24 20:28,228.32,Deposit,Check Deposit,1908.05
6973,711583458,3-26-24 23:28,30.93,Payment,Loan Payment,1877.12
6974,711583458,3-27-24 15:28,139.85,Purchase,Electronics,1737.27
6975,711583458,3-27-24 15:28,238.86,Deposit,Direct Deposit,1976.13
6976,711583458,3-27-24 18:28,97.09,Deposit,Mobile Deposit,2073.22
6977,711583458,3-28-24 22:28,200.58,Withdrawal,Mobile App Withdrawal,1872.64
6978,711583458,3-29-24 12:28,193.62,Purchase,Travel,1679.02
6979,711583458,3-30-24 18:28,48.46,OnlineShopping,eBay,1630.56
6980,711583458,3-31-24 18:28,93.86,Purchase,Furniture,1536.7
6981,711583458,04-03-24 12:28,67.6,Withdrawal,Branch Withdrawal,1469.1
6982,711583458,04-03-24 21:28,2200,IncomingTransfer,Salary,3669.1
6983,711583458,04-04-24 9:28,147.65,OnlineShopping,Etsy,3521.45
6984,711583458,04-05-24 12:28,187.93,Payment,Mortgage Payment,3333.52
6985,711583458,04-08-24 21:28,105.43,Purchase,Gas,3228.09
6986,711583458,04-10-24 19:28,58.31,OutgoingTransfer,Wire Transfer,3169.78
6987,711583458,04-12-24 21:28,1300,Payment,Rent Payment,1869.78
6988,711583458,4-13-24 21:28,188.14,Return,Amazon Return,2057.92
6989,711583458,4-15-24 19:28,157.84,Withdrawal,Branch Withdrawal,1900.08
6990,711583458,4-18-24 11:28,211.47,Deposit,Direct Deposit,2111.55
6991,711583458,4-19-24 17:28,24.69,Deposit,Direct Deposit,2136.24
6992,711583458,4-19-24 20:28,65.83,OutgoingTransfer,Wire Transfer,2070.41
6993,711583458,4-19-24 21:28,211.84,Purchase,Electronics,1858.57
6994,711583458,4-21-24 14:28,131.83,Deposit,Mobile Deposit,1990.4
6995,711583458,4-23-24 10:28,224.8,Withdrawal,Mobile App Withdrawal,1765.6
6996,711583458,4-24-24 20:28,71.22,OutgoingTransfer,Bank Transfer,1694.38
6997,711583458,4-24-24 23:28,115.3,OutgoingTransfer,International Transfer,1579.08
6998,711583458,4-25-24 10:28,189.65,Payment,Loan Payment,1389.43
6999,711583458,4-25-24 23:28,109.24,Deposit,Cash Deposit,1498.67
7000,711583458,4-27-24 15:28,97.54,Return,Walmart Return,1596.21
7001,711583458,05-02-24 20:28,142.19,OutgoingTransfer,Peer-to-Peer Transfer,1454.02
7002,711583458,05-04-24 20:28,101.48,Payment,Bill Payment,1352.54
7003,711583458,05-05-24 21:28,2200,IncomingTransfer,Salary,3552.54
7004,711583458,05-06-24 13:28,159.72,Deposit,Direct Deposit,3712.26
7005,711583458,05-11-24 21:28,1100,Payment,Rent Payment,2612.26
7006,711583458,05-12-24 11:28,64.45,Return,Walmart Return,2676.71
7007,711583458,5-13-24 10:28,90.73,Deposit,Cash Deposit,2767.44
7008,711583458,5-21-24 9:28,84.36,Payment,Bill Payment,2683.08
7009,711583458,5-21-24 22:28,14.71,Payment,Bill Payment,2668.37
7010,711583458,5-23-24 15:28,91.67,Purchase,Restaurant,2576.7
7011,711583458,5-25-24 19:28,42.11,OutgoingTransfer,Wire Transfer,2534.59
7012,711583458,5-27-24 13:28,207.36,OutgoingTransfer,Peer-to-Peer Transfer,2327.23
7013,711583458,5-28-24 15:28,212.27,Withdrawal,Mobile App Withdrawal,2114.96
7014,711583458,5-30-24 13:28,130.87,Deposit,Mobile Deposit,2245.83
7015,711583458,5-30-24 15:28,125.75,Payment,Mortgage Payment,2120.08
7016,711583458,06-03-24 14:28,98.19,Deposit,Check Deposit,2218.27
7017,711583458,06-05-24 21:28,2200,IncomingTransfer,Salary,4418.27
7018,711583458,06-06-24 10:28,56.35,Deposit,Mobile Deposit,4474.62
7019,711583458,06-06-24 15:28,83.54,Deposit,Mobile Deposit,4558.16
7020,711583458,06-06-24 17:28,160.73,Payment,Loan Payment,4397.43
7021,711583458,06-09-24 15:28,184.39,Return,Etsy Return,4581.82
7022,711583458,06-11-24 21:28,800,Payment,Rent Payment,3781.82
7023,711583458,6-13-24 15:28,246.42,Purchase,Restaurant,3535.4
7024,711583458,6-13-24 21:28,134.84,Return,eBay Return,3670.24
7025,711583458,6-24-24 14:28,193.52,Deposit,Direct Deposit,3863.76
7026,711583458,6-24-24 22:28,85.65,IncomingTransfer,Freelance Payment,3949.41
7027,711583458,6-28-24 22:28,48.38,OutgoingTransfer,Bank Transfer,3901.03
7028,711583458,07-02-24 12:28,126.44,OnlineShopping,Target,3774.59
7029,711583458,07-03-24 21:28,2200,IncomingTransfer,Salary,5974.59
7030,711583458,07-04-24 14:28,52.52,Withdrawal,Mobile App Withdrawal,5922.07
7031,711583458,07-09-24 9:28,146.11,Payment,Mortgage Payment,5775.96
7032,711583458,07-09-24 15:28,107.89,Purchase,Furniture,5668.07
7033,711583458,07-11-24 18:28,64.97,Return,Store Return,5733.04
7034,711583458,07-11-24 21:28,900,Payment,Rent Payment,4833.04
7035,711629733,1-22-24 23:28,57.61,OutgoingTransfer,Peer-to-Peer Transfer,1088.624572
7036,711629733,1-23-24 14:28,20.68,Withdrawal,Branch Withdrawal,1067.944572
7037,711629733,1-24-24 19:28,33.77,Payment,Loan Payment,1034.174572
7038,711629733,1-26-24 18:28,77.83,Payment,Mortgage Payment,956.3445723
7039,711629733,1-28-24 18:28,162.29,Purchase,Grocery,794.0545723
7040,711629733,1-31-24 16:28,128.63,IncomingTransfer,Freelance Payment,922.6845723
7041,711629733,02-02-24 21:28,2550,IncomingTransfer,Salary,3472.684572
7042,711629733,02-04-24 11:28,151.91,Payment,Mortgage Payment,3320.774572
7043,711629733,02-04-24 13:28,160.84,OnlineShopping,Best Buy,3159.934572
7044,711629733,02-04-24 19:28,224.39,OnlineShopping,Amazon,2935.544572
7045,711629733,02-05-24 15:28,130.67,OnlineShopping,eBay,2804.874572
7046,711629733,02-06-24 13:28,101.08,Return,Best Buy Return,2905.954572
7047,711629733,02-07-24 21:28,1500,Payment,Credit Card Payment,1405.954572
7048,711629733,02-08-24 18:28,13.91,Purchase,Travel,1392.044572
7049,711629733,02-10-24 12:28,16.68,Deposit,Check Deposit,1408.724572
7050,711629733,02-10-24 19:28,167.05,Return,Best Buy Return,1575.774572
7051,711629733,02-10-24 21:28,1600,Payment,Rent Payment,-24.22542771
7052,711629733,02-11-24 17:28,141.76,Withdrawal,Branch Withdrawal,-165.9854277
7053,711629733,2-19-24 21:28,209.61,Purchase,Gas,-375.5954277
7054,711629733,2-20-24 21:28,72.84,Purchase,Furniture,-448.4354277
7055,711629733,2-22-24 14:28,158.94,Payment,Loan Payment,-607.3754277
7056,711629733,2-23-24 16:28,234.81,Withdrawal,Branch Withdrawal,-842.1854277
7057,711629733,03-02-24 21:28,2550,IncomingTransfer,Salary,1707.814572
7058,711629733,03-03-24 21:28,116.43,OnlineShopping,AliExpress,1591.384572
7059,711629733,03-07-24 21:28,2200,Payment,Credit Card Payment,-608.6154277
7060,711629733,03-09-24 19:28,92.55,OutgoingTransfer,Bank Transfer,-701.1654277
7061,711629733,03-10-24 15:28,83.7,OutgoingTransfer,Wire Transfer,-784.8654277
7062,711629733,03-10-24 17:28,43.6,Deposit,Check Deposit,-741.2654277
7063,711629733,03-12-24 15:28,32.04,OutgoingTransfer,International Transfer,-773.3054277
7064,711629733,3-13-24 21:28,1400,Payment,Rent Payment,-2173.305428
7065,711629733,3-17-24 14:28,176.76,Withdrawal,Mobile App Withdrawal,-2350.065428
7066,711629733,3-20-24 13:28,99.14,Deposit,Direct Deposit,-2250.925428
7067,711629733,3-22-24 22:28,201.56,OnlineShopping,Target,-2452.485428
7068,711629733,3-28-24 13:28,78.46,OutgoingTransfer,Bank Transfer,-2530.945428
7069,711629733,04-01-24 14:28,156.05,Purchase,Entertainment,-2686.995428
7070,711629733,04-02-24 21:28,2550,IncomingTransfer,Salary,-136.9954277
7071,711629733,04-03-24 21:28,124.81,Deposit,Direct Deposit,-12.18542771
7072,711629733,04-04-24 16:28,61.12,Purchase,Electronics,-73.30542771
7073,711629733,04-07-24 21:28,2000,Payment,Credit Card Payment,-2073.305428
7074,711629733,04-08-24 10:28,118.55,Purchase,Pharmacy,-2191.855428
7075,711629733,04-09-24 21:28,71.56,OnlineShopping,Target,-2263.415428
7076,711629733,04-11-24 22:28,104.55,Withdrawal,Mobile App Withdrawal,-2367.965428
7077,711629733,04-12-24 16:28,63.73,Purchase,Electronics,-2431.695428
7078,711629733,4-13-24 11:28,234.34,Purchase,Home Improvement,-2666.035428
7079,711629733,4-13-24 21:28,1200,Payment,Rent Payment,-3866.035428
7080,711629733,4-14-24 15:28,39.2,Purchase,Home Improvement,-3905.235428
7081,711629733,4-14-24 15:28,209.49,Return,Walmart Return,-3695.745428
7082,711629733,4-14-24 16:28,168.85,Purchase,Home Improvement,-3864.595428
7083,711629733,4-29-24 12:28,214.3,Purchase,Entertainment,-4078.895428
7084,711629733,4-29-24 18:28,107.47,Deposit,Cash Deposit,-3971.425428
7085,711629733,4-29-24 23:28,219.32,Withdrawal,ATM Withdrawal,-4190.745428
7086,711629733,4-30-24 18:28,212.23,Deposit,Check Deposit,-3978.515428
7087,711629733,05-03-24 21:28,2550,IncomingTransfer,Salary,-1428.515428
7088,711629733,05-04-24 20:28,242.28,Purchase,Clothing,-1670.795428
7089,711629733,05-06-24 19:28,237.09,Payment,Mortgage Payment,-1907.885428
7090,711629733,05-06-24 23:28,198.95,Purchase,Entertainment,-2106.835428
7091,711629733,05-07-24 11:28,126.41,Payment,Loan Payment,-2233.245428
7092,711629733,05-08-24 21:28,1900,Payment,Credit Card Payment,-4133.245428
7093,711629733,05-12-24 15:28,183.22,OnlineShopping,Etsy,-4316.465428
7094,711629733,05-12-24 21:28,1000,Payment,Rent Payment,-5316.465428
7095,711629733,5-18-24 19:28,249.9,Deposit,Check Deposit,-5066.565428
7096,711629733,5-20-24 21:28,123.12,Payment,Mortgage Payment,-5189.685428
7097,711629733,5-22-24 12:28,92.41,Deposit,Mobile Deposit,-5097.275428
7098,711629733,5-23-24 18:28,192.47,Withdrawal,Mobile App Withdrawal,-5289.745428
7099,711629733,06-02-24 19:28,60.28,Purchase,Grocery,-5350.025428
7100,711629733,06-03-24 11:28,67.39,OnlineShopping,AliExpress,-5417.415428
7101,711629733,06-05-24 21:28,2550,IncomingTransfer,Salary,-2867.415428
7102,711629733,06-06-24 23:28,205,OutgoingTransfer,Bank Transfer,-3072.415428
7103,711629733,06-10-24 21:28,2000,Payment,Credit Card Payment,-5072.415428
7104,711629733,6-16-24 19:28,56.21,IncomingTransfer,Freelance Payment,-5016.205428
7105,711629733,6-16-24 21:28,1700,Payment,Rent Payment,-6716.205428
7106,711629733,6-18-24 9:28,77.44,IncomingTransfer,Freelance Payment,-6638.765428
7107,711629733,6-18-24 12:28,192.25,Return,Store Return,-6446.515428
7108,711629733,6-19-24 11:28,80.64,Withdrawal,Branch Withdrawal,-6527.155428
7109,711629733,6-21-24 21:28,210.91,Deposit,Mobile Deposit,-6316.245428
7110,711629733,6-25-24 11:28,71.88,Payment,Loan Payment,-6388.125428
7111,711629733,07-03-24 22:28,143.68,Purchase,Grocery,-6531.805428
7112,711629733,07-05-24 21:28,2550,IncomingTransfer,Salary,-3981.805428
7113,711629733,07-06-24 17:28,14.93,Deposit,Mobile Deposit,-3966.875428
7114,711629733,07-10-24 21:28,2100,Payment,Credit Card Payment,-6066.875428
7115,711629733,7-13-24 18:28,148.47,Purchase,Home Improvement,-6215.345428
7116,711629733,7-13-24 21:28,1100,Payment,Rent Payment,-7315.345428
7117,711629733,7-14-24 17:28,234.01,Payment,Loan Payment,-7549.355428
7118,711629733,7-14-24 22:28,122.17,Deposit,Cash Deposit,-7427.185428
7119,711631158,1-31-24 12:28,192.35,Purchase,Pharmacy,465.5457122
7120,711631158,1-31-24 22:28,207.11,Deposit,Direct Deposit,672.6557122
7121,711631158,02-03-24 21:28,2750,IncomingTransfer,Salary,3422.655712
7122,711631158,02-04-24 13:28,125.99,Withdrawal,ATM Withdrawal,3296.665712
7123,711631158,02-05-24 18:28,106.41,OnlineShopping,eBay,3190.255712
7124,711631158,02-08-24 21:28,1100,Payment,Credit Card Payment,2090.255712
7125,711631158,02-08-24 23:28,156.32,OutgoingTransfer,Wire Transfer,1933.935712
7126,711631158,02-10-24 12:28,135.75,OnlineShopping,Amazon,1798.185712
7127,711631158,02-10-24 17:28,213.49,OnlineShopping,Best Buy,1584.695712
7128,711631158,2-14-24 21:28,800,Payment,Installment Payment,784.6957122
7129,711631158,2-17-24 14:28,211.61,Withdrawal,ATM Withdrawal,573.0857122
7130,711631158,2-19-24 9:28,156.06,Payment,Mortgage Payment,417.0257122
7131,711631158,2-26-24 14:28,163.32,Return,Target Return,580.3457122
7132,711631158,2-27-24 15:28,57.79,OutgoingTransfer,Bank Transfer,522.5557122
7133,711631158,2-27-24 19:28,72,Deposit,Check Deposit,594.5557122
7134,711631158,03-01-24 13:28,88.63,OutgoingTransfer,Peer-to-Peer Transfer,505.9257122
7135,711631158,03-02-24 22:28,148.11,Withdrawal,Mobile App Withdrawal,357.8157122
7136,711631158,03-05-24 21:28,2750,IncomingTransfer,Salary,3107.815712
7137,711631158,03-06-24 9:28,147.36,Purchase,Grocery,2960.455712
7138,711631158,03-06-24 17:28,156.14,Return,eBay Return,3116.595712
7139,711631158,03-07-24 22:28,168.88,Purchase,Travel,2947.715712
7140,711631158,03-08-24 11:28,143.62,Deposit,Check Deposit,3091.335712
7141,711631158,03-10-24 21:28,1200,Payment,Credit Card Payment,1891.335712
7142,711631158,03-12-24 15:28,61.03,Payment,Mortgage Payment,1830.305712
7143,711631158,3-14-24 21:28,700,Payment,Installment Payment,1130.305712
7144,711631158,3-16-24 20:28,48.8,Withdrawal,Branch Withdrawal,1081.505712
7145,711631158,3-20-24 11:28,40.16,Withdrawal,Branch Withdrawal,1041.345712
7146,711631158,3-20-24 19:28,178.21,Return,Walmart Return,1219.555712
7147,711631158,3-22-24 21:28,193.18,Deposit,Mobile Deposit,1412.735712
7148,711631158,3-24-24 21:28,21.98,OutgoingTransfer,International Transfer,1390.755712
7149,711631158,3-25-24 17:28,22.48,Purchase,Home Improvement,1368.275712
7150,711631158,3-26-24 11:28,37.55,Withdrawal,ATM Withdrawal,1330.725712
7151,711631158,3-31-24 18:28,35.21,OnlineShopping,eBay,1295.515712
7152,711631158,04-01-24 21:28,2750,IncomingTransfer,Salary,4045.515712
7153,711631158,04-04-24 16:28,155.16,Payment,Bill Payment,3890.355712
7154,711631158,04-06-24 14:28,228.61,Return,eBay Return,4118.965712
7155,711631158,04-06-24 21:28,1100,Payment,Credit Card Payment,3018.965712
7156,711631158,4-16-24 21:28,800,Payment,Installment Payment,2218.965712
7157,711631158,4-16-24 21:28,46.46,Purchase,Clothing,2172.505712
7158,711631158,4-17-24 9:28,197.15,Deposit,Check Deposit,2369.655712
7159,711631158,4-18-24 18:28,201.59,Payment,Mortgage Payment,2168.065712
7160,711631158,4-20-24 16:28,136.47,Withdrawal,Mobile App Withdrawal,2031.595712
7161,711631158,4-21-24 19:28,181.18,Deposit,Mobile Deposit,2212.775712
7162,711631158,4-22-24 11:28,144.61,Deposit,Cash Deposit,2357.385712
7163,711631158,4-25-24 14:28,24.09,OutgoingTransfer,Bank Transfer,2333.295712
7164,711631158,4-27-24 16:28,69.96,Withdrawal,Branch Withdrawal,2263.335712
7165,711631158,4-28-24 19:28,58.2,OutgoingTransfer,Peer-to-Peer Transfer,2205.135712
7166,711631158,05-01-24 21:28,2750,IncomingTransfer,Salary,4955.135712
7167,711631158,05-01-24 21:28,57.81,OnlineShopping,Walmart,4897.325712
7168,711631158,05-02-24 12:28,244.45,OutgoingTransfer,International Transfer,4652.875712
7169,711631158,05-03-24 23:28,202.33,Return,Store Return,4855.205712
7170,711631158,05-05-24 21:28,120.98,Deposit,Mobile Deposit,4976.185712
7171,711631158,05-06-24 15:28,203.35,OnlineShopping,Amazon,4772.835712
7172,711631158,05-06-24 21:28,1100,Payment,Credit Card Payment,3672.835712
7173,711631158,05-07-24 22:28,12.99,Return,AliExpress Return,3685.825712
7174,711631158,05-09-24 23:28,17.16,Return,Target Return,3702.985712
7175,711631158,05-10-24 13:28,45.02,Return,Amazon Return,3748.005712
7176,711631158,5-13-24 10:28,76.95,Withdrawal,Mobile App Withdrawal,3671.055712
7177,711631158,5-15-24 21:28,700,Payment,Insurance Payment,2971.055712
7178,711631158,5-23-24 9:28,206.51,OnlineShopping,Amazon,2764.545712
7179,711631158,5-23-24 20:28,119.27,Purchase,Travel,2645.275712
7180,711631158,5-26-24 15:28,62.5,Purchase,Electronics,2582.775712
7181,711631158,5-29-24 11:28,209.29,Payment,Mortgage Payment,2373.485712
7182,711631158,5-31-24 13:28,58.09,Deposit,Mobile Deposit,2431.575712
7183,711631158,06-01-24 21:28,2750,IncomingTransfer,Salary,5181.575712
7184,711631158,06-05-24 10:28,74.16,OnlineShopping,Walmart,5107.415712
7185,711631158,06-05-24 13:28,149.64,Payment,Bill Payment,4957.775712
7186,711631158,06-06-24 9:28,40.24,Deposit,Cash Deposit,4998.015712
7187,711631158,06-06-24 11:28,206.7,Withdrawal,ATM Withdrawal,4791.315712
7188,711631158,06-06-24 21:28,1200,Payment,Credit Card Payment,3591.315712
7189,711631158,06-07-24 9:28,128.23,Deposit,Check Deposit,3719.545712
7190,711631158,06-08-24 10:28,170.75,OnlineShopping,Etsy,3548.795712
7191,711631158,06-08-24 18:28,195.89,Purchase,Furniture,3352.905712
7192,711631158,06-11-24 23:28,157.61,Deposit,Cash Deposit,3510.515712
7193,711631158,6-15-24 21:28,133.18,OutgoingTransfer,Bank Transfer,3377.335712
7194,711631158,6-18-24 21:28,900,Payment,Subscription Payment,2477.335712
7195,711631158,6-18-24 21:28,224.08,OutgoingTransfer,Bank Transfer,2253.255712
7196,711631158,6-19-24 9:28,191.12,Purchase,Clothing,2062.135712
7197,711631158,6-20-24 11:28,206.67,Purchase,Home Improvement,1855.465712
7198,711631158,6-20-24 20:28,220.1,Deposit,Mobile Deposit,2075.565712
7199,711631158,6-22-24 22:28,26.45,Payment,Loan Payment,2049.115712
7200,711631158,6-26-24 14:28,89.21,OutgoingTransfer,Bank Transfer,1959.905712
7201,711631158,6-27-24 20:28,122.97,OutgoingTransfer,Bank Transfer,1836.935712
7202,711631158,6-28-24 21:28,119.63,Purchase,Home Improvement,1717.305712
7203,711631158,07-01-24 12:28,64.04,Withdrawal,ATM Withdrawal,1653.265712
7204,711631158,07-03-24 20:28,26.9,OnlineShopping,AliExpress,1626.365712
7205,711631158,07-05-24 21:28,2750,IncomingTransfer,Salary,4376.365712
7206,711631158,07-06-24 13:28,175.93,OnlineShopping,Amazon,4200.435712
7207,711631158,07-10-24 11:28,186.48,Deposit,Check Deposit,4386.915712
7208,711631158,07-10-24 21:28,1200,Payment,Credit Card Payment,3186.915712
7209,711631158,07-12-24 23:28,43.61,Return,Store Return,3230.525712
7210,711631158,7-13-24 16:28,131.59,Return,AliExpress Return,3362.115712
7211,711631158,7-13-24 18:28,27.67,OnlineShopping,Amazon,3334.445712
7212,711631158,7-13-24 21:28,800,Payment,Subscription Payment,2534.445712
7213,711631158,7-17-24 16:28,131.96,IncomingTransfer,Freelance Payment,2666.405712
7214,711636558,1-21-24 18:28,197.85,OutgoingTransfer,Bank Transfer,1189.02363
7215,711636558,1-23-24 10:28,559.47,Deposit,Check Deposit,1748.49363
7216,711636558,1-26-24 21:28,669.65,Purchase,Home Improvement,1078.84363
7217,711636558,02-01-24 21:28,9500,IncomingTransfer,Salary,10578.84363
7218,711636558,02-03-24 17:28,499.59,OnlineShopping,Etsy,10079.25363
7219,711636558,02-05-24 19:28,236.81,Withdrawal,ATM Withdrawal,9842.44363
7220,711636558,02-06-24 21:28,2300,Payment,Credit Card Payment,7542.44363
7221,711636558,02-11-24 17:28,645.62,Deposit,Mobile Deposit,8188.06363
7222,711636558,2-13-24 15:28,169.8,Deposit,Cash Deposit,8357.86363
7223,711636558,2-13-24 21:28,2400,Payment,Insurance Payment,5957.86363
7224,711636558,2-14-24 11:28,571.86,Deposit,Cash Deposit,6529.72363
7225,711636558,2-21-24 11:28,448.51,Purchase,Travel,6081.21363
7226,711636558,2-25-24 20:28,705.3,IncomingTransfer,Freelance Payment,6786.51363
7227,711636558,03-04-24 17:28,466.97,Return,Target Return,7253.48363
7228,711636558,03-05-24 21:28,9500,IncomingTransfer,Salary,16753.48363
7229,711636558,03-07-24 16:28,582.99,Purchase,Home Improvement,16170.49363
7230,711636558,03-07-24 21:28,359.04,Deposit,Mobile Deposit,16529.53363
7231,711636558,03-09-24 21:28,501.25,Deposit,Mobile Deposit,17030.78363
7232,711636558,03-10-24 21:28,2100,Payment,Credit Card Payment,14930.78363
7233,711636558,3-15-24 21:28,2600,Payment,Subscription Payment,12330.78363
7234,711636558,3-21-24 15:28,496.29,OnlineShopping,eBay,11834.49363
7235,711636558,3-23-24 17:28,448.49,Return,eBay Return,12282.98363
7236,711636558,3-28-24 19:28,342.27,Purchase,Travel,11940.71363
7237,711636558,3-31-24 13:28,272.8,OnlineShopping,Target,11667.91363
7238,711636558,04-02-24 21:28,9500,IncomingTransfer,Salary,21167.91363
7239,711636558,04-02-24 21:28,490.54,Return,Target Return,21658.45363
7240,711636558,04-07-24 21:28,2200,Payment,Credit Card Payment,19458.45363
7241,711636558,04-08-24 20:28,124.83,OnlineShopping,Walmart,19333.62363
7242,711636558,4-13-24 21:28,4100,Payment,Subscription Payment,15233.62363
7243,711636558,4-15-24 22:28,637.82,Return,AliExpress Return,15871.44363
7244,711636558,4-19-24 13:28,599.93,Deposit,Direct Deposit,16471.37363
7245,711636558,4-22-24 9:28,673.52,OutgoingTransfer,Bank Transfer,15797.85363
7246,711636558,05-02-24 21:28,9500,IncomingTransfer,Salary,25297.85363
7247,711636558,05-06-24 12:28,649.6,Withdrawal,Mobile App Withdrawal,24648.25363
7248,711636558,05-07-24 21:28,2600,Payment,Credit Card Payment,22048.25363
7249,711636558,05-07-24 23:28,393.24,Withdrawal,Mobile App Withdrawal,21655.01363
7250,711636558,05-08-24 17:28,182.88,Purchase,Gas,21472.13363
7251,711636558,5-16-24 21:28,3700,Payment,Installment Payment,17772.13363
7252,711636558,5-17-24 9:28,603.63,Purchase,Electronics,17168.50363
7253,711636558,5-19-24 15:28,588.65,Payment,Loan Payment,16579.85363
7254,711636558,5-20-24 10:28,446.12,Deposit,Cash Deposit,17025.97363
7255,711636558,5-23-24 14:28,268.03,Purchase,Electronics,16757.94363
7256,711636558,5-26-24 20:28,606.21,Deposit,Direct Deposit,17364.15363
7257,711636558,5-28-24 14:28,502.85,Withdrawal,Branch Withdrawal,16861.30363
7258,711636558,06-03-24 15:28,475.9,Deposit,Direct Deposit,17337.20363
7259,711636558,06-05-24 21:28,9500,IncomingTransfer,Salary,26837.20363
7260,711636558,06-08-24 22:28,280.39,Deposit,Cash Deposit,27117.59363
7261,711636558,06-09-24 10:28,703.79,Deposit,Check Deposit,27821.38363
7262,711636558,06-10-24 21:28,3000,Payment,Credit Card Payment,24821.38363
7263,711636558,06-11-24 21:28,3400,Payment,Installment Payment,21421.38363
7264,711636558,6-23-24 20:28,352.28,Deposit,Direct Deposit,21773.66363
7265,711636558,6-27-24 9:28,343.21,Return,AliExpress Return,22116.87363
7266,711636558,6-29-24 17:28,392.31,OutgoingTransfer,International Transfer,21724.56363
7267,711636558,07-01-24 15:28,220.35,Purchase,Home Improvement,21504.21363
7268,711636558,07-05-24 21:28,9500,IncomingTransfer,Salary,31004.21363
7269,711636558,07-06-24 17:28,581.5,Withdrawal,Branch Withdrawal,30422.71363
7270,711636558,07-10-24 21:28,2900,Payment,Credit Card Payment,27522.71363
7271,711636558,07-12-24 16:28,259.43,IncomingTransfer,Freelance Payment,27782.14363
7272,711636558,7-17-24 9:28,695.03,Deposit,Cash Deposit,28477.17363
7273,711636558,7-17-24 21:28,3200,Payment,Insurance Payment,25277.17363
7274,711638658,1-31-24 15:28,364.53,IncomingTransfer,Freelance Payment,1578.277383
7275,711638658,02-03-24 10:28,292.35,Deposit,Direct Deposit,1870.627383
7276,711638658,02-03-24 12:28,348.22,Deposit,Direct Deposit,2218.847383
7277,711638658,02-03-24 21:28,4400,IncomingTransfer,Salary,6618.847383
7278,711638658,02-04-24 19:28,376.84,OnlineShopping,Amazon,6242.007383
7279,711638658,02-06-24 9:28,390.23,Withdrawal,Branch Withdrawal,5851.777383
7280,711638658,02-06-24 13:28,99.77,Return,Store Return,5951.547383
7281,711638658,02-07-24 10:28,106.43,Withdrawal,Mobile App Withdrawal,5845.117383
7282,711638658,02-08-24 21:28,2700,Payment,Credit Card Payment,3145.117383
7283,711638658,02-10-24 10:28,378.35,OnlineShopping,Etsy,2766.767383
7284,711638658,02-11-24 16:28,355.19,OnlineShopping,Best Buy,2411.577383
7285,711638658,2-15-24 21:28,1800,Payment,Insurance Payment,611.5773831
7286,711638658,2-16-24 23:28,335.69,Purchase,Travel,275.8873831
7287,711638658,2-21-24 18:28,396.12,Withdrawal,ATM Withdrawal,-120.2326169
7288,711638658,2-25-24 12:28,101.41,Return,Walmart Return,-18.82261686
7289,711638658,2-28-24 9:28,321.67,OnlineShopping,Target,-340.4926169
7290,711638658,2-28-24 17:28,94.82,Deposit,Check Deposit,-245.6726169
7291,711638658,03-02-24 11:28,189.08,Purchase,Electronics,-434.7526169
7292,711638658,03-04-24 21:28,4400,IncomingTransfer,Salary,3965.247383
7293,711638658,03-04-24 23:28,153.12,Payment,Loan Payment,3812.127383
7294,711638658,03-09-24 14:28,217.37,Withdrawal,Mobile App Withdrawal,3594.757383
7295,711638658,03-09-24 19:28,31.96,Payment,Mortgage Payment,3562.797383
7296,711638658,03-09-24 21:28,2800,Payment,Credit Card Payment,762.7973831
7297,711638658,03-09-24 22:28,148.55,IncomingTransfer,Freelance Payment,911.3473831
7298,711638658,03-10-24 11:28,118.54,IncomingTransfer,Freelance Payment,1029.887383
7299,711638658,03-11-24 21:28,1900,Payment,Insurance Payment,-870.1126169
7300,711638658,03-11-24 21:28,28.25,Payment,Mortgage Payment,-898.3626169
7301,711638658,3-16-24 10:28,304.68,Deposit,Direct Deposit,-593.6826169
7302,711638658,3-18-24 18:28,104.26,IncomingTransfer,Freelance Payment,-489.4226169
7303,711638658,3-26-24 18:28,95.19,Purchase,Grocery,-584.6126169
7304,711638658,3-26-24 18:28,24.75,OutgoingTransfer,Wire Transfer,-609.3626169
7305,711638658,3-27-24 17:28,387.46,Deposit,Direct Deposit,-221.9026169
7306,711638658,3-29-24 12:28,370.69,Payment,Loan Payment,-592.5926169
7307,711638658,04-03-24 16:28,304.19,Purchase,Grocery,-896.7826169
7308,711638658,04-03-24 21:28,4400,IncomingTransfer,Salary,3503.217383
7309,711638658,04-08-24 21:28,2200,Payment,Credit Card Payment,1303.217383
7310,711638658,04-09-24 10:28,283.41,IncomingTransfer,Freelance Payment,1586.627383
7311,711638658,4-14-24 14:28,302.31,OnlineShopping,Etsy,1284.317383
7312,711638658,4-15-24 21:28,1500,Payment,Subscription Payment,-215.6826169
7313,711638658,4-17-24 11:28,52.03,Return,Best Buy Return,-163.6526169
7314,711638658,4-17-24 23:28,237.94,OutgoingTransfer,International Transfer,-401.5926169
7315,711638658,4-26-24 23:28,219.38,Withdrawal,ATM Withdrawal,-620.9726169
7316,711638658,4-28-24 20:28,309.64,Deposit,Direct Deposit,-311.3326169
7317,711638658,05-02-24 9:28,264.62,IncomingTransfer,Freelance Payment,-46.71261686
7318,711638658,05-02-24 10:28,273.46,Withdrawal,ATM Withdrawal,-320.1726169
7319,711638658,05-04-24 21:28,4400,IncomingTransfer,Salary,4079.827383
7320,711638658,05-07-24 15:28,87.41,IncomingTransfer,Freelance Payment,4167.237383
7321,711638658,05-09-24 21:28,2000,Payment,Credit Card Payment,2167.237383
7322,711638658,05-10-24 14:28,392.69,Payment,Bill Payment,1774.547383
7323,711638658,05-10-24 21:28,1600,Payment,Subscription Payment,174.5473831
7324,711638658,05-12-24 22:28,227.71,Return,AliExpress Return,402.2573831
7325,711638658,5-13-24 18:28,34.48,Purchase,Travel,367.7773831
7326,711638658,5-16-24 9:28,171.89,OutgoingTransfer,Bank Transfer,195.8873831
7327,711638658,5-16-24 12:28,262.3,Deposit,Mobile Deposit,458.1873831
7328,711638658,5-18-24 17:28,178.06,Withdrawal,Mobile App Withdrawal,280.1273831
7329,711638658,5-18-24 18:28,33.93,Purchase,Electronics,246.1973831
7330,711638658,5-19-24 15:28,34.22,Withdrawal,ATM Withdrawal,211.9773831
7331,711638658,5-24-24 22:28,196.47,Withdrawal,Mobile App Withdrawal,15.50738314
7332,711638658,5-27-24 22:28,171.28,Purchase,Pharmacy,-155.7726169
7333,711638658,06-02-24 15:28,338.64,Purchase,Pharmacy,-494.4126169
7334,711638658,06-05-24 21:28,4400,IncomingTransfer,Salary,3905.587383
7335,711638658,06-07-24 21:28,236.98,Payment,Mortgage Payment,3668.607383
7336,711638658,06-09-24 20:28,287.33,OnlineShopping,Amazon,3381.277383
7337,711638658,06-10-24 21:28,2200,Payment,Credit Card Payment,1181.277383
7338,711638658,06-11-24 17:28,133.92,Deposit,Check Deposit,1315.197383
7339,711638658,06-11-24 21:28,1500,Payment,Insurance Payment,-184.8026169
7340,711638658,6-16-24 19:28,165.18,Deposit,Mobile Deposit,-19.62261686
7341,711638658,6-22-24 15:28,386.25,Withdrawal,Branch Withdrawal,-405.8726169
7342,711638658,6-23-24 18:28,397.78,Deposit,Check Deposit,-8.092616861
7343,711638658,6-24-24 15:28,190.67,Deposit,Direct Deposit,182.5773831
7344,711638658,6-28-24 18:28,288.92,Payment,Bill Payment,-106.3426169
7345,711638658,07-02-24 20:28,321.02,Withdrawal,Branch Withdrawal,-427.3626169
7346,711638658,07-02-24 21:28,4400,IncomingTransfer,Salary,3972.637383
7347,711638658,07-07-24 21:28,2700,Payment,Credit Card Payment,1272.637383
7348,711638658,07-09-24 9:28,345.84,Deposit,Cash Deposit,1618.477383
7349,711638658,07-09-24 12:28,212.98,Deposit,Direct Deposit,1831.457383
7350,711638658,07-10-24 16:28,295.6,IncomingTransfer,Freelance Payment,2127.057383
7351,711638658,07-10-24 17:28,357,Withdrawal,Mobile App Withdrawal,1770.057383
7352,711638658,07-12-24 17:28,343.41,Payment,Mortgage Payment,1426.647383
7353,711638658,7-15-24 14:28,385.65,Purchase,Travel,1040.997383
7354,711638658,7-16-24 21:28,1900,Payment,Insurance Payment,-859.0026169
7355,711663858,1-20-24 15:28,96.4,OutgoingTransfer,Bank Transfer,751.9287364
7356,711663858,1-21-24 14:28,29.38,OnlineShopping,eBay,722.5487364
7357,711663858,1-21-24 18:28,142.81,Deposit,Check Deposit,865.3587364
7358,711663858,1-26-24 12:28,212.97,OutgoingTransfer,International Transfer,652.3887364
7359,711663858,1-26-24 19:28,232.07,IncomingTransfer,Freelance Payment,884.4587364
7360,711663858,1-27-24 11:28,96.22,OutgoingTransfer,Peer-to-Peer Transfer,788.2387364
7361,711663858,1-29-24 11:28,124.92,Payment,Bill Payment,663.3187364
7362,711663858,1-29-24 23:28,128.1,IncomingTransfer,Freelance Payment,791.4187364
7363,711663858,1-30-24 20:28,381.46,Withdrawal,Mobile App Withdrawal,409.9587364
7364,711663858,1-31-24 11:28,241.54,Purchase,Travel,168.4187364
7365,711663858,02-01-24 16:28,93.48,Purchase,Gas,74.93873636
7366,711663858,02-01-24 18:28,429.87,Return,Best Buy Return,504.8087364
7367,711663858,02-03-24 19:28,412.9,Return,AliExpress Return,917.7087364
7368,711663858,02-03-24 21:28,6850,IncomingTransfer,Salary,7767.708736
7369,711663858,02-04-24 21:28,191.56,Deposit,Mobile Deposit,7959.268736
7370,711663858,02-05-24 20:28,352.73,Payment,Bill Payment,7606.538736
7371,711663858,02-05-24 21:28,54.49,Return,Target Return,7661.028736
7372,711663858,02-06-24 15:28,277.38,OutgoingTransfer,Wire Transfer,7383.648736
7373,711663858,02-07-24 9:28,93.75,Payment,Bill Payment,7289.898736
7374,711663858,02-07-24 11:28,159.89,OnlineShopping,AliExpress,7130.008736
7375,711663858,02-08-24 16:28,280.81,Deposit,Cash Deposit,7410.818736
7376,711663858,02-08-24 21:28,1200,Payment,Credit Card Payment,6210.818736
7377,711663858,02-11-24 12:28,12.29,Purchase,Grocery,6198.528736
7378,711663858,2-13-24 15:28,124.41,Deposit,Mobile Deposit,6322.938736
7379,711663858,2-14-24 9:28,207.73,OnlineShopping,Etsy,6115.208736
7380,711663858,2-15-24 12:28,360.94,Payment,Bill Payment,5754.268736
7381,711663858,2-15-24 21:28,3100,Payment,Rent Payment,2654.268736
7382,711663858,2-15-24 23:28,197.38,Deposit,Mobile Deposit,2851.648736
7383,711663858,2-16-24 13:28,463.71,Withdrawal,Mobile App Withdrawal,2387.938736
7384,711663858,2-17-24 15:28,259.85,Purchase,Grocery,2128.088736
7385,711663858,2-17-24 21:28,182.46,Return,Target Return,2310.548736
7386,711663858,2-17-24 22:28,44.93,OutgoingTransfer,Peer-to-Peer Transfer,2265.618736
7387,711663858,2-18-24 10:28,254.53,Return,Best Buy Return,2520.148736
7388,711663858,2-18-24 12:28,56.69,Purchase,Home Improvement,2463.458736
7389,711663858,2-18-24 19:28,349.44,Withdrawal,Branch Withdrawal,2114.018736
7390,711663858,2-19-24 11:28,389.79,OnlineShopping,Target,1724.228736
7391,711663858,2-19-24 20:28,364.93,Deposit,Mobile Deposit,2089.158736
7392,711663858,2-20-24 13:28,209.96,Payment,Loan Payment,1879.198736
7393,711663858,2-20-24 22:28,141.23,Deposit,Direct Deposit,2020.428736
7394,711663858,2-21-24 14:28,61.06,OnlineShopping,eBay,1959.368736
7395,711663858,2-23-24 22:28,19.12,Withdrawal,Mobile App Withdrawal,1940.248736
7396,711663858,2-25-24 21:28,224.24,Withdrawal,Branch Withdrawal,1716.008736
7397,711663858,2-28-24 11:28,469.49,Withdrawal,ATM Withdrawal,1246.518736
7398,711663858,2-29-24 19:28,45.62,Withdrawal,ATM Withdrawal,1200.898736
7399,711663858,03-02-24 20:28,457.79,Return,Etsy Return,1658.688736
7400,711663858,03-03-24 19:28,331.68,OnlineShopping,Target,1327.008736
7401,711663858,03-04-24 15:28,418.75,OnlineShopping,Best Buy,908.2587364
7402,711663858,03-05-24 11:28,485.16,Payment,Mortgage Payment,423.0987364
7403,711663858,03-05-24 21:28,6850,IncomingTransfer,Salary,7273.098736
7404,711663858,03-05-24 21:28,27.7,Deposit,Direct Deposit,7300.798736
7405,711663858,03-09-24 12:28,53.48,Payment,Bill Payment,7247.318736
7406,711663858,03-10-24 12:28,307.96,Purchase,Home Improvement,6939.358736
7407,711663858,03-10-24 21:28,1700,Payment,Credit Card Payment,5239.358736
7408,711663858,03-11-24 21:28,2700,Payment,Rent Payment,2539.358736
7409,711663858,03-12-24 18:28,388.9,Deposit,Mobile Deposit,2928.258736
7410,711663858,3-14-24 10:28,294.25,OnlineShopping,eBay,2634.008736
7411,711663858,3-14-24 10:28,39.8,Purchase,Home Improvement,2594.208736
7412,711663858,3-17-24 18:28,116.87,Return,Best Buy Return,2711.078736
7413,711663858,3-18-24 23:28,106.25,Deposit,Mobile Deposit,2817.328736
7414,711663858,3-20-24 9:28,367.22,OutgoingTransfer,Peer-to-Peer Transfer,2450.108736
7415,711663858,3-21-24 10:28,324.61,Deposit,Direct Deposit,2774.718736
7416,711663858,3-24-24 16:28,192.16,Purchase,Grocery,2582.558736
7417,711663858,3-25-24 18:28,403.14,Purchase,Travel,2179.418736
7418,711663858,3-28-24 22:28,344.91,Purchase,Restaurant,1834.508736
7419,711663858,3-29-24 21:28,188.85,OnlineShopping,AliExpress,1645.658736
7420,711663858,3-30-24 18:28,235.71,OutgoingTransfer,International Transfer,1409.948736
7421,711663858,3-31-24 10:28,259.23,IncomingTransfer,Freelance Payment,1669.178736
7422,711663858,3-31-24 12:28,68.34,Return,AliExpress Return,1737.518736
7423,711663858,04-01-24 23:28,186.89,OnlineShopping,Amazon,1550.628736
7424,711663858,04-02-24 14:28,198.97,Payment,Bill Payment,1351.658736
7425,711663858,04-03-24 11:28,251.86,Purchase,Pharmacy,1099.798736
7426,711663858,04-04-24 21:28,6850,IncomingTransfer,Salary,7949.798736
7427,711663858,04-07-24 11:28,76.09,Deposit,Mobile Deposit,8025.888736
7428,711663858,04-07-24 16:28,488.04,OutgoingTransfer,Peer-to-Peer Transfer,7537.848736
7429,711663858,04-09-24 21:28,1600,Payment,Credit Card Payment,5937.848736
7430,711663858,04-11-24 15:28,48.78,Deposit,Direct Deposit,5986.628736
7431,711663858,4-13-24 16:28,433.13,Deposit,Check Deposit,6419.758736
7432,711663858,4-13-24 19:28,395.03,OnlineShopping,AliExpress,6024.728736
7433,711663858,4-16-24 16:28,125.37,Purchase,Clothing,5899.358736
7434,711663858,4-16-24 19:28,192.77,Deposit,Cash Deposit,6092.128736
7435,711663858,4-16-24 21:28,1800,Payment,Rent Payment,4292.128736
7436,711663858,4-17-24 11:28,495.66,Purchase,Clothing,3796.468736
7437,711663858,4-17-24 21:28,76.26,Purchase,Travel,3720.208736
7438,711663858,4-18-24 13:28,258.05,Purchase,Furniture,3462.158736
7439,711663858,4-19-24 16:28,240.59,Deposit,Check Deposit,3702.748736
7440,711663858,4-21-24 12:28,477.21,OutgoingTransfer,Wire Transfer,3225.538736
7441,711663858,05-03-24 14:28,399.58,Withdrawal,Branch Withdrawal,2825.958736
7442,711663858,05-03-24 21:28,6850,IncomingTransfer,Salary,9675.958736
7443,711663858,05-06-24 13:28,29.71,OutgoingTransfer,Peer-to-Peer Transfer,9646.248736
7444,711663858,05-08-24 17:28,402.87,Return,AliExpress Return,10049.11874
7445,711663858,05-08-24 21:28,1400,Payment,Credit Card Payment,8649.118736
7446,711663858,05-10-24 14:28,110.64,Payment,Mortgage Payment,8538.478736
7447,711663858,05-11-24 17:28,30.43,IncomingTransfer,Freelance Payment,8568.908736
7448,711663858,05-12-24 21:28,1800,Payment,Rent Payment,6768.908736
7449,711663858,5-13-24 15:28,247.75,Return,Etsy Return,7016.658736
7450,711663858,5-14-24 21:28,213.83,Withdrawal,ATM Withdrawal,6802.828736
7451,711663858,5-16-24 12:28,453.21,Return,eBay Return,7256.038736
7452,711663858,5-16-24 17:28,32.33,Payment,Loan Payment,7223.708736
7453,711663858,5-17-24 11:28,203.92,OutgoingTransfer,Bank Transfer,7019.788736
7454,711663858,5-17-24 15:28,361.08,Return,eBay Return,7380.868736
7455,711663858,5-18-24 17:28,439.7,Withdrawal,ATM Withdrawal,6941.168736
7456,711663858,5-20-24 12:28,213.51,IncomingTransfer,Freelance Payment,7154.678736
7457,711663858,5-25-24 12:28,395.59,OnlineShopping,Etsy,6759.088736
7458,711663858,5-25-24 17:28,94.31,OutgoingTransfer,Peer-to-Peer Transfer,6664.778736
7459,711663858,5-25-24 19:28,461.89,OnlineShopping,Etsy,6202.888736
7460,711663858,5-26-24 11:28,457.21,Payment,Mortgage Payment,5745.678736
7461,711663858,5-31-24 19:28,198.37,IncomingTransfer,Freelance Payment,5944.048736
7462,711663858,5-31-24 22:28,181.42,Deposit,Cash Deposit,6125.468736
7463,711663858,06-01-24 10:28,91.5,Purchase,Clothing,6033.968736
7464,711663858,06-04-24 13:28,367.07,OnlineShopping,Best Buy,5666.898736
7465,711663858,06-04-24 21:28,6850,IncomingTransfer,Salary,12516.89874
7466,711663858,06-06-24 17:28,385.42,Deposit,Cash Deposit,12902.31874
7467,711663858,06-07-24 16:28,132.12,Purchase,Gas,12770.19874
7468,711663858,06-08-24 17:28,217.51,Purchase,Clothing,12552.68874
7469,711663858,06-09-24 14:28,36.83,Purchase,Restaurant,12515.85874
7470,711663858,06-09-24 21:28,1600,Payment,Credit Card Payment,10915.85874
7471,711663858,06-12-24 11:28,316.61,Deposit,Cash Deposit,11232.46874
7472,711663858,6-14-24 21:28,448.98,Deposit,Check Deposit,11681.44874
7473,711663858,6-17-24 17:28,34.61,Withdrawal,ATM Withdrawal,11646.83874
7474,711663858,6-18-24 21:28,3900,Payment,Rent Payment,7746.838736
7475,711663858,6-19-24 9:28,342.62,Payment,Mortgage Payment,7404.218736
7476,711663858,6-21-24 18:28,436.02,Payment,Bill Payment,6968.198736
7477,711663858,6-22-24 13:28,67.9,IncomingTransfer,Freelance Payment,7036.098736
7478,711663858,6-22-24 16:28,323.18,Payment,Loan Payment,6712.918736
7479,711663858,6-24-24 12:28,133.66,Purchase,Travel,6579.258736
7480,711663858,6-24-24 22:28,169.39,Purchase,Electronics,6409.868736
7481,711663858,6-25-24 19:28,93.22,Return,Store Return,6503.088736
7482,711663858,6-26-24 22:28,434.93,Deposit,Check Deposit,6938.018736
7483,711663858,6-27-24 19:28,97.8,Return,Target Return,7035.818736
7484,711663858,6-28-24 16:28,424.05,OutgoingTransfer,International Transfer,6611.768736
7485,711663858,6-29-24 17:28,157.37,Deposit,Cash Deposit,6769.138736
7486,711663858,6-30-24 16:28,295.36,Withdrawal,Branch Withdrawal,6473.778736
7487,711663858,07-01-24 20:28,329,Return,eBay Return,6802.778736
7488,711663858,07-01-24 21:28,6850,IncomingTransfer,Salary,13652.77874
7489,711663858,07-06-24 21:28,1500,Payment,Credit Card Payment,12152.77874
7490,711663858,07-07-24 15:28,254.32,Return,AliExpress Return,12407.09874
7491,711663858,07-10-24 15:28,489.66,Return,Etsy Return,12896.75874
7492,711663858,07-11-24 20:28,178.98,OnlineShopping,Etsy,12717.77874
7493,711663858,7-13-24 20:28,75.87,Deposit,Mobile Deposit,12793.64874
7494,711663858,7-13-24 21:28,286.61,Return,Best Buy Return,13080.25874
7495,711663858,7-14-24 11:28,97.23,Deposit,Cash Deposit,13177.48874
7496,711663858,7-14-24 20:28,339.19,Deposit,Check Deposit,13516.67874
7497,711663858,7-15-24 15:28,413.96,OnlineShopping,Target,13102.71874
7498,711663858,7-16-24 21:28,4000,Payment,Rent Payment,9102.718736
7499,711663858,7-17-24 16:28,57.07,IncomingTransfer,Freelance Payment,9159.788736
7500,711694083,1-20-24 10:28,126.59,Deposit,Check Deposit,972.2458053
7501,711694083,1-26-24 9:28,146.34,OutgoingTransfer,Wire Transfer,825.9058053
7502,711694083,1-26-24 15:28,65.38,Payment,Bill Payment,760.5258053
7503,711694083,1-27-24 16:28,183.29,OnlineShopping,Best Buy,577.2358053
7504,711694083,02-04-24 21:28,1700,IncomingTransfer,Salary,2277.235805
7505,711694083,02-06-24 15:28,200.55,Deposit,Check Deposit,2477.785805
7506,711694083,02-07-24 16:28,49.78,Payment,Loan Payment,2428.005805
7507,711694083,02-09-24 21:28,1500,Payment,Credit Card Payment,928.0058053
7508,711694083,02-11-24 17:28,207.52,OnlineShopping,eBay,720.4858053
7509,711694083,02-12-24 21:28,600,Payment,Subscription Payment,120.4858053
7510,711694083,2-14-24 15:28,138.29,Purchase,Home Improvement,-17.80419474
7511,711694083,2-15-24 21:28,63.81,Deposit,Cash Deposit,46.00580526
7512,711694083,2-20-24 16:28,110.91,OnlineShopping,Walmart,-64.90419474
7513,711694083,2-20-24 19:28,51.87,Withdrawal,Branch Withdrawal,-116.7741947
7514,711694083,2-25-24 18:28,207.62,IncomingTransfer,Freelance Payment,90.84580526
7515,711694083,2-28-24 23:28,239.16,Return,Amazon Return,330.0058053
7516,711694083,2-29-24 18:28,135.83,Deposit,Check Deposit,465.8358053
7517,711694083,2-29-24 22:28,29.93,Purchase,Entertainment,435.9058053
7518,711694083,2-29-24 23:28,209.27,Return,Walmart Return,645.1758053
7519,711694083,03-03-24 21:28,1700,IncomingTransfer,Salary,2345.175805
7520,711694083,03-07-24 18:28,168.4,Deposit,Direct Deposit,2513.575805
7521,711694083,03-08-24 21:28,1600,Payment,Credit Card Payment,913.5758053
7522,711694083,03-10-24 14:28,153.55,Withdrawal,Branch Withdrawal,760.0258053
7523,711694083,03-11-24 15:28,160.76,Purchase,Restaurant,599.2658053
7524,711694083,03-12-24 21:28,159.87,OutgoingTransfer,Wire Transfer,439.3958053
7525,711694083,3-13-24 22:28,68.94,OutgoingTransfer,Peer-to-Peer Transfer,370.4558053
7526,711694083,3-16-24 10:28,28.19,Deposit,Cash Deposit,398.6458053
7527,711694083,3-18-24 21:28,600,Payment,Subscription Payment,-201.3541947
7528,711694083,3-27-24 12:28,121.77,Withdrawal,ATM Withdrawal,-323.1241947
7529,711694083,3-27-24 14:28,231.74,OutgoingTransfer,International Transfer,-554.8641947
7530,711694083,3-28-24 15:28,239.94,Purchase,Travel,-794.8041947
7531,711694083,3-28-24 23:28,202.68,Withdrawal,Branch Withdrawal,-997.4841947
7532,711694083,04-02-24 21:28,1700,IncomingTransfer,Salary,702.5158053
7533,711694083,04-04-24 10:28,167.81,OutgoingTransfer,Peer-to-Peer Transfer,534.7058053
7534,711694083,04-04-24 20:28,185.83,Purchase,Restaurant,348.8758053
7535,711694083,04-04-24 21:28,83.44,Withdrawal,Branch Withdrawal,265.4358053
7536,711694083,04-04-24 23:28,188.15,OutgoingTransfer,International Transfer,77.28580526
7537,711694083,04-05-24 22:28,232.86,Purchase,Travel,-155.5741947
7538,711694083,04-05-24 23:28,50.72,Deposit,Cash Deposit,-104.8541947
7539,711694083,04-06-24 14:28,226.46,OutgoingTransfer,Bank Transfer,-331.3141947
7540,711694083,04-07-24 11:28,38.57,Payment,Loan Payment,-369.8841947
7541,711694083,04-07-24 21:28,1500,Payment,Credit Card Payment,-1869.884195
7542,711694083,04-10-24 12:28,126.67,OnlineShopping,Target,-1996.554195
7543,711694083,04-10-24 21:28,500,Payment,Insurance Payment,-2496.554195
7544,711694083,04-11-24 16:28,88.24,Return,Store Return,-2408.314195
7545,711694083,4-20-24 16:28,205.79,Withdrawal,Mobile App Withdrawal,-2614.104195
7546,711694083,4-22-24 20:28,19.07,Payment,Loan Payment,-2633.174195
7547,711694083,4-24-24 15:28,157.69,Withdrawal,Mobile App Withdrawal,-2790.864195
7548,711694083,4-26-24 12:28,208.77,Deposit,Mobile Deposit,-2582.094195
7549,711694083,4-26-24 18:28,205.18,Return,Walmart Return,-2376.914195
7550,711694083,4-27-24 21:28,129.31,Withdrawal,ATM Withdrawal,-2506.224195
7551,711694083,05-03-24 13:28,197.43,OnlineShopping,Walmart,-2703.654195
7552,711694083,05-03-24 23:28,193.62,Deposit,Direct Deposit,-2510.034195
7553,711694083,05-04-24 21:28,1700,IncomingTransfer,Salary,-810.0341947
7554,711694083,05-06-24 18:28,158.73,Payment,Loan Payment,-968.7641947
7555,711694083,05-09-24 21:28,1500,Payment,Credit Card Payment,-2468.764195
7556,711694083,5-14-24 22:28,46.13,OutgoingTransfer,Peer-to-Peer Transfer,-2514.894195
7557,711694083,5-16-24 21:28,600,Payment,Insurance Payment,-3114.894195
7558,711694083,5-18-24 11:28,214.94,Withdrawal,Mobile App Withdrawal,-3329.834195
7559,711694083,5-19-24 17:28,168.14,Return,Store Return,-3161.694195
7560,711694083,5-21-24 19:28,90.95,Deposit,Mobile Deposit,-3070.744195
7561,711694083,5-23-24 15:28,35.31,Payment,Loan Payment,-3106.054195
7562,711694083,5-24-24 14:28,57.81,OnlineShopping,Best Buy,-3163.864195
7563,711694083,5-26-24 14:28,76.77,Purchase,Restaurant,-3240.634195
7564,711694083,5-27-24 13:28,89.03,IncomingTransfer,Freelance Payment,-3151.604195
7565,711694083,5-30-24 21:28,103.69,Deposit,Mobile Deposit,-3047.914195
7566,711694083,06-01-24 17:28,238.15,Withdrawal,ATM Withdrawal,-3286.064195
7567,711694083,06-05-24 15:28,164.36,Purchase,Furniture,-3450.424195
7568,711694083,06-05-24 21:28,1700,IncomingTransfer,Salary,-1750.424195
7569,711694083,06-06-24 10:28,75.05,Deposit,Direct Deposit,-1675.374195
7570,711694083,06-06-24 11:28,203.08,Withdrawal,ATM Withdrawal,-1878.454195
7571,711694083,06-07-24 19:28,171.55,Purchase,Clothing,-2050.004195
7572,711694083,06-10-24 21:28,1800,Payment,Credit Card Payment,-3850.004195
7573,711694083,06-12-24 13:28,199.17,Withdrawal,ATM Withdrawal,-4049.174195
7574,711694083,06-12-24 21:28,700,Payment,Insurance Payment,-4749.174195
7575,711694083,6-15-24 20:28,96.42,Return,Store Return,-4652.754195
7576,711694083,6-16-24 10:28,168.9,OnlineShopping,Walmart,-4821.654195
7577,711694083,6-24-24 9:28,204.39,OnlineShopping,Etsy,-5026.044195
7578,711694083,6-24-24 17:28,10.98,Purchase,Gas,-5037.024195
7579,711694083,6-30-24 16:28,119.09,Payment,Bill Payment,-5156.114195
7580,711694083,6-30-24 20:28,63.17,Deposit,Cash Deposit,-5092.944195
7581,711694083,07-02-24 21:28,1700,IncomingTransfer,Salary,-3392.944195
7582,711694083,07-07-24 21:28,1800,Payment,Credit Card Payment,-5192.944195
7583,711694083,07-09-24 23:28,31.94,OnlineShopping,Amazon,-5224.884195
7584,711694083,07-11-24 21:28,400,Payment,Subscription Payment,-5624.884195
7585,711694083,07-12-24 23:28,87.29,IncomingTransfer,Freelance Payment,-5537.594195
7586,711694083,7-15-24 22:28,161.2,Deposit,Cash Deposit,-5376.394195
7587,711694083,7-17-24 9:28,177.6,Deposit,Mobile Deposit,-5198.794195
7588,711694083,7-17-24 18:28,204.12,OnlineShopping,Walmart,-5402.914195
7589,711711483,1-23-24 12:28,462.67,OnlineShopping,Etsy,1706.021174
7590,711711483,1-23-24 21:28,420.33,OutgoingTransfer,Wire Transfer,1285.691174
7591,711711483,1-28-24 19:28,263.93,IncomingTransfer,Freelance Payment,1549.621174
7592,711711483,1-29-24 17:28,667.58,Deposit,Cash Deposit,2217.201174
7593,711711483,02-02-24 10:28,465.61,Return,Amazon Return,2682.811174
7594,711711483,02-04-24 20:28,642.42,Withdrawal,ATM Withdrawal,2040.391174
7595,711711483,02-04-24 21:28,8950,IncomingTransfer,Salary,10990.39117
7596,711711483,02-09-24 21:28,3500,Payment,Credit Card Payment,7490.391174
7597,711711483,02-11-24 11:28,291.71,Payment,Mortgage Payment,7198.681174
7598,711711483,2-13-24 21:28,195.29,Withdrawal,Mobile App Withdrawal,7003.391174
7599,711711483,2-17-24 21:28,3000,Payment,Rent Payment,4003.391174
7600,711711483,2-26-24 12:28,181.95,Purchase,Entertainment,3821.441174
7601,711711483,03-04-24 21:28,8950,IncomingTransfer,Salary,12771.44117
7602,711711483,03-09-24 21:28,3200,Payment,Credit Card Payment,9571.441174
7603,711711483,03-10-24 21:28,5500,Payment,Rent Payment,4071.441174
7604,711711483,03-12-24 10:28,492.62,Return,eBay Return,4564.061174
7605,711711483,3-14-24 20:28,535.55,OutgoingTransfer,Wire Transfer,4028.511174
7606,711711483,3-15-24 21:28,359.48,Withdrawal,Mobile App Withdrawal,3669.031174
7607,711711483,3-17-24 17:28,479.12,Deposit,Check Deposit,4148.151174
7608,711711483,3-27-24 23:28,446.04,Payment,Bill Payment,3702.111174
7609,711711483,3-29-24 14:28,517.07,IncomingTransfer,Freelance Payment,4219.181174
7610,711711483,3-31-24 12:28,148.84,Withdrawal,ATM Withdrawal,4070.341174
7611,711711483,04-03-24 21:28,8950,IncomingTransfer,Salary,13020.34117
7612,711711483,04-04-24 17:28,580.77,Deposit,Check Deposit,13601.11117
7613,711711483,04-05-24 21:28,158.89,Return,Amazon Return,13760.00117
7614,711711483,04-08-24 21:28,2700,Payment,Credit Card Payment,11060.00117
7615,711711483,4-15-24 21:28,4800,Payment,Rent Payment,6260.001174
7616,711711483,4-16-24 13:28,668.36,Deposit,Direct Deposit,6928.361174
7617,711711483,4-22-24 13:28,126.82,Return,Target Return,7055.181174
7618,711711483,4-28-24 18:28,672.45,Deposit,Direct Deposit,7727.631174
7619,711711483,4-29-24 18:28,514.63,Purchase,Clothing,7213.001174
7620,711711483,4-30-24 18:28,292.23,Purchase,Travel,6920.771174
7621,711711483,4-30-24 22:28,248.81,IncomingTransfer,Freelance Payment,7169.581174
7622,711711483,05-02-24 21:28,8950,IncomingTransfer,Salary,16119.58117
7623,711711483,05-03-24 18:28,248.96,Purchase,Gas,15870.62117
7624,711711483,05-05-24 16:28,108.8,Withdrawal,Branch Withdrawal,15761.82117
7625,711711483,05-07-24 21:28,2900,Payment,Credit Card Payment,12861.82117
7626,711711483,05-08-24 18:28,508.01,OutgoingTransfer,Bank Transfer,12353.81117
7627,711711483,5-15-24 23:28,632.55,IncomingTransfer,Freelance Payment,12986.36117
7628,711711483,5-17-24 21:28,4000,Payment,Rent Payment,8986.361174
7629,711711483,5-23-24 14:28,331.83,OnlineShopping,Best Buy,8654.531174
7630,711711483,5-28-24 14:28,181.11,OutgoingTransfer,International Transfer,8473.421174
7631,711711483,06-01-24 12:28,248.34,Purchase,Travel,8225.081174
7632,711711483,06-02-24 18:28,584.15,Return,Store Return,8809.231174
7633,711711483,06-05-24 21:28,8950,IncomingTransfer,Salary,17759.23117
7634,711711483,06-10-24 21:28,3200,Payment,Credit Card Payment,14559.23117
7635,711711483,06-10-24 21:28,2500,Payment,Rent Payment,12059.23117
7636,711711483,06-12-24 12:28,717.54,OnlineShopping,AliExpress,11341.69117
7637,711711483,6-19-24 10:28,614.93,Purchase,Home Improvement,10726.76117
7638,711711483,6-22-24 11:28,135.37,Deposit,Mobile Deposit,10862.13117
7639,711711483,6-28-24 9:28,691.59,Purchase,Furniture,10170.54117
7640,711711483,6-28-24 9:28,360.11,Purchase,Entertainment,9810.431174
7641,711711483,6-30-24 17:28,672.05,Deposit,Mobile Deposit,10482.48117
7642,711711483,07-04-24 21:28,8950,IncomingTransfer,Salary,19432.48117
7643,711711483,07-09-24 21:28,2900,Payment,Credit Card Payment,16532.48117
7644,711711483,07-11-24 10:28,304.64,Purchase,Grocery,16227.84117
7645,711711483,7-17-24 19:28,472.88,Withdrawal,ATM Withdrawal,15754.96117
7646,711711483,7-17-24 21:28,5300,Payment,Rent Payment,10454.96117
7647,711745233,1-21-24 14:28,88.53,Deposit,Cash Deposit,88.53
7648,711745233,1-23-24 9:28,61.28,Withdrawal,Mobile App Withdrawal,27.25
7649,711745233,1-27-24 22:28,494.72,Return,Target Return,521.97
7650,711745233,1-31-24 9:28,485.77,OutgoingTransfer,Bank Transfer,36.2
7651,711745233,1-31-24 22:28,247.85,Deposit,Check Deposit,284.05
7652,711745233,02-02-24 21:28,5750,IncomingTransfer,Salary,6034.05
7653,711745233,02-04-24 22:28,21.2,Return,Store Return,6055.25
7654,711745233,02-05-24 18:28,471.31,Withdrawal,Mobile App Withdrawal,5583.94
7655,711745233,02-07-24 15:28,337.33,Purchase,Clothing,5246.61
7656,711745233,2-13-24 17:28,495.94,Withdrawal,Mobile App Withdrawal,4750.67
7657,711745233,2-13-24 22:28,496.59,Payment,Loan Payment,4254.08
7658,711745233,2-16-24 21:28,2100,Payment,Insurance Payment,2154.08
7659,711745233,2-17-24 11:28,486.42,OutgoingTransfer,International Transfer,1667.66
7660,711745233,2-17-24 13:28,250.6,Deposit,Check Deposit,1918.26
7661,711745233,2-17-24 22:28,447,Deposit,Direct Deposit,2365.26
7662,711745233,2-20-24 11:28,339.17,OnlineShopping,Best Buy,2026.09
7663,711745233,2-20-24 16:28,45.59,Return,Store Return,2071.68
7664,711745233,2-29-24 11:28,17.71,IncomingTransfer,Freelance Payment,2089.39
7665,711745233,03-02-24 21:28,5750,IncomingTransfer,Salary,7839.39
7666,711745233,03-03-24 18:28,126.83,Deposit,Check Deposit,7966.22
7667,711745233,03-04-24 12:28,175.64,Purchase,Travel,7790.58
7668,711745233,03-04-24 18:28,441.78,Deposit,Direct Deposit,8232.36
7669,711745233,03-05-24 10:28,431.86,Deposit,Cash Deposit,8664.22
7670,711745233,03-07-24 9:28,339.94,IncomingTransfer,Freelance Payment,9004.16
7671,711745233,03-07-24 14:28,174.15,Deposit,Check Deposit,9178.31
7672,711745233,03-07-24 19:28,327.69,Purchase,Furniture,8850.62
7673,711745233,03-08-24 17:28,477.7,Withdrawal,Mobile App Withdrawal,8372.92
7674,711745233,3-13-24 20:28,74.08,Purchase,Grocery,8298.84
7675,711745233,3-13-24 21:28,1700,Payment,Installment Payment,6598.84
7676,711745233,3-14-24 15:28,339.33,Return,AliExpress Return,6938.17
7677,711745233,3-15-24 10:28,363.89,OnlineShopping,Best Buy,6574.28
7678,711745233,3-18-24 18:28,286.88,OutgoingTransfer,Wire Transfer,6287.4
7679,711745233,3-20-24 21:28,438.6,Withdrawal,Branch Withdrawal,5848.8
7680,711745233,3-21-24 16:28,316.1,Deposit,Cash Deposit,6164.9
7681,711745233,3-24-24 19:28,473.05,Purchase,Gas,5691.85
7682,711745233,3-25-24 12:28,21.43,IncomingTransfer,Freelance Payment,5713.28
7683,711745233,3-31-24 18:28,89.83,Return,Amazon Return,5803.11
7684,711745233,04-02-24 9:28,99.39,Withdrawal,Branch Withdrawal,5703.72
7685,711745233,04-02-24 21:28,5750,IncomingTransfer,Salary,11453.72
7686,711745233,04-05-24 10:28,480.31,IncomingTransfer,Freelance Payment,11934.03
7687,711745233,04-09-24 9:28,456.61,Purchase,Clothing,11477.42
7688,711745233,04-09-24 21:28,263.74,OutgoingTransfer,Peer-to-Peer Transfer,11213.68
7689,711745233,04-10-24 21:28,2500,Payment,Insurance Payment,8713.68
7690,711745233,04-11-24 19:28,409.23,Return,Etsy Return,9122.91
7691,711745233,04-11-24 20:28,92.65,Deposit,Cash Deposit,9215.56
7692,711745233,4-15-24 18:28,92.08,Purchase,Gas,9123.48
7693,711745233,4-19-24 20:28,291.82,Purchase,Restaurant,8831.66
7694,711745233,4-28-24 22:28,338.64,OutgoingTransfer,Peer-to-Peer Transfer,8493.02
7695,711745233,4-30-24 17:28,67.91,Withdrawal,Branch Withdrawal,8425.11
7696,711745233,05-02-24 21:28,5750,IncomingTransfer,Salary,14175.11
7697,711745233,05-11-24 22:28,214.99,Payment,Loan Payment,13960.12
7698,711745233,05-12-24 16:28,388.2,IncomingTransfer,Freelance Payment,14348.32
7699,711745233,5-14-24 16:28,33.48,IncomingTransfer,Freelance Payment,14381.8
7700,711745233,5-15-24 21:28,1800,Payment,Installment Payment,12581.8
7701,711745233,5-17-24 16:28,191.24,Purchase,Entertainment,12390.56
7702,711745233,5-31-24 21:28,125.35,Deposit,Mobile Deposit,12515.91
7703,711745233,06-01-24 11:28,19.76,Deposit,Mobile Deposit,12535.67
7704,711745233,06-04-24 21:28,5750,IncomingTransfer,Salary,18285.67
7705,711745233,06-06-24 20:28,197.58,Return,Walmart Return,18483.25
7706,711745233,06-08-24 10:28,138.49,Deposit,Direct Deposit,18621.74
7707,711745233,06-11-24 22:28,282.94,OnlineShopping,Best Buy,18338.8
7708,711745233,06-12-24 23:28,266.06,OutgoingTransfer,Peer-to-Peer Transfer,18072.74
7709,711745233,6-13-24 21:28,2500,Payment,Subscription Payment,15572.74
7710,711745233,6-14-24 19:28,146.54,Purchase,Entertainment,15426.2
7711,711745233,6-14-24 23:28,469.93,OnlineShopping,Etsy,14956.27
7712,711745233,6-15-24 21:28,385.08,OutgoingTransfer,Bank Transfer,14571.19
7713,711745233,6-23-24 11:28,484.78,Deposit,Cash Deposit,15055.97
7714,711745233,6-27-24 10:28,426.2,Payment,Mortgage Payment,14629.77
7715,711745233,6-29-24 17:28,382.21,Payment,Loan Payment,14247.56
7716,711745233,07-01-24 13:28,121.34,Payment,Bill Payment,14126.22
7717,711745233,07-01-24 21:28,5750,IncomingTransfer,Salary,19876.22
7718,711745233,07-02-24 16:28,467.67,Deposit,Direct Deposit,20343.89
7719,711745233,07-05-24 10:28,210.09,Deposit,Direct Deposit,20553.98
7720,711745233,07-07-24 12:28,320.09,OutgoingTransfer,Wire Transfer,20233.89
7721,711745233,07-10-24 14:28,17.96,Deposit,Check Deposit,20251.85
7722,711745233,07-10-24 21:28,1600,Payment,Installment Payment,18651.85
7723,711745233,07-12-24 11:28,323.98,Payment,Loan Payment,18327.87
7724,711745233,7-13-24 21:28,201.83,Purchase,Electronics,18126.04
7725,711745233,7-16-24 15:28,245.58,Withdrawal,ATM Withdrawal,17880.46
7726,711745233,7-17-24 15:28,410.23,Return,Walmart Return,18290.69
7727,711745233,7-17-24 20:28,274.34,Return,Store Return,18565.03
7728,711794358,1-21-24 13:28,529.58,Deposit,Check Deposit,529.58
7729,711794358,1-24-24 11:28,251.5,IncomingTransfer,Freelance Payment,781.08
7730,711794358,1-25-24 14:28,713.7,Purchase,Travel,67.38
7731,711794358,1-30-24 18:28,202.85,Payment,Mortgage Payment,-135.47
7732,711794358,1-31-24 14:28,162.49,Withdrawal,Branch Withdrawal,-297.96
7733,711794358,1-31-24 16:28,296.14,OnlineShopping,Target,-594.1
7734,711794358,02-03-24 12:28,642.36,Payment,Loan Payment,-1236.46
7735,711794358,02-03-24 12:28,589.31,Withdrawal,Mobile App Withdrawal,-1825.77
7736,711794358,02-03-24 21:28,8000,IncomingTransfer,Salary,6174.23
7737,711794358,02-04-24 13:28,384.87,OnlineShopping,Best Buy,5789.36
7738,711794358,02-06-24 10:28,122.56,Purchase,Pharmacy,5666.8
7739,711794358,02-11-24 16:28,467,Withdrawal,ATM Withdrawal,5199.8
7740,711794358,2-14-24 9:28,302.22,Withdrawal,ATM Withdrawal,4897.58
7741,711794358,2-16-24 21:28,4500,Payment,Rent Payment,397.58
7742,711794358,2-19-24 20:28,585.06,OutgoingTransfer,Bank Transfer,-187.48
7743,711794358,2-23-24 18:28,412.53,Deposit,Check Deposit,225.05
7744,711794358,03-05-24 19:28,454.09,OnlineShopping,Etsy,-229.04
7745,711794358,03-05-24 21:28,8000,IncomingTransfer,Salary,7770.96
7746,711794358,03-06-24 11:28,409.1,Purchase,Pharmacy,7361.86
7747,711794358,03-07-24 18:28,519.48,Deposit,Check Deposit,7881.34
7748,711794358,03-09-24 19:28,457.76,Payment,Bill Payment,7423.58
7749,711794358,03-10-24 12:28,223.79,Withdrawal,ATM Withdrawal,7199.79
7750,711794358,03-10-24 21:28,2700,Payment,Rent Payment,4499.79
7751,711794358,3-19-24 12:28,385.14,Purchase,Furniture,4114.65
7752,711794358,3-23-24 22:28,422.38,Deposit,Direct Deposit,4537.03
7753,711794358,3-26-24 11:28,261.46,OnlineShopping,Best Buy,4275.57
7754,711794358,3-31-24 10:28,748.41,IncomingTransfer,Freelance Payment,5023.98
7755,711794358,04-04-24 12:28,398.01,OutgoingTransfer,International Transfer,4625.97
7756,711794358,04-05-24 21:28,8000,IncomingTransfer,Salary,12625.97
7757,711794358,04-07-24 20:28,312.93,OnlineShopping,Walmart,12313.04
7758,711794358,04-07-24 22:28,417.61,Payment,Mortgage Payment,11895.43
7759,711794358,4-17-24 21:28,4800,Payment,Rent Payment,7095.43
7760,711794358,4-24-24 9:28,714.27,Deposit,Mobile Deposit,7809.7
7761,711794358,4-24-24 20:28,619.34,Return,Etsy Return,8429.04
7762,711794358,4-29-24 12:28,745.33,Return,Walmart Return,9174.37
7763,711794358,4-29-24 22:28,379.68,Withdrawal,Mobile App Withdrawal,8794.69
7764,711794358,4-30-24 19:28,220.24,OutgoingTransfer,Peer-to-Peer Transfer,8574.45
7765,711794358,05-01-24 20:28,456.97,Withdrawal,Branch Withdrawal,8117.48
7766,711794358,05-01-24 21:28,8000,IncomingTransfer,Salary,16117.48
7767,711794358,05-02-24 15:28,501.83,Purchase,Home Improvement,15615.65
7768,711794358,05-06-24 22:28,592.79,Purchase,Pharmacy,15022.86
7769,711794358,05-11-24 12:28,467.89,IncomingTransfer,Freelance Payment,15490.75
7770,711794358,05-11-24 20:28,723.6,Purchase,Gas,14767.15
7771,711794358,05-12-24 21:28,4700,Payment,Rent Payment,10067.15
7772,711794358,5-13-24 15:28,623.68,Payment,Bill Payment,9443.47
7773,711794358,5-21-24 11:28,158.79,Withdrawal,ATM Withdrawal,9284.68
7774,711794358,5-26-24 18:28,617.92,OnlineShopping,AliExpress,8666.76
7775,711794358,5-28-24 10:28,240.97,Purchase,Electronics,8425.79
7776,711794358,5-29-24 20:28,219.99,Purchase,Electronics,8205.8
7777,711794358,5-31-24 14:28,684.46,Purchase,Travel,7521.34
7778,711794358,06-02-24 21:28,8000,IncomingTransfer,Salary,15521.34
7779,711794358,06-03-24 21:28,258.21,Deposit,Mobile Deposit,15779.55
7780,711794358,06-09-24 21:28,670.87,Withdrawal,ATM Withdrawal,15108.68
7781,711794358,06-12-24 13:28,636.05,Deposit,Check Deposit,15744.73
7782,711794358,6-15-24 21:28,4800,Payment,Rent Payment,10944.73
7783,711794358,6-26-24 15:28,334.72,Purchase,Grocery,10610.01
7784,711794358,6-28-24 12:28,625.13,OnlineShopping,Etsy,9984.88
7785,711794358,07-01-24 11:28,409.5,OutgoingTransfer,Wire Transfer,9575.38
7786,711794358,07-03-24 22:28,539.76,Return,Best Buy Return,10115.14
7787,711794358,07-04-24 21:28,8000,IncomingTransfer,Salary,18115.14
7788,711794358,07-05-24 15:28,508.43,Deposit,Mobile Deposit,18623.57
7789,711794358,07-07-24 19:28,388.76,Withdrawal,ATM Withdrawal,18234.81
7790,711794358,07-08-24 22:28,592.13,Deposit,Cash Deposit,18826.94
7791,711794358,07-11-24 22:28,346.9,OnlineShopping,AliExpress,18480.04
7792,711794358,7-13-24 21:28,2700,Payment,Rent Payment,15780.04
7793,711879633,1-21-24 14:28,235.55,OutgoingTransfer,Bank Transfer,1324.129549
7794,711879633,1-22-24 14:28,112.8,Deposit,Direct Deposit,1436.929549
7795,711879633,1-27-24 22:28,75.32,Purchase,Furniture,1361.609549
7796,711879633,1-29-24 12:28,149.63,Purchase,Entertainment,1211.979549
7797,711879633,02-04-24 21:28,2950,IncomingTransfer,Salary,4161.979549
7798,711879633,02-07-24 11:28,215.76,Withdrawal,ATM Withdrawal,3946.219549
7799,711879633,02-08-24 23:28,79.38,Return,Etsy Return,4025.599549
7800,711879633,02-09-24 21:28,2200,Payment,Credit Card Payment,1825.599549
7801,711879633,02-09-24 21:28,147.99,Deposit,Direct Deposit,1973.589549
7802,711879633,02-11-24 21:28,900,Payment,Rent Payment,1073.589549
7803,711879633,02-11-24 21:28,133.09,Deposit,Direct Deposit,1206.679549
7804,711879633,02-12-24 15:28,107.14,OutgoingTransfer,International Transfer,1099.539549
7805,711879633,2-19-24 14:28,184.71,Deposit,Check Deposit,1284.249549
7806,711879633,2-19-24 19:28,145.17,Purchase,Clothing,1139.079549
7807,711879633,2-20-24 23:28,240.23,Deposit,Direct Deposit,1379.309549
7808,711879633,2-23-24 9:28,167.09,Purchase,Clothing,1212.219549
7809,711879633,2-24-24 15:28,121.05,IncomingTransfer,Freelance Payment,1333.269549
7810,711879633,2-26-24 20:28,219.27,Purchase,Furniture,1113.999549
7811,711879633,2-27-24 11:28,146.4,Deposit,Mobile Deposit,1260.399549
7812,711879633,2-28-24 11:28,52.61,IncomingTransfer,Freelance Payment,1313.009549
7813,711879633,2-28-24 19:28,116.7,OnlineShopping,Amazon,1196.309549
7814,711879633,2-29-24 17:28,225.86,IncomingTransfer,Freelance Payment,1422.169549
7815,711879633,03-01-24 20:28,10.6,Return,Etsy Return,1432.769549
7816,711879633,03-05-24 21:28,2950,IncomingTransfer,Salary,4382.769549
7817,711879633,03-05-24 22:28,130.77,Purchase,Grocery,4251.999549
7818,711879633,03-10-24 21:28,2100,Payment,Credit Card Payment,2151.999549
7819,711879633,03-11-24 12:28,198.62,Deposit,Check Deposit,2350.619549
7820,711879633,03-11-24 16:28,79.45,Deposit,Mobile Deposit,2430.069549
7821,711879633,03-11-24 23:28,222.7,OnlineShopping,eBay,2207.369549
7822,711879633,3-17-24 11:28,13.41,Deposit,Cash Deposit,2220.779549
7823,711879633,3-17-24 21:28,1900,Payment,Rent Payment,320.7795488
7824,711879633,3-24-24 16:28,34.24,Return,Store Return,355.0195488
7825,711879633,3-24-24 19:28,165.73,OnlineShopping,Walmart,189.2895488
7826,711879633,3-24-24 19:28,213.96,Deposit,Cash Deposit,403.2495488
7827,711879633,3-25-24 12:28,36.91,Deposit,Direct Deposit,440.1595488
7828,711879633,3-30-24 11:28,13.18,Deposit,Mobile Deposit,453.3395488
7829,711879633,04-03-24 21:28,28.75,Return,AliExpress Return,482.0895488
7830,711879633,04-04-24 13:28,201.15,Return,Etsy Return,683.2395488
7831,711879633,04-04-24 21:28,2950,IncomingTransfer,Salary,3633.239549
7832,711879633,04-09-24 21:28,2000,Payment,Credit Card Payment,1633.239549
7833,711879633,04-11-24 14:28,235.02,OutgoingTransfer,International Transfer,1398.219549
7834,711879633,04-12-24 15:28,116.26,Withdrawal,Branch Withdrawal,1281.959549
7835,711879633,4-13-24 21:28,1200,Payment,Rent Payment,81.95954881
7836,711879633,4-15-24 16:28,77.39,Purchase,Pharmacy,4.569548806
7837,711879633,4-18-24 18:28,39.37,Purchase,Home Improvement,-34.80045119
7838,711879633,4-19-24 20:28,142.94,Deposit,Direct Deposit,108.1395488
7839,711879633,4-20-24 21:28,22.53,Withdrawal,ATM Withdrawal,85.60954881
7840,711879633,4-30-24 23:28,173.88,Deposit,Direct Deposit,259.4895488
7841,711879633,05-01-24 15:28,227.21,Deposit,Direct Deposit,486.6995488
7842,711879633,05-01-24 21:28,2950,IncomingTransfer,Salary,3436.699549
7843,711879633,05-04-24 11:28,247.49,Deposit,Cash Deposit,3684.189549
7844,711879633,05-06-24 21:28,2800,Payment,Credit Card Payment,884.1895488
7845,711879633,05-11-24 14:28,121.97,Return,Amazon Return,1006.159549
7846,711879633,05-11-24 20:28,152.19,Deposit,Cash Deposit,1158.349549
7847,711879633,05-12-24 12:28,143.52,OutgoingTransfer,Wire Transfer,1014.829549
7848,711879633,5-16-24 21:28,1600,Payment,Rent Payment,-585.1704512
7849,711879633,5-20-24 18:28,108.7,Payment,Bill Payment,-693.8704512
7850,711879633,5-22-24 16:28,24.11,OnlineShopping,Walmart,-717.9804512
7851,711879633,5-24-24 14:28,175.57,IncomingTransfer,Freelance Payment,-542.4104512
7852,711879633,5-24-24 22:28,107.35,OutgoingTransfer,Peer-to-Peer Transfer,-649.7604512
7853,711879633,5-25-24 22:28,38.47,Withdrawal,Branch Withdrawal,-688.2304512
7854,711879633,5-26-24 15:28,246.67,OnlineShopping,Amazon,-934.9004512
7855,711879633,5-30-24 10:28,85.18,Purchase,Furniture,-1020.080451
7856,711879633,06-02-24 18:28,50.23,Purchase,Clothing,-1070.310451
7857,711879633,06-02-24 21:28,2950,IncomingTransfer,Salary,1879.689549
7858,711879633,06-03-24 21:28,215.73,Withdrawal,ATM Withdrawal,1663.959549
7859,711879633,06-06-24 17:28,146.65,Withdrawal,Mobile App Withdrawal,1517.309549
7860,711879633,06-07-24 21:28,2700,Payment,Credit Card Payment,-1182.690451
7861,711879633,06-11-24 9:28,173.12,OnlineShopping,eBay,-1355.810451
7862,711879633,6-13-24 10:28,68.93,OnlineShopping,AliExpress,-1424.740451
7863,711879633,6-13-24 13:28,70.19,Deposit,Direct Deposit,-1354.550451
7864,711879633,6-16-24 21:28,243.01,Payment,Mortgage Payment,-1597.560451
7865,711879633,6-17-24 10:28,210.09,Return,Etsy Return,-1387.470451
7866,711879633,6-18-24 21:28,900,Payment,Rent Payment,-2287.470451
7867,711879633,6-19-24 19:28,177.23,Purchase,Restaurant,-2464.700451
7868,711879633,6-20-24 22:28,91.84,Deposit,Check Deposit,-2372.860451
7869,711879633,6-23-24 22:28,246.07,Withdrawal,ATM Withdrawal,-2618.930451
7870,711879633,6-25-24 23:28,133.95,Purchase,Home Improvement,-2752.880451
7871,711879633,07-01-24 22:28,132.09,Purchase,Clothing,-2884.970451
7872,711879633,07-02-24 21:28,2950,IncomingTransfer,Salary,65.02954881
7873,711879633,07-03-24 13:28,131.53,Deposit,Direct Deposit,196.5595488
7874,711879633,07-07-24 15:28,238.13,Withdrawal,Branch Withdrawal,-41.57045119
7875,711879633,07-07-24 21:28,2300,Payment,Credit Card Payment,-2341.570451
7876,711879633,07-08-24 10:28,175.66,OnlineShopping,AliExpress,-2517.230451
7877,711879633,07-10-24 21:28,1600,Payment,Rent Payment,-4117.230451
7878,711879633,07-12-24 14:28,185.9,Withdrawal,Mobile App Withdrawal,-4303.130451
7879,711879633,7-14-24 15:28,99.17,OnlineShopping,Target,-4402.300451
7880,711879633,7-17-24 14:28,22.66,Withdrawal,ATM Withdrawal,-4424.960451
7881,711907083,1-20-24 10:28,356.19,OutgoingTransfer,Bank Transfer,249.3077259
7882,711907083,1-31-24 13:28,222.55,OnlineShopping,Target,26.75772588
7883,711907083,02-03-24 21:28,8050,IncomingTransfer,Salary,8076.757726
7884,711907083,02-08-24 21:28,1100,Payment,Credit Card Payment,6976.757726
7885,711907083,02-10-24 17:28,391.48,OutgoingTransfer,International Transfer,6585.277726
7886,711907083,02-11-24 15:28,169.21,Purchase,Travel,6416.067726
7887,711907083,02-12-24 20:28,113.37,Return,Best Buy Return,6529.437726
7888,711907083,02-12-24 21:28,3100,Payment,Installment Payment,3429.437726
7889,711907083,2-14-24 13:28,186.98,IncomingTransfer,Freelance Payment,3616.417726
7890,711907083,2-15-24 17:28,595.8,Purchase,Entertainment,3020.617726
7891,711907083,2-16-24 13:28,177.53,Purchase,Entertainment,2843.087726
7892,711907083,2-18-24 22:28,527.55,Purchase,Entertainment,2315.537726
7893,711907083,2-19-24 16:28,613.18,Purchase,Pharmacy,1702.357726
7894,711907083,2-21-24 22:28,484.43,Withdrawal,ATM Withdrawal,1217.927726
7895,711907083,2-25-24 16:28,294.97,Withdrawal,Mobile App Withdrawal,922.9577259
7896,711907083,2-29-24 13:28,596.16,OnlineShopping,Target,326.7977259
7897,711907083,03-01-24 20:28,233.63,Deposit,Check Deposit,560.4277259
7898,711907083,03-04-24 21:28,8050,IncomingTransfer,Salary,8610.427726
7899,711907083,03-09-24 21:28,1200,Payment,Credit Card Payment,7410.427726
7900,711907083,03-09-24 21:28,242.48,OutgoingTransfer,Wire Transfer,7167.947726
7901,711907083,03-11-24 21:28,3400,Payment,Installment Payment,3767.947726
7902,711907083,3-13-24 15:28,360.11,Deposit,Direct Deposit,4128.057726
7903,711907083,3-14-24 21:28,481.09,Return,Target Return,4609.147726
7904,711907083,3-17-24 11:28,363.59,Return,Etsy Return,4972.737726
7905,711907083,3-18-24 17:28,604.55,IncomingTransfer,Freelance Payment,5577.287726
7906,711907083,3-20-24 22:28,565.33,Purchase,Restaurant,5011.957726
7907,711907083,3-26-24 15:28,413.69,Withdrawal,Mobile App Withdrawal,4598.267726
7908,711907083,3-29-24 11:28,617.24,Withdrawal,Mobile App Withdrawal,3981.027726
7909,711907083,04-04-24 19:28,225.09,Withdrawal,Mobile App Withdrawal,3755.937726
7910,711907083,04-05-24 21:28,8050,IncomingTransfer,Salary,11805.93773
7911,711907083,04-08-24 11:28,317.34,Deposit,Cash Deposit,12123.27773
7912,711907083,04-08-24 14:28,290.19,Deposit,Cash Deposit,12413.46773
7913,711907083,04-09-24 19:28,559.02,Purchase,Furniture,11854.44773
7914,711907083,04-10-24 21:28,1400,Payment,Credit Card Payment,10454.44773
7915,711907083,04-11-24 21:28,614.34,Return,eBay Return,11068.78773
7916,711907083,4-15-24 17:28,413.52,Purchase,Gas,10655.26773
7917,711907083,4-17-24 21:28,2400,Payment,Insurance Payment,8255.267726
7918,711907083,4-23-24 10:28,456.21,Purchase,Electronics,7799.057726
7919,711907083,4-26-24 19:28,437.06,Deposit,Mobile Deposit,8236.117726
7920,711907083,4-30-24 12:28,536.44,Purchase,Pharmacy,7699.677726
7921,711907083,4-30-24 20:28,184.91,Deposit,Direct Deposit,7884.587726
7922,711907083,05-03-24 9:28,268.27,Return,Target Return,8152.857726
7923,711907083,05-04-24 13:28,718.45,Withdrawal,Branch Withdrawal,7434.407726
7924,711907083,05-05-24 21:28,8050,IncomingTransfer,Salary,15484.40773
7925,711907083,05-07-24 10:28,612.68,Deposit,Direct Deposit,16097.08773
7926,711907083,05-07-24 16:28,632.43,OnlineShopping,Etsy,15464.65773
7927,711907083,05-07-24 23:28,625.42,OnlineShopping,eBay,14839.23773
7928,711907083,05-10-24 11:28,333.97,Deposit,Direct Deposit,15173.20773
7929,711907083,05-10-24 21:28,1500,Payment,Credit Card Payment,13673.20773
7930,711907083,05-11-24 18:28,734.21,Payment,Loan Payment,12938.99773
7931,711907083,5-13-24 17:28,238.82,Return,eBay Return,13177.81773
7932,711907083,5-13-24 19:28,656.26,Deposit,Direct Deposit,13834.07773
7933,711907083,5-15-24 16:28,700.32,Return,Etsy Return,14534.39773
7934,711907083,5-15-24 21:28,2600,Payment,Subscription Payment,11934.39773
7935,711907083,5-17-24 13:28,731.96,Withdrawal,ATM Withdrawal,11202.43773
7936,711907083,5-20-24 11:28,389.98,Deposit,Check Deposit,11592.41773
7937,711907083,5-23-24 22:28,608.33,Deposit,Check Deposit,12200.74773
7938,711907083,5-23-24 23:28,214.93,Deposit,Check Deposit,12415.67773
7939,711907083,5-25-24 12:28,114.37,Purchase,Restaurant,12301.30773
7940,711907083,5-26-24 19:28,190.21,OutgoingTransfer,Peer-to-Peer Transfer,12111.09773
7941,711907083,5-27-24 18:28,464.38,OutgoingTransfer,Peer-to-Peer Transfer,11646.71773
7942,711907083,06-01-24 12:28,637.07,Deposit,Direct Deposit,12283.78773
7943,711907083,06-05-24 21:28,8050,IncomingTransfer,Salary,20333.78773
7944,711907083,06-07-24 9:28,351.42,Deposit,Check Deposit,20685.20773
7945,711907083,06-10-24 21:28,1600,Payment,Credit Card Payment,19085.20773
7946,711907083,06-12-24 11:28,202.21,OutgoingTransfer,Wire Transfer,18882.99773
7947,711907083,06-12-24 20:28,277.23,OutgoingTransfer,Bank Transfer,18605.76773
7948,711907083,6-15-24 21:28,3400,Payment,Insurance Payment,15205.76773
7949,711907083,6-19-24 12:28,243.41,OnlineShopping,Best Buy,14962.35773
7950,711907083,6-19-24 16:28,171.5,Deposit,Cash Deposit,15133.85773
7951,711907083,6-27-24 17:28,194.81,Deposit,Direct Deposit,15328.66773
7952,711907083,6-29-24 18:28,373.32,Purchase,Grocery,14955.34773
7953,711907083,07-01-24 21:28,8050,IncomingTransfer,Salary,23005.34773
7954,711907083,07-02-24 11:28,493.87,Return,Target Return,23499.21773
7955,711907083,07-03-24 16:28,159.04,Return,AliExpress Return,23658.25773
7956,711907083,07-06-24 10:28,596.39,Withdrawal,Mobile App Withdrawal,23061.86773
7957,711907083,07-06-24 21:28,1500,Payment,Credit Card Payment,21561.86773
7958,711907083,07-09-24 12:28,718.74,Purchase,Entertainment,20843.12773
7959,711907083,07-12-24 15:28,574.94,OutgoingTransfer,Peer-to-Peer Transfer,20268.18773
7960,711907083,7-13-24 13:28,161.07,Payment,Mortgage Payment,20107.11773
7961,711907083,7-14-24 13:28,457.7,Purchase,Gas,19649.41773
7962,711907083,7-15-24 21:28,2700,Payment,Subscription Payment,16949.41773
7963,711929058,1-21-24 12:28,152.7,Withdrawal,Branch Withdrawal,930.1279854
7964,711929058,02-04-24 21:28,6100,IncomingTransfer,Salary,7030.127985
7965,711929058,02-08-24 11:28,38.72,Purchase,Restaurant,6991.407985
7966,711929058,02-08-24 22:28,298.91,Purchase,Restaurant,6692.497985
7967,711929058,02-09-24 10:28,138.96,Purchase,Electronics,6553.537985
7968,711929058,02-09-24 21:28,1600,Payment,Credit Card Payment,4953.537985
7969,711929058,02-12-24 21:28,3900,Payment,Rent Payment,1053.537985
7970,711929058,2-13-24 11:28,475.17,Deposit,Check Deposit,1528.707985
7971,711929058,2-21-24 12:28,438.98,Payment,Mortgage Payment,1089.727985
7972,711929058,2-27-24 23:28,86.73,Deposit,Cash Deposit,1176.457985
7973,711929058,2-29-24 13:28,470.26,Purchase,Home Improvement,706.1979854
7974,711929058,03-01-24 14:28,424.62,Return,Store Return,1130.817985
7975,711929058,03-01-24 18:28,92.45,Payment,Mortgage Payment,1038.367985
7976,711929058,03-03-24 21:28,6100,IncomingTransfer,Salary,7138.367985
7977,711929058,03-04-24 13:28,89.87,Purchase,Electronics,7048.497985
7978,711929058,03-04-24 19:28,199.26,Purchase,Pharmacy,6849.237985
7979,711929058,03-05-24 16:28,233.55,Deposit,Cash Deposit,7082.787985
7980,711929058,03-08-24 21:28,1500,Payment,Credit Card Payment,5582.787985
7981,711929058,03-10-24 18:28,488.63,Deposit,Check Deposit,6071.417985
7982,711929058,3-13-24 14:28,364.14,Payment,Mortgage Payment,5707.277985
7983,711929058,3-14-24 21:28,2000,Payment,Rent Payment,3707.277985
7984,711929058,3-16-24 12:28,477.02,Deposit,Mobile Deposit,4184.297985
7985,711929058,3-17-24 10:28,403.52,Deposit,Check Deposit,4587.817985
7986,711929058,3-17-24 17:28,325.84,Return,Walmart Return,4913.657985
7987,711929058,3-20-24 16:28,326.18,IncomingTransfer,Freelance Payment,5239.837985
7988,711929058,3-25-24 10:28,126.87,OnlineShopping,Target,5112.967985
7989,711929058,04-02-24 21:28,6100,IncomingTransfer,Salary,11212.96799
7990,711929058,04-07-24 14:28,118.25,Return,Amazon Return,11331.21799
7991,711929058,04-07-24 21:28,1600,Payment,Credit Card Payment,9731.217985
7992,711929058,04-07-24 21:28,485.5,Deposit,Cash Deposit,10216.71799
7993,711929058,04-10-24 19:28,234.99,Return,Amazon Return,10451.70799
7994,711929058,4-13-24 15:28,380.27,Withdrawal,ATM Withdrawal,10071.43799
7995,711929058,4-13-24 19:28,25.3,Purchase,Clothing,10046.13799
7996,711929058,4-13-24 21:28,178.14,Purchase,Restaurant,9867.997985
7997,711929058,4-16-24 21:28,1700,Payment,Rent Payment,8167.997985
7998,711929058,4-17-24 16:28,161.5,Payment,Mortgage Payment,8006.497985
7999,711929058,4-23-24 16:28,77.43,IncomingTransfer,Freelance Payment,8083.927985
8000,711929058,4-26-24 20:28,293.64,Payment,Loan Payment,7790.287985
8001,711929058,4-27-24 18:28,448.45,OutgoingTransfer,Wire Transfer,7341.837985
8002,711929058,05-02-24 20:28,123.56,Withdrawal,ATM Withdrawal,7218.277985
8003,711929058,05-04-24 21:28,6100,IncomingTransfer,Salary,13318.27799
8004,711929058,05-04-24 22:28,259.4,Purchase,Furniture,13058.87799
8005,711929058,05-09-24 21:28,1600,Payment,Credit Card Payment,11458.87799
8006,711929058,05-10-24 12:28,367.71,Payment,Bill Payment,11091.16799
8007,711929058,5-14-24 15:28,204.64,Purchase,Gas,10886.52799
8008,711929058,5-17-24 14:28,249.08,Deposit,Check Deposit,11135.60799
8009,711929058,5-17-24 22:28,485.55,Purchase,Entertainment,10650.05799
8010,711929058,5-18-24 21:28,2800,Payment,Rent Payment,7850.057985
8011,711929058,5-26-24 15:28,223.65,OnlineShopping,Walmart,7626.407985
8012,711929058,06-01-24 11:28,266.69,Purchase,Restaurant,7359.717985
8013,711929058,06-02-24 21:28,6100,IncomingTransfer,Salary,13459.71799
8014,711929058,06-07-24 21:28,1400,Payment,Credit Card Payment,12059.71799
8015,711929058,06-08-24 19:28,27.95,Purchase,Furniture,12031.76799
8016,711929058,6-13-24 21:28,1800,Payment,Rent Payment,10231.76799
8017,711929058,6-16-24 17:28,107.72,OnlineShopping,AliExpress,10124.04799
8018,711929058,6-24-24 10:28,131.33,Return,Target Return,10255.37799
8019,711929058,6-28-24 22:28,207.78,Payment,Loan Payment,10047.59799
8020,711929058,6-29-24 20:28,165.31,OutgoingTransfer,Peer-to-Peer Transfer,9882.287985
8021,711929058,6-30-24 10:28,468.1,Deposit,Cash Deposit,10350.38799
8022,711929058,07-02-24 20:28,210.92,Deposit,Check Deposit,10561.30799
8023,711929058,07-02-24 20:28,306.63,OnlineShopping,AliExpress,10254.67799
8024,711929058,07-02-24 21:28,6100,IncomingTransfer,Salary,16354.67799
8025,711929058,07-04-24 10:28,355.81,Purchase,Restaurant,15998.86799
8026,711929058,07-07-24 21:28,1500,Payment,Credit Card Payment,14498.86799
8027,711929058,07-08-24 21:28,122.23,Return,Amazon Return,14621.09799
8028,711929058,7-13-24 20:28,465.25,Return,AliExpress Return,15086.34799
8029,711929058,7-18-24 21:28,3500,Payment,Rent Payment,11586.34799
8030,712036383,1-22-24 13:28,146.48,Deposit,Direct Deposit,146.48
8031,712036383,02-01-24 15:28,336.82,Payment,Bill Payment,-190.34
8032,712036383,02-02-24 21:28,5800,IncomingTransfer,Salary,5609.66
8033,712036383,02-05-24 21:28,426.79,Return,Target Return,6036.45
8034,712036383,02-06-24 16:28,291.23,Withdrawal,Branch Withdrawal,5745.22
8035,712036383,02-07-24 19:28,249.2,Withdrawal,ATM Withdrawal,5496.02
8036,712036383,02-11-24 19:28,341.6,Payment,Loan Payment,5154.42
8037,712036383,2-15-24 21:28,2000,Payment,Installment Payment,3154.42
8038,712036383,2-18-24 22:28,214.83,Purchase,Gas,2939.59
8039,712036383,2-20-24 9:28,406.46,Payment,Bill Payment,2533.13
8040,712036383,2-20-24 12:28,69.44,Deposit,Direct Deposit,2602.57
8041,712036383,2-20-24 15:28,344.56,Deposit,Mobile Deposit,2947.13
8042,712036383,2-21-24 13:28,298.14,Deposit,Cash Deposit,3245.27
8043,712036383,2-21-24 16:28,275.35,Deposit,Direct Deposit,3520.62
8044,712036383,2-23-24 11:28,58.52,IncomingTransfer,Freelance Payment,3579.14
8045,712036383,2-23-24 22:28,172.76,Withdrawal,ATM Withdrawal,3406.38
8046,712036383,2-29-24 16:28,122.34,Payment,Mortgage Payment,3284.04
8047,712036383,2-29-24 22:28,286.36,Purchase,Electronics,2997.68
8048,712036383,03-01-24 21:28,5800,IncomingTransfer,Salary,8797.68
8049,712036383,03-05-24 23:28,211.05,Payment,Loan Payment,8586.63
8050,712036383,03-07-24 22:28,250.27,Withdrawal,ATM Withdrawal,8336.36
8051,712036383,03-10-24 21:28,2300,Payment,Installment Payment,6036.36
8052,712036383,03-11-24 20:28,470.55,OnlineShopping,Best Buy,5565.81
8053,712036383,3-20-24 15:28,430.72,Deposit,Check Deposit,5996.53
8054,712036383,3-31-24 19:28,163.15,Deposit,Mobile Deposit,6159.68
8055,712036383,04-03-24 11:28,156.26,Deposit,Check Deposit,6315.94
8056,712036383,04-04-24 21:28,5800,IncomingTransfer,Salary,12115.94
8057,712036383,04-06-24 19:28,296.63,Withdrawal,ATM Withdrawal,11819.31
8058,712036383,04-10-24 18:28,327.92,Deposit,Mobile Deposit,12147.23
8059,712036383,04-11-24 19:28,201.44,OnlineShopping,Amazon,11945.79
8060,712036383,04-11-24 21:28,342.58,Purchase,Gas,11603.21
8061,712036383,04-12-24 23:28,509.46,Deposit,Cash Deposit,12112.67
8062,712036383,4-13-24 21:28,1700,Payment,Subscription Payment,10412.67
8063,712036383,4-15-24 16:28,224.11,Payment,Bill Payment,10188.56
8064,712036383,4-16-24 11:28,306.06,Purchase,Electronics,9882.5
8065,712036383,4-19-24 19:28,149.53,Payment,Bill Payment,9732.97
8066,712036383,4-23-24 16:28,313.74,OnlineShopping,Etsy,9419.23
8067,712036383,4-23-24 22:28,384.81,Deposit,Cash Deposit,9804.04
8068,712036383,4-28-24 10:28,92.09,Payment,Loan Payment,9711.95
8069,712036383,4-30-24 12:28,187.07,Deposit,Cash Deposit,9899.02
8070,712036383,05-01-24 17:28,108.78,OutgoingTransfer,Peer-to-Peer Transfer,9790.24
8071,712036383,05-02-24 13:28,207.58,Withdrawal,Branch Withdrawal,9582.66
8072,712036383,05-02-24 21:28,5800,IncomingTransfer,Salary,15382.66
8073,712036383,05-04-24 16:28,183.79,OnlineShopping,Amazon,15198.87
8074,712036383,05-05-24 17:28,285.3,IncomingTransfer,Freelance Payment,15484.17
8075,712036383,05-10-24 21:28,1500,Payment,Subscription Payment,13984.17
8076,712036383,05-11-24 10:28,193.61,Deposit,Direct Deposit,14177.78
8077,712036383,05-11-24 17:28,103.73,Purchase,Pharmacy,14074.05
8078,712036383,05-12-24 21:28,358.28,OnlineShopping,AliExpress,13715.77
8079,712036383,5-14-24 23:28,462.85,Return,Etsy Return,14178.62
8080,712036383,5-17-24 19:28,300.29,Deposit,Mobile Deposit,14478.91
8081,712036383,5-18-24 10:28,282.01,Return,AliExpress Return,14760.92
8082,712036383,5-18-24 13:28,519.8,Withdrawal,Mobile App Withdrawal,14241.12
8083,712036383,5-20-24 19:28,413.27,OnlineShopping,Walmart,13827.85
8084,712036383,5-22-24 16:28,545.25,Deposit,Cash Deposit,14373.1
8085,712036383,5-22-24 18:28,280.1,Payment,Mortgage Payment,14093
8086,712036383,5-24-24 23:28,275.91,Deposit,Check Deposit,14368.91
8087,712036383,5-28-24 17:28,361.09,Return,Best Buy Return,14730
8088,712036383,5-30-24 10:28,57.06,Purchase,Gas,14672.94
8089,712036383,06-01-24 15:28,260.53,Purchase,Travel,14412.41
8090,712036383,06-03-24 21:28,5800,IncomingTransfer,Salary,20212.41
8091,712036383,06-04-24 15:28,531.17,Deposit,Direct Deposit,20743.58
8092,712036383,06-06-24 9:28,324.02,Withdrawal,Branch Withdrawal,20419.56
8093,712036383,06-11-24 10:28,473.12,Withdrawal,Mobile App Withdrawal,19946.44
8094,712036383,06-12-24 11:28,275.47,Deposit,Direct Deposit,20221.91
8095,712036383,6-13-24 21:28,2500,Payment,Insurance Payment,17721.91
8096,712036383,6-15-24 15:28,349.33,Payment,Bill Payment,17372.58
8097,712036383,6-18-24 14:28,511.39,OnlineShopping,eBay,16861.19
8098,712036383,6-19-24 21:28,546.26,Purchase,Restaurant,16314.93
8099,712036383,6-24-24 14:28,450.84,Deposit,Cash Deposit,16765.77
8100,712036383,6-25-24 12:28,433.26,OutgoingTransfer,Wire Transfer,16332.51
8101,712036383,6-29-24 16:28,543.44,Return,Store Return,16875.95
8102,712036383,6-29-24 18:28,347.38,Payment,Bill Payment,16528.57
8103,712036383,07-01-24 22:28,202.24,Deposit,Mobile Deposit,16730.81
8104,712036383,07-03-24 19:28,296.23,Withdrawal,Mobile App Withdrawal,16434.58
8105,712036383,07-04-24 21:28,5800,IncomingTransfer,Salary,22234.58
8106,712036383,07-05-24 12:28,105.18,Purchase,Restaurant,22129.4
8107,712036383,07-07-24 21:28,303.9,Purchase,Clothing,21825.5
8108,712036383,07-12-24 9:28,118.74,Purchase,Furniture,21706.76
8109,712036383,7-14-24 21:28,2200,Payment,Installment Payment,19506.76
8110,712037358,1-21-24 13:28,316.75,Deposit,Mobile Deposit,1619.006807
8111,712037358,1-25-24 23:28,479.48,IncomingTransfer,Freelance Payment,2098.486807
8112,712037358,1-30-24 12:28,325.88,Purchase,Home Improvement,1772.606807
8113,712037358,1-30-24 18:28,60.5,Return,eBay Return,1833.106807
8114,712037358,02-01-24 11:28,134.91,Return,Amazon Return,1968.016807
8115,712037358,02-02-24 20:28,305.1,Purchase,Pharmacy,1662.916807
8116,712037358,02-02-24 21:28,5600,IncomingTransfer,Salary,7262.916807
8117,712037358,02-06-24 21:28,266.12,OnlineShopping,Walmart,6996.796807
8118,712037358,02-07-24 21:28,2600,Payment,Credit Card Payment,4396.796807
8119,712037358,2-17-24 15:28,110.71,Purchase,Electronics,4286.086807
8120,712037358,2-18-24 21:28,3200,Payment,Rent Payment,1086.086807
8121,712037358,2-23-24 17:28,515.4,Withdrawal,Mobile App Withdrawal,570.6868068
8122,712037358,2-26-24 18:28,366.23,Purchase,Travel,204.4568068
8123,712037358,2-26-24 23:28,220.88,OnlineShopping,AliExpress,-16.4231932
8124,712037358,03-03-24 16:28,265.75,OnlineShopping,Walmart,-282.1731932
8125,712037358,03-05-24 21:28,5600,IncomingTransfer,Salary,5317.826807
8126,712037358,03-10-24 11:28,434.63,Payment,Mortgage Payment,4883.196807
8127,712037358,03-10-24 21:28,2200,Payment,Credit Card Payment,2683.196807
8128,712037358,03-12-24 17:28,287.03,Withdrawal,Mobile App Withdrawal,2396.166807
8129,712037358,3-13-24 21:28,2900,Payment,Rent Payment,-503.8331932
8130,712037358,3-14-24 17:28,136.86,Purchase,Entertainment,-640.6931932
8131,712037358,3-15-24 12:28,543.36,Purchase,Clothing,-1184.053193
8132,712037358,3-16-24 10:28,269.83,Deposit,Check Deposit,-914.2231932
8133,712037358,3-22-24 13:28,499.45,Withdrawal,ATM Withdrawal,-1413.673193
8134,712037358,3-24-24 12:28,138.98,Return,Best Buy Return,-1274.693193
8135,712037358,3-26-24 19:28,188.41,Deposit,Mobile Deposit,-1086.283193
8136,712037358,3-30-24 22:28,185.23,Withdrawal,Branch Withdrawal,-1271.513193
8137,712037358,04-02-24 18:28,355.54,IncomingTransfer,Freelance Payment,-915.9731932
8138,712037358,04-03-24 21:28,5600,IncomingTransfer,Salary,4684.026807
8139,712037358,04-05-24 20:28,85.65,Deposit,Mobile Deposit,4769.676807
8140,712037358,04-06-24 10:28,248.29,Purchase,Pharmacy,4521.386807
8141,712037358,04-08-24 21:28,2100,Payment,Credit Card Payment,2421.386807
8142,712037358,04-10-24 9:28,349.66,Deposit,Mobile Deposit,2771.046807
8143,712037358,04-11-24 21:28,2400,Payment,Rent Payment,371.0468068
8144,712037358,4-27-24 11:28,93.85,OnlineShopping,eBay,277.1968068
8145,712037358,4-30-24 11:28,280.03,Deposit,Direct Deposit,557.2268068
8146,712037358,05-01-24 21:28,5600,IncomingTransfer,Salary,6157.226807
8147,712037358,05-03-24 22:28,473.55,Purchase,Entertainment,5683.676807
8148,712037358,05-06-24 21:28,2300,Payment,Credit Card Payment,3383.676807
8149,712037358,05-06-24 23:28,317.58,Return,Best Buy Return,3701.256807
8150,712037358,5-14-24 22:28,155.17,OnlineShopping,Walmart,3546.086807
8151,712037358,5-16-24 21:28,2900,Payment,Rent Payment,646.0868068
8152,712037358,5-18-24 13:28,98.37,Deposit,Check Deposit,744.4568068
8153,712037358,5-24-24 17:28,121.7,Purchase,Pharmacy,622.7568068
8154,712037358,5-25-24 14:28,151.62,Return,Target Return,774.3768068
8155,712037358,5-26-24 13:28,537.76,Return,Walmart Return,1312.136807
8156,712037358,06-01-24 16:28,457.96,Withdrawal,Branch Withdrawal,854.1768068
8157,712037358,06-02-24 21:28,5600,IncomingTransfer,Salary,6454.176807
8158,712037358,06-07-24 15:28,174.94,Purchase,Travel,6279.236807
8159,712037358,06-07-24 21:28,2000,Payment,Credit Card Payment,4279.236807
8160,712037358,06-10-24 12:28,53.54,Return,Store Return,4332.776807
8161,712037358,06-10-24 21:28,2800,Payment,Rent Payment,1532.776807
8162,712037358,06-11-24 22:28,157.65,Purchase,Pharmacy,1375.126807
8163,712037358,6-15-24 11:28,525.16,Deposit,Cash Deposit,1900.286807
8164,712037358,6-15-24 14:28,431.18,IncomingTransfer,Freelance Payment,2331.466807
8165,712037358,6-16-24 15:28,424.13,Purchase,Pharmacy,1907.336807
8166,712037358,6-29-24 13:28,379.1,Payment,Mortgage Payment,1528.236807
8167,712037358,07-02-24 21:28,5600,IncomingTransfer,Salary,7128.236807
8168,712037358,07-07-24 21:28,2000,Payment,Credit Card Payment,5128.236807
8169,712037358,07-09-24 15:28,88.9,Return,Best Buy Return,5217.136807
8170,712037358,07-10-24 9:28,100.89,Deposit,Cash Deposit,5318.026807
8171,712037358,7-17-24 21:28,2400,Payment,Rent Payment,2918.026807
8172,712037358,7-17-24 23:28,164.5,Return,Target Return,3082.526807
8173,712046808,1-21-24 11:28,52.52,Deposit,Check Deposit,1005.049585
8174,712046808,1-30-24 19:28,434.26,OnlineShopping,Etsy,570.7895853
8175,712046808,02-04-24 16:28,118.68,Return,eBay Return,689.4695853
8176,712046808,02-04-24 21:28,1800,IncomingTransfer,Salary,2489.469585
8177,712046808,02-04-24 22:28,168.36,OnlineShopping,Amazon,2321.109585
8178,712046808,02-06-24 9:28,210.28,IncomingTransfer,Freelance Payment,2531.389585
8179,712046808,02-07-24 12:28,267.01,Payment,Loan Payment,2264.379585
8180,712046808,02-09-24 21:28,1800,Payment,Credit Card Payment,464.3795853
8181,712046808,02-12-24 20:28,247.79,Withdrawal,Mobile App Withdrawal,216.5895853
8182,712046808,02-12-24 21:28,1000,Payment,Rent Payment,-783.4104147
8183,712046808,2-28-24 17:28,418.86,OutgoingTransfer,Wire Transfer,-1202.270415
8184,712046808,2-28-24 18:28,380.01,Deposit,Check Deposit,-822.2604147
8185,712046808,03-01-24 15:28,227.58,OnlineShopping,Best Buy,-1049.840415
8186,712046808,03-01-24 21:28,1800,IncomingTransfer,Salary,750.1595853
8187,712046808,03-04-24 14:28,237.06,IncomingTransfer,Freelance Payment,987.2195853
8188,712046808,03-04-24 16:28,232.17,Purchase,Travel,755.0495853
8189,712046808,03-06-24 18:28,65.03,Payment,Bill Payment,690.0195853
8190,712046808,03-06-24 21:28,1800,Payment,Credit Card Payment,-1109.980415
8191,712046808,03-08-24 19:28,300.77,Purchase,Travel,-1410.750415
8192,712046808,03-09-24 11:28,462.6,Payment,Bill Payment,-1873.350415
8193,712046808,03-12-24 21:28,700,Payment,Rent Payment,-2573.350415
8194,712046808,3-16-24 12:28,364.75,OutgoingTransfer,Wire Transfer,-2938.100415
8195,712046808,3-20-24 19:28,487.29,OnlineShopping,Amazon,-3425.390415
8196,712046808,3-24-24 12:28,55.44,OutgoingTransfer,Bank Transfer,-3480.830415
8197,712046808,3-24-24 20:28,285.18,IncomingTransfer,Freelance Payment,-3195.650415
8198,712046808,3-25-24 21:28,456.69,OnlineShopping,Target,-3652.340415
8199,712046808,3-26-24 13:28,346.83,Payment,Bill Payment,-3999.170415
8200,712046808,3-26-24 16:28,427.19,Purchase,Entertainment,-4426.360415
8201,712046808,3-30-24 19:28,187.19,Deposit,Check Deposit,-4239.170415
8202,712046808,04-03-24 21:28,1800,IncomingTransfer,Salary,-2439.170415
8203,712046808,04-06-24 10:28,71.2,OnlineShopping,Best Buy,-2510.370415
8204,712046808,04-08-24 21:28,1700,Payment,Credit Card Payment,-4210.370415
8205,712046808,04-11-24 20:28,18.12,Deposit,Cash Deposit,-4192.250415
8206,712046808,4-13-24 21:28,900,Payment,Rent Payment,-5092.250415
8207,712046808,4-15-24 12:28,371.51,Withdrawal,ATM Withdrawal,-5463.760415
8208,712046808,4-15-24 14:28,403.02,Withdrawal,Branch Withdrawal,-5866.780415
8209,712046808,4-16-24 13:28,86.3,Withdrawal,Mobile App Withdrawal,-5953.080415
8210,712046808,4-18-24 14:28,351.59,Deposit,Check Deposit,-5601.490415
8211,712046808,4-21-24 21:28,359.93,Deposit,Direct Deposit,-5241.560415
8212,712046808,05-01-24 21:28,1800,IncomingTransfer,Salary,-3441.560415
8213,712046808,05-06-24 21:28,1900,Payment,Credit Card Payment,-5341.560415
8214,712046808,05-10-24 21:28,1100,Payment,Rent Payment,-6441.560415
8215,712046808,5-16-24 9:28,412.3,Deposit,Cash Deposit,-6029.260415
8216,712046808,5-22-24 15:28,99.02,Deposit,Check Deposit,-5930.240415
8217,712046808,5-26-24 16:28,111.87,Purchase,Restaurant,-6042.110415
8218,712046808,06-02-24 21:28,1800,IncomingTransfer,Salary,-4242.110415
8219,712046808,06-04-24 9:28,74.19,Deposit,Cash Deposit,-4167.920415
8220,712046808,06-07-24 21:28,2000,Payment,Credit Card Payment,-6167.920415
8221,712046808,06-11-24 21:28,600,Payment,Rent Payment,-6767.920415
8222,712046808,06-12-24 10:28,33.59,Deposit,Cash Deposit,-6734.330415
8223,712046808,06-12-24 19:28,113.8,Withdrawal,Branch Withdrawal,-6848.130415
8224,712046808,6-19-24 12:28,380.5,Deposit,Check Deposit,-6467.630415
8225,712046808,6-24-24 10:28,288.57,Purchase,Gas,-6756.200415
8226,712046808,6-25-24 22:28,412.7,OnlineShopping,Target,-7168.900415
8227,712046808,07-02-24 21:28,1800,IncomingTransfer,Salary,-5368.900415
8228,712046808,07-03-24 18:28,145.61,Purchase,Travel,-5514.510415
8229,712046808,07-04-24 10:28,138.75,Return,Target Return,-5375.760415
8230,712046808,07-07-24 20:28,74.67,Return,Store Return,-5301.090415
8231,712046808,07-07-24 21:28,1700,Payment,Credit Card Payment,-7001.090415
8232,712046808,7-15-24 21:28,500,Payment,Rent Payment,-7501.090415
8233,712046808,7-16-24 12:28,358.41,Purchase,Restaurant,-7859.500415
8234,712050933,1-20-24 10:28,162.23,Deposit,Cash Deposit,162.23
8235,712050933,1-22-24 21:28,735.36,Deposit,Mobile Deposit,897.59
8236,712050933,02-01-24 20:28,366.85,Purchase,Furniture,530.74
8237,712050933,02-03-24 11:28,492.44,OnlineShopping,eBay,38.3
8238,712050933,02-03-24 15:28,347.42,Withdrawal,ATM Withdrawal,-309.12
8239,712050933,02-03-24 16:28,494.68,IncomingTransfer,Freelance Payment,185.56
8240,712050933,02-05-24 21:28,6700,IncomingTransfer,Salary,6885.56
8241,712050933,02-08-24 14:28,357.14,Purchase,Pharmacy,6528.42
8242,712050933,02-10-24 11:28,447.07,Return,Best Buy Return,6975.49
8243,712050933,2-13-24 17:28,688.51,Purchase,Gas,6286.98
8244,712050933,2-17-24 19:28,690.73,Payment,Mortgage Payment,5596.25
8245,712050933,2-18-24 21:28,3000,Payment,Rent Payment,2596.25
8246,712050933,2-18-24 21:28,298.45,Return,Target Return,2894.7
8247,712050933,2-18-24 22:28,700.66,OnlineShopping,Amazon,2194.04
8248,712050933,2-25-24 11:28,157.82,OnlineShopping,Etsy,2036.22
8249,712050933,2-27-24 12:28,305.19,OutgoingTransfer,Wire Transfer,1731.03
8250,712050933,03-01-24 22:28,571.73,Return,Target Return,2302.76
8251,712050933,03-04-24 21:28,6700,IncomingTransfer,Salary,9002.76
8252,712050933,03-08-24 23:28,582.59,Purchase,Gas,8420.17
8253,712050933,3-16-24 10:28,409.4,Withdrawal,Branch Withdrawal,8010.77
8254,712050933,3-17-24 21:28,3100,Payment,Rent Payment,4910.77
8255,712050933,3-18-24 17:28,310.24,Purchase,Travel,4600.53
8256,712050933,3-27-24 23:28,510.63,Deposit,Direct Deposit,5111.16
8257,712050933,04-01-24 14:28,580.23,OnlineShopping,Best Buy,4530.93
8258,712050933,04-05-24 21:28,6700,IncomingTransfer,Salary,11230.93
8259,712050933,4-17-24 21:28,4000,Payment,Rent Payment,7230.93
8260,712050933,4-18-24 17:28,119.05,OutgoingTransfer,International Transfer,7111.88
8261,712050933,4-26-24 19:28,405.91,Return,Best Buy Return,7517.79
8262,712050933,4-27-24 20:28,138.08,Deposit,Mobile Deposit,7655.87
8263,712050933,05-02-24 15:28,387.57,Return,Store Return,8043.44
8264,712050933,05-04-24 10:28,209.57,Deposit,Check Deposit,8253.01
8265,712050933,05-04-24 21:28,6700,IncomingTransfer,Salary,14953.01
8266,712050933,05-12-24 17:28,614.24,Return,eBay Return,15567.25
8267,712050933,5-14-24 21:28,2900,Payment,Rent Payment,12667.25
8268,712050933,5-22-24 18:28,436.43,Withdrawal,ATM Withdrawal,12230.82
8269,712050933,5-31-24 18:28,619.04,Purchase,Furniture,11611.78
8270,712050933,06-04-24 21:28,6700,IncomingTransfer,Salary,18311.78
8271,712050933,06-10-24 19:28,454.76,OutgoingTransfer,International Transfer,17857.02
8272,712050933,06-12-24 18:28,356.22,Purchase,Electronics,17500.8
8273,712050933,6-13-24 23:28,171.94,Deposit,Mobile Deposit,17672.74
8274,712050933,6-13-24 23:28,212.12,Deposit,Cash Deposit,17884.86
8275,712050933,6-14-24 12:28,445.81,OutgoingTransfer,Bank Transfer,17439.05
8276,712050933,6-15-24 12:28,705.43,Return,eBay Return,18144.48
8277,712050933,6-15-24 21:28,4200,Payment,Rent Payment,13944.48
8278,712050933,6-18-24 16:28,571.49,Return,AliExpress Return,14515.97
8279,712050933,6-23-24 12:28,463.05,Withdrawal,ATM Withdrawal,14052.92
8280,712050933,6-28-24 14:28,527.17,Purchase,Travel,13525.75
8281,712050933,6-29-24 14:28,376.74,IncomingTransfer,Freelance Payment,13902.49
8282,712050933,07-02-24 21:28,6700,IncomingTransfer,Salary,20602.49
8283,712050933,07-12-24 22:28,400.05,OnlineShopping,Amazon,20202.44
8284,712050933,7-15-24 21:28,2200,Payment,Rent Payment,18002.44
8285,712050933,7-16-24 22:28,516.72,Return,Amazon Return,18519.16
8286,712050933,7-17-24 20:28,234.03,IncomingTransfer,Freelance Payment,18753.19
8287,712071708,02-04-24 17:28,149.94,OutgoingTransfer,Peer-to-Peer Transfer,736.734393
8288,712071708,02-04-24 21:28,3300,IncomingTransfer,Salary,4036.734393
8289,712071708,02-08-24 21:28,72.17,Purchase,Gas,3964.564393
8290,712071708,02-09-24 21:28,1700,Payment,Credit Card Payment,2264.564393
8291,712071708,02-10-24 19:28,99.25,IncomingTransfer,Freelance Payment,2363.814393
8292,712071708,02-11-24 21:28,1100,Payment,Installment Payment,1263.814393
8293,712071708,2-14-24 15:28,86.77,IncomingTransfer,Freelance Payment,1350.584393
8294,712071708,2-20-24 22:28,16.69,Purchase,Pharmacy,1333.894393
8295,712071708,03-04-24 21:28,3300,IncomingTransfer,Salary,4633.894393
8296,712071708,03-09-24 21:28,1600,Payment,Credit Card Payment,3033.894393
8297,712071708,03-12-24 9:28,142.6,IncomingTransfer,Freelance Payment,3176.494393
8298,712071708,3-18-24 21:28,1000,Payment,Subscription Payment,2176.494393
8299,712071708,3-18-24 21:28,233.25,Withdrawal,Mobile App Withdrawal,1943.244393
8300,712071708,3-27-24 11:28,249.62,Deposit,Cash Deposit,2192.864393
8301,712071708,3-27-24 18:28,111.01,Return,Amazon Return,2303.874393
8302,712071708,3-28-24 23:28,148.14,IncomingTransfer,Freelance Payment,2452.014393
8303,712071708,04-03-24 11:28,48.71,Purchase,Travel,2403.304393
8304,712071708,04-05-24 21:28,3300,IncomingTransfer,Salary,5703.304393
8305,712071708,04-10-24 10:28,82.33,OnlineShopping,eBay,5620.974393
8306,712071708,04-10-24 10:28,239.62,Purchase,Travel,5381.354393
8307,712071708,04-10-24 21:28,1500,Payment,Credit Card Payment,3881.354393
8308,712071708,04-11-24 19:28,189.59,Payment,Mortgage Payment,3691.764393
8309,712071708,4-15-24 21:28,900,Payment,Installment Payment,2791.764393
8310,712071708,4-23-24 15:28,10.35,Deposit,Mobile Deposit,2802.114393
8311,712071708,4-25-24 9:28,192.59,Deposit,Cash Deposit,2994.704393
8312,712071708,05-01-24 21:28,3300,IncomingTransfer,Salary,6294.704393
8313,712071708,05-05-24 21:28,83.96,Withdrawal,Branch Withdrawal,6210.744393
8314,712071708,05-06-24 14:28,166,Payment,Mortgage Payment,6044.744393
8315,712071708,05-06-24 21:28,1800,Payment,Credit Card Payment,4244.744393
8316,712071708,05-10-24 22:28,101.02,Purchase,Clothing,4143.724393
8317,712071708,5-13-24 16:28,31,OnlineShopping,AliExpress,4112.724393
8318,712071708,5-16-24 21:28,1200,Payment,Insurance Payment,2912.724393
8319,712071708,5-21-24 15:28,117.01,Deposit,Check Deposit,3029.734393
8320,712071708,5-21-24 19:28,16.95,OnlineShopping,Etsy,3012.784393
8321,712071708,5-28-24 17:28,221.68,Withdrawal,Mobile App Withdrawal,2791.104393
8322,712071708,06-04-24 21:28,3300,IncomingTransfer,Salary,6091.104393
8323,712071708,06-08-24 12:28,209.36,OutgoingTransfer,Peer-to-Peer Transfer,5881.744393
8324,712071708,06-09-24 21:28,1700,Payment,Credit Card Payment,4181.744393
8325,712071708,06-10-24 22:28,130.79,Purchase,Pharmacy,4050.954393
8326,712071708,06-11-24 13:28,145.28,Withdrawal,Mobile App Withdrawal,3905.674393
8327,712071708,06-12-24 11:28,94.59,Purchase,Restaurant,3811.084393
8328,712071708,6-15-24 21:28,900,Payment,Installment Payment,2911.084393
8329,712071708,6-18-24 14:28,222.9,Return,eBay Return,3133.984393
8330,712071708,6-18-24 14:28,130.94,Purchase,Furniture,3003.044393
8331,712071708,6-26-24 12:28,37.3,Return,Amazon Return,3040.344393
8332,712071708,07-03-24 21:28,3300,IncomingTransfer,Salary,6340.344393
8333,712071708,07-05-24 17:28,88.1,OnlineShopping,Walmart,6252.244393
8334,712071708,07-07-24 15:28,85.32,Deposit,Direct Deposit,6337.564393
8335,712071708,07-08-24 21:28,1500,Payment,Credit Card Payment,4837.564393
8336,712071708,7-14-24 22:28,116.31,Withdrawal,Branch Withdrawal,4721.254393
8337,712071708,7-15-24 9:28,15.59,Return,Best Buy Return,4736.844393
8338,712071708,7-16-24 19:28,234.63,Withdrawal,Mobile App Withdrawal,4502.214393
8339,712071708,7-16-24 21:28,1300,Payment,Subscription Payment,3202.214393
8340,712111608,1-22-24 16:28,62.78,Deposit,Direct Deposit,62.78
8341,712111608,1-24-24 20:28,56.54,Purchase,Electronics,6.24
8342,712111608,1-29-24 11:28,169.83,Deposit,Direct Deposit,176.07
8343,712111608,1-30-24 16:28,18.69,Deposit,Check Deposit,194.76
8344,712111608,02-01-24 16:28,121.3,Deposit,Cash Deposit,316.06
8345,712111608,02-02-24 17:28,127.63,Deposit,Mobile Deposit,443.69
8346,712111608,02-05-24 13:28,192.47,Withdrawal,Branch Withdrawal,251.22
8347,712111608,02-05-24 21:28,2050,IncomingTransfer,Salary,2301.22
8348,712111608,02-12-24 9:28,184.48,OnlineShopping,AliExpress,2116.74
8349,712111608,2-15-24 21:28,1100,Payment,Rent Payment,1016.74
8350,712111608,2-19-24 22:28,144.18,OnlineShopping,eBay,872.56
8351,712111608,2-20-24 19:28,244.12,Purchase,Home Improvement,628.44
8352,712111608,2-26-24 15:28,19.93,Deposit,Check Deposit,648.37
8353,712111608,2-29-24 13:28,229.63,Deposit,Cash Deposit,878
8354,712111608,03-02-24 21:28,2050,IncomingTransfer,Salary,2928
8355,712111608,03-04-24 10:28,13.42,Deposit,Check Deposit,2941.42
8356,712111608,03-08-24 11:28,78.7,Withdrawal,Mobile App Withdrawal,2862.72
8357,712111608,03-10-24 18:28,248.19,IncomingTransfer,Freelance Payment,3110.91
8358,712111608,3-13-24 17:28,210.23,Purchase,Furniture,2900.68
8359,712111608,3-13-24 21:28,87.33,Purchase,Gas,2813.35
8360,712111608,3-16-24 14:28,242.71,Withdrawal,ATM Withdrawal,2570.64
8361,712111608,3-17-24 12:28,185.66,Payment,Bill Payment,2384.98
8362,712111608,3-17-24 21:28,800,Payment,Rent Payment,1584.98
8363,712111608,3-19-24 16:28,176.38,Return,Etsy Return,1761.36
8364,712111608,3-21-24 11:28,207.68,OutgoingTransfer,Peer-to-Peer Transfer,1553.68
8365,712111608,3-22-24 17:28,135.74,OutgoingTransfer,Peer-to-Peer Transfer,1417.94
8366,712111608,3-24-24 16:28,25.94,Payment,Mortgage Payment,1392
8367,712111608,3-24-24 22:28,188.14,Purchase,Entertainment,1203.86
8368,712111608,04-01-24 10:28,174.91,Purchase,Travel,1028.95
8369,712111608,04-03-24 21:28,2050,IncomingTransfer,Salary,3078.95
8370,712111608,04-04-24 9:28,72.71,Purchase,Grocery,3006.24
8371,712111608,04-07-24 10:28,25.66,Deposit,Check Deposit,3031.9
8372,712111608,04-10-24 17:28,237.74,OutgoingTransfer,Wire Transfer,2794.16
8373,712111608,04-12-24 10:28,248.99,Purchase,Gas,2545.17
8374,712111608,4-13-24 15:28,79.94,Deposit,Direct Deposit,2625.11
8375,712111608,4-13-24 19:28,29.67,OnlineShopping,Best Buy,2595.44
8376,712111608,4-13-24 21:28,900,Payment,Rent Payment,1695.44
8377,712111608,4-18-24 22:28,30.25,OnlineShopping,Etsy,1665.19
8378,712111608,4-18-24 23:28,18.69,OutgoingTransfer,Peer-to-Peer Transfer,1646.5
8379,712111608,4-23-24 18:28,48.02,IncomingTransfer,Freelance Payment,1694.52
8380,712111608,4-24-24 12:28,70.75,Withdrawal,Branch Withdrawal,1623.77
8381,712111608,4-24-24 16:28,178.74,Deposit,Mobile Deposit,1802.51
8382,712111608,4-26-24 18:28,137.04,Return,Store Return,1939.55
8383,712111608,4-26-24 22:28,150.25,Payment,Bill Payment,1789.3
8384,712111608,4-27-24 11:28,46.38,Withdrawal,ATM Withdrawal,1742.92
8385,712111608,4-29-24 20:28,154.91,Deposit,Cash Deposit,1897.83
8386,712111608,05-02-24 21:28,2050,IncomingTransfer,Salary,3947.83
8387,712111608,05-04-24 18:28,141.26,Purchase,Clothing,3806.57
8388,712111608,05-08-24 14:28,19.49,Return,AliExpress Return,3826.06
8389,712111608,05-08-24 18:28,88.75,Purchase,Electronics,3737.31
8390,712111608,05-09-24 14:28,51.72,Withdrawal,Mobile App Withdrawal,3685.59
8391,712111608,5-13-24 15:28,124.18,Withdrawal,Mobile App Withdrawal,3561.41
8392,712111608,5-13-24 21:28,800,Payment,Rent Payment,2761.41
8393,712111608,5-17-24 11:28,65.97,Deposit,Mobile Deposit,2827.38
8394,712111608,5-21-24 22:28,30.97,Deposit,Cash Deposit,2858.35
8395,712111608,5-25-24 17:28,21.28,Return,eBay Return,2879.63
8396,712111608,06-01-24 21:28,164.9,Purchase,Home Improvement,2714.73
8397,712111608,06-01-24 22:28,101.35,OutgoingTransfer,Bank Transfer,2613.38
8398,712111608,06-02-24 21:28,2050,IncomingTransfer,Salary,4663.38
8399,712111608,06-04-24 16:28,12.47,IncomingTransfer,Freelance Payment,4675.85
8400,712111608,06-05-24 13:28,35.65,Purchase,Clothing,4640.2
8401,712111608,06-07-24 20:28,242.64,Withdrawal,Mobile App Withdrawal,4397.56
8402,712111608,06-09-24 21:28,80.17,Return,Etsy Return,4477.73
8403,712111608,6-15-24 21:28,1100,Payment,Rent Payment,3377.73
8404,712111608,6-18-24 9:28,110.55,Withdrawal,ATM Withdrawal,3267.18
8405,712111608,6-20-24 10:28,26.08,Deposit,Direct Deposit,3293.26
8406,712111608,6-22-24 12:28,206.17,Purchase,Furniture,3087.09
8407,712111608,6-22-24 17:28,90.66,Deposit,Mobile Deposit,3177.75
8408,712111608,6-26-24 21:28,32.35,Purchase,Pharmacy,3145.4
8409,712111608,6-26-24 22:28,81.84,OnlineShopping,Etsy,3063.56
8410,712111608,6-27-24 19:28,86.4,Purchase,Pharmacy,2977.16
8411,712111608,6-29-24 10:28,218.62,OutgoingTransfer,International Transfer,2758.54
8412,712111608,07-03-24 13:28,212.14,OutgoingTransfer,Bank Transfer,2546.4
8413,712111608,07-03-24 20:28,243.62,OnlineShopping,Target,2302.78
8414,712111608,07-04-24 19:28,50.8,OutgoingTransfer,International Transfer,2251.98
8415,712111608,07-05-24 21:28,2050,IncomingTransfer,Salary,4301.98
8416,712111608,07-06-24 13:28,168.68,OutgoingTransfer,Bank Transfer,4133.3
8417,712111608,07-08-24 19:28,202.85,Purchase,Pharmacy,3930.45
8418,712111608,07-10-24 11:28,146.76,Withdrawal,Mobile App Withdrawal,3783.69
8419,712111608,7-13-24 17:28,115,Payment,Mortgage Payment,3668.69
8420,712111608,7-14-24 16:28,216.9,Deposit,Check Deposit,3885.59
8421,712111608,7-15-24 9:28,202.99,Payment,Loan Payment,3682.6
8422,712111608,7-16-24 21:28,1200,Payment,Rent Payment,2482.6
8423,712111608,7-17-24 9:28,110.27,Deposit,Mobile Deposit,2592.87
8424,712117983,1-24-24 9:28,105.85,OutgoingTransfer,Peer-to-Peer Transfer,1048.661017
8425,712117983,02-04-24 21:28,9050,IncomingTransfer,Salary,10098.66102
8426,712117983,02-05-24 21:28,662.38,OnlineShopping,AliExpress,9436.281017
8427,712117983,02-07-24 11:28,378.78,Payment,Mortgage Payment,9057.501017
8428,712117983,02-09-24 21:28,2100,Payment,Credit Card Payment,6957.501017
8429,712117983,02-11-24 13:28,576.09,OutgoingTransfer,Wire Transfer,6381.411017
8430,712117983,2-15-24 17:28,394.9,Purchase,Furniture,5986.511017
8431,712117983,2-18-24 21:28,2500,Payment,Insurance Payment,3486.511017
8432,712117983,2-19-24 22:28,119.47,Deposit,Check Deposit,3605.981017
8433,712117983,2-19-24 22:28,261.7,Purchase,Travel,3344.281017
8434,712117983,2-21-24 14:28,623.52,OutgoingTransfer,Wire Transfer,2720.761017
8435,712117983,2-21-24 17:28,282.22,Purchase,Home Improvement,2438.541017
8436,712117983,2-24-24 19:28,697.5,Deposit,Direct Deposit,3136.041017
8437,712117983,2-27-24 15:28,123.35,Deposit,Cash Deposit,3259.391017
8438,712117983,2-28-24 19:28,507.52,Payment,Bill Payment,2751.871017
8439,712117983,03-02-24 11:28,273.4,Withdrawal,ATM Withdrawal,2478.471017
8440,712117983,03-05-24 17:28,433.24,Purchase,Grocery,2045.231017
8441,712117983,03-05-24 21:28,9050,IncomingTransfer,Salary,11095.23102
8442,712117983,03-10-24 21:28,1900,Payment,Credit Card Payment,9195.231017
8443,712117983,03-10-24 21:28,132.24,Withdrawal,Mobile App Withdrawal,9062.991017
8444,712117983,03-11-24 15:28,632.46,Deposit,Cash Deposit,9695.451017
8445,712117983,03-11-24 18:28,265.43,Payment,Mortgage Payment,9430.021017
8446,712117983,3-14-24 15:28,459.35,Deposit,Mobile Deposit,9889.371017
8447,712117983,3-15-24 20:28,171.02,Purchase,Clothing,9718.351017
8448,712117983,3-15-24 21:28,4000,Payment,Insurance Payment,5718.351017
8449,712117983,3-16-24 17:28,381.85,Withdrawal,Branch Withdrawal,5336.501017
8450,712117983,3-17-24 19:28,122.32,Payment,Mortgage Payment,5214.181017
8451,712117983,3-23-24 21:28,503.17,Purchase,Gas,4711.011017
8452,712117983,3-24-24 12:28,145.66,Deposit,Cash Deposit,4856.671017
8453,712117983,3-24-24 22:28,625.95,Payment,Bill Payment,4230.721017
8454,712117983,3-25-24 12:28,655.15,Return,Walmart Return,4885.871017
8455,712117983,3-31-24 10:28,367.66,Payment,Loan Payment,4518.211017
8456,712117983,04-03-24 21:28,9050,IncomingTransfer,Salary,13568.21102
8457,712117983,04-08-24 21:28,2100,Payment,Credit Card Payment,11468.21102
8458,712117983,04-11-24 18:28,291.07,OutgoingTransfer,Bank Transfer,11177.14102
8459,712117983,04-11-24 21:28,4100,Payment,Insurance Payment,7077.141017
8460,712117983,4-14-24 11:28,248.17,Purchase,Home Improvement,6828.971017
8461,712117983,4-14-24 15:28,444.21,OnlineShopping,Etsy,6384.761017
8462,712117983,4-27-24 14:28,307.37,Deposit,Check Deposit,6692.131017
8463,712117983,4-28-24 13:28,427.65,OnlineShopping,Etsy,6264.481017
8464,712117983,4-28-24 16:28,726.04,Deposit,Mobile Deposit,6990.521017
8465,712117983,05-04-24 21:28,9050,IncomingTransfer,Salary,16040.52102
8466,712117983,05-06-24 17:28,738.3,Withdrawal,Mobile App Withdrawal,15302.22102
8467,712117983,05-07-24 23:28,522.24,Deposit,Cash Deposit,15824.46102
8468,712117983,05-08-24 21:28,173.72,Payment,Loan Payment,15650.74102
8469,712117983,05-09-24 21:28,2400,Payment,Credit Card Payment,13250.74102
8470,712117983,05-11-24 15:28,619.77,Return,Etsy Return,13870.51102
8471,712117983,5-13-24 14:28,181.82,Purchase,Grocery,13688.69102
8472,712117983,5-14-24 9:28,719.72,Deposit,Direct Deposit,14408.41102
8473,712117983,5-17-24 9:28,424.16,Purchase,Entertainment,13984.25102
8474,712117983,5-18-24 21:28,2700,Payment,Subscription Payment,11284.25102
8475,712117983,5-20-24 20:28,205.94,IncomingTransfer,Freelance Payment,11490.19102
8476,712117983,5-23-24 23:28,441.35,Withdrawal,Branch Withdrawal,11048.84102
8477,712117983,5-24-24 18:28,550.79,OutgoingTransfer,Peer-to-Peer Transfer,10498.05102
8478,712117983,5-30-24 17:28,383.58,Payment,Loan Payment,10114.47102
8479,712117983,5-31-24 22:28,269.64,OnlineShopping,Amazon,9844.831017
8480,712117983,06-01-24 17:28,600.73,Withdrawal,Branch Withdrawal,9244.101017
8481,712117983,06-04-24 21:28,9050,IncomingTransfer,Salary,18294.10102
8482,712117983,06-05-24 19:28,573.53,Deposit,Mobile Deposit,18867.63102
8483,712117983,06-06-24 22:28,580.45,Purchase,Pharmacy,18287.18102
8484,712117983,06-09-24 17:28,337.35,Deposit,Direct Deposit,18624.53102
8485,712117983,06-09-24 21:28,2400,Payment,Credit Card Payment,16224.53102
8486,712117983,6-13-24 19:28,429.56,OnlineShopping,Target,15794.97102
8487,712117983,6-13-24 20:28,409.56,Return,Best Buy Return,16204.53102
8488,712117983,6-17-24 20:28,266.23,Withdrawal,Mobile App Withdrawal,15938.30102
8489,712117983,6-17-24 21:28,3900,Payment,Insurance Payment,12038.30102
8490,712117983,6-17-24 21:28,632.61,Purchase,Furniture,11405.69102
8491,712117983,6-19-24 20:28,233.28,Payment,Bill Payment,11172.41102
8492,712117983,6-22-24 15:28,608.44,Purchase,Pharmacy,10563.97102
8493,712117983,6-22-24 15:28,673.19,Purchase,Entertainment,9890.781017
8494,712117983,6-27-24 17:28,452.93,Withdrawal,Mobile App Withdrawal,9437.851017
8495,712117983,07-01-24 17:28,440.64,Withdrawal,Branch Withdrawal,8997.211017
8496,712117983,07-02-24 19:28,253.06,OutgoingTransfer,Peer-to-Peer Transfer,8744.151017
8497,712117983,07-05-24 21:28,9050,IncomingTransfer,Salary,17794.15102
8498,712117983,07-10-24 21:28,2300,Payment,Credit Card Payment,15494.15102
8499,712117983,07-11-24 21:28,3900,Payment,Insurance Payment,11594.15102
8500,712117983,7-14-24 17:28,225.26,OnlineShopping,Best Buy,11368.89102
8501,712117983,7-15-24 22:28,613.88,OnlineShopping,Walmart,10755.01102
8502,712146558,1-28-24 17:28,121.26,Withdrawal,Mobile App Withdrawal,879.6685825
8503,712146558,1-29-24 23:28,230.5,Payment,Bill Payment,649.1685825
8504,712146558,02-01-24 9:28,17.75,Payment,Mortgage Payment,631.4185825
8505,712146558,02-02-24 17:28,217.33,Deposit,Mobile Deposit,848.7485825
8506,712146558,02-03-24 12:28,16.53,Withdrawal,Mobile App Withdrawal,832.2185825
8507,712146558,02-05-24 21:28,2950,IncomingTransfer,Salary,3782.218583
8508,712146558,02-08-24 13:28,248.13,Return,Etsy Return,4030.348583
8509,712146558,02-08-24 18:28,156.43,Purchase,Home Improvement,3873.918583
8510,712146558,02-10-24 15:28,95.83,Deposit,Cash Deposit,3969.748583
8511,712146558,02-10-24 21:28,2400,Payment,Credit Card Payment,1569.748583
8512,712146558,2-15-24 21:28,900,Payment,Installment Payment,669.7485825
8513,712146558,2-20-24 9:28,205.2,Deposit,Cash Deposit,874.9485825
8514,712146558,2-21-24 12:28,185.36,Deposit,Cash Deposit,1060.308583
8515,712146558,2-23-24 10:28,100.98,OutgoingTransfer,Bank Transfer,959.3285825
8516,712146558,2-24-24 10:28,156.11,Purchase,Furniture,803.2185825
8517,712146558,2-24-24 16:28,107.67,Purchase,Electronics,695.5485825
8518,712146558,2-24-24 18:28,229.2,Payment,Mortgage Payment,466.3485825
8519,712146558,2-26-24 14:28,185.29,IncomingTransfer,Freelance Payment,651.6385825
8520,712146558,03-04-24 22:28,62.94,OutgoingTransfer,International Transfer,588.6985825
8521,712146558,03-05-24 21:28,2950,IncomingTransfer,Salary,3538.698583
8522,712146558,03-08-24 15:28,109.4,OutgoingTransfer,International Transfer,3429.298583
8523,712146558,03-09-24 13:28,23.22,Purchase,Electronics,3406.078583
8524,712146558,03-10-24 21:28,2100,Payment,Credit Card Payment,1306.078583
8525,712146558,3-13-24 12:28,37.9,Withdrawal,Branch Withdrawal,1268.178583
8526,712146558,3-14-24 13:28,25.63,Deposit,Cash Deposit,1293.808583
8527,712146558,3-16-24 18:28,169.52,Deposit,Mobile Deposit,1463.328583
8528,712146558,3-16-24 19:28,226.56,OutgoingTransfer,Bank Transfer,1236.768583
8529,712146558,3-16-24 21:28,231.5,OutgoingTransfer,Peer-to-Peer Transfer,1005.268583
8530,712146558,3-16-24 22:28,47.75,Deposit,Mobile Deposit,1053.018583
8531,712146558,3-17-24 14:28,127.99,Deposit,Cash Deposit,1181.008583
8532,712146558,3-18-24 21:28,1300,Payment,Insurance Payment,-118.9914175
8533,712146558,3-19-24 21:28,142.65,OutgoingTransfer,Wire Transfer,-261.6414175
8534,712146558,3-26-24 17:28,24.02,Return,eBay Return,-237.6214175
8535,712146558,3-27-24 10:28,163.38,OnlineShopping,Amazon,-401.0014175
8536,712146558,3-30-24 11:28,35.35,OutgoingTransfer,Wire Transfer,-436.3514175
8537,712146558,3-31-24 12:28,93.09,OutgoingTransfer,International Transfer,-529.4414175
8538,712146558,3-31-24 14:28,133.09,Purchase,Pharmacy,-662.5314175
8539,712146558,04-01-24 21:28,2950,IncomingTransfer,Salary,2287.468583
8540,712146558,04-03-24 16:28,47.32,Deposit,Check Deposit,2334.788583
8541,712146558,04-06-24 21:28,2100,Payment,Credit Card Payment,234.7885825
8542,712146558,04-07-24 11:28,57.33,OnlineShopping,Best Buy,177.4585825
8543,712146558,04-07-24 21:28,165.77,Purchase,Restaurant,11.68858252
8544,712146558,4-14-24 10:28,51.8,Withdrawal,Branch Withdrawal,-40.11141748
8545,712146558,4-16-24 21:28,900,Payment,Subscription Payment,-940.1114175
8546,712146558,4-26-24 21:28,27.73,Return,Etsy Return,-912.3814175
8547,712146558,05-02-24 21:28,2950,IncomingTransfer,Salary,2037.618583
8548,712146558,05-03-24 18:28,241.14,Withdrawal,Branch Withdrawal,1796.478583
8549,712146558,05-06-24 13:28,74.93,Purchase,Electronics,1721.548583
8550,712146558,05-07-24 21:28,1800,Payment,Credit Card Payment,-78.45141748
8551,712146558,05-10-24 20:28,174.13,Return,Store Return,95.67858252
8552,712146558,5-14-24 18:28,105.96,Purchase,Restaurant,-10.28141748
8553,712146558,5-15-24 16:28,249.9,Withdrawal,ATM Withdrawal,-260.1814175
8554,712146558,5-15-24 17:28,80.16,OnlineShopping,AliExpress,-340.3414175
8555,712146558,5-15-24 23:28,14.72,OnlineShopping,Target,-355.0614175
8556,712146558,5-17-24 21:28,1200,Payment,Subscription Payment,-1555.061417
8557,712146558,5-26-24 22:28,138.64,Purchase,Gas,-1693.701417
8558,712146558,5-27-24 13:28,170.8,Withdrawal,Mobile App Withdrawal,-1864.501417
8559,712146558,5-27-24 15:28,166.36,Purchase,Clothing,-2030.861417
8560,712146558,06-02-24 21:28,2950,IncomingTransfer,Salary,919.1385825
8561,712146558,06-06-24 16:28,46.37,Purchase,Pharmacy,872.7685825
8562,712146558,06-07-24 21:28,1900,Payment,Credit Card Payment,-1027.231417
8563,712146558,6-14-24 21:28,800,Payment,Insurance Payment,-1827.231417
8564,712146558,6-15-24 19:28,225.91,Payment,Bill Payment,-2053.141417
8565,712146558,6-17-24 22:28,111,OnlineShopping,eBay,-2164.141417
8566,712146558,6-19-24 17:28,225.68,Withdrawal,ATM Withdrawal,-2389.821417
8567,712146558,6-20-24 12:28,146.81,Purchase,Home Improvement,-2536.631417
8568,712146558,6-20-24 13:28,84.26,Deposit,Check Deposit,-2452.371417
8569,712146558,6-20-24 19:28,116.25,Deposit,Direct Deposit,-2336.121417
8570,712146558,6-21-24 15:28,175.03,OutgoingTransfer,Peer-to-Peer Transfer,-2511.151417
8571,712146558,6-22-24 22:28,151.83,Deposit,Check Deposit,-2359.321417
8572,712146558,6-24-24 14:28,48.31,OnlineShopping,Etsy,-2407.631417
8573,712146558,6-24-24 22:28,34.69,OnlineShopping,Amazon,-2442.321417
8574,712146558,6-25-24 19:28,130.8,Payment,Bill Payment,-2573.121417
8575,712146558,6-27-24 17:28,169.09,Deposit,Check Deposit,-2404.031417
8576,712146558,07-02-24 10:28,84.48,Purchase,Pharmacy,-2488.511417
8577,712146558,07-04-24 21:28,2950,IncomingTransfer,Salary,461.4885825
8578,712146558,07-05-24 15:28,112.47,Deposit,Mobile Deposit,573.9585825
8579,712146558,07-07-24 12:28,208.53,Withdrawal,Mobile App Withdrawal,365.4285825
8580,712146558,07-07-24 20:28,208.27,Deposit,Check Deposit,573.6985825
8581,712146558,07-07-24 21:28,90.02,Payment,Bill Payment,483.6785825
8582,712146558,07-09-24 21:28,1700,Payment,Credit Card Payment,-1216.321417
8583,712146558,07-12-24 23:28,212.49,Payment,Loan Payment,-1428.811417
8584,712146558,7-18-24 21:28,800,Payment,Installment Payment,-2228.811417
8585,712159083,1-26-24 20:28,30.52,Purchase,Furniture,-30.52
8586,712159083,02-04-24 21:28,2750,IncomingTransfer,Salary,2719.48
8587,712159083,02-10-24 14:28,200.68,Withdrawal,Mobile App Withdrawal,2518.8
8588,712159083,2-14-24 21:28,1800,Payment,Rent Payment,718.8
8589,712159083,2-19-24 10:28,25.93,Return,Target Return,744.73
8590,712159083,2-23-24 23:28,83.59,OnlineShopping,Etsy,661.14
8591,712159083,2-26-24 15:28,13.65,Payment,Loan Payment,647.49
8592,712159083,2-27-24 22:28,62.37,Withdrawal,Branch Withdrawal,585.12
8593,712159083,03-04-24 21:28,2750,IncomingTransfer,Salary,3335.12
8594,712159083,3-15-24 15:28,214.11,OutgoingTransfer,Peer-to-Peer Transfer,3121.01
8595,712159083,3-16-24 21:28,1100,Payment,Rent Payment,2021.01
8596,712159083,3-19-24 15:28,109.12,Return,AliExpress Return,2130.13
8597,712159083,3-23-24 19:28,164.1,OnlineShopping,Walmart,1966.03
8598,712159083,3-29-24 20:28,244.88,IncomingTransfer,Freelance Payment,2210.91
8599,712159083,04-01-24 21:28,2750,IncomingTransfer,Salary,4960.91
8600,712159083,04-02-24 12:28,87.84,OutgoingTransfer,Wire Transfer,4873.07
8601,712159083,04-09-24 23:28,115.1,Payment,Loan Payment,4757.97
8602,712159083,04-10-24 19:28,181.52,Payment,Mortgage Payment,4576.45
8603,712159083,04-10-24 21:28,1200,Payment,Rent Payment,3376.45
8604,712159083,4-13-24 21:28,89.55,Withdrawal,Branch Withdrawal,3286.9
8605,712159083,4-14-24 10:28,146.03,Return,eBay Return,3432.93
8606,712159083,4-18-24 15:28,111.51,Purchase,Gas,3321.42
8607,712159083,4-21-24 15:28,54.82,Deposit,Check Deposit,3376.24
8608,712159083,4-21-24 16:28,126.58,Payment,Loan Payment,3249.66
8609,712159083,4-27-24 18:28,96.28,Withdrawal,Branch Withdrawal,3153.38
8610,712159083,05-03-24 21:28,2750,IncomingTransfer,Salary,5903.38
8611,712159083,05-07-24 15:28,152.12,Payment,Mortgage Payment,5751.26
8612,712159083,05-07-24 21:28,154.99,Purchase,Restaurant,5596.27
8613,712159083,05-12-24 21:28,800,Payment,Rent Payment,4796.27
8614,712159083,5-16-24 17:28,21.71,Purchase,Home Improvement,4774.56
8615,712159083,5-20-24 10:28,184.11,OutgoingTransfer,International Transfer,4590.45
8616,712159083,5-28-24 13:28,226.04,Withdrawal,Mobile App Withdrawal,4364.41
8617,712159083,5-28-24 15:28,248.06,Deposit,Mobile Deposit,4612.47
8618,712159083,06-01-24 21:28,2750,IncomingTransfer,Salary,7362.47
8619,712159083,06-05-24 16:28,172.32,Deposit,Check Deposit,7534.79
8620,712159083,06-10-24 21:28,800,Payment,Rent Payment,6734.79
8621,712159083,6-15-24 20:28,163.7,Payment,Loan Payment,6571.09
8622,712159083,6-17-24 14:28,205.24,OutgoingTransfer,International Transfer,6365.85
8623,712159083,6-20-24 17:28,32.26,OutgoingTransfer,International Transfer,6333.59
8624,712159083,6-22-24 10:28,95.94,IncomingTransfer,Freelance Payment,6429.53
8625,712159083,6-26-24 13:28,203.25,OutgoingTransfer,International Transfer,6226.28
8626,712159083,6-29-24 12:28,161.6,Payment,Loan Payment,6064.68
8627,712159083,07-03-24 18:28,139.03,Deposit,Check Deposit,6203.71
8628,712159083,07-03-24 20:28,119.84,Payment,Loan Payment,6083.87
8629,712159083,07-03-24 21:28,2750,IncomingTransfer,Salary,8833.87
8630,712159083,7-16-24 22:28,154.64,Return,eBay Return,8988.51
8631,712159083,7-18-24 21:28,700,Payment,Rent Payment,8288.51
8632,712171158,1-20-24 18:28,40.26,Purchase,Electronics,-40.26
8633,712171158,1-21-24 10:28,207.77,Return,Amazon Return,167.51
8634,712171158,1-22-24 14:28,67.86,IncomingTransfer,Freelance Payment,235.37
8635,712171158,1-25-24 14:28,49.37,Withdrawal,Mobile App Withdrawal,186
8636,712171158,1-27-24 10:28,129.33,Return,Amazon Return,315.33
8637,712171158,1-28-24 10:28,223.04,Withdrawal,Branch Withdrawal,92.29
8638,712171158,1-28-24 14:28,169.04,Deposit,Mobile Deposit,261.33
8639,712171158,02-04-24 21:28,2500,IncomingTransfer,Salary,2761.33
8640,712171158,02-12-24 10:28,34.45,OutgoingTransfer,Bank Transfer,2726.88
8641,712171158,02-12-24 17:28,236.76,Return,Etsy Return,2963.64
8642,712171158,2-15-24 21:28,1200,Payment,Rent Payment,1763.64
8643,712171158,2-17-24 14:28,53.15,Purchase,Electronics,1710.49
8644,712171158,2-17-24 20:28,242.62,OnlineShopping,Best Buy,1467.87
8645,712171158,2-19-24 18:28,175.7,Purchase,Grocery,1292.17
8646,712171158,2-20-24 14:28,148.16,OnlineShopping,eBay,1144.01
8647,712171158,2-24-24 14:28,20.13,Return,AliExpress Return,1164.14
8648,712171158,2-26-24 12:28,82.7,Return,AliExpress Return,1246.84
8649,712171158,2-29-24 14:28,159.98,Deposit,Cash Deposit,1406.82
8650,712171158,03-01-24 10:28,172.27,OnlineShopping,Amazon,1234.55
8651,712171158,03-01-24 21:28,212.37,OnlineShopping,AliExpress,1022.18
8652,712171158,03-03-24 21:28,2500,IncomingTransfer,Salary,3522.18
8653,712171158,03-05-24 13:28,19,IncomingTransfer,Freelance Payment,3541.18
8654,712171158,03-11-24 17:28,87.47,OnlineShopping,Etsy,3453.71
8655,712171158,03-12-24 22:28,156.79,IncomingTransfer,Freelance Payment,3610.5
8656,712171158,3-13-24 15:28,95.07,Return,Store Return,3705.57
8657,712171158,3-14-24 15:28,243.43,OnlineShopping,Amazon,3462.14
8658,712171158,3-15-24 21:28,800,Payment,Rent Payment,2662.14
8659,712171158,3-16-24 20:28,143.92,Purchase,Travel,2518.22
8660,712171158,3-17-24 20:28,18.41,Purchase,Grocery,2499.81
8661,712171158,3-22-24 19:28,205.63,Purchase,Furniture,2294.18
8662,712171158,3-23-24 16:28,86.25,Purchase,Home Improvement,2207.93
8663,712171158,3-23-24 18:28,23.52,OnlineShopping,eBay,2184.41
8664,712171158,3-25-24 10:28,148.83,Return,Store Return,2333.24
8665,712171158,3-27-24 9:28,72.67,Deposit,Check Deposit,2405.91
8666,712171158,3-30-24 18:28,39.08,Payment,Mortgage Payment,2366.83
8667,712171158,04-01-24 21:28,2500,IncomingTransfer,Salary,4866.83
8668,712171158,04-05-24 21:28,142.4,Payment,Mortgage Payment,4724.43
8669,712171158,04-07-24 15:28,23.15,OnlineShopping,AliExpress,4701.28
8670,712171158,04-08-24 11:28,159.9,Purchase,Clothing,4541.38
8671,712171158,04-11-24 23:28,29.96,Purchase,Pharmacy,4511.42
8672,712171158,4-13-24 17:28,13.66,Deposit,Cash Deposit,4525.08
8673,712171158,4-14-24 21:28,900,Payment,Rent Payment,3625.08
8674,712171158,4-19-24 14:28,32.63,Purchase,Grocery,3592.45
8675,712171158,4-24-24 19:28,203.23,Withdrawal,Mobile App Withdrawal,3389.22
8676,712171158,4-28-24 11:28,225.38,Deposit,Mobile Deposit,3614.6
8677,712171158,05-01-24 21:28,2500,IncomingTransfer,Salary,6114.6
8678,712171158,05-04-24 11:28,199.68,Payment,Loan Payment,5914.92
8679,712171158,05-06-24 10:28,199.88,OnlineShopping,AliExpress,5715.04
8680,712171158,05-10-24 9:28,219.55,Purchase,Travel,5495.49
8681,712171158,05-10-24 18:28,147.52,Deposit,Check Deposit,5643.01
8682,712171158,05-11-24 18:28,201.08,Deposit,Cash Deposit,5844.09
8683,712171158,05-12-24 12:28,209.6,Payment,Loan Payment,5634.49
8684,712171158,05-12-24 21:28,1200,Payment,Rent Payment,4434.49
8685,712171158,5-13-24 17:28,83.55,Purchase,Travel,4350.94
8686,712171158,5-13-24 22:28,217.38,OnlineShopping,Target,4133.56
8687,712171158,5-14-24 22:28,106.79,OnlineShopping,AliExpress,4026.77
8688,712171158,5-21-24 19:28,186.56,Deposit,Direct Deposit,4213.33
8689,712171158,5-23-24 23:28,138,Purchase,Furniture,4075.33
8690,712171158,5-24-24 14:28,192.33,Payment,Loan Payment,3883
8691,712171158,5-24-24 16:28,27.91,Deposit,Cash Deposit,3910.91
8692,712171158,5-24-24 23:28,167.98,Return,Etsy Return,4078.89
8693,712171158,5-25-24 11:28,240.71,OutgoingTransfer,Peer-to-Peer Transfer,3838.18
8694,712171158,06-03-24 21:28,2500,IncomingTransfer,Salary,6338.18
8695,712171158,06-04-24 15:28,190.98,Deposit,Cash Deposit,6529.16
8696,712171158,06-06-24 14:28,59.96,Withdrawal,ATM Withdrawal,6469.2
8697,712171158,06-07-24 22:28,152.69,IncomingTransfer,Freelance Payment,6621.89
8698,712171158,06-12-24 16:28,54.34,IncomingTransfer,Freelance Payment,6676.23
8699,712171158,6-14-24 11:28,177.88,Purchase,Entertainment,6498.35
8700,712171158,6-14-24 21:28,900,Payment,Rent Payment,5598.35
8701,712171158,6-15-24 12:28,30.84,OnlineShopping,AliExpress,5567.51
8702,712171158,6-16-24 17:28,210.09,Payment,Mortgage Payment,5357.42
8703,712171158,6-18-24 15:28,223.07,Purchase,Grocery,5134.35
8704,712171158,6-18-24 17:28,16.67,Payment,Mortgage Payment,5117.68
8705,712171158,6-20-24 14:28,14.98,IncomingTransfer,Freelance Payment,5132.66
8706,712171158,6-20-24 21:28,133.67,Withdrawal,ATM Withdrawal,4998.99
8707,712171158,6-24-24 9:28,230.73,IncomingTransfer,Freelance Payment,5229.72
8708,712171158,6-25-24 13:28,208.88,Payment,Bill Payment,5020.84
8709,712171158,6-26-24 18:28,168.46,OutgoingTransfer,Wire Transfer,4852.38
8710,712171158,6-27-24 10:28,12.16,Withdrawal,ATM Withdrawal,4840.22
8711,712171158,6-27-24 23:28,249,OnlineShopping,Best Buy,4591.22
8712,712171158,6-28-24 11:28,136.25,Payment,Mortgage Payment,4454.97
8713,712171158,6-29-24 21:28,25.39,Payment,Mortgage Payment,4429.58
8714,712171158,07-05-24 21:28,2500,IncomingTransfer,Salary,6929.58
8715,712171158,07-06-24 18:28,130.54,Purchase,Entertainment,6799.04
8716,712171158,07-08-24 15:28,235.93,Return,Store Return,7034.97
8717,712171158,07-10-24 11:28,104.12,Purchase,Electronics,6930.85
8718,712171158,07-12-24 13:28,112.74,Payment,Loan Payment,6818.11
8719,712171158,07-12-24 15:28,183.15,Withdrawal,Mobile App Withdrawal,6634.96
8720,712171158,07-12-24 21:28,1600,Payment,Rent Payment,5034.96
8721,712171158,7-14-24 20:28,234.34,Deposit,Check Deposit,5269.3
8722,712171158,7-16-24 18:28,52.14,Withdrawal,Branch Withdrawal,5217.16
8723,712198983,1-23-24 20:28,240.87,OnlineShopping,AliExpress,-240.87
8724,712198983,02-01-24 10:28,254.75,Purchase,Entertainment,-495.62
8725,712198983,02-02-24 21:28,6600,IncomingTransfer,Salary,6104.38
8726,712198983,02-03-24 19:28,445.29,Payment,Mortgage Payment,5659.09
8727,712198983,02-06-24 10:28,91.27,IncomingTransfer,Freelance Payment,5750.36
8728,712198983,02-08-24 12:28,257.27,IncomingTransfer,Freelance Payment,6007.63
8729,712198983,02-11-24 21:28,2700,Payment,Rent Payment,3307.63
8730,712198983,02-12-24 17:28,363.68,OnlineShopping,Walmart,2943.95
8731,712198983,2-16-24 10:28,484.35,IncomingTransfer,Freelance Payment,3428.3
8732,712198983,2-21-24 12:28,311.23,Withdrawal,Branch Withdrawal,3117.07
8733,712198983,2-21-24 21:28,118.85,Payment,Loan Payment,2998.22
8734,712198983,2-23-24 9:28,231.8,IncomingTransfer,Freelance Payment,3230.02
8735,712198983,2-23-24 11:28,355.99,Withdrawal,Branch Withdrawal,2874.03
8736,712198983,2-23-24 16:28,80.39,OutgoingTransfer,International Transfer,2793.64
8737,712198983,2-29-24 12:28,543.12,IncomingTransfer,Freelance Payment,3336.76
8738,712198983,03-02-24 22:28,278.38,OnlineShopping,Walmart,3058.38
8739,712198983,03-03-24 14:28,497.02,Return,Target Return,3555.4
8740,712198983,03-05-24 21:28,6600,IncomingTransfer,Salary,10155.4
8741,712198983,03-08-24 9:28,143.09,Purchase,Restaurant,10012.31
8742,712198983,03-09-24 13:28,281.51,Purchase,Travel,9730.8
8743,712198983,3-14-24 21:28,3100,Payment,Rent Payment,6630.8
8744,712198983,3-20-24 19:28,392.67,Withdrawal,Mobile App Withdrawal,6238.13
8745,712198983,3-21-24 15:28,135.15,Deposit,Cash Deposit,6373.28
8746,712198983,3-22-24 11:28,331.61,Withdrawal,ATM Withdrawal,6041.67
8747,712198983,3-23-24 12:28,495.74,Payment,Bill Payment,5545.93
8748,712198983,3-28-24 9:28,209.32,Return,Etsy Return,5755.25
8749,712198983,04-02-24 21:28,6600,IncomingTransfer,Salary,12355.25
8750,712198983,04-08-24 17:28,203.26,Return,AliExpress Return,12558.51
8751,712198983,04-08-24 23:28,395.3,Deposit,Mobile Deposit,12953.81
8752,712198983,04-10-24 12:28,257.52,OnlineShopping,Amazon,12696.29
8753,712198983,04-11-24 12:28,150.49,Purchase,Electronics,12545.8
8754,712198983,4-16-24 13:28,454.36,OnlineShopping,eBay,12091.44
8755,712198983,4-16-24 22:28,465.28,Payment,Loan Payment,11626.16
8756,712198983,4-17-24 21:28,3900,Payment,Rent Payment,7726.16
8757,712198983,4-24-24 11:28,288.38,OutgoingTransfer,Bank Transfer,7437.78
8758,712198983,4-25-24 17:28,226.29,Payment,Loan Payment,7211.49
8759,712198983,05-03-24 21:28,6600,IncomingTransfer,Salary,13811.49
8760,712198983,05-06-24 18:28,188.45,Withdrawal,Mobile App Withdrawal,13623.04
8761,712198983,05-06-24 18:28,254.57,Deposit,Cash Deposit,13877.61
8762,712198983,05-06-24 18:28,242.9,Payment,Bill Payment,13634.71
8763,712198983,05-07-24 10:28,538.9,Withdrawal,ATM Withdrawal,13095.81
8764,712198983,05-08-24 23:28,307.76,Deposit,Check Deposit,13403.57
8765,712198983,05-10-24 18:28,383.56,Return,Walmart Return,13787.13
8766,712198983,05-12-24 11:28,214.44,Withdrawal,Branch Withdrawal,13572.69
8767,712198983,05-12-24 17:28,215.13,Withdrawal,ATM Withdrawal,13357.56
8768,712198983,05-12-24 21:28,4000,Payment,Rent Payment,9357.56
8769,712198983,5-15-24 19:28,529.62,Purchase,Grocery,8827.94
8770,712198983,5-17-24 13:28,503.49,Return,Walmart Return,9331.43
8771,712198983,5-22-24 22:28,472.78,Purchase,Clothing,8858.65
8772,712198983,5-23-24 22:28,104.4,IncomingTransfer,Freelance Payment,8963.05
8773,712198983,5-26-24 19:28,315.37,OnlineShopping,Target,8647.68
8774,712198983,5-29-24 11:28,310.14,IncomingTransfer,Freelance Payment,8957.82
8775,712198983,5-31-24 11:28,531.4,Withdrawal,ATM Withdrawal,8426.42
8776,712198983,06-02-24 12:28,376.18,Withdrawal,Mobile App Withdrawal,8050.24
8777,712198983,06-02-24 20:28,297.13,OnlineShopping,Etsy,7753.11
8778,712198983,06-04-24 21:28,6600,IncomingTransfer,Salary,14353.11
8779,712198983,06-11-24 13:28,145.7,Withdrawal,Mobile App Withdrawal,14207.41
8780,712198983,06-11-24 21:28,2800,Payment,Rent Payment,11407.41
8781,712198983,6-13-24 11:28,352.46,Payment,Loan Payment,11054.95
8782,712198983,6-13-24 22:28,277.99,Purchase,Restaurant,10776.96
8783,712198983,6-14-24 19:28,534.83,Purchase,Travel,10242.13
8784,712198983,6-15-24 10:28,62.06,Purchase,Entertainment,10180.07
8785,712198983,6-15-24 19:28,313.88,Deposit,Check Deposit,10493.95
8786,712198983,6-23-24 18:28,232.05,Deposit,Mobile Deposit,10726
8787,712198983,6-25-24 14:28,526.19,Deposit,Cash Deposit,11252.19
8788,712198983,6-26-24 20:28,113.48,IncomingTransfer,Freelance Payment,11365.67
8789,712198983,6-26-24 23:28,478.49,IncomingTransfer,Freelance Payment,11844.16
8790,712198983,6-28-24 18:28,466.48,Withdrawal,Branch Withdrawal,11377.68
8791,712198983,6-28-24 22:28,186.37,OutgoingTransfer,Wire Transfer,11191.31
8792,712198983,6-30-24 10:28,529.46,OnlineShopping,Etsy,10661.85
8793,712198983,07-01-24 14:28,546.83,Return,Store Return,11208.68
8794,712198983,07-01-24 16:28,369.65,Withdrawal,ATM Withdrawal,10839.03
8795,712198983,07-04-24 21:28,6600,IncomingTransfer,Salary,17439.03
8796,712198983,07-11-24 18:28,270,OnlineShopping,Amazon,17169.03
8797,712198983,07-11-24 21:28,136,IncomingTransfer,Freelance Payment,17305.03
8798,712198983,7-13-24 21:28,4200,Payment,Rent Payment,13105.03
8799,712198983,7-14-24 17:28,122.04,Return,Store Return,13227.07
8800,712198983,7-16-24 12:28,331.66,Return,Etsy Return,13558.73
8801,712198983,7-16-24 20:28,98.9,Purchase,Home Improvement,13459.83
8802,712242633,1-22-24 15:28,68.2,Purchase,Entertainment,1313.512141
8803,712242633,1-23-24 17:28,188.34,IncomingTransfer,Freelance Payment,1501.852141
8804,712242633,1-24-24 9:28,221.43,Withdrawal,Mobile App Withdrawal,1280.422141
8805,712242633,1-24-24 16:28,201.76,Withdrawal,Mobile App Withdrawal,1078.662141
8806,712242633,1-25-24 20:28,190.5,Deposit,Mobile Deposit,1269.162141
8807,712242633,1-26-24 13:28,123.43,Deposit,Check Deposit,1392.592141
8808,712242633,1-26-24 14:28,116.79,Purchase,Home Improvement,1275.802141
8809,712242633,1-26-24 17:28,59.03,OnlineShopping,Etsy,1216.772141
8810,712242633,1-29-24 19:28,120.87,Withdrawal,ATM Withdrawal,1095.902141
8811,712242633,1-30-24 21:28,34.18,Deposit,Cash Deposit,1130.082141
8812,712242633,02-02-24 19:28,144.02,Return,Etsy Return,1274.102141
8813,712242633,02-02-24 23:28,193.34,Return,Store Return,1467.442141
8814,712242633,02-03-24 21:28,3050,IncomingTransfer,Salary,4517.442141
8815,712242633,02-06-24 12:28,83.16,OnlineShopping,eBay,4434.282141
8816,712242633,02-07-24 14:28,79.2,Payment,Bill Payment,4355.082141
8817,712242633,02-08-24 21:28,3100,Payment,Credit Card Payment,1255.082141
8818,712242633,02-10-24 21:28,145.61,Deposit,Mobile Deposit,1400.692141
8819,712242633,2-13-24 10:28,201.67,Purchase,Electronics,1199.022141
8820,712242633,2-14-24 9:28,195.31,OnlineShopping,Amazon,1003.712141
8821,712242633,2-16-24 21:28,1100,Payment,Subscription Payment,-96.2878589
8822,712242633,2-19-24 16:28,148.8,Withdrawal,ATM Withdrawal,-245.0878589
8823,712242633,2-24-24 22:28,153.95,Return,Best Buy Return,-91.1378589
8824,712242633,2-28-24 17:28,206.26,Deposit,Cash Deposit,115.1221411
8825,712242633,03-02-24 21:28,3050,IncomingTransfer,Salary,3165.122141
8826,712242633,03-07-24 15:28,246.28,Deposit,Check Deposit,3411.402141
8827,712242633,03-07-24 21:28,3000,Payment,Credit Card Payment,411.4021411
8828,712242633,03-08-24 17:28,106.75,Payment,Loan Payment,304.6521411
8829,712242633,03-08-24 18:28,42.08,Purchase,Restaurant,262.5721411
8830,712242633,03-12-24 11:28,136.92,Deposit,Cash Deposit,399.4921411
8831,712242633,3-17-24 14:28,119.89,Deposit,Cash Deposit,519.3821411
8832,712242633,3-18-24 21:28,1300,Payment,Subscription Payment,-780.6178589
8833,712242633,3-20-24 22:28,90.41,Return,Target Return,-690.2078589
8834,712242633,3-27-24 16:28,230.2,Payment,Bill Payment,-920.4078589
8835,712242633,3-28-24 14:28,199.02,Withdrawal,Mobile App Withdrawal,-1119.427859
8836,712242633,3-29-24 17:28,85.32,Purchase,Home Improvement,-1204.747859
8837,712242633,04-01-24 10:28,37.97,Deposit,Mobile Deposit,-1166.777859
8838,712242633,04-02-24 9:28,33.01,Purchase,Travel,-1199.787859
8839,712242633,04-04-24 18:28,169.83,Purchase,Grocery,-1369.617859
8840,712242633,04-04-24 21:28,3050,IncomingTransfer,Salary,1680.382141
8841,712242633,04-05-24 15:28,107.86,Payment,Mortgage Payment,1572.522141
8842,712242633,04-09-24 21:28,2700,Payment,Credit Card Payment,-1127.477859
8843,712242633,04-09-24 21:28,163.06,Payment,Bill Payment,-1290.537859
8844,712242633,04-10-24 10:28,199.01,Return,Walmart Return,-1091.527859
8845,712242633,04-10-24 13:28,144.07,OutgoingTransfer,Bank Transfer,-1235.597859
8846,712242633,04-10-24 23:28,173.7,Deposit,Direct Deposit,-1061.897859
8847,712242633,4-13-24 13:28,164.8,Purchase,Entertainment,-1226.697859
8848,712242633,4-16-24 21:28,1100,Payment,Subscription Payment,-2326.697859
8849,712242633,4-18-24 11:28,142.03,OnlineShopping,Target,-2468.727859
8850,712242633,4-19-24 23:28,25.06,Purchase,Clothing,-2493.787859
8851,712242633,4-23-24 19:28,107.46,OnlineShopping,Best Buy,-2601.247859
8852,712242633,4-24-24 11:28,223.49,Withdrawal,Branch Withdrawal,-2824.737859
8853,712242633,4-25-24 22:28,232.88,Purchase,Entertainment,-3057.617859
8854,712242633,4-26-24 12:28,225.04,Deposit,Check Deposit,-2832.577859
8855,712242633,4-27-24 11:28,53.37,IncomingTransfer,Freelance Payment,-2779.207859
8856,712242633,4-28-24 10:28,225.53,Purchase,Electronics,-3004.737859
8857,712242633,05-02-24 21:28,104.58,Return,Target Return,-2900.157859
8858,712242633,05-04-24 21:28,3050,IncomingTransfer,Salary,149.8421411
8859,712242633,05-06-24 22:28,201.9,Purchase,Grocery,-52.0578589
8860,712242633,05-09-24 16:28,186.71,Purchase,Travel,-238.7678589
8861,712242633,05-09-24 21:28,2500,Payment,Credit Card Payment,-2738.767859
8862,712242633,5-13-24 9:28,81.67,Return,eBay Return,-2657.097859
8863,712242633,5-13-24 21:28,1200,Payment,Installment Payment,-3857.097859
8864,712242633,5-19-24 10:28,201.18,IncomingTransfer,Freelance Payment,-3655.917859
8865,712242633,5-19-24 22:28,39.58,Deposit,Check Deposit,-3616.337859
8866,712242633,5-21-24 17:28,181.08,IncomingTransfer,Freelance Payment,-3435.257859
8867,712242633,5-22-24 23:28,126.14,Payment,Mortgage Payment,-3561.397859
8868,712242633,5-25-24 14:28,231.23,Return,Store Return,-3330.167859
8869,712242633,5-29-24 14:28,25.86,Deposit,Check Deposit,-3304.307859
8870,712242633,5-30-24 17:28,102.41,Payment,Loan Payment,-3406.717859
8871,712242633,5-31-24 14:28,175.71,Deposit,Direct Deposit,-3231.007859
8872,712242633,06-01-24 21:28,3050,IncomingTransfer,Salary,-181.0078589
8873,712242633,06-06-24 21:28,2800,Payment,Credit Card Payment,-2981.007859
8874,712242633,06-08-24 11:28,155.48,OutgoingTransfer,International Transfer,-3136.487859
8875,712242633,06-10-24 22:28,24.46,IncomingTransfer,Freelance Payment,-3112.027859
8876,712242633,06-12-24 22:28,211.77,Payment,Mortgage Payment,-3323.797859
8877,712242633,6-13-24 11:28,85.16,Payment,Loan Payment,-3408.957859
8878,712242633,6-15-24 21:28,120.16,IncomingTransfer,Freelance Payment,-3288.797859
8879,712242633,6-18-24 17:28,41.49,Return,Store Return,-3247.307859
8880,712242633,6-18-24 21:28,800,Payment,Subscription Payment,-4047.307859
8881,712242633,6-21-24 19:28,136.14,Withdrawal,Branch Withdrawal,-4183.447859
8882,712242633,6-22-24 22:28,173.32,Deposit,Mobile Deposit,-4010.127859
8883,712242633,6-23-24 14:28,242.51,OutgoingTransfer,Bank Transfer,-4252.637859
8884,712242633,6-26-24 13:28,50.95,Withdrawal,Branch Withdrawal,-4303.587859
8885,712242633,6-29-24 12:28,235.66,Purchase,Home Improvement,-4539.247859
8886,712242633,6-30-24 17:28,210.59,Withdrawal,Branch Withdrawal,-4749.837859
8887,712242633,6-30-24 17:28,15.75,Payment,Bill Payment,-4765.587859
8888,712242633,07-01-24 16:28,220.81,Payment,Loan Payment,-4986.397859
8889,712242633,07-04-24 21:28,3050,IncomingTransfer,Salary,-1936.397859
8890,712242633,07-09-24 21:28,3100,Payment,Credit Card Payment,-5036.397859
8891,712242633,07-10-24 16:28,39.54,Withdrawal,Mobile App Withdrawal,-5075.937859
8892,712242633,07-12-24 11:28,31.38,Return,Best Buy Return,-5044.557859
8893,712242633,7-16-24 15:28,233.05,Payment,Mortgage Payment,-5277.607859
8894,712242633,7-16-24 20:28,152.25,OutgoingTransfer,Bank Transfer,-5429.857859
8895,712242633,7-16-24 21:28,1300,Payment,Subscription Payment,-6729.857859
8896,712332183,1-23-24 13:28,717.02,Deposit,Direct Deposit,1243.83008
8897,712332183,1-26-24 17:28,314.76,Purchase,Grocery,929.0700798
8898,712332183,1-27-24 22:28,663.3,Payment,Loan Payment,265.7700798
8899,712332183,1-28-24 20:28,177.82,Deposit,Cash Deposit,443.5900798
8900,712332183,1-30-24 12:28,584.51,OnlineShopping,Walmart,-140.9199202
8901,712332183,1-30-24 18:28,540.83,Payment,Loan Payment,-681.7499202
8902,712332183,02-04-24 19:28,490.42,Purchase,Furniture,-1172.16992
8903,712332183,02-05-24 21:28,6800,IncomingTransfer,Salary,5627.83008
8904,712332183,02-10-24 21:28,1300,Payment,Credit Card Payment,4327.83008
8905,712332183,02-12-24 14:28,245.73,Withdrawal,Branch Withdrawal,4082.10008
8906,712332183,2-14-24 19:28,282.96,Deposit,Mobile Deposit,4365.06008
8907,712332183,2-15-24 20:28,143.92,IncomingTransfer,Freelance Payment,4508.98008
8908,712332183,2-17-24 13:28,331,OnlineShopping,AliExpress,4177.98008
8909,712332183,2-18-24 20:28,207.25,Return,Target Return,4385.23008
8910,712332183,2-18-24 21:28,1800,Payment,Subscription Payment,2585.23008
8911,712332183,2-22-24 17:28,334.58,IncomingTransfer,Freelance Payment,2919.81008
8912,712332183,2-24-24 19:28,341.12,Deposit,Cash Deposit,3260.93008
8913,712332183,03-02-24 20:28,318.92,Withdrawal,Mobile App Withdrawal,2942.01008
8914,712332183,03-02-24 21:28,6800,IncomingTransfer,Salary,9742.01008
8915,712332183,03-05-24 17:28,473.8,Payment,Loan Payment,9268.21008
8916,712332183,03-06-24 14:28,696.69,OutgoingTransfer,Wire Transfer,8571.52008
8917,712332183,03-07-24 21:28,1100,Payment,Credit Card Payment,7471.52008
8918,712332183,03-08-24 15:28,277.4,OutgoingTransfer,International Transfer,7194.12008
8919,712332183,03-08-24 18:28,500.43,OutgoingTransfer,Peer-to-Peer Transfer,6693.69008
8920,712332183,03-10-24 21:28,2400,Payment,Installment Payment,4293.69008
8921,712332183,03-11-24 22:28,516.37,Purchase,Home Improvement,3777.32008
8922,712332183,03-12-24 23:28,463.5,Purchase,Pharmacy,3313.82008
8923,712332183,3-13-24 16:28,123.89,Purchase,Grocery,3189.93008
8924,712332183,3-20-24 23:28,251.7,OutgoingTransfer,Wire Transfer,2938.23008
8925,712332183,3-22-24 9:28,236.76,Purchase,Entertainment,2701.47008
8926,712332183,3-22-24 13:28,117.2,OnlineShopping,Walmart,2584.27008
8927,712332183,3-23-24 15:28,687.15,Purchase,Gas,1897.12008
8928,712332183,3-30-24 15:28,730.94,IncomingTransfer,Freelance Payment,2628.06008
8929,712332183,04-03-24 10:28,133.36,Purchase,Restaurant,2494.70008
8930,712332183,04-03-24 21:28,6800,IncomingTransfer,Salary,9294.70008
8931,712332183,04-04-24 14:28,663.39,Deposit,Cash Deposit,9958.09008
8932,712332183,04-04-24 21:28,681.77,Withdrawal,Mobile App Withdrawal,9276.32008
8933,712332183,04-08-24 9:28,708.76,Return,Walmart Return,9985.08008
8934,712332183,04-08-24 21:28,1300,Payment,Credit Card Payment,8685.08008
8935,712332183,04-09-24 20:28,559.64,Deposit,Cash Deposit,9244.72008
8936,712332183,04-09-24 22:28,320.16,Payment,Mortgage Payment,8924.56008
8937,712332183,4-14-24 21:28,2200,Payment,Insurance Payment,6724.56008
8938,712332183,4-19-24 9:28,618.98,Deposit,Check Deposit,7343.54008
8939,712332183,4-20-24 13:28,318.07,Withdrawal,Branch Withdrawal,7025.47008
8940,712332183,4-20-24 19:28,286.9,Deposit,Cash Deposit,7312.37008
8941,712332183,4-23-24 21:28,539.28,Purchase,Gas,6773.09008
8942,712332183,4-26-24 12:28,192.94,Deposit,Direct Deposit,6966.03008
8943,712332183,4-27-24 15:28,473.39,Payment,Bill Payment,6492.64008
8944,712332183,4-28-24 13:28,115.06,IncomingTransfer,Freelance Payment,6607.70008
8945,712332183,4-29-24 15:28,109.25,Deposit,Mobile Deposit,6716.95008
8946,712332183,4-30-24 18:28,591.87,Purchase,Grocery,6125.08008
8947,712332183,4-30-24 20:28,300.88,IncomingTransfer,Freelance Payment,6425.96008
8948,712332183,05-01-24 14:28,560.48,Return,Walmart Return,6986.44008
8949,712332183,05-04-24 21:28,6800,IncomingTransfer,Salary,13786.44008
8950,712332183,05-05-24 17:28,150.13,Deposit,Cash Deposit,13936.57008
8951,712332183,05-06-24 23:28,261.69,Deposit,Cash Deposit,14198.26008
8952,712332183,05-08-24 10:28,696.64,Purchase,Home Improvement,13501.62008
8953,712332183,05-09-24 21:28,1000,Payment,Credit Card Payment,12501.62008
8954,712332183,5-14-24 13:28,725.93,Purchase,Pharmacy,11775.69008
8955,712332183,5-15-24 21:28,1800,Payment,Installment Payment,9975.69008
8956,712332183,5-17-24 12:28,137.38,Return,Store Return,10113.07008
8957,712332183,5-19-24 18:28,161.56,OutgoingTransfer,International Transfer,9951.51008
8958,712332183,5-19-24 19:28,601.02,Deposit,Check Deposit,10552.53008
8959,712332183,5-22-24 17:28,396.98,Payment,Mortgage Payment,10155.55008
8960,712332183,5-23-24 16:28,427.17,Purchase,Home Improvement,9728.38008
8961,712332183,5-24-24 18:28,349.96,Purchase,Clothing,9378.42008
8962,712332183,5-25-24 13:28,633.66,OnlineShopping,Etsy,8744.76008
8963,712332183,5-26-24 18:28,300.1,Purchase,Furniture,8444.66008
8964,712332183,5-29-24 13:28,206.65,Deposit,Direct Deposit,8651.31008
8965,712332183,5-29-24 19:28,746.81,Deposit,Mobile Deposit,9398.12008
8966,712332183,06-03-24 17:28,310.52,OnlineShopping,AliExpress,9087.60008
8967,712332183,06-03-24 20:28,576.45,Deposit,Check Deposit,9664.05008
8968,712332183,06-04-24 17:28,596.57,Deposit,Mobile Deposit,10260.62008
8969,712332183,06-05-24 21:28,6800,IncomingTransfer,Salary,17060.62008
8970,712332183,06-08-24 20:28,144.85,Deposit,Cash Deposit,17205.47008
8971,712332183,06-10-24 21:28,1100,Payment,Credit Card Payment,16105.47008
8972,712332183,06-10-24 22:28,680.26,Deposit,Direct Deposit,16785.73008
8973,712332183,06-12-24 21:28,498.66,Return,Store Return,17284.39008
8974,712332183,6-13-24 21:28,2200,Payment,Installment Payment,15084.39008
8975,712332183,6-18-24 9:28,165.48,Deposit,Cash Deposit,15249.87008
8976,712332183,6-19-24 10:28,449.36,Payment,Mortgage Payment,14800.51008
8977,712332183,6-21-24 14:28,707.93,Deposit,Direct Deposit,15508.44008
8978,712332183,6-23-24 14:28,269.2,Withdrawal,Mobile App Withdrawal,15239.24008
8979,712332183,6-24-24 14:28,623.03,Purchase,Gas,14616.21008
8980,712332183,6-26-24 21:28,660.28,Deposit,Check Deposit,15276.49008
8981,712332183,6-28-24 23:28,353.28,Payment,Bill Payment,14923.21008
8982,712332183,6-30-24 20:28,198.42,Deposit,Cash Deposit,15121.63008
8983,712332183,07-05-24 21:28,6800,IncomingTransfer,Salary,21921.63008
8984,712332183,07-10-24 21:28,1100,Payment,Credit Card Payment,20821.63008
8985,712332183,07-12-24 19:28,749.45,OnlineShopping,AliExpress,20072.18008
8986,712332183,7-13-24 21:28,2900,Payment,Installment Payment,17172.18008
8987,712332183,7-17-24 23:28,408.05,OutgoingTransfer,Wire Transfer,16764.13008
8988,712341933,1-21-24 19:28,382.55,Payment,Bill Payment,912.4292714
8989,712341933,1-21-24 22:28,75.16,Payment,Bill Payment,837.2692714
8990,712341933,1-23-24 11:28,403.04,Deposit,Mobile Deposit,1240.309271
8991,712341933,1-23-24 17:28,490.34,Return,Best Buy Return,1730.649271
8992,712341933,1-24-24 12:28,316.59,OnlineShopping,Amazon,1414.059271
8993,712341933,1-26-24 22:28,316.57,OnlineShopping,Etsy,1097.489271
8994,712341933,1-28-24 14:28,391.48,Return,AliExpress Return,1488.969271
8995,712341933,1-28-24 18:28,311.33,Deposit,Mobile Deposit,1800.299271
8996,712341933,02-02-24 21:28,5800,IncomingTransfer,Salary,7600.299271
8997,712341933,02-03-24 19:28,237.86,IncomingTransfer,Freelance Payment,7838.159271
8998,712341933,02-07-24 13:28,96.89,Deposit,Cash Deposit,7935.049271
8999,712341933,02-07-24 21:28,2400,Payment,Credit Card Payment,5535.049271
9000,712341933,02-08-24 21:28,179.73,Deposit,Cash Deposit,5714.779271
9001,712341933,02-09-24 11:28,301.83,Withdrawal,ATM Withdrawal,5412.949271
9002,712341933,02-09-24 22:28,252.2,OutgoingTransfer,Bank Transfer,5160.749271
9003,712341933,02-11-24 10:28,516.95,Return,eBay Return,5677.699271
9004,712341933,02-11-24 16:28,215.71,IncomingTransfer,Freelance Payment,5893.409271
9005,712341933,02-11-24 22:28,93.08,Deposit,Check Deposit,5986.489271
9006,712341933,2-13-24 21:28,436.94,Deposit,Mobile Deposit,6423.429271
9007,712341933,2-15-24 14:28,136.02,Purchase,Grocery,6287.409271
9008,712341933,2-15-24 21:28,2300,Payment,Subscription Payment,3987.409271
9009,712341933,2-17-24 11:28,169.92,Deposit,Mobile Deposit,4157.329271
9010,712341933,2-21-24 10:28,266.77,Deposit,Mobile Deposit,4424.099271
9011,712341933,2-24-24 17:28,134.94,Return,Target Return,4559.039271
9012,712341933,2-26-24 20:28,202.69,Deposit,Direct Deposit,4761.729271
9013,712341933,2-26-24 22:28,341.71,Purchase,Travel,4420.019271
9014,712341933,2-27-24 15:28,542.38,OutgoingTransfer,Wire Transfer,3877.639271
9015,712341933,2-27-24 21:28,178.98,Return,eBay Return,4056.619271
9016,712341933,2-28-24 20:28,539.48,Withdrawal,Mobile App Withdrawal,3517.139271
9017,712341933,2-29-24 11:28,192.48,Purchase,Electronics,3324.659271
9018,712341933,2-29-24 14:28,392.24,OutgoingTransfer,Peer-to-Peer Transfer,2932.419271
9019,712341933,03-01-24 23:28,429.04,Deposit,Direct Deposit,3361.459271
9020,712341933,03-02-24 17:28,437.11,Purchase,Grocery,2924.349271
9021,712341933,03-03-24 14:28,240.76,Purchase,Entertainment,2683.589271
9022,712341933,03-03-24 21:28,5800,IncomingTransfer,Salary,8483.589271
9023,712341933,03-06-24 21:28,243.4,Deposit,Direct Deposit,8726.989271
9024,712341933,03-07-24 12:28,226.99,Return,Etsy Return,8953.979271
9025,712341933,03-08-24 21:28,2400,Payment,Credit Card Payment,6553.979271
9026,712341933,03-09-24 17:28,160.63,Payment,Bill Payment,6393.349271
9027,712341933,03-10-24 20:28,90.42,Return,eBay Return,6483.769271
9028,712341933,03-12-24 15:28,180.86,Purchase,Restaurant,6302.909271
9029,712341933,3-16-24 21:28,2400,Payment,Installment Payment,3902.909271
9030,712341933,3-18-24 17:28,192.26,OnlineShopping,Best Buy,3710.649271
9031,712341933,3-22-24 17:28,153.01,Purchase,Pharmacy,3557.639271
9032,712341933,3-22-24 23:28,332.1,Deposit,Check Deposit,3889.739271
9033,712341933,3-24-24 11:28,423.32,Withdrawal,ATM Withdrawal,3466.419271
9034,712341933,3-24-24 22:28,124.51,Return,Amazon Return,3590.929271
9035,712341933,3-25-24 9:28,79.65,Purchase,Clothing,3511.279271
9036,712341933,3-30-24 13:28,407.58,OutgoingTransfer,Bank Transfer,3103.699271
9037,712341933,3-31-24 19:28,251.97,OutgoingTransfer,Peer-to-Peer Transfer,2851.729271
9038,712341933,3-31-24 21:28,241.79,OutgoingTransfer,International Transfer,2609.939271
9039,712341933,04-01-24 15:28,363.12,Deposit,Cash Deposit,2973.059271
9040,712341933,04-02-24 16:28,299.03,Withdrawal,Branch Withdrawal,2674.029271
9041,712341933,04-02-24 17:28,225.02,Return,Store Return,2899.049271
9042,712341933,04-02-24 21:28,5800,IncomingTransfer,Salary,8699.049271
9043,712341933,04-03-24 16:28,523.16,Withdrawal,Branch Withdrawal,8175.889271
9044,712341933,04-04-24 16:28,66.28,Purchase,Gas,8109.609271
9045,712341933,04-07-24 11:28,152.92,OnlineShopping,Walmart,7956.689271
9046,712341933,04-07-24 21:28,2400,Payment,Credit Card Payment,5556.689271
9047,712341933,04-09-24 23:28,51.66,IncomingTransfer,Freelance Payment,5608.349271
9048,712341933,04-10-24 21:28,2200,Payment,Installment Payment,3408.349271
9049,712341933,4-14-24 14:28,110.68,Payment,Mortgage Payment,3297.669271
9050,712341933,4-14-24 21:28,316.42,Purchase,Pharmacy,2981.249271
9051,712341933,4-18-24 12:28,379.32,Withdrawal,Mobile App Withdrawal,2601.929271
9052,712341933,4-18-24 23:28,93.9,Deposit,Mobile Deposit,2695.829271
9053,712341933,4-21-24 10:28,502.95,Return,AliExpress Return,3198.779271
9054,712341933,4-21-24 14:28,489.31,Purchase,Grocery,2709.469271
9055,712341933,4-25-24 15:28,286.72,Deposit,Direct Deposit,2996.189271
9056,712341933,4-25-24 22:28,379.05,IncomingTransfer,Freelance Payment,3375.239271
9057,712341933,4-29-24 12:28,274.59,OnlineShopping,AliExpress,3100.649271
9058,712341933,05-04-24 21:28,5800,IncomingTransfer,Salary,8900.649271
9059,712341933,05-09-24 20:28,128.15,Purchase,Home Improvement,8772.499271
9060,712341933,05-09-24 21:28,2100,Payment,Credit Card Payment,6672.499271
9061,712341933,05-09-24 23:28,286.14,OnlineShopping,Walmart,6386.359271
9062,712341933,05-10-24 21:28,91.7,Payment,Bill Payment,6294.659271
9063,712341933,05-11-24 19:28,521.08,Return,Best Buy Return,6815.739271
9064,712341933,05-11-24 21:28,2400,Payment,Insurance Payment,4415.739271
9065,712341933,5-13-24 10:28,333.3,Withdrawal,Branch Withdrawal,4082.439271
9066,712341933,5-14-24 14:28,75.48,Deposit,Direct Deposit,4157.919271
9067,712341933,5-15-24 12:28,307.27,Withdrawal,ATM Withdrawal,3850.649271
9068,712341933,5-16-24 9:28,138.42,IncomingTransfer,Freelance Payment,3989.069271
9069,712341933,5-17-24 10:28,361.81,Purchase,Grocery,3627.259271
9070,712341933,5-17-24 17:28,437.42,Deposit,Mobile Deposit,4064.679271
9071,712341933,5-18-24 14:28,140.64,OutgoingTransfer,International Transfer,3924.039271
9072,712341933,5-21-24 22:28,271.98,Deposit,Cash Deposit,4196.019271
9073,712341933,5-23-24 21:28,471.59,Purchase,Electronics,3724.429271
9074,712341933,06-01-24 17:28,434.04,Payment,Bill Payment,3290.389271
9075,712341933,06-01-24 22:28,233.76,Purchase,Pharmacy,3056.629271
9076,712341933,06-02-24 14:28,102.56,Withdrawal,Branch Withdrawal,2954.069271
9077,712341933,06-03-24 23:28,148.95,IncomingTransfer,Freelance Payment,3103.019271
9078,712341933,06-04-24 12:28,462.87,Purchase,Travel,2640.149271
9079,712341933,06-04-24 19:28,102.96,Purchase,Gas,2537.189271
9080,712341933,06-04-24 21:28,5800,IncomingTransfer,Salary,8337.189271
9081,712341933,06-05-24 13:28,81.34,Withdrawal,Mobile App Withdrawal,8255.849271
9082,712341933,06-09-24 19:28,64.81,Purchase,Gas,8191.039271
9083,712341933,06-09-24 21:28,2200,Payment,Credit Card Payment,5991.039271
9084,712341933,06-10-24 9:28,412.59,Withdrawal,ATM Withdrawal,5578.449271
9085,712341933,06-10-24 11:28,143.52,Withdrawal,ATM Withdrawal,5434.929271
9086,712341933,06-10-24 13:28,321.38,Return,Best Buy Return,5756.309271
9087,712341933,06-10-24 21:28,1700,Payment,Subscription Payment,4056.309271
9088,712341933,6-14-24 17:28,462.76,Deposit,Check Deposit,4519.069271
9089,712341933,6-14-24 17:28,110.38,Withdrawal,Branch Withdrawal,4408.689271
9090,712341933,6-17-24 23:28,456.34,OutgoingTransfer,International Transfer,3952.349271
9091,712341933,6-19-24 16:28,407.05,Payment,Mortgage Payment,3545.299271
9092,712341933,6-21-24 15:28,460.87,Purchase,Restaurant,3084.429271
9093,712341933,6-22-24 12:28,124.81,Purchase,Pharmacy,2959.619271
9094,712341933,6-23-24 15:28,519.59,Return,Etsy Return,3479.209271
9095,712341933,6-24-24 18:28,123.86,IncomingTransfer,Freelance Payment,3603.069271
9096,712341933,6-24-24 18:28,395.95,Purchase,Pharmacy,3207.119271
9097,712341933,6-24-24 19:28,131.02,Purchase,Grocery,3076.099271
9098,712341933,6-24-24 22:28,185.77,Payment,Bill Payment,2890.329271
9099,712341933,6-29-24 15:28,508.86,Return,eBay Return,3399.189271
9100,712341933,6-29-24 16:28,165.44,Purchase,Entertainment,3233.749271
9101,712341933,6-30-24 21:28,459.12,Withdrawal,ATM Withdrawal,2774.629271
9102,712341933,07-02-24 13:28,205.77,Return,Best Buy Return,2980.399271
9103,712341933,07-04-24 21:28,5800,IncomingTransfer,Salary,8780.399271
9104,712341933,07-05-24 9:28,313.29,Withdrawal,ATM Withdrawal,8467.109271
9105,712341933,07-06-24 13:28,443.54,OnlineShopping,Amazon,8023.569271
9106,712341933,07-09-24 21:28,2100,Payment,Credit Card Payment,5923.569271
9107,712341933,07-10-24 16:28,143.76,Purchase,Home Improvement,5779.809271
9108,712341933,7-13-24 22:28,106.99,Purchase,Travel,5672.819271
9109,712341933,7-14-24 10:28,140.85,OnlineShopping,Etsy,5531.969271
9110,712341933,7-16-24 21:28,2400,Payment,Subscription Payment,3131.969271
9111,712414908,1-27-24 21:28,379.59,Deposit,Direct Deposit,379.59
9112,712414908,1-28-24 18:28,346.63,OutgoingTransfer,Wire Transfer,32.96
9113,712414908,1-28-24 19:28,58.69,OnlineShopping,AliExpress,-25.73
9114,712414908,1-29-24 16:28,169.65,Purchase,Home Improvement,-195.38
9115,712414908,02-01-24 22:28,394.22,Deposit,Direct Deposit,198.84
9116,712414908,02-04-24 21:28,2150,IncomingTransfer,Salary,2348.84
9117,712414908,02-08-24 20:28,84.11,Return,Store Return,2432.95
9118,712414908,02-09-24 14:28,479.39,OutgoingTransfer,Peer-to-Peer Transfer,1953.56
9119,712414908,02-09-24 15:28,69.24,Purchase,Clothing,1884.32
9120,712414908,02-12-24 10:28,364.74,Purchase,Electronics,1519.58
9121,712414908,02-12-24 21:28,700,Payment,Installment Payment,819.58
9122,712414908,2-17-24 15:28,153.07,Payment,Loan Payment,666.51
9123,712414908,2-19-24 17:28,336.09,Return,Target Return,1002.6
9124,712414908,2-19-24 18:28,485.33,Withdrawal,Branch Withdrawal,517.27
9125,712414908,2-20-24 12:28,170.02,Deposit,Mobile Deposit,687.29
9126,712414908,2-20-24 18:28,296.15,Deposit,Direct Deposit,983.44
9127,712414908,2-22-24 23:28,202.35,Purchase,Furniture,781.09
9128,712414908,2-23-24 20:28,192.86,Payment,Bill Payment,588.23
9129,712414908,2-24-24 13:28,420.49,Withdrawal,Mobile App Withdrawal,167.74
9130,712414908,2-24-24 15:28,127.97,Purchase,Gas,39.77
9131,712414908,03-01-24 18:28,361.4,Purchase,Home Improvement,-321.63
9132,712414908,03-02-24 21:28,2150,IncomingTransfer,Salary,1828.37
9133,712414908,03-06-24 14:28,487.91,Purchase,Travel,1340.46
9134,712414908,03-10-24 21:28,388.01,Withdrawal,Mobile App Withdrawal,952.45
9135,712414908,03-11-24 17:28,477.34,Deposit,Check Deposit,1429.79
9136,712414908,3-13-24 11:28,163.5,Purchase,Entertainment,1266.29
9137,712414908,3-13-24 14:28,314.41,Purchase,Restaurant,951.88
9138,712414908,3-13-24 21:28,600,Payment,Subscription Payment,351.88
9139,712414908,3-14-24 22:28,107.92,Purchase,Furniture,243.96
9140,712414908,3-15-24 18:28,421.12,OnlineShopping,AliExpress,-177.16
9141,712414908,3-20-24 18:28,296.33,Withdrawal,Branch Withdrawal,-473.49
9142,712414908,3-22-24 13:28,473.1,Purchase,Pharmacy,-946.59
9143,712414908,3-23-24 15:28,269.99,OnlineShopping,Target,-1216.58
9144,712414908,3-24-24 19:28,190.07,OutgoingTransfer,Wire Transfer,-1406.65
9145,712414908,3-25-24 20:28,497.83,Deposit,Check Deposit,-908.82
9146,712414908,3-28-24 13:28,115.25,Withdrawal,Branch Withdrawal,-1024.07
9147,712414908,04-01-24 14:28,299.58,Withdrawal,Mobile App Withdrawal,-1323.65
9148,712414908,04-03-24 21:28,2150,IncomingTransfer,Salary,826.35
9149,712414908,04-06-24 16:28,473.27,OnlineShopping,Target,353.08
9150,712414908,4-14-24 17:28,427.73,OnlineShopping,Target,-74.65
9151,712414908,4-14-24 21:28,600,Payment,Installment Payment,-674.65
9152,712414908,4-15-24 9:28,208.61,Withdrawal,ATM Withdrawal,-883.26
9153,712414908,4-17-24 22:28,234.88,Payment,Bill Payment,-1118.14
9154,712414908,4-19-24 18:28,472.98,Purchase,Home Improvement,-1591.12
9155,712414908,4-20-24 19:28,161.09,Withdrawal,Mobile App Withdrawal,-1752.21
9156,712414908,4-21-24 16:28,406.75,Return,Best Buy Return,-1345.46
9157,712414908,4-23-24 12:28,400.18,OnlineShopping,Walmart,-1745.64
9158,712414908,4-23-24 21:28,246.02,Purchase,Travel,-1991.66
9159,712414908,4-25-24 22:28,403.46,IncomingTransfer,Freelance Payment,-1588.2
9160,712414908,4-27-24 15:28,409.08,Purchase,Entertainment,-1997.28
9161,712414908,4-28-24 17:28,421.62,Withdrawal,Branch Withdrawal,-2418.9
9162,712414908,05-04-24 21:28,2150,IncomingTransfer,Salary,-268.9
9163,712414908,05-09-24 15:28,91.06,Deposit,Direct Deposit,-177.84
9164,712414908,5-13-24 23:28,398.24,OnlineShopping,Best Buy,-576.08
9165,712414908,5-14-24 11:28,291.73,IncomingTransfer,Freelance Payment,-284.35
9166,712414908,5-14-24 13:28,116.78,Return,Target Return,-167.57
9167,712414908,5-14-24 13:28,383.83,Purchase,Home Improvement,-551.4
9168,712414908,5-14-24 19:28,154.77,Deposit,Mobile Deposit,-396.63
9169,712414908,5-15-24 14:28,497.37,Deposit,Cash Deposit,100.74
9170,712414908,5-15-24 19:28,395.38,Return,AliExpress Return,496.12
9171,712414908,5-15-24 21:28,700,Payment,Subscription Payment,-203.88
9172,712414908,5-15-24 23:28,430.26,Return,Amazon Return,226.38
9173,712414908,5-20-24 19:28,36.34,Purchase,Home Improvement,190.04
9174,712414908,5-22-24 12:28,49.3,OutgoingTransfer,Bank Transfer,140.74
9175,712414908,5-24-24 18:28,322.03,Payment,Loan Payment,-181.29
9176,712414908,5-24-24 23:28,213.06,Payment,Loan Payment,-394.35
9177,712414908,5-26-24 15:28,235.51,OutgoingTransfer,International Transfer,-629.86
9178,712414908,5-27-24 9:28,98.47,Purchase,Clothing,-728.33
9179,712414908,5-29-24 20:28,52.39,Purchase,Furniture,-780.72
9180,712414908,06-02-24 22:28,160.43,Purchase,Travel,-941.15
9181,712414908,06-03-24 21:28,2150,IncomingTransfer,Salary,1208.85
9182,712414908,06-05-24 21:28,282.52,Deposit,Direct Deposit,1491.37
9183,712414908,06-06-24 15:28,246.05,Withdrawal,ATM Withdrawal,1245.32
9184,712414908,06-08-24 13:28,38.34,OutgoingTransfer,Wire Transfer,1206.98
9185,712414908,06-09-24 14:28,334.56,Deposit,Check Deposit,1541.54
9186,712414908,06-10-24 12:28,221.7,Withdrawal,Branch Withdrawal,1319.84
9187,712414908,06-10-24 21:28,800,Payment,Installment Payment,519.84
9188,712414908,06-12-24 16:28,53.58,Withdrawal,ATM Withdrawal,466.26
9189,712414908,6-15-24 14:28,122.66,Purchase,Clothing,343.6
9190,712414908,6-19-24 18:28,481.16,Payment,Loan Payment,-137.56
9191,712414908,6-20-24 12:28,356.77,Payment,Loan Payment,-494.33
9192,712414908,6-21-24 11:28,381.85,Withdrawal,ATM Withdrawal,-876.18
9193,712414908,6-22-24 15:28,167.66,Purchase,Home Improvement,-1043.84
9194,712414908,6-25-24 11:28,18.06,OnlineShopping,AliExpress,-1061.9
9195,712414908,6-28-24 11:28,175.08,Purchase,Furniture,-1236.98
9196,712414908,07-05-24 21:28,2150,IncomingTransfer,Salary,913.02
9197,712414908,07-10-24 14:28,347,Withdrawal,Branch Withdrawal,566.02
9198,712414908,07-10-24 15:28,329.06,Withdrawal,Branch Withdrawal,236.96
9199,712414908,7-15-24 23:28,94.17,IncomingTransfer,Freelance Payment,331.13
9200,712414908,7-16-24 21:28,800,Payment,Insurance Payment,-468.87
9201,712414908,7-17-24 15:28,110.4,Payment,Loan Payment,-579.27
9202,712414908,7-17-24 19:28,453.04,Purchase,Restaurant,-1032.31
9203,712431183,1-22-24 9:28,220.91,Purchase,Grocery,-220.91
9204,712431183,1-23-24 16:28,71.43,OutgoingTransfer,Bank Transfer,-292.34
9205,712431183,1-24-24 22:28,68.41,Return,Etsy Return,-223.93
9206,712431183,02-04-24 21:28,25.84,Deposit,Mobile Deposit,-198.09
9207,712431183,02-05-24 21:28,2800,IncomingTransfer,Salary,2601.91
9208,712431183,02-07-24 18:28,211.48,OutgoingTransfer,International Transfer,2390.43
9209,712431183,2-13-24 14:28,138.58,OnlineShopping,Best Buy,2251.85
9210,712431183,2-15-24 15:28,78.37,Purchase,Furniture,2173.48
9211,712431183,2-15-24 22:28,12.18,Return,Target Return,2185.66
9212,712431183,2-17-24 21:28,1300,Payment,Rent Payment,885.66
9213,712431183,2-19-24 14:28,30.81,Deposit,Cash Deposit,916.47
9214,712431183,2-19-24 23:28,81.03,OnlineShopping,Amazon,835.44
9215,712431183,2-23-24 12:28,226.52,Payment,Mortgage Payment,608.92
9216,712431183,2-25-24 12:28,126.74,OnlineShopping,Amazon,482.18
9217,712431183,2-26-24 15:28,143.22,Withdrawal,ATM Withdrawal,338.96
9218,712431183,2-27-24 15:28,240.93,Withdrawal,Mobile App Withdrawal,98.03
9219,712431183,2-28-24 19:28,28.05,Deposit,Direct Deposit,126.08
9220,712431183,2-29-24 21:28,225.83,Payment,Loan Payment,-99.75
9221,712431183,03-02-24 18:28,171.24,Payment,Bill Payment,-270.99
9222,712431183,03-05-24 21:28,2800,IncomingTransfer,Salary,2529.01
9223,712431183,03-06-24 21:28,63.53,OnlineShopping,Amazon,2465.48
9224,712431183,03-08-24 18:28,90.75,Purchase,Home Improvement,2374.73
9225,712431183,03-10-24 18:28,120.94,Deposit,Cash Deposit,2495.67
9226,712431183,03-12-24 10:28,115.94,Purchase,Restaurant,2379.73
9227,712431183,3-13-24 14:28,138.08,Withdrawal,Mobile App Withdrawal,2241.65
9228,712431183,3-15-24 21:28,800,Payment,Rent Payment,1441.65
9229,712431183,3-16-24 18:28,135.14,Purchase,Restaurant,1306.51
9230,712431183,3-17-24 10:28,234.6,Withdrawal,Mobile App Withdrawal,1071.91
9231,712431183,3-17-24 14:28,242.22,OnlineShopping,Target,829.69
9232,712431183,3-18-24 23:28,152.14,Return,Amazon Return,981.83
9233,712431183,3-20-24 11:28,87.31,Withdrawal,Mobile App Withdrawal,894.52
9234,712431183,3-22-24 19:28,245.69,OutgoingTransfer,Bank Transfer,648.83
9235,712431183,3-26-24 17:28,15.19,Purchase,Grocery,633.64
9236,712431183,3-26-24 20:28,215.6,Purchase,Clothing,418.04
9237,712431183,3-29-24 23:28,37.36,Withdrawal,Mobile App Withdrawal,380.68
9238,712431183,04-01-24 11:28,85.45,Payment,Mortgage Payment,295.23
9239,712431183,04-03-24 16:28,76.63,Payment,Loan Payment,218.6
9240,712431183,04-03-24 20:28,91.23,Deposit,Check Deposit,309.83
9241,712431183,04-03-24 23:28,67.77,Purchase,Clothing,242.06
9242,712431183,04-04-24 21:28,2800,IncomingTransfer,Salary,3042.06
9243,712431183,04-07-24 11:28,118.47,Deposit,Check Deposit,3160.53
9244,712431183,04-08-24 16:28,59.79,Purchase,Travel,3100.74
9245,712431183,04-09-24 16:28,10.3,Purchase,Clothing,3090.44
9246,712431183,04-10-24 22:28,73.59,Purchase,Restaurant,3016.85
9247,712431183,04-11-24 15:28,233.88,Payment,Bill Payment,2782.97
9248,712431183,04-11-24 21:28,800,Payment,Rent Payment,1982.97
9249,712431183,4-13-24 14:28,196.3,Return,Target Return,2179.27
9250,712431183,4-14-24 14:28,14.94,OnlineShopping,Best Buy,2164.33
9251,712431183,4-21-24 17:28,40.94,OutgoingTransfer,Wire Transfer,2123.39
9252,712431183,4-22-24 17:28,36.44,Withdrawal,ATM Withdrawal,2086.95
9253,712431183,4-23-24 17:28,198.12,Deposit,Cash Deposit,2285.07
9254,712431183,4-23-24 23:28,123.33,OnlineShopping,Target,2161.74
9255,712431183,4-24-24 23:28,182.06,Deposit,Mobile Deposit,2343.8
9256,712431183,4-26-24 14:28,41.1,Payment,Mortgage Payment,2302.7
9257,712431183,4-26-24 20:28,241.59,Purchase,Restaurant,2061.11
9258,712431183,4-28-24 21:28,219.21,Withdrawal,Branch Withdrawal,1841.9
9259,712431183,4-29-24 18:28,127.47,Withdrawal,Branch Withdrawal,1714.43
9260,712431183,4-30-24 9:28,176.81,OutgoingTransfer,Wire Transfer,1537.62
9261,712431183,05-01-24 21:28,2800,IncomingTransfer,Salary,4337.62
9262,712431183,05-07-24 16:28,164.39,OutgoingTransfer,International Transfer,4173.23
9263,712431183,05-08-24 10:28,206.13,Payment,Bill Payment,3967.1
9264,712431183,05-08-24 14:28,140.85,OutgoingTransfer,Peer-to-Peer Transfer,3826.25
9265,712431183,05-10-24 18:28,96.68,OutgoingTransfer,Peer-to-Peer Transfer,3729.57
9266,712431183,5-13-24 21:28,1700,Payment,Rent Payment,2029.57
9267,712431183,5-14-24 13:28,13.65,Payment,Mortgage Payment,2015.92
9268,712431183,5-14-24 18:28,87.2,Deposit,Mobile Deposit,2103.12
9269,712431183,5-22-24 20:28,56.33,Purchase,Gas,2046.79
9270,712431183,5-22-24 22:28,65.04,Payment,Bill Payment,1981.75
9271,712431183,5-30-24 17:28,187.96,Purchase,Grocery,1793.79
9272,712431183,06-01-24 20:28,131.74,Deposit,Check Deposit,1925.53
9273,712431183,06-01-24 21:28,2800,IncomingTransfer,Salary,4725.53
9274,712431183,06-03-24 19:28,35.95,Purchase,Electronics,4689.58
9275,712431183,06-07-24 16:28,170.32,Purchase,Entertainment,4519.26
9276,712431183,06-07-24 23:28,55.45,Purchase,Pharmacy,4463.81
9277,712431183,06-09-24 22:28,208.3,Withdrawal,ATM Withdrawal,4255.51
9278,712431183,06-11-24 19:28,135.06,Withdrawal,Mobile App Withdrawal,4120.45
9279,712431183,6-13-24 16:28,38.09,Deposit,Check Deposit,4158.54
9280,712431183,6-14-24 21:28,1600,Payment,Rent Payment,2558.54
9281,712431183,6-16-24 21:28,209.87,IncomingTransfer,Freelance Payment,2768.41
9282,712431183,6-18-24 14:28,96.4,Payment,Loan Payment,2672.01
9283,712431183,6-22-24 10:28,138.72,Deposit,Cash Deposit,2810.73
9284,712431183,6-27-24 16:28,22.44,OutgoingTransfer,Wire Transfer,2788.29
9285,712431183,6-27-24 18:28,186.1,Purchase,Grocery,2602.19
9286,712431183,6-28-24 9:28,242.41,OutgoingTransfer,Bank Transfer,2359.78
9287,712431183,6-28-24 10:28,57.85,Deposit,Check Deposit,2417.63
9288,712431183,6-29-24 10:28,82.81,Purchase,Travel,2334.82
9289,712431183,6-29-24 18:28,45.87,Deposit,Direct Deposit,2380.69
9290,712431183,07-02-24 21:28,2800,IncomingTransfer,Salary,5180.69
9291,712431183,07-10-24 21:28,800,Payment,Rent Payment,4380.69
9292,712431183,07-11-24 19:28,81.15,OutgoingTransfer,International Transfer,4299.54
9293,712431183,07-12-24 18:28,222.35,Return,Target Return,4521.89
9294,712431183,7-16-24 10:28,33,Return,Store Return,4554.89
9295,712437108,1-20-24 18:28,612.55,Deposit,Check Deposit,612.55
9296,712437108,1-20-24 18:28,606.93,OutgoingTransfer,International Transfer,5.62
9297,712437108,1-22-24 19:28,450.82,OnlineShopping,eBay,-445.2
9298,712437108,1-22-24 21:28,165.67,Return,Walmart Return,-279.53
9299,712437108,1-29-24 11:28,395.84,Withdrawal,Branch Withdrawal,-675.37
9300,712437108,02-02-24 21:28,9800,IncomingTransfer,Salary,9124.63
9301,712437108,02-10-24 12:28,314.12,Deposit,Check Deposit,9438.75
9302,712437108,2-14-24 13:28,370.36,OnlineShopping,eBay,9068.39
9303,712437108,2-15-24 19:28,272.95,Payment,Mortgage Payment,8795.44
9304,712437108,2-15-24 21:28,4800,Payment,Rent Payment,3995.44
9305,712437108,2-17-24 16:28,345.49,Return,Etsy Return,4340.93
9306,712437108,2-19-24 13:28,692.52,Return,Walmart Return,5033.45
9307,712437108,2-19-24 22:28,163.32,Withdrawal,Mobile App Withdrawal,4870.13
9308,712437108,2-20-24 11:28,589.88,Deposit,Cash Deposit,5460.01
9309,712437108,2-20-24 14:28,631.12,Purchase,Clothing,4828.89
9310,712437108,2-21-24 18:28,325.36,Purchase,Restaurant,4503.53
9311,712437108,2-24-24 19:28,437.65,Payment,Bill Payment,4065.88
9312,712437108,2-24-24 22:28,482.82,Deposit,Direct Deposit,4548.7
9313,712437108,2-26-24 15:28,458.58,Payment,Bill Payment,4090.12
9314,712437108,03-01-24 14:28,438.84,Purchase,Clothing,3651.28
9315,712437108,03-03-24 21:28,9800,IncomingTransfer,Salary,13451.28
9316,712437108,03-04-24 16:28,292.46,Deposit,Cash Deposit,13743.74
9317,712437108,03-05-24 22:28,287.14,OnlineShopping,Etsy,13456.6
9318,712437108,03-09-24 19:28,482.67,Payment,Bill Payment,12973.93
9319,712437108,3-13-24 10:28,602.47,Withdrawal,Mobile App Withdrawal,12371.46
9320,712437108,3-15-24 19:28,670.5,Purchase,Grocery,11700.96
9321,712437108,3-15-24 21:28,4100,Payment,Rent Payment,7600.96
9322,712437108,3-16-24 19:28,462.14,Purchase,Grocery,7138.82
9323,712437108,3-18-24 17:28,682.94,Purchase,Furniture,6455.88
9324,712437108,3-24-24 15:28,346.78,OutgoingTransfer,Bank Transfer,6109.1
9325,712437108,3-25-24 10:28,645.22,Withdrawal,ATM Withdrawal,5463.88
9326,712437108,3-25-24 23:28,107.71,Purchase,Entertainment,5356.17
9327,712437108,3-27-24 20:28,304.72,OnlineShopping,Amazon,5051.45
9328,712437108,3-27-24 23:28,689.25,IncomingTransfer,Freelance Payment,5740.7
9329,712437108,3-30-24 15:28,221.87,Return,Walmart Return,5962.57
9330,712437108,04-01-24 21:28,9800,IncomingTransfer,Salary,15762.57
9331,712437108,04-02-24 22:28,327.32,Deposit,Check Deposit,16089.89
9332,712437108,04-04-24 17:28,247.46,Withdrawal,ATM Withdrawal,15842.43
9333,712437108,04-06-24 16:28,721.5,Deposit,Mobile Deposit,16563.93
9334,712437108,04-07-24 10:28,649.91,Withdrawal,Mobile App Withdrawal,15914.02
9335,712437108,04-09-24 12:28,378.79,Return,Etsy Return,16292.81
9336,712437108,04-10-24 21:28,6000,Payment,Rent Payment,10292.81
9337,712437108,04-11-24 10:28,552.68,Payment,Loan Payment,9740.13
9338,712437108,04-12-24 12:28,131.77,Purchase,Furniture,9608.36
9339,712437108,4-15-24 10:28,427.41,OutgoingTransfer,Wire Transfer,9180.95
9340,712437108,4-15-24 12:28,187.83,Deposit,Check Deposit,9368.78
9341,712437108,4-17-24 22:28,489.32,Payment,Bill Payment,8879.46
9342,712437108,4-20-24 11:28,388.98,Return,AliExpress Return,9268.44
9343,712437108,4-21-24 19:28,432.54,Deposit,Direct Deposit,9700.98
9344,712437108,4-22-24 21:28,345.78,OnlineShopping,Walmart,9355.2
9345,712437108,4-30-24 15:28,228.07,Deposit,Check Deposit,9583.27
9346,712437108,05-02-24 9:28,398.3,Deposit,Mobile Deposit,9981.57
9347,712437108,05-02-24 21:28,9800,IncomingTransfer,Salary,19781.57
9348,712437108,05-05-24 19:28,179.8,Deposit,Mobile Deposit,19961.37
9349,712437108,05-06-24 19:28,464.64,Withdrawal,Mobile App Withdrawal,19496.73
9350,712437108,05-09-24 9:28,137.6,Payment,Loan Payment,19359.13
9351,712437108,05-09-24 10:28,674.18,OutgoingTransfer,Bank Transfer,18684.95
9352,712437108,05-10-24 16:28,747.37,Withdrawal,Branch Withdrawal,17937.58
9353,712437108,5-13-24 10:28,226.95,OnlineShopping,eBay,17710.63
9354,712437108,5-14-24 12:28,661.46,Purchase,Pharmacy,17049.17
9355,712437108,5-15-24 17:28,368.56,Deposit,Cash Deposit,17417.73
9356,712437108,5-15-24 21:28,4100,Payment,Rent Payment,13317.73
9357,712437108,5-16-24 20:28,624.97,OutgoingTransfer,Bank Transfer,12692.76
9358,712437108,5-19-24 11:28,528.91,Payment,Mortgage Payment,12163.85
9359,712437108,5-19-24 12:28,650.06,Payment,Bill Payment,11513.79
9360,712437108,5-20-24 14:28,274.52,OutgoingTransfer,Bank Transfer,11239.27
9361,712437108,5-21-24 16:28,735.51,Return,Best Buy Return,11974.78
9362,712437108,5-26-24 12:28,272.97,Deposit,Direct Deposit,12247.75
9363,712437108,5-26-24 12:28,130.98,OnlineShopping,AliExpress,12116.77
9364,712437108,5-28-24 14:28,199.89,Withdrawal,Branch Withdrawal,11916.88
9365,712437108,5-28-24 23:28,730.77,Withdrawal,Branch Withdrawal,11186.11
9366,712437108,5-29-24 11:28,559.87,OnlineShopping,Walmart,10626.24
9367,712437108,5-31-24 13:28,683.77,IncomingTransfer,Freelance Payment,11310.01
9368,712437108,06-04-24 21:28,9800,IncomingTransfer,Salary,21110.01
9369,712437108,06-06-24 16:28,564.99,Deposit,Mobile Deposit,21675
9370,712437108,06-08-24 11:28,682.09,Withdrawal,Mobile App Withdrawal,20992.91
9371,712437108,06-10-24 22:28,720.61,Deposit,Direct Deposit,21713.52
9372,712437108,06-12-24 20:28,151.69,Return,Walmart Return,21865.21
9373,712437108,6-16-24 18:28,707.07,Return,Store Return,22572.28
9374,712437108,6-16-24 21:28,5800,Payment,Rent Payment,16772.28
9375,712437108,6-18-24 19:28,372.8,OutgoingTransfer,Peer-to-Peer Transfer,16399.48
9376,712437108,6-19-24 10:28,464.75,OnlineShopping,Walmart,15934.73
9377,712437108,6-19-24 23:28,256.51,Purchase,Restaurant,15678.22
9378,712437108,6-21-24 13:28,344.64,Payment,Loan Payment,15333.58
9379,712437108,6-21-24 14:28,227.83,Purchase,Restaurant,15105.75
9380,712437108,6-22-24 18:28,576.8,Purchase,Pharmacy,14528.95
9381,712437108,6-24-24 20:28,201.68,Purchase,Travel,14327.27
9382,712437108,6-25-24 10:28,157.96,Purchase,Furniture,14169.31
9383,712437108,6-28-24 11:28,209.27,OnlineShopping,Walmart,13960.04
9384,712437108,6-28-24 17:28,312.89,Deposit,Check Deposit,14272.93
9385,712437108,6-29-24 16:28,721.32,Withdrawal,ATM Withdrawal,13551.61
9386,712437108,07-01-24 21:28,9800,IncomingTransfer,Salary,23351.61
9387,712437108,07-02-24 17:28,667.37,IncomingTransfer,Freelance Payment,24018.98
9388,712437108,07-02-24 19:28,651.4,Withdrawal,Branch Withdrawal,23367.58
9389,712437108,07-05-24 19:28,545.55,Purchase,Electronics,22822.03
9390,712437108,07-05-24 23:28,644.01,Payment,Loan Payment,22178.02
9391,712437108,07-09-24 11:28,239.39,Withdrawal,Branch Withdrawal,21938.63
9392,712437108,07-12-24 21:28,2600,Payment,Rent Payment,19338.63
9393,712437108,7-15-24 12:28,141.18,IncomingTransfer,Freelance Payment,19479.81
9394,712437108,7-15-24 22:28,179.1,Withdrawal,Branch Withdrawal,19300.71
9395,712437108,7-17-24 17:28,412.65,OnlineShopping,eBay,18888.06
9396,712444533,1-21-24 21:28,431.5,Withdrawal,ATM Withdrawal,-431.5
9397,712444533,1-27-24 11:28,649.38,Deposit,Cash Deposit,217.88
9398,712444533,02-01-24 21:28,8100,IncomingTransfer,Salary,8317.88
9399,712444533,02-02-24 13:28,640.22,Deposit,Check Deposit,8958.1
9400,712444533,02-03-24 21:28,406.1,OnlineShopping,Walmart,8552
9401,712444533,02-05-24 11:28,708.99,Return,Amazon Return,9260.99
9402,712444533,02-06-24 12:28,560.27,Withdrawal,Mobile App Withdrawal,8700.72
9403,712444533,02-09-24 23:28,502.17,Return,eBay Return,9202.89
9404,712444533,02-10-24 18:28,297.9,Deposit,Direct Deposit,9500.79
9405,712444533,02-10-24 21:28,2900,Payment,Insurance Payment,6600.79
9406,712444533,02-11-24 17:28,339.83,OnlineShopping,AliExpress,6260.96
9407,712444533,2-17-24 15:28,228.05,Return,Best Buy Return,6489.01
9408,712444533,2-18-24 15:28,434.2,OnlineShopping,Etsy,6054.81
9409,712444533,2-19-24 13:28,287.15,OutgoingTransfer,Bank Transfer,5767.66
9410,712444533,2-19-24 19:28,535.79,Purchase,Home Improvement,5231.87
9411,712444533,2-25-24 21:28,442.29,Purchase,Home Improvement,4789.58
9412,712444533,2-26-24 13:28,653.4,Withdrawal,ATM Withdrawal,4136.18
9413,712444533,2-27-24 21:28,728.24,Payment,Loan Payment,3407.94
9414,712444533,03-02-24 21:28,8100,IncomingTransfer,Salary,11507.94
9415,712444533,03-11-24 21:28,3500,Payment,Insurance Payment,8007.94
9416,712444533,03-11-24 23:28,383.79,Deposit,Cash Deposit,8391.73
9417,712444533,03-12-24 9:28,615.97,Payment,Bill Payment,7775.76
9418,712444533,03-12-24 17:28,730.32,Withdrawal,ATM Withdrawal,7045.44
9419,712444533,03-12-24 17:28,748.9,Purchase,Grocery,6296.54
9420,712444533,03-12-24 23:28,556.24,Purchase,Home Improvement,5740.3
9421,712444533,3-15-24 14:28,525.02,Withdrawal,ATM Withdrawal,5215.28
9422,712444533,3-22-24 20:28,235.47,OnlineShopping,Best Buy,4979.81
9423,712444533,3-26-24 10:28,708.37,Purchase,Entertainment,4271.44
9424,712444533,3-26-24 18:28,126.35,Purchase,Electronics,4145.09
9425,712444533,3-29-24 21:28,512.77,OutgoingTransfer,Wire Transfer,3632.32
9426,712444533,04-03-24 17:28,396.53,Withdrawal,Branch Withdrawal,3235.79
9427,712444533,04-03-24 21:28,8100,IncomingTransfer,Salary,11335.79
9428,712444533,04-04-24 21:28,542.63,Deposit,Mobile Deposit,11878.42
9429,712444533,04-08-24 23:28,728.42,OutgoingTransfer,Wire Transfer,11150
9430,712444533,04-12-24 13:28,372.97,Withdrawal,ATM Withdrawal,10777.03
9431,712444533,4-14-24 10:28,254.48,Payment,Loan Payment,10522.55
9432,712444533,4-17-24 21:28,3200,Payment,Subscription Payment,7322.55
9433,712444533,4-28-24 14:28,601.86,Deposit,Check Deposit,7924.41
9434,712444533,4-29-24 12:28,639.89,Purchase,Travel,7284.52
9435,712444533,05-02-24 17:28,358.19,Purchase,Entertainment,6926.33
9436,712444533,05-03-24 12:28,347.45,Payment,Bill Payment,6578.88
9437,712444533,05-04-24 21:28,8100,IncomingTransfer,Salary,14678.88
9438,712444533,05-06-24 9:28,723.32,Withdrawal,Branch Withdrawal,13955.56
9439,712444533,05-10-24 9:28,576.82,Return,Etsy Return,14532.38
9440,712444533,05-10-24 17:28,650.33,OnlineShopping,Best Buy,13882.05
9441,712444533,5-14-24 17:28,140,Purchase,Travel,13742.05
9442,712444533,5-17-24 12:28,288.9,OnlineShopping,AliExpress,13453.15
9443,712444533,5-17-24 15:28,396.61,Purchase,Furniture,13056.54
9444,712444533,5-18-24 10:28,693.25,Purchase,Clothing,12363.29
9445,712444533,5-18-24 20:28,523.82,OnlineShopping,Best Buy,11839.47
9446,712444533,5-18-24 21:28,3200,Payment,Subscription Payment,8639.47
9447,712444533,5-20-24 13:28,117.46,Purchase,Gas,8522.01
9448,712444533,5-21-24 20:28,319.42,Withdrawal,Mobile App Withdrawal,8202.59
9449,712444533,5-22-24 15:28,307.72,Return,Target Return,8510.31
9450,712444533,5-23-24 20:28,361.65,Payment,Bill Payment,8148.66
9451,712444533,5-30-24 15:28,368.13,OutgoingTransfer,Wire Transfer,7780.53
9452,712444533,5-31-24 10:28,122.79,Payment,Loan Payment,7657.74
9453,712444533,06-01-24 21:28,8100,IncomingTransfer,Salary,15757.74
9454,712444533,06-05-24 23:28,501.25,OutgoingTransfer,International Transfer,15256.49
9455,712444533,06-08-24 11:28,217.72,Withdrawal,ATM Withdrawal,15038.77
9456,712444533,06-08-24 19:28,527.44,Withdrawal,ATM Withdrawal,14511.33
9457,712444533,06-12-24 11:28,698.18,Return,Walmart Return,15209.51
9458,712444533,06-12-24 13:28,144.41,OnlineShopping,Walmart,15065.1
9459,712444533,6-13-24 10:28,738.35,OnlineShopping,eBay,14326.75
9460,712444533,6-13-24 14:28,326.03,OutgoingTransfer,Bank Transfer,14000.72
9461,712444533,6-16-24 11:28,485.56,Withdrawal,ATM Withdrawal,13515.16
9462,712444533,6-18-24 21:28,3000,Payment,Installment Payment,10515.16
9463,712444533,6-19-24 10:28,272.18,OnlineShopping,Target,10242.98
9464,712444533,6-21-24 18:28,382.74,OutgoingTransfer,Wire Transfer,9860.24
9465,712444533,6-25-24 11:28,464.75,OnlineShopping,Amazon,9395.49
9466,712444533,6-25-24 16:28,600.93,OnlineShopping,Walmart,8794.56
9467,712444533,6-28-24 13:28,698.59,Withdrawal,Mobile App Withdrawal,8095.97
9468,712444533,6-29-24 20:28,731.16,Deposit,Direct Deposit,8827.13
9469,712444533,6-30-24 16:28,685.06,Purchase,Clothing,8142.07
9470,712444533,07-05-24 21:28,8100,IncomingTransfer,Salary,16242.07
9471,712444533,07-11-24 22:28,251.12,Deposit,Check Deposit,16493.19
9472,712444533,7-13-24 12:28,705.66,OnlineShopping,eBay,15787.53
9473,712444533,7-15-24 12:28,463.44,Withdrawal,Mobile App Withdrawal,15324.09
9474,712444533,7-15-24 16:28,133.74,Withdrawal,ATM Withdrawal,15190.35
9475,712444533,7-16-24 21:28,2100,Payment,Subscription Payment,13090.35
9476,712454958,1-30-24 13:28,162.85,Deposit,Cash Deposit,968.8987407
9477,712454958,02-02-24 21:28,6250,IncomingTransfer,Salary,7218.898741
9478,712454958,02-03-24 22:28,382.02,Purchase,Entertainment,6836.878741
9479,712454958,02-05-24 20:28,450.44,Purchase,Grocery,6386.438741
9480,712454958,02-07-24 20:28,331.83,Withdrawal,ATM Withdrawal,6054.608741
9481,712454958,02-07-24 21:28,1800,Payment,Credit Card Payment,4254.608741
9482,712454958,2-17-24 12:28,262.91,Payment,Loan Payment,3991.698741
9483,712454958,2-17-24 19:28,370.59,Deposit,Direct Deposit,4362.288741
9484,712454958,2-17-24 21:28,2300,Payment,Subscription Payment,2062.288741
9485,712454958,2-23-24 14:28,293.22,Purchase,Gas,1769.068741
9486,712454958,2-27-24 15:28,106.38,Deposit,Cash Deposit,1875.448741
9487,712454958,2-27-24 20:28,196.97,Deposit,Direct Deposit,2072.418741
9488,712454958,2-28-24 17:28,441.48,OutgoingTransfer,Bank Transfer,1630.938741
9489,712454958,03-02-24 14:28,366.01,Withdrawal,ATM Withdrawal,1264.928741
9490,712454958,03-02-24 21:28,6250,IncomingTransfer,Salary,7514.928741
9491,712454958,03-07-24 21:28,2100,Payment,Credit Card Payment,5414.928741
9492,712454958,03-09-24 18:28,144.99,Payment,Bill Payment,5269.938741
9493,712454958,03-12-24 21:28,2000,Payment,Insurance Payment,3269.938741
9494,712454958,3-15-24 13:28,450.58,OutgoingTransfer,Peer-to-Peer Transfer,2819.358741
9495,712454958,3-20-24 11:28,255.6,OnlineShopping,AliExpress,2563.758741
9496,712454958,3-20-24 19:28,246.34,Deposit,Direct Deposit,2810.098741
9497,712454958,3-25-24 23:28,489.08,IncomingTransfer,Freelance Payment,3299.178741
9498,712454958,3-27-24 14:28,262.5,Deposit,Cash Deposit,3561.678741
9499,712454958,3-28-24 18:28,294.84,Purchase,Pharmacy,3266.838741
9500,712454958,04-05-24 15:28,314.6,Deposit,Check Deposit,3581.438741
9501,712454958,04-05-24 17:28,201,Deposit,Check Deposit,3782.438741
9502,712454958,04-05-24 21:28,6250,IncomingTransfer,Salary,10032.43874
9503,712454958,04-08-24 16:28,464.19,Withdrawal,Mobile App Withdrawal,9568.248741
9504,712454958,04-10-24 21:28,1900,Payment,Credit Card Payment,7668.248741
9505,712454958,04-11-24 21:28,2500,Payment,Insurance Payment,5168.248741
9506,712454958,4-19-24 20:28,242.86,OnlineShopping,Walmart,4925.388741
9507,712454958,4-20-24 20:28,444.07,Deposit,Mobile Deposit,5369.458741
9508,712454958,4-27-24 20:28,266.63,Return,Amazon Return,5636.088741
9509,712454958,05-04-24 21:28,6250,IncomingTransfer,Salary,11886.08874
9510,712454958,05-07-24 14:28,420.99,OnlineShopping,Etsy,11465.09874
9511,712454958,05-09-24 21:28,2000,Payment,Credit Card Payment,9465.098741
9512,712454958,5-15-24 13:28,149.26,Purchase,Travel,9315.838741
9513,712454958,5-17-24 9:28,103.28,Payment,Mortgage Payment,9212.558741
9514,712454958,5-18-24 21:28,2100,Payment,Insurance Payment,7112.558741
9515,712454958,5-23-24 22:28,303.37,Deposit,Direct Deposit,7415.928741
9516,712454958,06-03-24 21:28,6250,IncomingTransfer,Salary,13665.92874
9517,712454958,06-08-24 21:28,1500,Payment,Credit Card Payment,12165.92874
9518,712454958,6-14-24 21:28,445.72,Deposit,Cash Deposit,12611.64874
9519,712454958,6-16-24 21:28,2200,Payment,Insurance Payment,10411.64874
9520,712454958,6-18-24 14:28,504.05,Withdrawal,Branch Withdrawal,9907.598741
9521,712454958,6-19-24 11:28,265.49,OutgoingTransfer,Peer-to-Peer Transfer,9642.108741
9522,712454958,6-21-24 15:28,250.84,Deposit,Direct Deposit,9892.948741
9523,712454958,6-29-24 15:28,87.44,Return,Store Return,9980.388741
9524,712454958,07-01-24 13:28,363.01,Purchase,Home Improvement,9617.378741
9525,712454958,07-04-24 21:28,6250,IncomingTransfer,Salary,15867.37874
9526,712454958,07-05-24 23:28,204.34,Deposit,Cash Deposit,16071.71874
9527,712454958,07-07-24 20:28,496.07,Return,Walmart Return,16567.78874
9528,712454958,07-09-24 21:28,2000,Payment,Credit Card Payment,14567.78874
9529,712454958,7-13-24 21:28,2400,Payment,Insurance Payment,12167.78874
9530,712454958,7-16-24 21:28,221.84,Return,Store Return,12389.62874
9531,712454958,7-17-24 19:28,112.3,OutgoingTransfer,Peer-to-Peer Transfer,12277.32874
9532,712515558,1-21-24 20:28,398.82,OutgoingTransfer,International Transfer,573.7852251
9533,712515558,1-23-24 14:28,103.72,OutgoingTransfer,Wire Transfer,470.0652251
9534,712515558,1-25-24 18:28,74.62,Payment,Mortgage Payment,395.4452251
9535,712515558,1-29-24 15:28,505.12,Payment,Bill Payment,-109.6747749
9536,712515558,1-30-24 15:28,98.2,OutgoingTransfer,Wire Transfer,-207.8747749
9537,712515558,02-05-24 21:28,6550,IncomingTransfer,Salary,6342.125225
9538,712515558,02-06-24 17:28,51.63,Purchase,Furniture,6290.495225
9539,712515558,02-06-24 20:28,337.18,Deposit,Check Deposit,6627.675225
9540,712515558,02-07-24 20:28,535.98,Return,Target Return,7163.655225
9541,712515558,02-09-24 17:28,334.71,OnlineShopping,Target,6828.945225
9542,712515558,02-10-24 21:28,1900,Payment,Credit Card Payment,4928.945225
9543,712515558,02-11-24 10:28,321.74,Purchase,Furniture,4607.205225
9544,712515558,2-15-24 11:28,533.95,Withdrawal,Branch Withdrawal,4073.255225
9545,712515558,2-15-24 12:28,264.9,Purchase,Travel,3808.355225
9546,712515558,2-16-24 21:28,2500,Payment,Rent Payment,1308.355225
9547,712515558,2-19-24 18:28,207.05,Deposit,Mobile Deposit,1515.405225
9548,712515558,2-21-24 10:28,80.93,Payment,Mortgage Payment,1434.475225
9549,712515558,2-21-24 20:28,262.42,OnlineShopping,Amazon,1172.055225
9550,712515558,2-22-24 18:28,102.8,OnlineShopping,eBay,1069.255225
9551,712515558,2-28-24 23:28,506.24,Deposit,Direct Deposit,1575.495225
9552,712515558,03-01-24 21:28,6550,IncomingTransfer,Salary,8125.495225
9553,712515558,03-03-24 18:28,459.92,Deposit,Direct Deposit,8585.415225
9554,712515558,03-06-24 21:28,1700,Payment,Credit Card Payment,6885.415225
9555,712515558,03-12-24 21:28,2400,Payment,Rent Payment,4485.415225
9556,712515558,3-13-24 21:28,146.18,Payment,Loan Payment,4339.235225
9557,712515558,3-16-24 10:28,257.67,Deposit,Direct Deposit,4596.905225
9558,712515558,3-18-24 9:28,493.71,OutgoingTransfer,Bank Transfer,4103.195225
9559,712515558,3-19-24 17:28,103.88,IncomingTransfer,Freelance Payment,4207.075225
9560,712515558,3-21-24 10:28,258.74,Purchase,Home Improvement,3948.335225
9561,712515558,3-23-24 17:28,542.15,Return,Etsy Return,4490.485225
9562,712515558,3-25-24 10:28,345.46,OnlineShopping,Etsy,4145.025225
9563,712515558,3-29-24 23:28,136.92,Withdrawal,Branch Withdrawal,4008.105225
9564,712515558,3-30-24 10:28,272.82,Purchase,Travel,3735.285225
9565,712515558,3-30-24 12:28,382.25,OutgoingTransfer,Peer-to-Peer Transfer,3353.035225
9566,712515558,3-31-24 16:28,270.34,Return,AliExpress Return,3623.375225
9567,712515558,04-02-24 21:28,6550,IncomingTransfer,Salary,10173.37523
9568,712515558,04-03-24 17:28,131.79,Return,Amazon Return,10305.16523
9569,712515558,04-06-24 14:28,367.68,Purchase,Grocery,9937.485225
9570,712515558,04-07-24 21:28,2000,Payment,Credit Card Payment,7937.485225
9571,712515558,04-09-24 21:28,421.92,Withdrawal,Branch Withdrawal,7515.565225
9572,712515558,04-09-24 23:28,130.85,Payment,Loan Payment,7384.715225
9573,712515558,04-12-24 12:28,462.03,OnlineShopping,AliExpress,6922.685225
9574,712515558,4-14-24 13:28,67.11,OutgoingTransfer,International Transfer,6855.575225
9575,712515558,4-14-24 21:28,2300,Payment,Rent Payment,4555.575225
9576,712515558,4-16-24 12:28,192.02,Return,Amazon Return,4747.595225
9577,712515558,4-16-24 13:28,545.41,OutgoingTransfer,Bank Transfer,4202.185225
9578,712515558,4-18-24 15:28,212.37,Payment,Loan Payment,3989.815225
9579,712515558,4-21-24 15:28,105.29,Deposit,Mobile Deposit,4095.105225
9580,712515558,4-25-24 16:28,238.99,Purchase,Electronics,3856.115225
9581,712515558,4-25-24 18:28,507.33,Purchase,Restaurant,3348.785225
9582,712515558,4-26-24 14:28,311.95,Payment,Loan Payment,3036.835225
9583,712515558,4-27-24 11:28,86.1,Purchase,Clothing,2950.735225
9584,712515558,4-29-24 9:28,278.76,OutgoingTransfer,Wire Transfer,2671.975225
9585,712515558,4-30-24 12:28,430.58,Purchase,Grocery,2241.395225
9586,712515558,05-01-24 9:28,60.2,OnlineShopping,Target,2181.195225
9587,712515558,05-01-24 21:28,6550,IncomingTransfer,Salary,8731.195225
9588,712515558,05-02-24 11:28,360.47,Withdrawal,Branch Withdrawal,8370.725225
9589,712515558,05-06-24 21:28,2200,Payment,Credit Card Payment,6170.725225
9590,712515558,05-07-24 14:28,549.82,Payment,Loan Payment,5620.905225
9591,712515558,05-09-24 20:28,304.89,Withdrawal,Branch Withdrawal,5316.015225
9592,712515558,05-10-24 18:28,508.35,Deposit,Cash Deposit,5824.365225
9593,712515558,05-12-24 12:28,237.09,Deposit,Check Deposit,6061.455225
9594,712515558,5-14-24 17:28,170.14,OnlineShopping,Walmart,5891.315225
9595,712515558,5-16-24 10:28,330.66,Deposit,Mobile Deposit,6221.975225
9596,712515558,5-16-24 21:28,3700,Payment,Rent Payment,2521.975225
9597,712515558,5-17-24 14:28,238.14,Withdrawal,ATM Withdrawal,2283.835225
9598,712515558,5-18-24 18:28,453.72,OutgoingTransfer,Peer-to-Peer Transfer,1830.115225
9599,712515558,5-18-24 22:28,516.87,Purchase,Furniture,1313.245225
9600,712515558,5-19-24 12:28,458.44,Return,Target Return,1771.685225
9601,712515558,5-25-24 10:28,531.86,Purchase,Clothing,1239.825225
9602,712515558,5-25-24 17:28,308.36,OutgoingTransfer,Wire Transfer,931.4652251
9603,712515558,5-26-24 12:28,440,Deposit,Mobile Deposit,1371.465225
9604,712515558,5-26-24 15:28,173.82,Withdrawal,ATM Withdrawal,1197.645225
9605,712515558,5-31-24 15:28,263.7,Deposit,Check Deposit,1461.345225
9606,712515558,06-01-24 11:28,433.44,OnlineShopping,Amazon,1027.905225
9607,712515558,06-01-24 16:28,430.89,Purchase,Pharmacy,597.0152251
9608,712515558,06-03-24 21:28,6550,IncomingTransfer,Salary,7147.015225
9609,712515558,06-04-24 13:28,249.81,Purchase,Gas,6897.205225
9610,712515558,06-08-24 21:28,1600,Payment,Credit Card Payment,5297.205225
9611,712515558,6-13-24 21:28,272.74,OnlineShopping,eBay,5024.465225
9612,712515558,6-16-24 21:28,1900,Payment,Rent Payment,3124.465225
9613,712515558,6-20-24 12:28,211.59,Return,Amazon Return,3336.055225
9614,712515558,6-23-24 11:28,83.91,Purchase,Gas,3252.145225
9615,712515558,6-26-24 22:28,533.31,Deposit,Mobile Deposit,3785.455225
9616,712515558,6-29-24 14:28,358.15,Withdrawal,Branch Withdrawal,3427.305225
9617,712515558,07-01-24 13:28,150.56,IncomingTransfer,Freelance Payment,3577.865225
9618,712515558,07-03-24 21:28,6550,IncomingTransfer,Salary,10127.86523
9619,712515558,07-06-24 13:28,131.92,Withdrawal,Branch Withdrawal,9995.945225
9620,712515558,07-06-24 13:28,533.74,Withdrawal,ATM Withdrawal,9462.205225
9621,712515558,07-08-24 17:28,534.89,Payment,Loan Payment,8927.315225
9622,712515558,07-08-24 21:28,1900,Payment,Credit Card Payment,7027.315225
9623,712515558,7-13-24 12:28,359.14,Deposit,Cash Deposit,7386.455225
9624,712515558,7-16-24 12:28,491.76,Deposit,Direct Deposit,7878.215225
9625,712515558,7-16-24 21:28,3100,Payment,Rent Payment,4778.215225
9626,712515558,7-16-24 21:28,288.79,Deposit,Mobile Deposit,5067.005225
9627,712532058,1-20-24 13:28,109.8,Return,Etsy Return,1252.796326
9628,712532058,1-27-24 19:28,225.4,Payment,Loan Payment,1027.396326
9629,712532058,1-28-24 19:28,41.71,OutgoingTransfer,Wire Transfer,985.6863257
9630,712532058,02-01-24 17:28,123.3,Return,Amazon Return,1108.986326
9631,712532058,02-05-24 21:28,3450,IncomingTransfer,Salary,4558.986326
9632,712532058,02-06-24 13:28,230.71,Withdrawal,Branch Withdrawal,4328.276326
9633,712532058,02-10-24 21:28,2000,Payment,Credit Card Payment,2328.276326
9634,712532058,02-11-24 22:28,98.75,Purchase,Travel,2229.526326
9635,712532058,2-13-24 18:28,344.17,IncomingTransfer,Freelance Payment,2573.696326
9636,712532058,2-16-24 21:28,1700,Payment,Rent Payment,873.6963257
9637,712532058,2-17-24 18:28,31.06,OutgoingTransfer,Peer-to-Peer Transfer,842.6363257
9638,712532058,2-18-24 17:28,59.22,OutgoingTransfer,Bank Transfer,783.4163257
9639,712532058,2-18-24 17:28,353.01,Deposit,Mobile Deposit,1136.426326
9640,712532058,2-24-24 12:28,198.43,Purchase,Entertainment,937.9963257
9641,712532058,2-24-24 18:28,205.96,Withdrawal,Branch Withdrawal,732.0363257
9642,712532058,2-28-24 23:28,372.56,Purchase,Entertainment,359.4763257
9643,712532058,2-28-24 23:28,165.55,Purchase,Travel,193.9263257
9644,712532058,2-29-24 16:28,261.82,Deposit,Cash Deposit,455.7463257
9645,712532058,2-29-24 18:28,167.61,Payment,Mortgage Payment,288.1363257
9646,712532058,2-29-24 20:28,382.51,Purchase,Grocery,-94.3736743
9647,712532058,2-29-24 21:28,43.8,Purchase,Pharmacy,-138.1736743
9648,712532058,03-02-24 10:28,175,Withdrawal,ATM Withdrawal,-313.1736743
9649,712532058,03-03-24 11:28,111.4,Purchase,Pharmacy,-424.5736743
9650,712532058,03-04-24 21:28,3450,IncomingTransfer,Salary,3025.426326
9651,712532058,03-07-24 20:28,355.51,Deposit,Mobile Deposit,3380.936326
9652,712532058,03-08-24 23:28,72.4,Purchase,Gas,3308.536326
9653,712532058,03-09-24 21:28,1400,Payment,Credit Card Payment,1908.536326
9654,712532058,03-11-24 9:28,276.11,Purchase,Furniture,1632.426326
9655,712532058,03-11-24 16:28,268.69,Return,eBay Return,1901.116326
9656,712532058,03-11-24 21:28,2000,Payment,Rent Payment,-98.8836743
9657,712532058,3-13-24 14:28,100.34,Payment,Loan Payment,-199.2236743
9658,712532058,3-15-24 18:28,49.22,Purchase,Home Improvement,-248.4436743
9659,712532058,3-19-24 19:28,68.76,Withdrawal,ATM Withdrawal,-317.2036743
9660,712532058,3-19-24 21:28,242.94,Payment,Bill Payment,-560.1436743
9661,712532058,3-23-24 15:28,167.62,Deposit,Mobile Deposit,-392.5236743
9662,712532058,3-24-24 16:28,118.44,Withdrawal,ATM Withdrawal,-510.9636743
9663,712532058,3-26-24 11:28,89.71,Deposit,Check Deposit,-421.2536743
9664,712532058,3-27-24 11:28,30.17,Deposit,Mobile Deposit,-391.0836743
9665,712532058,3-27-24 11:28,226.3,Deposit,Direct Deposit,-164.7836743
9666,712532058,3-30-24 18:28,146.68,Payment,Mortgage Payment,-311.4636743
9667,712532058,3-30-24 20:28,295.15,Payment,Bill Payment,-606.6136743
9668,712532058,3-30-24 22:28,232.92,IncomingTransfer,Freelance Payment,-373.6936743
9669,712532058,04-02-24 18:28,119.82,IncomingTransfer,Freelance Payment,-253.8736743
9670,712532058,04-02-24 21:28,3450,IncomingTransfer,Salary,3196.126326
9671,712532058,04-05-24 12:28,295.71,OnlineShopping,Target,2900.416326
9672,712532058,04-07-24 16:28,396.14,OnlineShopping,Etsy,2504.276326
9673,712532058,04-07-24 21:28,2000,Payment,Credit Card Payment,504.2763257
9674,712532058,04-09-24 14:28,251.95,OutgoingTransfer,Peer-to-Peer Transfer,252.3263257
9675,712532058,04-10-24 21:28,2200,Payment,Rent Payment,-1947.673674
9676,712532058,04-12-24 21:28,286.39,Deposit,Mobile Deposit,-1661.283674
9677,712532058,4-14-24 11:28,39.22,Withdrawal,Mobile App Withdrawal,-1700.503674
9678,712532058,4-16-24 13:28,189.04,Purchase,Clothing,-1889.543674
9679,712532058,4-16-24 22:28,111.84,Deposit,Cash Deposit,-1777.703674
9680,712532058,4-17-24 16:28,176.58,Deposit,Check Deposit,-1601.123674
9681,712532058,4-20-24 15:28,340.39,OnlineShopping,Amazon,-1941.513674
9682,712532058,4-21-24 12:28,362.89,IncomingTransfer,Freelance Payment,-1578.623674
9683,712532058,4-22-24 20:28,359.46,Return,Walmart Return,-1219.163674
9684,712532058,4-23-24 10:28,161.05,Deposit,Mobile Deposit,-1058.113674
9685,712532058,4-24-24 15:28,71.89,Purchase,Entertainment,-1130.003674
9686,712532058,4-28-24 14:28,384.53,Payment,Loan Payment,-1514.533674
9687,712532058,05-02-24 21:28,3450,IncomingTransfer,Salary,1935.466326
9688,712532058,05-03-24 13:28,122.04,Purchase,Entertainment,1813.426326
9689,712532058,05-04-24 20:28,92.22,Return,eBay Return,1905.646326
9690,712532058,05-06-24 11:28,100.31,Purchase,Clothing,1805.336326
9691,712532058,05-06-24 11:28,301.07,IncomingTransfer,Freelance Payment,2106.406326
9692,712532058,05-07-24 16:28,75.64,Deposit,Direct Deposit,2182.046326
9693,712532058,05-07-24 21:28,1800,Payment,Credit Card Payment,382.0463257
9694,712532058,05-08-24 23:28,274.57,OutgoingTransfer,Peer-to-Peer Transfer,107.4763257
9695,712532058,05-10-24 21:28,1300,Payment,Rent Payment,-1192.523674
9696,712532058,05-10-24 21:28,225.19,Payment,Bill Payment,-1417.713674
9697,712532058,05-12-24 18:28,152.45,Return,AliExpress Return,-1265.263674
9698,712532058,5-14-24 22:28,384.56,Return,Amazon Return,-880.7036743
9699,712532058,5-14-24 23:28,376.61,Payment,Mortgage Payment,-1257.313674
9700,712532058,5-18-24 12:28,26.21,Purchase,Home Improvement,-1283.523674
9701,712532058,5-18-24 18:28,112.25,Deposit,Mobile Deposit,-1171.273674
9702,712532058,5-21-24 11:28,217.28,Return,Target Return,-953.9936743
9703,712532058,5-21-24 23:28,144.81,Purchase,Electronics,-1098.803674
9704,712532058,5-22-24 20:28,252.41,Purchase,Pharmacy,-1351.213674
9705,712532058,5-26-24 11:28,185.26,OnlineShopping,eBay,-1536.473674
9706,712532058,5-27-24 11:28,333.03,Withdrawal,ATM Withdrawal,-1869.503674
9707,712532058,5-27-24 20:28,393.81,Purchase,Furniture,-2263.313674
9708,712532058,06-01-24 11:28,252.18,Deposit,Mobile Deposit,-2011.133674
9709,712532058,06-01-24 21:28,3450,IncomingTransfer,Salary,1438.866326
9710,712532058,06-02-24 18:28,239.68,Purchase,Furniture,1199.186326
9711,712532058,06-04-24 9:28,170.65,Deposit,Check Deposit,1369.836326
9712,712532058,06-04-24 14:28,252.9,OnlineShopping,Etsy,1116.936326
9713,712532058,06-06-24 21:28,1800,Payment,Credit Card Payment,-683.0636743
9714,712532058,06-08-24 18:28,168.39,Return,Walmart Return,-514.6736743
9715,712532058,06-09-24 12:28,138.63,Return,Etsy Return,-376.0436743
9716,712532058,06-10-24 14:28,248.44,Deposit,Mobile Deposit,-127.6036743
9717,712532058,06-10-24 21:28,1100,Payment,Rent Payment,-1227.603674
9718,712532058,06-11-24 12:28,64.52,Payment,Bill Payment,-1292.123674
9719,712532058,06-12-24 13:28,325.55,Return,AliExpress Return,-966.5736743
9720,712532058,6-15-24 16:28,118.86,Deposit,Direct Deposit,-847.7136743
9721,712532058,6-17-24 21:28,193.67,Payment,Bill Payment,-1041.383674
9722,712532058,6-18-24 12:28,39.74,OutgoingTransfer,Bank Transfer,-1081.123674
9723,712532058,6-19-24 12:28,160.38,Purchase,Pharmacy,-1241.503674
9724,712532058,6-20-24 9:28,263.22,Purchase,Home Improvement,-1504.723674
9725,712532058,6-22-24 10:28,373.29,Withdrawal,Branch Withdrawal,-1878.013674
9726,712532058,6-22-24 16:28,267.17,Withdrawal,ATM Withdrawal,-2145.183674
9727,712532058,6-23-24 16:28,90.35,Withdrawal,ATM Withdrawal,-2235.533674
9728,712532058,6-23-24 22:28,182.39,Payment,Mortgage Payment,-2417.923674
9729,712532058,6-25-24 11:28,243.15,Purchase,Furniture,-2661.073674
9730,712532058,6-26-24 23:28,192.59,Deposit,Check Deposit,-2468.483674
9731,712532058,6-27-24 17:28,86.62,Payment,Loan Payment,-2555.103674
9732,712532058,6-28-24 19:28,125.04,Return,Target Return,-2430.063674
9733,712532058,07-01-24 23:28,148.9,OnlineShopping,Walmart,-2578.963674
9734,712532058,07-03-24 21:28,3450,IncomingTransfer,Salary,871.0363257
9735,712532058,07-08-24 21:28,1800,Payment,Credit Card Payment,-928.9636743
9736,712532058,07-11-24 14:28,87.08,Return,Etsy Return,-841.8836743
9737,712532058,07-12-24 21:28,1700,Payment,Rent Payment,-2541.883674
9738,712532058,7-14-24 22:28,37.91,Withdrawal,Branch Withdrawal,-2579.793674
9739,712532058,7-15-24 21:28,91.45,Return,AliExpress Return,-2488.343674
9740,712563408,1-21-24 11:28,298.46,Deposit,Check Deposit,2143.239662
9741,712563408,1-21-24 15:28,390.25,Purchase,Electronics,1752.989662
9742,712563408,1-24-24 20:28,136.83,Purchase,Clothing,1616.159662
9743,712563408,1-31-24 15:28,240.69,Return,Target Return,1856.849662
9744,712563408,02-05-24 21:28,4950,IncomingTransfer,Salary,6806.849662
9745,712563408,02-07-24 17:28,120.23,Deposit,Check Deposit,6927.079662
9746,712563408,02-10-24 21:28,3300,Payment,Credit Card Payment,3627.079662
9747,712563408,2-13-24 20:28,391.01,OutgoingTransfer,International Transfer,3236.069662
9748,712563408,2-14-24 18:28,393.24,OutgoingTransfer,Bank Transfer,2842.829662
9749,712563408,2-15-24 21:28,1800,Payment,Installment Payment,1042.829662
9750,712563408,2-15-24 23:28,211.1,OnlineShopping,Amazon,831.7296624
9751,712563408,2-17-24 22:28,93.83,OutgoingTransfer,Peer-to-Peer Transfer,737.8996624
9752,712563408,2-26-24 12:28,147.13,IncomingTransfer,Freelance Payment,885.0296624
9753,712563408,03-03-24 21:28,4950,IncomingTransfer,Salary,5835.029662
9754,712563408,03-04-24 18:28,145.22,OutgoingTransfer,International Transfer,5689.809662
9755,712563408,03-05-24 20:28,97.94,Purchase,Entertainment,5591.869662
9756,712563408,03-08-24 21:28,3400,Payment,Credit Card Payment,2191.869662
9757,712563408,03-09-24 16:28,271.84,OnlineShopping,Best Buy,1920.029662
9758,712563408,03-12-24 12:28,285.67,Purchase,Clothing,1634.359662
9759,712563408,03-12-24 12:28,303.06,Deposit,Check Deposit,1937.419662
9760,712563408,3-16-24 15:28,303.61,Deposit,Direct Deposit,2241.029662
9761,712563408,3-16-24 21:28,1400,Payment,Installment Payment,841.0296624
9762,712563408,3-18-24 10:28,274.37,Deposit,Cash Deposit,1115.399662
9763,712563408,3-19-24 22:28,71.75,Return,Target Return,1187.149662
9764,712563408,3-24-24 20:28,234.35,Withdrawal,Mobile App Withdrawal,952.7996624
9765,712563408,3-28-24 19:28,301.19,Deposit,Direct Deposit,1253.989662
9766,712563408,3-29-24 9:28,153.4,Purchase,Home Improvement,1100.589662
9767,712563408,3-29-24 23:28,190.71,Purchase,Home Improvement,909.8796624
9768,712563408,04-02-24 21:28,4950,IncomingTransfer,Salary,5859.879662
9769,712563408,04-07-24 21:28,3400,Payment,Credit Card Payment,2459.879662
9770,712563408,4-15-24 15:28,384.89,Deposit,Cash Deposit,2844.769662
9771,712563408,4-17-24 21:28,2100,Payment,Installment Payment,744.7696624
9772,712563408,4-18-24 11:28,93.92,Withdrawal,ATM Withdrawal,650.8496624
9773,712563408,4-22-24 10:28,78.37,OutgoingTransfer,Wire Transfer,572.4796624
9774,712563408,4-22-24 23:28,361.05,OnlineShopping,Target,211.4296624
9775,712563408,4-25-24 15:28,317.62,Return,Best Buy Return,529.0496624
9776,712563408,4-27-24 12:28,48.23,Withdrawal,Branch Withdrawal,480.8196624
9777,712563408,4-29-24 12:28,273.16,Purchase,Restaurant,207.6596624
9778,712563408,05-01-24 21:28,4950,IncomingTransfer,Salary,5157.659662
9779,712563408,05-01-24 23:28,43.49,Purchase,Grocery,5114.169662
9780,712563408,05-05-24 22:28,122.58,OutgoingTransfer,Bank Transfer,4991.589662
9781,712563408,05-06-24 15:28,388.17,Return,Store Return,5379.759662
9782,712563408,05-06-24 21:28,3500,Payment,Credit Card Payment,1879.759662
9783,712563408,05-11-24 10:28,332.41,Withdrawal,Branch Withdrawal,1547.349662
9784,712563408,05-11-24 11:28,77.26,IncomingTransfer,Freelance Payment,1624.609662
9785,712563408,05-12-24 10:28,113.7,IncomingTransfer,Freelance Payment,1738.309662
9786,712563408,5-14-24 21:28,2200,Payment,Subscription Payment,-461.6903376
9787,712563408,5-16-24 11:28,383.36,OutgoingTransfer,Bank Transfer,-845.0503376
9788,712563408,5-27-24 15:28,308.95,OnlineShopping,Best Buy,-1154.000338
9789,712563408,06-02-24 12:28,338.05,OnlineShopping,Target,-1492.050338
9790,712563408,06-03-24 21:28,4950,IncomingTransfer,Salary,3457.949662
9791,712563408,06-08-24 21:28,3600,Payment,Credit Card Payment,-142.0503376
9792,712563408,6-14-24 21:28,1400,Payment,Insurance Payment,-1542.050338
9793,712563408,6-22-24 12:28,315.54,OnlineShopping,Amazon,-1857.590338
9794,712563408,6-27-24 11:28,331.84,Purchase,Electronics,-2189.430338
9795,712563408,6-27-24 14:28,205.71,Purchase,Electronics,-2395.140338
9796,712563408,6-29-24 17:28,332.67,Deposit,Check Deposit,-2062.470338
9797,712563408,07-02-24 21:28,4950,IncomingTransfer,Salary,2887.529662
9798,712563408,07-03-24 11:28,59.85,Deposit,Cash Deposit,2947.379662
9799,712563408,07-04-24 10:28,65.41,Withdrawal,Mobile App Withdrawal,2881.969662
9800,712563408,07-07-24 21:28,3500,Payment,Credit Card Payment,-618.0303376
9801,712563408,07-12-24 12:28,272.32,Payment,Mortgage Payment,-890.3503376
9802,712563408,7-13-24 21:28,1600,Payment,Subscription Payment,-2490.350338
9803,712563408,7-15-24 14:28,359.2,OutgoingTransfer,Wire Transfer,-2849.550338
9804,712571883,1-20-24 11:28,216.06,Withdrawal,Mobile App Withdrawal,812.4670767
9805,712571883,1-20-24 14:28,137.17,Deposit,Mobile Deposit,949.6370767
9806,712571883,1-21-24 17:28,199.71,Purchase,Travel,749.9270767
9807,712571883,1-24-24 21:28,243.94,OutgoingTransfer,Bank Transfer,505.9870767
9808,712571883,1-26-24 22:28,124.86,Payment,Mortgage Payment,381.1270767
9809,712571883,1-29-24 23:28,235.85,Return,Best Buy Return,616.9770767
9810,712571883,1-30-24 16:28,218.45,Purchase,Clothing,398.5270767
9811,712571883,1-30-24 17:28,112.5,Deposit,Check Deposit,511.0270767
9812,712571883,02-02-24 21:28,2450,IncomingTransfer,Salary,2961.027077
9813,712571883,02-03-24 21:28,232.65,Purchase,Gas,2728.377077
9814,712571883,02-05-24 22:28,159.66,Return,Amazon Return,2888.037077
9815,712571883,02-07-24 21:28,2100,Payment,Credit Card Payment,788.0370767
9816,712571883,02-09-24 20:28,84.05,Purchase,Furniture,703.9870767
9817,712571883,02-11-24 14:28,179.97,Withdrawal,ATM Withdrawal,524.0170767
9818,712571883,2-16-24 21:28,900,Payment,Installment Payment,-375.9829233
9819,712571883,2-17-24 10:28,141.87,OutgoingTransfer,Peer-to-Peer Transfer,-517.8529233
9820,712571883,03-01-24 21:28,191.62,OnlineShopping,AliExpress,-709.4729233
9821,712571883,03-05-24 21:28,2450,IncomingTransfer,Salary,1740.527077
9822,712571883,03-06-24 22:28,113.92,Payment,Mortgage Payment,1626.607077
9823,712571883,03-10-24 15:28,100.82,Deposit,Cash Deposit,1727.427077
9824,712571883,03-10-24 18:28,76.74,Return,Etsy Return,1804.167077
9825,712571883,03-10-24 21:28,1700,Payment,Credit Card Payment,104.1670767
9826,712571883,03-11-24 21:28,700,Payment,Subscription Payment,-595.8329233
9827,712571883,3-13-24 14:28,92.18,IncomingTransfer,Freelance Payment,-503.6529233
9828,712571883,3-13-24 22:28,50.09,OutgoingTransfer,Wire Transfer,-553.7429233
9829,712571883,3-23-24 20:28,142.79,IncomingTransfer,Freelance Payment,-410.9529233
9830,712571883,3-24-24 17:28,30.94,Purchase,Travel,-441.8929233
9831,712571883,3-27-24 20:28,239.25,Purchase,Home Improvement,-681.1429233
9832,712571883,3-30-24 14:28,185.66,OutgoingTransfer,International Transfer,-866.8029233
9833,712571883,04-02-24 13:28,209.39,Purchase,Grocery,-1076.192923
9834,712571883,04-04-24 21:28,2450,IncomingTransfer,Salary,1373.807077
9835,712571883,04-05-24 13:28,87.82,Deposit,Mobile Deposit,1461.627077
9836,712571883,04-08-24 22:28,55.41,Return,Best Buy Return,1517.037077
9837,712571883,04-09-24 21:28,2100,Payment,Credit Card Payment,-582.9629233
9838,712571883,04-12-24 20:28,53.06,Return,Store Return,-529.9029233
9839,712571883,4-13-24 14:28,220.93,Deposit,Mobile Deposit,-308.9729233
9840,712571883,4-14-24 21:28,700,Payment,Installment Payment,-1008.972923
9841,712571883,4-15-24 11:28,220.02,Deposit,Mobile Deposit,-788.9529233
9842,712571883,4-16-24 18:28,148.74,Withdrawal,ATM Withdrawal,-937.6929233
9843,712571883,4-17-24 16:28,17.3,OnlineShopping,Etsy,-954.9929233
9844,712571883,4-20-24 22:28,98.6,Purchase,Travel,-1053.592923
9845,712571883,4-22-24 9:28,248.76,Payment,Mortgage Payment,-1302.352923
9846,712571883,4-23-24 23:28,80.91,OutgoingTransfer,Wire Transfer,-1383.262923
9847,712571883,4-27-24 12:28,219.71,Return,Walmart Return,-1163.552923
9848,712571883,4-29-24 18:28,165.65,Withdrawal,ATM Withdrawal,-1329.202923
9849,712571883,05-03-24 15:28,11.42,Purchase,Furniture,-1340.622923
9850,712571883,05-03-24 21:28,2450,IncomingTransfer,Salary,1109.377077
9851,712571883,05-04-24 11:28,154.9,Purchase,Restaurant,954.4770767
9852,712571883,05-04-24 18:28,240.9,Payment,Loan Payment,713.5770767
9853,712571883,05-08-24 21:28,1900,Payment,Credit Card Payment,-1186.422923
9854,712571883,05-09-24 18:28,155.68,Return,Store Return,-1030.742923
9855,712571883,05-10-24 21:28,1000,Payment,Installment Payment,-2030.742923
9856,712571883,05-12-24 10:28,93.9,Deposit,Check Deposit,-1936.842923
9857,712571883,5-13-24 12:28,25.51,Deposit,Direct Deposit,-1911.332923
9858,712571883,5-21-24 13:28,44.9,Purchase,Restaurant,-1956.232923
9859,712571883,5-23-24 15:28,150.03,Withdrawal,Mobile App Withdrawal,-2106.262923
9860,712571883,5-23-24 16:28,31.77,Payment,Bill Payment,-2138.032923
9861,712571883,5-31-24 12:28,180.49,Purchase,Pharmacy,-2318.522923
9862,712571883,06-02-24 21:28,187.3,Deposit,Mobile Deposit,-2131.222923
9863,712571883,06-03-24 16:28,55.6,OutgoingTransfer,International Transfer,-2186.822923
9864,712571883,06-03-24 19:28,103.02,Purchase,Pharmacy,-2289.842923
9865,712571883,06-03-24 21:28,2450,IncomingTransfer,Salary,160.1570767
9866,712571883,06-08-24 10:28,249.28,Payment,Loan Payment,-89.12292335
9867,712571883,06-08-24 21:28,2300,Payment,Credit Card Payment,-2389.122923
9868,712571883,06-09-24 22:28,76.65,Deposit,Check Deposit,-2312.472923
9869,712571883,06-12-24 21:28,1100,Payment,Insurance Payment,-3412.472923
9870,712571883,6-14-24 12:28,154,IncomingTransfer,Freelance Payment,-3258.472923
9871,712571883,6-18-24 14:28,176.24,IncomingTransfer,Freelance Payment,-3082.232923
9872,712571883,6-24-24 15:28,234.67,OutgoingTransfer,Peer-to-Peer Transfer,-3316.902923
9873,712571883,07-02-24 12:28,152.93,Withdrawal,Branch Withdrawal,-3469.832923
9874,712571883,07-04-24 21:28,2450,IncomingTransfer,Salary,-1019.832923
9875,712571883,07-09-24 21:28,2300,Payment,Credit Card Payment,-3319.832923
9876,712571883,07-10-24 21:28,1100,Payment,Installment Payment,-4419.832923
9877,712571883,07-11-24 11:28,172.05,OnlineShopping,Etsy,-4591.882923
9878,712571883,07-12-24 15:28,186.02,Withdrawal,Mobile App Withdrawal,-4777.902923
9879,712571883,7-14-24 17:28,186.66,Withdrawal,ATM Withdrawal,-4964.562923
9880,712578933,1-24-24 11:28,195.4,OnlineShopping,Walmart,-195.4
9881,712578933,1-25-24 13:28,282.56,Payment,Mortgage Payment,-477.96
9882,712578933,1-28-24 14:28,305.73,Return,Store Return,-172.23
9883,712578933,02-02-24 21:28,4350,IncomingTransfer,Salary,4177.77
9884,712578933,02-03-24 17:28,306.93,Payment,Bill Payment,3870.84
9885,712578933,02-11-24 19:28,23.18,IncomingTransfer,Freelance Payment,3894.02
9886,712578933,02-12-24 15:28,291.4,Payment,Mortgage Payment,3602.62
9887,712578933,2-13-24 21:28,1400,Payment,Installment Payment,2202.62
9888,712578933,2-17-24 14:28,188.08,Payment,Loan Payment,2014.54
9889,712578933,2-20-24 21:28,137.04,OutgoingTransfer,International Transfer,1877.5
9890,712578933,2-21-24 13:28,100.35,Purchase,Gas,1777.15
9891,712578933,2-25-24 11:28,314.17,OutgoingTransfer,Bank Transfer,1462.98
9892,712578933,03-05-24 21:28,4350,IncomingTransfer,Salary,5812.98
9893,712578933,03-07-24 11:28,22.61,Purchase,Travel,5790.37
9894,712578933,03-10-24 21:28,1900,Payment,Subscription Payment,3890.37
9895,712578933,03-12-24 13:28,201.64,Payment,Mortgage Payment,3688.73
9896,712578933,3-14-24 23:28,283.92,OutgoingTransfer,Peer-to-Peer Transfer,3404.81
9897,712578933,3-21-24 10:28,237.7,Return,AliExpress Return,3642.51
9898,712578933,3-26-24 12:28,142.3,OnlineShopping,AliExpress,3500.21
9899,712578933,3-26-24 20:28,216.23,Purchase,Furniture,3283.98
9900,712578933,04-03-24 11:28,102.53,Payment,Mortgage Payment,3181.45
9901,712578933,04-03-24 21:28,4350,IncomingTransfer,Salary,7531.45
9902,712578933,04-04-24 21:28,99.36,OutgoingTransfer,International Transfer,7432.09
9903,712578933,04-08-24 20:28,55.19,Deposit,Mobile Deposit,7487.28
9904,712578933,04-09-24 17:28,46.49,Deposit,Cash Deposit,7533.77
9905,712578933,4-17-24 21:28,1500,Payment,Insurance Payment,6033.77
9906,712578933,4-20-24 17:28,311.12,Return,Best Buy Return,6344.89
9907,712578933,4-24-24 17:28,392.17,Purchase,Pharmacy,5952.72
9908,712578933,4-26-24 11:28,332.91,OutgoingTransfer,Peer-to-Peer Transfer,5619.81
9909,712578933,4-27-24 17:28,68.55,OnlineShopping,eBay,5551.26
9910,712578933,05-01-24 17:28,65.45,Deposit,Mobile Deposit,5616.71
9911,712578933,05-01-24 23:28,136.36,OutgoingTransfer,Wire Transfer,5480.35
9912,712578933,05-02-24 18:28,180.74,Payment,Bill Payment,5299.61
9913,712578933,05-04-24 11:28,121.39,Payment,Loan Payment,5178.22
9914,712578933,05-04-24 21:28,4350,IncomingTransfer,Salary,9528.22
9915,712578933,5-18-24 21:28,1400,Payment,Installment Payment,8128.22
9916,712578933,5-21-24 13:28,100.94,Withdrawal,Mobile App Withdrawal,8027.28
9917,712578933,5-26-24 19:28,215.98,OnlineShopping,Best Buy,7811.3
9918,712578933,5-28-24 21:28,185.22,OutgoingTransfer,Peer-to-Peer Transfer,7626.08
9919,712578933,5-31-24 21:28,311.27,OutgoingTransfer,International Transfer,7314.81
9920,712578933,06-01-24 21:28,4350,IncomingTransfer,Salary,11664.81
9921,712578933,06-02-24 17:28,253.12,Return,Etsy Return,11917.93
9922,712578933,6-13-24 10:28,206.1,OutgoingTransfer,Wire Transfer,11711.83
9923,712578933,6-14-24 12:28,134.17,Deposit,Direct Deposit,11846
9924,712578933,6-14-24 21:28,1200,Payment,Subscription Payment,10646
9925,712578933,6-19-24 11:28,87.14,OutgoingTransfer,Bank Transfer,10558.86
9926,712578933,6-25-24 13:28,238.34,Deposit,Check Deposit,10797.2
9927,712578933,6-30-24 20:28,142.83,IncomingTransfer,Freelance Payment,10940.03
9928,712578933,07-02-24 14:28,228.5,Deposit,Cash Deposit,11168.53
9929,712578933,07-03-24 21:28,4350,IncomingTransfer,Salary,15518.53
9930,712578933,07-03-24 22:28,69.93,Withdrawal,Mobile App Withdrawal,15448.6
9931,712578933,07-04-24 9:28,252.1,OutgoingTransfer,Wire Transfer,15196.5
9932,712578933,07-07-24 13:28,51.17,Deposit,Mobile Deposit,15247.67
9933,712578933,07-07-24 22:28,67.55,IncomingTransfer,Freelance Payment,15315.22
9934,712578933,7-13-24 18:28,360.3,Payment,Mortgage Payment,14954.92
9935,712578933,7-13-24 21:28,1200,Payment,Insurance Payment,13754.92
9936,712644483,1-20-24 18:28,170.8,OnlineShopping,Walmart,511.9639547
9937,712644483,1-20-24 19:28,473.87,Purchase,Home Improvement,38.09395471
9938,712644483,1-31-24 14:28,429.82,Payment,Loan Payment,-391.7260453
9939,712644483,02-02-24 14:28,310.3,Purchase,Pharmacy,-702.0260453
9940,712644483,02-02-24 21:28,5150,IncomingTransfer,Salary,4447.973955
9941,712644483,02-04-24 16:28,397.8,Return,Store Return,4845.773955
9942,712644483,02-04-24 18:28,541.04,Payment,Loan Payment,4304.733955
9943,712644483,02-06-24 18:28,463.57,OnlineShopping,AliExpress,3841.163955
9944,712644483,02-07-24 21:28,1500,Payment,Credit Card Payment,2341.163955
9945,712644483,02-09-24 16:28,454.35,Deposit,Cash Deposit,2795.513955
9946,712644483,02-10-24 13:28,220.78,Deposit,Direct Deposit,3016.293955
9947,712644483,02-10-24 16:28,278.85,Withdrawal,ATM Withdrawal,2737.443955
9948,712644483,02-10-24 16:28,116.94,Withdrawal,ATM Withdrawal,2620.503955
9949,712644483,2-14-24 21:28,2400,Payment,Rent Payment,220.5039547
9950,712644483,2-17-24 21:28,520.22,Purchase,Clothing,-299.7160453
9951,712644483,2-18-24 10:28,61.51,Withdrawal,ATM Withdrawal,-361.2260453
9952,712644483,2-18-24 12:28,103.76,Return,Walmart Return,-257.4660453
9953,712644483,2-26-24 15:28,147.18,Deposit,Cash Deposit,-110.2860453
9954,712644483,2-27-24 17:28,407.3,Return,Amazon Return,297.0139547
9955,712644483,03-02-24 21:28,5150,IncomingTransfer,Salary,5447.013955
9956,712644483,03-07-24 21:28,1700,Payment,Credit Card Payment,3747.013955
9957,712644483,03-11-24 21:28,2800,Payment,Rent Payment,947.0139547
9958,712644483,03-11-24 22:28,99.16,Withdrawal,Branch Withdrawal,847.8539547
9959,712644483,3-17-24 10:28,260.57,Deposit,Cash Deposit,1108.423955
9960,712644483,3-19-24 20:28,333.2,Return,Target Return,1441.623955
9961,712644483,3-19-24 21:28,139.89,Deposit,Direct Deposit,1581.513955
9962,712644483,3-23-24 22:28,498.9,Return,Store Return,2080.413955
9963,712644483,3-26-24 16:28,318.15,IncomingTransfer,Freelance Payment,2398.563955
9964,712644483,3-26-24 23:28,104.79,Purchase,Pharmacy,2293.773955
9965,712644483,3-27-24 13:28,472.65,Return,Amazon Return,2766.423955
9966,712644483,3-29-24 20:28,408.06,OutgoingTransfer,Bank Transfer,2358.363955
9967,712644483,3-29-24 21:28,518.38,Return,Best Buy Return,2876.743955
9968,712644483,04-01-24 10:28,458.02,Payment,Bill Payment,2418.723955
9969,712644483,04-01-24 21:28,5150,IncomingTransfer,Salary,7568.723955
9970,712644483,04-06-24 21:28,1500,Payment,Credit Card Payment,6068.723955
9971,712644483,04-10-24 16:28,121.47,IncomingTransfer,Freelance Payment,6190.193955
9972,712644483,04-10-24 21:28,3200,Payment,Rent Payment,2990.193955
9973,712644483,4-13-24 22:28,492.05,Payment,Loan Payment,2498.143955
9974,712644483,4-14-24 19:28,463.53,Purchase,Gas,2034.613955
9975,712644483,4-15-24 22:28,142.48,Payment,Bill Payment,1892.133955
9976,712644483,4-22-24 10:28,235.4,Payment,Bill Payment,1656.733955
9977,712644483,4-25-24 9:28,206,Deposit,Check Deposit,1862.733955
9978,712644483,4-27-24 21:28,471.02,Deposit,Cash Deposit,2333.753955
9979,712644483,4-28-24 16:28,66.34,IncomingTransfer,Freelance Payment,2400.093955
9980,712644483,4-28-24 18:28,297.48,OnlineShopping,Walmart,2102.613955
9981,712644483,05-03-24 21:28,5150,IncomingTransfer,Salary,7252.613955
9982,712644483,05-07-24 11:28,368.53,Deposit,Direct Deposit,7621.143955
9983,712644483,05-08-24 21:28,1300,Payment,Credit Card Payment,6321.143955
9984,712644483,05-11-24 15:28,543.48,Return,eBay Return,6864.623955
9985,712644483,05-12-24 22:28,243.33,IncomingTransfer,Freelance Payment,7107.953955
9986,712644483,5-15-24 16:28,354.96,OutgoingTransfer,International Transfer,6752.993955
9987,712644483,5-15-24 18:28,262.46,OutgoingTransfer,Bank Transfer,6490.533955
9988,712644483,5-18-24 13:28,70.57,Purchase,Furniture,6419.963955
9989,712644483,5-18-24 21:28,2400,Payment,Rent Payment,4019.963955
9990,712644483,5-28-24 21:28,135.23,Deposit,Check Deposit,4155.193955
9991,712644483,5-29-24 22:28,433.12,Purchase,Grocery,3722.073955
9992,712644483,06-04-24 18:28,459.59,IncomingTransfer,Freelance Payment,4181.663955
9993,712644483,06-04-24 21:28,5150,IncomingTransfer,Salary,9331.663955
9994,712644483,06-05-24 21:28,58.12,OutgoingTransfer,International Transfer,9273.543955
9995,712644483,06-09-24 17:28,200.62,OutgoingTransfer,Wire Transfer,9072.923955
9996,712644483,06-09-24 21:28,1300,Payment,Credit Card Payment,7772.923955
9997,712644483,06-10-24 18:28,329.63,Purchase,Travel,7443.293955
9998,712644483,06-10-24 21:28,2700,Payment,Rent Payment,4743.293955
9999,712644483,06-12-24 13:28,132.02,Payment,Loan Payment,4611.273955
10000,712644483,6-16-24 18:28,401.54,OnlineShopping,eBay,4209.733955
10001,712644483,6-18-24 14:28,402.22,OutgoingTransfer,Bank Transfer,3807.513955
10002,712644483,6-19-24 15:28,401.73,OutgoingTransfer,Wire Transfer,3405.783955
10003,712644483,6-19-24 19:28,203.15,Payment,Bill Payment,3202.633955
10004,712644483,6-20-24 17:28,56.44,Purchase,Entertainment,3146.193955
10005,712644483,6-23-24 18:28,374.84,Return,eBay Return,3521.033955
10006,712644483,6-30-24 13:28,211.21,Return,Walmart Return,3732.243955
10007,712644483,07-01-24 18:28,119,Purchase,Home Improvement,3613.243955
10008,712644483,07-02-24 17:28,181.3,Deposit,Cash Deposit,3794.543955
10009,712644483,07-02-24 21:28,5150,IncomingTransfer,Salary,8944.543955
10010,712644483,07-06-24 11:28,126.41,Deposit,Mobile Deposit,9070.953955
10011,712644483,07-07-24 14:28,486.26,OnlineShopping,Etsy,8584.693955
10012,712644483,07-07-24 19:28,463.51,Return,Amazon Return,9048.203955
10013,712644483,07-07-24 21:28,1300,Payment,Credit Card Payment,7748.203955
10014,712644483,07-11-24 14:28,166.61,Purchase,Clothing,7581.593955
10015,712644483,7-17-24 21:28,2500,Payment,Rent Payment,5081.593955
10016,712660308,1-25-24 11:28,117.35,Purchase,Furniture,-117.35
10017,712660308,1-26-24 14:28,78.31,Deposit,Mobile Deposit,-39.04
10018,712660308,1-30-24 19:28,143.24,Purchase,Clothing,-182.28
10019,712660308,1-31-24 10:28,235.98,Deposit,Check Deposit,53.7
10020,712660308,02-03-24 12:28,112.46,Deposit,Check Deposit,166.16
10021,712660308,02-04-24 21:28,2450,IncomingTransfer,Salary,2616.16
10022,712660308,02-05-24 11:28,247.09,OnlineShopping,Amazon,2369.07
10023,712660308,02-11-24 22:28,141.9,Return,Best Buy Return,2510.97
10024,712660308,2-13-24 13:28,137.03,Purchase,Clothing,2373.94
10025,712660308,2-14-24 12:28,146.64,Deposit,Direct Deposit,2520.58
10026,712660308,2-15-24 21:28,800,Payment,Rent Payment,1720.58
10027,712660308,2-18-24 12:28,143.68,Purchase,Home Improvement,1576.9
10028,712660308,2-20-24 13:28,57.33,Return,Amazon Return,1634.23
10029,712660308,2-22-24 9:28,147.14,Deposit,Check Deposit,1781.37
10030,712660308,2-24-24 19:28,27.11,Deposit,Check Deposit,1808.48
10031,712660308,2-29-24 23:28,41.18,OutgoingTransfer,Wire Transfer,1767.3
10032,712660308,03-02-24 20:28,13.48,Return,AliExpress Return,1780.78
10033,712660308,03-05-24 21:28,2450,IncomingTransfer,Salary,4230.78
10034,712660308,03-08-24 20:28,39.72,Payment,Bill Payment,4191.06
10035,712660308,3-14-24 17:28,60.08,Return,Target Return,4251.14
10036,712660308,3-15-24 11:28,153.87,OutgoingTransfer,Bank Transfer,4097.27
10037,712660308,3-15-24 21:28,900,Payment,Rent Payment,3197.27
10038,712660308,3-23-24 17:28,140.06,Payment,Loan Payment,3057.21
10039,712660308,04-03-24 21:28,2450,IncomingTransfer,Salary,5507.21
10040,712660308,4-15-24 14:28,43.87,Return,AliExpress Return,5551.08
10041,712660308,4-16-24 21:28,700,Payment,Rent Payment,4851.08
10042,712660308,4-24-24 9:28,211.66,Withdrawal,ATM Withdrawal,4639.42
10043,712660308,4-26-24 23:28,64.25,Purchase,Clothing,4575.17
10044,712660308,4-27-24 12:28,203.81,Withdrawal,Branch Withdrawal,4371.36
10045,712660308,4-27-24 13:28,54.59,Purchase,Furniture,4316.77
10046,712660308,4-28-24 16:28,82.26,OnlineShopping,Etsy,4234.51
10047,712660308,4-28-24 22:28,67.72,OutgoingTransfer,Peer-to-Peer Transfer,4166.79
10048,712660308,4-29-24 14:28,211.89,Withdrawal,Mobile App Withdrawal,3954.9
10049,712660308,4-30-24 15:28,95.96,Return,Best Buy Return,4050.86
10050,712660308,05-02-24 21:28,2450,IncomingTransfer,Salary,6500.86
10051,712660308,5-13-24 9:28,101.51,OnlineShopping,AliExpress,6399.35
10052,712660308,5-13-24 21:28,1600,Payment,Rent Payment,4799.35
10053,712660308,5-21-24 20:28,113,Purchase,Gas,4686.35
10054,712660308,5-23-24 23:28,48.49,Purchase,Electronics,4637.86
10055,712660308,5-29-24 21:28,181.67,Deposit,Direct Deposit,4819.53
10056,712660308,5-30-24 16:28,102.43,Withdrawal,Mobile App Withdrawal,4717.1
10057,712660308,06-01-24 21:28,2450,IncomingTransfer,Salary,7167.1
10058,712660308,06-10-24 21:28,1200,Payment,Rent Payment,5967.1
10059,712660308,6-13-24 18:28,90.6,Purchase,Clothing,5876.5
10060,712660308,6-22-24 21:28,196.85,Deposit,Mobile Deposit,6073.35
10061,712660308,6-22-24 22:28,141.25,Return,eBay Return,6214.6
10062,712660308,6-25-24 18:28,214.53,Return,Walmart Return,6429.13
10063,712660308,07-01-24 21:28,234.51,Return,Etsy Return,6663.64
10064,712660308,07-03-24 17:28,191.39,OutgoingTransfer,International Transfer,6472.25
10065,712660308,07-03-24 21:28,2450,IncomingTransfer,Salary,8922.25
10066,712660308,07-07-24 10:28,202.03,Deposit,Check Deposit,9124.28
10067,712660308,7-18-24 21:28,1500,Payment,Rent Payment,7624.28
10068,712683633,1-22-24 22:28,168.99,Return,AliExpress Return,168.99
10069,712683633,1-23-24 11:28,245.44,Deposit,Direct Deposit,414.43
10070,712683633,1-27-24 21:28,138.53,OnlineShopping,Amazon,275.9
10071,712683633,1-30-24 19:28,186.53,Purchase,Grocery,89.37
10072,712683633,02-02-24 21:28,2800,IncomingTransfer,Salary,2889.37
10073,712683633,02-04-24 19:28,37.28,Deposit,Cash Deposit,2926.65
10074,712683633,02-07-24 11:28,222.55,Return,Etsy Return,3149.2
10075,712683633,02-07-24 19:28,237.68,OnlineShopping,AliExpress,2911.52
10076,712683633,02-08-24 23:28,73.24,Return,Etsy Return,2984.76
10077,712683633,02-11-24 11:28,15.58,Purchase,Electronics,2969.18
10078,712683633,02-12-24 21:28,900,Payment,Subscription Payment,2069.18
10079,712683633,2-20-24 17:28,182.39,Deposit,Check Deposit,2251.57
10080,712683633,2-21-24 18:28,224.58,Return,eBay Return,2476.15
10081,712683633,2-26-24 10:28,136.9,Return,Target Return,2613.05
10082,712683633,03-02-24 13:28,87.24,Payment,Loan Payment,2525.81
10083,712683633,03-05-24 21:28,2800,IncomingTransfer,Salary,5325.81
10084,712683633,03-08-24 10:28,212.19,Withdrawal,Mobile App Withdrawal,5113.62
10085,712683633,3-14-24 21:28,144.23,Purchase,Home Improvement,4969.39
10086,712683633,3-15-24 14:28,71.6,Deposit,Mobile Deposit,5040.99
10087,712683633,3-18-24 21:28,1000,Payment,Insurance Payment,4040.99
10088,712683633,04-03-24 21:28,2800,IncomingTransfer,Salary,6840.99
10089,712683633,04-04-24 13:28,226.01,Deposit,Check Deposit,7067
10090,712683633,04-10-24 13:28,234.24,Return,Etsy Return,7301.24
10091,712683633,4-15-24 14:28,162.48,IncomingTransfer,Freelance Payment,7463.72
10092,712683633,4-15-24 21:28,1100,Payment,Installment Payment,6363.72
10093,712683633,4-17-24 12:28,105.65,Purchase,Electronics,6258.07
10094,712683633,4-20-24 13:28,173.28,Deposit,Check Deposit,6431.35
10095,712683633,4-24-24 10:28,148.97,Withdrawal,Mobile App Withdrawal,6282.38
10096,712683633,05-01-24 21:28,2800,IncomingTransfer,Salary,9082.38
10097,712683633,05-02-24 22:28,129.12,OutgoingTransfer,Peer-to-Peer Transfer,8953.26
10098,712683633,5-14-24 14:28,113.21,Payment,Mortgage Payment,8840.05
10099,712683633,5-15-24 18:28,78.3,OutgoingTransfer,Bank Transfer,8761.75
10100,712683633,5-17-24 21:28,700,Payment,Subscription Payment,8061.75
10101,712683633,5-25-24 17:28,208.96,Purchase,Clothing,7852.79
10102,712683633,5-26-24 13:28,243.15,Purchase,Electronics,7609.64
10103,712683633,5-28-24 11:28,223.57,Purchase,Entertainment,7386.07
10104,712683633,5-28-24 22:28,219.3,Deposit,Mobile Deposit,7605.37
10105,712683633,5-30-24 13:28,223.79,OnlineShopping,eBay,7381.58
10106,712683633,06-03-24 18:28,58.44,Purchase,Home Improvement,7323.14
10107,712683633,06-03-24 21:28,2800,IncomingTransfer,Salary,10123.14
10108,712683633,06-09-24 20:28,116.13,Purchase,Furniture,10007.01
10109,712683633,06-11-24 14:28,46.88,Payment,Bill Payment,9960.13
10110,712683633,6-16-24 14:28,125.2,Return,Best Buy Return,10085.33
10111,712683633,6-17-24 21:28,700,Payment,Installment Payment,9385.33
10112,712683633,6-25-24 10:28,199.91,OutgoingTransfer,Peer-to-Peer Transfer,9185.42
10113,712683633,07-03-24 21:28,2800,IncomingTransfer,Salary,11985.42
10114,712683633,07-04-24 20:28,78.8,Purchase,Grocery,11906.62
10115,712683633,7-17-24 12:28,38.46,OnlineShopping,Target,11868.16
10116,712683633,7-18-24 21:28,700,Payment,Subscription Payment,11168.16
10117,712788258,1-27-24 11:28,74.4,Return,Etsy Return,1016.574319
10118,712788258,1-27-24 13:28,197.05,OnlineShopping,Best Buy,819.5243185
10119,712788258,02-01-24 15:28,240.14,Deposit,Mobile Deposit,1059.664319
10120,712788258,02-05-24 21:28,3700,IncomingTransfer,Salary,4759.664319
10121,712788258,02-07-24 19:28,168.71,OutgoingTransfer,Wire Transfer,4590.954319
10122,712788258,02-10-24 21:28,2100,Payment,Credit Card Payment,2490.954319
10123,712788258,02-11-24 10:28,283.82,Purchase,Electronics,2207.134319
10124,712788258,2-13-24 10:28,211.23,Withdrawal,Mobile App Withdrawal,1995.904319
10125,712788258,2-13-24 13:28,275.05,OutgoingTransfer,International Transfer,1720.854319
10126,712788258,2-15-24 21:28,1600,Payment,Rent Payment,120.8543185
10127,712788258,2-17-24 16:28,256.1,Purchase,Home Improvement,-135.2456815
10128,712788258,2-20-24 17:28,263.19,OutgoingTransfer,Bank Transfer,-398.4356815
10129,712788258,2-24-24 10:28,342.45,IncomingTransfer,Freelance Payment,-55.98568147
10130,712788258,2-24-24 12:28,211.7,Payment,Bill Payment,-267.6856815
10131,712788258,2-24-24 18:28,299.55,Purchase,Pharmacy,-567.2356815
10132,712788258,2-25-24 16:28,160.1,Withdrawal,ATM Withdrawal,-727.3356815
10133,712788258,2-25-24 19:28,392.09,OnlineShopping,eBay,-1119.425681
10134,712788258,2-27-24 21:28,339.89,OnlineShopping,Amazon,-1459.315681
10135,712788258,03-01-24 10:28,120.27,Deposit,Check Deposit,-1339.045681
10136,712788258,03-02-24 21:28,3700,IncomingTransfer,Salary,2360.954319
10137,712788258,03-03-24 16:28,206.31,Purchase,Pharmacy,2154.644319
10138,712788258,03-04-24 16:28,155.38,Deposit,Cash Deposit,2310.024319
10139,712788258,03-07-24 21:28,2100,Payment,Credit Card Payment,210.0243185
10140,712788258,03-10-24 21:28,2000,Payment,Rent Payment,-1789.975681
10141,712788258,03-12-24 10:28,41.22,OutgoingTransfer,Wire Transfer,-1831.195681
10142,712788258,3-14-24 10:28,47.24,Purchase,Restaurant,-1878.435681
10143,712788258,3-14-24 21:28,189.45,Return,Etsy Return,-1688.985681
10144,712788258,3-15-24 12:28,224.58,Withdrawal,Branch Withdrawal,-1913.565681
10145,712788258,3-17-24 10:28,387.23,Return,Store Return,-1526.335681
10146,712788258,3-19-24 20:28,88.65,OnlineShopping,eBay,-1614.985681
10147,712788258,3-23-24 22:28,118.99,Deposit,Direct Deposit,-1495.995681
10148,712788258,3-28-24 18:28,339.05,Withdrawal,Branch Withdrawal,-1835.045681
10149,712788258,3-28-24 21:28,334.47,Payment,Mortgage Payment,-2169.515681
10150,712788258,3-30-24 10:28,33.5,Purchase,Furniture,-2203.015681
10151,712788258,3-30-24 15:28,339.09,Purchase,Restaurant,-2542.105681
10152,712788258,3-30-24 18:28,145.01,Purchase,Restaurant,-2687.115681
10153,712788258,3-31-24 17:28,292.88,Return,Store Return,-2394.235681
10154,712788258,04-05-24 21:28,3700,IncomingTransfer,Salary,1305.764319
10155,712788258,04-10-24 21:28,1400,Payment,Credit Card Payment,-94.23568147
10156,712788258,04-10-24 21:28,1400,Payment,Rent Payment,-1494.235681
10157,712788258,04-12-24 19:28,290.48,OutgoingTransfer,Bank Transfer,-1784.715681
10158,712788258,4-13-24 19:28,132.2,Purchase,Furniture,-1916.915681
10159,712788258,4-14-24 22:28,100.05,Return,Store Return,-1816.865681
10160,712788258,4-16-24 22:28,57.49,OutgoingTransfer,Bank Transfer,-1874.355681
10161,712788258,4-18-24 15:28,38.98,IncomingTransfer,Freelance Payment,-1835.375681
10162,712788258,4-19-24 20:28,254.9,Payment,Mortgage Payment,-2090.275681
10163,712788258,4-21-24 15:28,130.31,IncomingTransfer,Freelance Payment,-1959.965681
10164,712788258,4-22-24 13:28,75.81,OnlineShopping,Best Buy,-2035.775681
10165,712788258,4-22-24 21:28,319.14,IncomingTransfer,Freelance Payment,-1716.635681
10166,712788258,4-23-24 13:28,321.05,Deposit,Mobile Deposit,-1395.585681
10167,712788258,4-23-24 15:28,320.98,Deposit,Mobile Deposit,-1074.605681
10168,712788258,4-28-24 15:28,145.06,Deposit,Direct Deposit,-929.5456815
10169,712788258,05-01-24 21:28,237.84,Withdrawal,ATM Withdrawal,-1167.385681
10170,712788258,05-03-24 15:28,251.32,Purchase,Home Improvement,-1418.705681
10171,712788258,05-03-24 21:28,3700,IncomingTransfer,Salary,2281.294319
10172,712788258,05-06-24 9:28,274.54,Withdrawal,Mobile App Withdrawal,2006.754319
10173,712788258,05-07-24 14:28,392.19,Purchase,Clothing,1614.564319
10174,712788258,05-08-24 21:28,1500,Payment,Credit Card Payment,114.5643185
10175,712788258,05-09-24 15:28,276.14,Deposit,Mobile Deposit,390.7043185
10176,712788258,05-11-24 18:28,346.59,OnlineShopping,Etsy,44.11431853
10177,712788258,5-13-24 20:28,90.38,Payment,Bill Payment,-46.26568147
10178,712788258,5-16-24 21:28,900,Payment,Rent Payment,-946.2656815
10179,712788258,5-17-24 12:28,286.3,Return,eBay Return,-659.9656815
10180,712788258,5-21-24 19:28,381.25,Purchase,Entertainment,-1041.215681
10181,712788258,5-23-24 13:28,65.01,Deposit,Cash Deposit,-976.2056815
10182,712788258,5-25-24 14:28,62.08,Return,Store Return,-914.1256815
10183,712788258,5-26-24 14:28,347.94,OutgoingTransfer,International Transfer,-1262.065681
10184,712788258,5-28-24 17:28,367.75,Deposit,Direct Deposit,-894.3156815
10185,712788258,5-30-24 9:28,60.5,OutgoingTransfer,Peer-to-Peer Transfer,-954.8156815
10186,712788258,5-31-24 14:28,92.03,OnlineShopping,Target,-1046.845681
10187,712788258,5-31-24 19:28,263.81,Deposit,Check Deposit,-783.0356815
10188,712788258,06-01-24 20:28,66.56,Return,Best Buy Return,-716.4756815
10189,712788258,06-05-24 21:28,3700,IncomingTransfer,Salary,2983.524319
10190,712788258,06-06-24 11:28,361.65,OutgoingTransfer,Wire Transfer,2621.874319
10191,712788258,06-09-24 20:28,268.48,Purchase,Travel,2353.394319
10192,712788258,06-10-24 21:28,1400,Payment,Credit Card Payment,953.3943185
10193,712788258,06-10-24 21:28,1000,Payment,Rent Payment,-46.60568147
10194,712788258,6-15-24 10:28,72.1,Payment,Mortgage Payment,-118.7056815
10195,712788258,6-19-24 17:28,309.61,Withdrawal,ATM Withdrawal,-428.3156815
10196,712788258,6-20-24 13:28,72.62,Payment,Loan Payment,-500.9356815
10197,712788258,6-20-24 16:28,333.22,Payment,Bill Payment,-834.1556815
10198,712788258,6-22-24 20:28,71.02,IncomingTransfer,Freelance Payment,-763.1356815
10199,712788258,6-26-24 9:28,128.44,Deposit,Mobile Deposit,-634.6956815
10200,712788258,6-26-24 15:28,365.14,OutgoingTransfer,Wire Transfer,-999.8356815
10201,712788258,6-29-24 18:28,218.53,Purchase,Restaurant,-1218.365681
10202,712788258,6-30-24 14:28,238.87,Purchase,Restaurant,-1457.235681
10203,712788258,6-30-24 15:28,292.51,Return,Etsy Return,-1164.725681
10204,712788258,6-30-24 17:28,266.61,OnlineShopping,Best Buy,-1431.335681
10205,712788258,6-30-24 19:28,383.18,OnlineShopping,Amazon,-1814.515681
10206,712788258,07-01-24 21:28,3700,IncomingTransfer,Salary,1885.484319
10207,712788258,07-02-24 19:28,318.84,OnlineShopping,Amazon,1566.644319
10208,712788258,07-03-24 17:28,224.26,Withdrawal,ATM Withdrawal,1342.384319
10209,712788258,07-04-24 16:28,248.51,Purchase,Home Improvement,1093.874319
10210,712788258,07-06-24 21:28,1900,Payment,Credit Card Payment,-806.1256815
10211,712788258,07-09-24 9:28,142.05,Deposit,Mobile Deposit,-664.0756815
10212,712788258,7-15-24 11:28,77.03,OutgoingTransfer,Peer-to-Peer Transfer,-741.1056815
10213,712788258,7-15-24 17:28,285.18,IncomingTransfer,Freelance Payment,-455.9256815
10214,712788258,7-18-24 21:28,1200,Payment,Rent Payment,-1655.925681
10215,712813458,02-01-24 23:28,625.55,OutgoingTransfer,Bank Transfer,1487.707578
10216,712813458,02-04-24 12:28,460.12,Purchase,Furniture,1027.587578
10217,712813458,02-05-24 19:28,564.47,Deposit,Cash Deposit,1592.057578
10218,712813458,02-05-24 21:28,15350,IncomingTransfer,Salary,16942.05758
10219,712813458,02-08-24 16:28,399.99,Purchase,Electronics,16542.06758
10220,712813458,02-09-24 19:28,606.1,OutgoingTransfer,Peer-to-Peer Transfer,15935.96758
10221,712813458,02-10-24 21:28,2700,Payment,Credit Card Payment,13235.96758
10222,712813458,02-12-24 12:28,772,Deposit,Mobile Deposit,14007.96758
10223,712813458,2-15-24 21:28,6800,Payment,Rent Payment,7207.967578
10224,712813458,2-15-24 23:28,692.45,Return,Store Return,7900.417578
10225,712813458,2-17-24 11:28,564.2,Withdrawal,ATM Withdrawal,7336.217578
10226,712813458,2-28-24 17:28,453.77,OnlineShopping,Etsy,6882.447578
10227,712813458,2-29-24 22:28,271.69,Withdrawal,Branch Withdrawal,6610.757578
10228,712813458,03-02-24 14:28,720.86,Withdrawal,ATM Withdrawal,5889.897578
10229,712813458,03-03-24 22:28,637.76,OutgoingTransfer,Peer-to-Peer Transfer,5252.137578
10230,712813458,03-05-24 21:28,15350,IncomingTransfer,Salary,20602.13758
10231,712813458,03-07-24 9:28,611.38,Deposit,Check Deposit,21213.51758
10232,712813458,03-08-24 22:28,775.12,Return,Store Return,21988.63758
10233,712813458,03-10-24 21:28,3600,Payment,Credit Card Payment,18388.63758
10234,712813458,3-17-24 22:28,507.09,Purchase,Furniture,17881.54758
10235,712813458,3-18-24 21:28,9100,Payment,Rent Payment,8781.547578
10236,712813458,3-20-24 14:28,458.82,OnlineShopping,eBay,8322.727578
10237,712813458,3-24-24 18:28,492.04,OnlineShopping,Best Buy,7830.687578
10238,712813458,3-27-24 20:28,802.48,Payment,Bill Payment,7028.207578
10239,712813458,3-28-24 22:28,277.77,Deposit,Mobile Deposit,7305.977578
10240,712813458,3-31-24 18:28,704.91,OutgoingTransfer,Peer-to-Peer Transfer,6601.067578
10241,712813458,04-05-24 21:28,15350,IncomingTransfer,Salary,21951.06758
10242,712813458,04-07-24 16:28,400.89,OutgoingTransfer,Bank Transfer,21550.17758
10243,712813458,04-10-24 21:28,2700,Payment,Credit Card Payment,18850.17758
10244,712813458,04-10-24 21:28,6500,Payment,Rent Payment,12350.17758
10245,712813458,4-14-24 10:28,554.74,Payment,Mortgage Payment,11795.43758
10246,712813458,4-24-24 12:28,248.21,Deposit,Cash Deposit,12043.64758
10247,712813458,4-25-24 16:28,824.75,Deposit,Direct Deposit,12868.39758
10248,712813458,4-30-24 12:28,755.93,Purchase,Home Improvement,12112.46758
10249,712813458,05-04-24 21:28,15350,IncomingTransfer,Salary,27462.46758
10250,712813458,05-09-24 21:28,3600,Payment,Credit Card Payment,23862.46758
10251,712813458,5-13-24 21:28,8300,Payment,Rent Payment,15562.46758
10252,712813458,5-16-24 23:28,418.09,Deposit,Check Deposit,15980.55758
10253,712813458,5-27-24 13:28,913.38,Purchase,Restaurant,15067.17758
10254,712813458,06-05-24 21:28,15350,IncomingTransfer,Salary,30417.17758
10255,712813458,06-10-24 20:28,810.78,Deposit,Cash Deposit,31227.95758
10256,712813458,06-10-24 21:28,3700,Payment,Credit Card Payment,27527.95758
10257,712813458,06-10-24 21:28,9200,Payment,Rent Payment,18327.95758
10258,712813458,6-22-24 22:28,774.07,IncomingTransfer,Freelance Payment,19102.02758
10259,712813458,6-24-24 18:28,779.77,Purchase,Grocery,18322.25758
10260,712813458,6-24-24 21:28,265.48,Withdrawal,ATM Withdrawal,18056.77758
10261,712813458,6-26-24 16:28,760.86,OutgoingTransfer,Peer-to-Peer Transfer,17295.91758
10262,712813458,07-02-24 21:28,15350,IncomingTransfer,Salary,32645.91758
10263,712813458,07-04-24 9:28,575.57,Deposit,Direct Deposit,33221.48758
10264,712813458,07-07-24 21:28,3500,Payment,Credit Card Payment,29721.48758
10265,712813458,07-11-24 21:28,4600,Payment,Rent Payment,25121.48758
10266,712813458,7-13-24 14:28,748.9,Deposit,Direct Deposit,25870.38758
10267,712813458,7-15-24 21:28,752.14,Withdrawal,Branch Withdrawal,25118.24758
10268,712829808,1-21-24 15:28,496.16,Return,Store Return,496.16
10269,712829808,1-22-24 12:28,222.22,Purchase,Electronics,273.94
10270,712829808,1-22-24 12:28,272.08,Return,Best Buy Return,546.02
10271,712829808,1-24-24 17:28,165.46,Deposit,Cash Deposit,711.48
10272,712829808,1-26-24 14:28,426.28,Deposit,Mobile Deposit,1137.76
10273,712829808,1-29-24 14:28,481.51,OnlineShopping,AliExpress,656.25
10274,712829808,1-31-24 11:28,333.29,OutgoingTransfer,Wire Transfer,322.96
10275,712829808,02-02-24 12:28,336.49,Withdrawal,ATM Withdrawal,-13.53
10276,712829808,02-03-24 21:28,5750,IncomingTransfer,Salary,5736.47
10277,712829808,02-04-24 19:28,328.06,Withdrawal,ATM Withdrawal,5408.41
10278,712829808,02-06-24 9:28,176.23,Payment,Mortgage Payment,5232.18
10279,712829808,2-13-24 14:28,365.01,Withdrawal,Branch Withdrawal,4867.17
10280,712829808,2-15-24 21:28,1600,Payment,Installment Payment,3267.17
10281,712829808,2-20-24 9:28,119.61,IncomingTransfer,Freelance Payment,3386.78
10282,712829808,2-25-24 11:28,207.9,OutgoingTransfer,Bank Transfer,3178.88
10283,712829808,03-01-24 21:28,5750,IncomingTransfer,Salary,8928.88
10284,712829808,03-02-24 21:28,386.6,Payment,Bill Payment,8542.28
10285,712829808,03-07-24 14:28,455.69,IncomingTransfer,Freelance Payment,8997.97
10286,712829808,03-07-24 22:28,351.62,IncomingTransfer,Freelance Payment,9349.59
10287,712829808,03-07-24 23:28,325.44,Deposit,Mobile Deposit,9675.03
10288,712829808,03-12-24 9:28,180.2,OutgoingTransfer,Bank Transfer,9494.83
10289,712829808,03-12-24 15:28,139.46,Payment,Bill Payment,9355.37
10290,712829808,3-18-24 21:28,1800,Payment,Installment Payment,7555.37
10291,712829808,3-20-24 14:28,80.01,IncomingTransfer,Freelance Payment,7635.38
10292,712829808,3-26-24 18:28,367.76,Return,Walmart Return,8003.14
10293,712829808,3-28-24 17:28,508.82,Purchase,Pharmacy,7494.32
10294,712829808,04-01-24 10:28,497.4,Withdrawal,Mobile App Withdrawal,6996.92
10295,712829808,04-01-24 21:28,5750,IncomingTransfer,Salary,12746.92
10296,712829808,04-03-24 21:28,446.23,Purchase,Clothing,12300.69
10297,712829808,04-08-24 19:28,523.98,Purchase,Home Improvement,11776.71
10298,712829808,04-08-24 23:28,316.23,OutgoingTransfer,Bank Transfer,11460.48
10299,712829808,04-12-24 21:28,2500,Payment,Insurance Payment,8960.48
10300,712829808,4-13-24 19:28,95.93,OnlineShopping,Etsy,8864.55
10301,712829808,4-17-24 19:28,199.86,Payment,Loan Payment,8664.69
10302,712829808,4-29-24 23:28,539.72,IncomingTransfer,Freelance Payment,9204.41
10303,712829808,05-03-24 21:28,5750,IncomingTransfer,Salary,14954.41
10304,712829808,05-04-24 17:28,452.75,Withdrawal,Branch Withdrawal,14501.66
10305,712829808,05-10-24 11:28,181.38,OutgoingTransfer,Wire Transfer,14320.28
10306,712829808,05-11-24 18:28,380.63,OnlineShopping,eBay,13939.65
10307,712829808,5-13-24 21:28,2400,Payment,Installment Payment,11539.65
10308,712829808,5-20-24 16:28,465.6,OutgoingTransfer,Wire Transfer,11074.05
10309,712829808,06-01-24 20:28,548.92,Deposit,Check Deposit,11622.97
10310,712829808,06-04-24 20:28,230.61,OutgoingTransfer,International Transfer,11392.36
10311,712829808,06-05-24 21:28,5750,IncomingTransfer,Salary,17142.36
10312,712829808,06-06-24 16:28,198.38,Purchase,Restaurant,16943.98
10313,712829808,06-12-24 21:28,2500,Payment,Insurance Payment,14443.98
10314,712829808,6-22-24 22:28,486.89,Purchase,Pharmacy,13957.09
10315,712829808,6-30-24 14:28,101.41,Deposit,Cash Deposit,14058.5
10316,712829808,07-03-24 21:28,5750,IncomingTransfer,Salary,19808.5
10317,712829808,07-05-24 16:28,111.93,OnlineShopping,Best Buy,19696.57
10318,712829808,07-09-24 18:28,294.69,Withdrawal,ATM Withdrawal,19401.88
10319,712829808,7-16-24 21:28,1500,Payment,Subscription Payment,17901.88
10320,712895733,1-22-24 14:28,607.45,Payment,Mortgage Payment,-125.3729148
10321,712895733,1-25-24 19:28,591.4,OnlineShopping,eBay,-716.7729148
10322,712895733,1-29-24 20:28,391.86,Purchase,Furniture,-1108.632915
10323,712895733,1-30-24 19:28,188.26,Purchase,Furniture,-1296.892915
10324,712895733,02-02-24 18:28,625.66,Payment,Loan Payment,-1922.552915
10325,712895733,02-03-24 10:28,541.78,Purchase,Entertainment,-2464.332915
10326,712895733,02-04-24 21:28,6900,IncomingTransfer,Salary,4435.667085
10327,712895733,02-07-24 9:28,472.49,OutgoingTransfer,Wire Transfer,3963.177085
10328,712895733,02-07-24 16:28,150.21,Purchase,Travel,3812.967085
10329,712895733,02-08-24 16:28,344.39,Purchase,Entertainment,3468.577085
10330,712895733,02-09-24 21:28,700,Payment,Credit Card Payment,2768.577085
10331,712895733,02-11-24 15:28,209.9,Purchase,Home Improvement,2558.677085
10332,712895733,02-11-24 21:28,2200,Payment,Rent Payment,358.6770852
10333,712895733,2-15-24 14:28,685.7,Return,eBay Return,1044.377085
10334,712895733,2-16-24 22:28,638.64,Withdrawal,Mobile App Withdrawal,405.7370852
10335,712895733,2-18-24 21:28,438.92,OnlineShopping,Etsy,-33.18291483
10336,712895733,2-20-24 11:28,604.72,Deposit,Check Deposit,571.5370852
10337,712895733,2-21-24 23:28,470.9,Purchase,Grocery,100.6370852
10338,712895733,2-22-24 13:28,190.88,Deposit,Mobile Deposit,291.5170852
10339,712895733,2-26-24 10:28,451.17,Purchase,Home Improvement,-159.6529148
10340,712895733,2-26-24 14:28,600.47,Withdrawal,Mobile App Withdrawal,-760.1229148
10341,712895733,2-29-24 14:28,128.6,Payment,Bill Payment,-888.7229148
10342,712895733,03-01-24 20:28,333.16,Deposit,Cash Deposit,-555.5629148
10343,712895733,03-01-24 22:28,237.42,OutgoingTransfer,International Transfer,-792.9829148
10344,712895733,03-03-24 13:28,414.6,OutgoingTransfer,International Transfer,-1207.582915
10345,712895733,03-05-24 21:28,6900,IncomingTransfer,Salary,5692.417085
10346,712895733,03-06-24 15:28,152.23,OnlineShopping,Amazon,5540.187085
10347,712895733,03-07-24 10:28,141.01,IncomingTransfer,Freelance Payment,5681.197085
10348,712895733,03-07-24 11:28,209.59,Withdrawal,ATM Withdrawal,5471.607085
10349,712895733,03-07-24 16:28,277.52,OutgoingTransfer,Wire Transfer,5194.087085
10350,712895733,03-09-24 16:28,316.72,Deposit,Check Deposit,5510.807085
10351,712895733,03-09-24 22:28,330.87,Deposit,Cash Deposit,5841.677085
10352,712895733,03-10-24 21:28,600,Payment,Credit Card Payment,5241.677085
10353,712895733,03-12-24 20:28,450.11,Purchase,Pharmacy,4791.567085
10354,712895733,3-14-24 9:28,179.91,OnlineShopping,Amazon,4611.657085
10355,712895733,3-15-24 16:28,352.47,Purchase,Pharmacy,4259.187085
10356,712895733,3-16-24 19:28,690.16,Deposit,Mobile Deposit,4949.347085
10357,712895733,3-17-24 21:28,3500,Payment,Rent Payment,1449.347085
10358,712895733,3-17-24 22:28,449.08,Deposit,Mobile Deposit,1898.427085
10359,712895733,3-21-24 13:28,493.25,Purchase,Travel,1405.177085
10360,712895733,3-21-24 15:28,316.97,Return,eBay Return,1722.147085
10361,712895733,3-27-24 10:28,280.29,Purchase,Home Improvement,1441.857085
10362,712895733,3-27-24 10:28,713.37,OutgoingTransfer,Peer-to-Peer Transfer,728.4870852
10363,712895733,3-27-24 22:28,713.44,OnlineShopping,Target,15.04708517
10364,712895733,3-29-24 11:28,567.77,Payment,Mortgage Payment,-552.7229148
10365,712895733,3-31-24 15:28,273.72,Deposit,Cash Deposit,-279.0029148
10366,712895733,04-02-24 17:28,147.72,Purchase,Restaurant,-426.7229148
10367,712895733,04-03-24 21:28,6900,IncomingTransfer,Salary,6473.277085
10368,712895733,04-04-24 15:28,330.17,IncomingTransfer,Freelance Payment,6803.447085
10369,712895733,04-08-24 16:28,169.47,Purchase,Electronics,6633.977085
10370,712895733,04-08-24 21:28,600,Payment,Credit Card Payment,6033.977085
10371,712895733,04-11-24 21:28,4200,Payment,Rent Payment,1833.977085
10372,712895733,04-12-24 13:28,646.52,Purchase,Restaurant,1187.457085
10373,712895733,04-12-24 16:28,733.99,Purchase,Clothing,453.4670852
10374,712895733,4-13-24 22:28,369.07,Deposit,Check Deposit,822.5370852
10375,712895733,4-14-24 18:28,218.78,Deposit,Direct Deposit,1041.317085
10376,712895733,4-15-24 13:28,618.82,Deposit,Cash Deposit,1660.137085
10377,712895733,4-21-24 10:28,394.98,Deposit,Cash Deposit,2055.117085
10378,712895733,4-29-24 23:28,285.79,OutgoingTransfer,Bank Transfer,1769.327085
10379,712895733,4-30-24 13:28,691.18,Purchase,Gas,1078.147085
10380,712895733,05-01-24 13:28,124.38,Return,Store Return,1202.527085
10381,712895733,05-01-24 23:28,435.36,Return,AliExpress Return,1637.887085
10382,712895733,05-03-24 15:28,447.99,OnlineShopping,Etsy,1189.897085
10383,712895733,05-04-24 21:28,6900,IncomingTransfer,Salary,8089.897085
10384,712895733,05-07-24 23:28,280.97,IncomingTransfer,Freelance Payment,8370.867085
10385,712895733,05-09-24 21:28,800,Payment,Credit Card Payment,7570.867085
10386,712895733,05-10-24 16:28,195.24,Withdrawal,Mobile App Withdrawal,7375.627085
10387,712895733,05-10-24 23:28,637.41,Withdrawal,Branch Withdrawal,6738.217085
10388,712895733,5-14-24 12:28,564.33,OutgoingTransfer,Bank Transfer,6173.887085
10389,712895733,5-15-24 22:28,411.42,Withdrawal,Branch Withdrawal,5762.467085
10390,712895733,5-16-24 13:28,455.09,Withdrawal,Branch Withdrawal,5307.377085
10391,712895733,5-17-24 14:28,588.57,Purchase,Electronics,4718.807085
10392,712895733,5-17-24 21:28,2400,Payment,Rent Payment,2318.807085
10393,712895733,5-17-24 21:28,499.25,OnlineShopping,Best Buy,1819.557085
10394,712895733,5-21-24 15:28,479.29,Payment,Mortgage Payment,1340.267085
10395,712895733,5-22-24 18:28,204.14,Purchase,Clothing,1136.127085
10396,712895733,5-25-24 21:28,454.22,Purchase,Electronics,681.9070852
10397,712895733,5-25-24 21:28,372.69,Deposit,Check Deposit,1054.597085
10398,712895733,5-30-24 17:28,236.54,Deposit,Mobile Deposit,1291.137085
10399,712895733,5-31-24 15:28,682.44,OnlineShopping,Best Buy,608.6970852
10400,712895733,06-02-24 19:28,485.59,Withdrawal,Mobile App Withdrawal,123.1070852
10401,712895733,06-02-24 21:28,6900,IncomingTransfer,Salary,7023.107085
10402,712895733,06-04-24 18:28,172.49,Return,eBay Return,7195.597085
10403,712895733,06-06-24 10:28,312.5,IncomingTransfer,Freelance Payment,7508.097085
10404,712895733,06-07-24 21:28,800,Payment,Credit Card Payment,6708.097085
10405,712895733,06-08-24 12:28,350.99,Payment,Mortgage Payment,6357.107085
10406,712895733,06-09-24 11:28,654.09,OnlineShopping,AliExpress,5703.017085
10407,712895733,6-15-24 21:28,4300,Payment,Rent Payment,1403.017085
10408,712895733,6-16-24 11:28,732.81,Payment,Mortgage Payment,670.2070852
10409,712895733,6-23-24 13:28,206.64,OnlineShopping,Amazon,463.5670852
10410,712895733,6-25-24 18:28,557.65,Payment,Bill Payment,-94.08291483
10411,712895733,6-28-24 15:28,287.07,Deposit,Mobile Deposit,192.9870852
10412,712895733,07-02-24 19:28,487.86,Withdrawal,Branch Withdrawal,-294.8729148
10413,712895733,07-05-24 21:28,6900,IncomingTransfer,Salary,6605.127085
10414,712895733,07-07-24 22:28,680.81,Withdrawal,ATM Withdrawal,5924.317085
10415,712895733,07-09-24 20:28,490.19,Deposit,Mobile Deposit,6414.507085
10416,712895733,07-10-24 21:28,700,Payment,Credit Card Payment,5714.507085
10417,712895733,07-11-24 13:28,434.38,Withdrawal,Branch Withdrawal,5280.127085
10418,712895733,7-16-24 21:28,3000,Payment,Rent Payment,2280.127085
10419,712949733,1-20-24 11:28,318.76,Payment,Bill Payment,1032.282854
10420,712949733,1-23-24 15:28,396.67,Return,AliExpress Return,1428.952854
10421,712949733,1-28-24 12:28,329.91,OnlineShopping,eBay,1099.042854
10422,712949733,1-28-24 15:28,93.64,Return,Amazon Return,1192.682854
10423,712949733,1-30-24 13:28,305.44,Purchase,Grocery,887.2428539
10424,712949733,1-30-24 13:28,318.03,OutgoingTransfer,Bank Transfer,569.2128539
10425,712949733,02-01-24 9:28,195.96,Deposit,Mobile Deposit,765.1728539
10426,712949733,02-02-24 13:28,212.31,Payment,Mortgage Payment,552.8628539
10427,712949733,02-02-24 21:28,3950,IncomingTransfer,Salary,4502.862854
10428,712949733,02-03-24 12:28,30.8,Withdrawal,Mobile App Withdrawal,4472.062854
10429,712949733,02-04-24 13:28,329.03,Withdrawal,ATM Withdrawal,4143.032854
10430,712949733,02-07-24 21:28,2200,Payment,Credit Card Payment,1943.032854
10431,712949733,02-09-24 11:28,126.86,Return,AliExpress Return,2069.892854
10432,712949733,02-10-24 12:28,25.99,Withdrawal,Mobile App Withdrawal,2043.902854
10433,712949733,02-11-24 18:28,42.63,OnlineShopping,Etsy,2001.272854
10434,712949733,2-13-24 21:28,2300,Payment,Rent Payment,-298.7271461
10435,712949733,2-23-24 17:28,42.35,Deposit,Check Deposit,-256.3771461
10436,712949733,2-24-24 22:28,355.68,Withdrawal,Branch Withdrawal,-612.0571461
10437,712949733,2-28-24 12:28,281.45,Deposit,Check Deposit,-330.6071461
10438,712949733,03-02-24 19:28,33.66,Payment,Bill Payment,-364.2671461
10439,712949733,03-02-24 21:28,3950,IncomingTransfer,Salary,3585.732854
10440,712949733,03-02-24 21:28,103.05,OutgoingTransfer,Peer-to-Peer Transfer,3482.682854
10441,712949733,03-03-24 13:28,356.77,Deposit,Check Deposit,3839.452854
10442,712949733,03-04-24 18:28,90.33,Deposit,Mobile Deposit,3929.782854
10443,712949733,03-07-24 9:28,111.05,Withdrawal,Branch Withdrawal,3818.732854
10444,712949733,03-07-24 21:28,2100,Payment,Credit Card Payment,1718.732854
10445,712949733,03-09-24 13:28,180.88,Purchase,Home Improvement,1537.852854
10446,712949733,3-17-24 21:28,1000,Payment,Rent Payment,537.8528539
10447,712949733,3-19-24 23:28,392.28,Withdrawal,Mobile App Withdrawal,145.5728539
10448,712949733,3-22-24 21:28,256.74,IncomingTransfer,Freelance Payment,402.3128539
10449,712949733,3-22-24 22:28,273.44,Deposit,Cash Deposit,675.7528539
10450,712949733,3-28-24 13:28,97.72,OnlineShopping,eBay,578.0328539
10451,712949733,3-31-24 11:28,173.42,OnlineShopping,eBay,404.6128539
10452,712949733,04-01-24 21:28,3950,IncomingTransfer,Salary,4354.612854
10453,712949733,04-06-24 21:28,3000,Payment,Credit Card Payment,1354.612854
10454,712949733,04-08-24 23:28,115.12,Deposit,Cash Deposit,1469.732854
10455,712949733,04-09-24 21:28,22.66,Purchase,Restaurant,1447.072854
10456,712949733,4-15-24 21:28,1400,Payment,Rent Payment,47.07285388
10457,712949733,4-17-24 17:28,161.26,Return,Target Return,208.3328539
10458,712949733,4-20-24 14:28,104.24,Purchase,Restaurant,104.0928539
10459,712949733,4-29-24 14:28,197.05,Purchase,Home Improvement,-92.95714612
10460,712949733,4-29-24 22:28,77.74,Deposit,Direct Deposit,-15.21714612
10461,712949733,05-01-24 21:28,3950,IncomingTransfer,Salary,3934.782854
10462,712949733,05-03-24 17:28,140.26,Deposit,Direct Deposit,4075.042854
10463,712949733,05-04-24 16:28,321.54,Purchase,Electronics,3753.502854
10464,712949733,05-06-24 21:28,2700,Payment,Credit Card Payment,1053.502854
10465,712949733,05-09-24 21:28,61.05,Return,Store Return,1114.552854
10466,712949733,05-10-24 19:28,331.34,Withdrawal,Mobile App Withdrawal,783.2128539
10467,712949733,5-16-24 20:28,133.97,Deposit,Cash Deposit,917.1828539
10468,712949733,5-17-24 21:28,1900,Payment,Rent Payment,-982.8171461
10469,712949733,5-26-24 10:28,362.61,Withdrawal,Mobile App Withdrawal,-1345.427146
10470,712949733,5-30-24 11:28,279.23,Deposit,Cash Deposit,-1066.197146
10471,712949733,06-02-24 10:28,381.44,Deposit,Mobile Deposit,-684.7571461
10472,712949733,06-05-24 17:28,289.61,OnlineShopping,Amazon,-974.3671461
10473,712949733,06-05-24 21:28,3950,IncomingTransfer,Salary,2975.632854
10474,712949733,06-07-24 17:28,307.95,IncomingTransfer,Freelance Payment,3283.582854
10475,712949733,06-07-24 22:28,63.96,OutgoingTransfer,Bank Transfer,3219.622854
10476,712949733,06-08-24 21:28,343.95,Purchase,Entertainment,2875.672854
10477,712949733,06-10-24 21:28,2500,Payment,Credit Card Payment,375.6728539
10478,712949733,6-15-24 12:28,23.3,Purchase,Travel,352.3728539
10479,712949733,6-15-24 14:28,133.06,Withdrawal,Branch Withdrawal,219.3128539
10480,712949733,6-15-24 21:28,2500,Payment,Rent Payment,-2280.687146
10481,712949733,6-18-24 9:28,160.2,Payment,Bill Payment,-2440.887146
10482,712949733,6-19-24 14:28,186.07,Purchase,Electronics,-2626.957146
10483,712949733,6-22-24 11:28,319.19,Withdrawal,Mobile App Withdrawal,-2946.147146
10484,712949733,6-28-24 10:28,245.56,Withdrawal,ATM Withdrawal,-3191.707146
10485,712949733,07-01-24 11:28,351.62,Purchase,Gas,-3543.327146
10486,712949733,07-01-24 21:28,3950,IncomingTransfer,Salary,406.6728539
10487,712949733,07-04-24 10:28,305.48,Deposit,Cash Deposit,712.1528539
10488,712949733,07-05-24 14:28,145.09,Purchase,Clothing,567.0628539
10489,712949733,07-05-24 14:28,92.05,Purchase,Electronics,475.0128539
10490,712949733,07-06-24 19:28,321.72,Return,Walmart Return,796.7328539
10491,712949733,07-06-24 21:28,2600,Payment,Credit Card Payment,-1803.267146
10492,712949733,07-07-24 20:28,159.38,Withdrawal,ATM Withdrawal,-1962.647146
10493,712949733,07-12-24 13:28,271.33,Deposit,Check Deposit,-1691.317146
10494,712949733,7-13-24 19:28,256.56,Withdrawal,Mobile App Withdrawal,-1947.877146
10495,712949733,7-13-24 21:28,2500,Payment,Rent Payment,-4447.877146
10496,712949733,7-14-24 14:28,141.46,Deposit,Direct Deposit,-4306.417146
10497,712949733,7-17-24 14:28,114.22,Purchase,Entertainment,-4420.637146
10498,712961658,1-20-24 16:28,174.9,IncomingTransfer,Freelance Payment,1893.688387
10499,712961658,1-22-24 10:28,31.21,Return,Store Return,1924.898387
10500,712961658,1-27-24 14:28,195.93,OutgoingTransfer,International Transfer,1728.968387
10501,712961658,1-27-24 16:28,111.69,IncomingTransfer,Freelance Payment,1840.658387
10502,712961658,1-27-24 21:28,235.77,Return,Best Buy Return,2076.428387
10503,712961658,1-29-24 11:28,198.3,Deposit,Check Deposit,2274.728387
10504,712961658,1-31-24 10:28,102.68,Withdrawal,Branch Withdrawal,2172.048387
10505,712961658,02-01-24 21:28,3100,IncomingTransfer,Salary,5272.048387
10506,712961658,02-03-24 22:28,12.62,Deposit,Cash Deposit,5284.668387
10507,712961658,02-05-24 18:28,46.75,Purchase,Furniture,5237.918387
10508,712961658,02-05-24 21:28,151.97,OutgoingTransfer,Wire Transfer,5085.948387
10509,712961658,02-06-24 12:28,88.31,Withdrawal,Branch Withdrawal,4997.638387
10510,712961658,02-06-24 21:28,2400,Payment,Credit Card Payment,2597.638387
10511,712961658,02-07-24 22:28,66.86,Deposit,Direct Deposit,2664.498387
10512,712961658,02-07-24 23:28,203.44,Purchase,Restaurant,2461.058387
10513,712961658,02-08-24 9:28,33.81,Withdrawal,Mobile App Withdrawal,2427.248387
10514,712961658,02-08-24 22:28,11.29,Purchase,Electronics,2415.958387
10515,712961658,02-08-24 22:28,138.94,Deposit,Mobile Deposit,2554.898387
10516,712961658,02-09-24 14:28,205.75,Payment,Loan Payment,2349.148387
10517,712961658,2-16-24 21:28,1000,Payment,Subscription Payment,1349.148387
10518,712961658,2-18-24 12:28,131.73,OutgoingTransfer,Wire Transfer,1217.418387
10519,712961658,2-18-24 19:28,153.02,Purchase,Restaurant,1064.398387
10520,712961658,2-20-24 20:28,46.28,IncomingTransfer,Freelance Payment,1110.678387
10521,712961658,2-22-24 22:28,216.63,Purchase,Electronics,894.0483874
10522,712961658,2-28-24 14:28,186.87,OutgoingTransfer,Bank Transfer,707.1783874
10523,712961658,2-29-24 10:28,70.49,Deposit,Check Deposit,777.6683874
10524,712961658,03-01-24 21:28,3100,IncomingTransfer,Salary,3877.668387
10525,712961658,03-06-24 20:28,22.65,OutgoingTransfer,Wire Transfer,3855.018387
10526,712961658,03-06-24 21:28,2500,Payment,Credit Card Payment,1355.018387
10527,712961658,03-11-24 21:28,1300,Payment,Subscription Payment,55.01838742
10528,712961658,03-12-24 15:28,231.44,OutgoingTransfer,Peer-to-Peer Transfer,-176.4216126
10529,712961658,03-12-24 20:28,128.01,OutgoingTransfer,Wire Transfer,-304.4316126
10530,712961658,3-16-24 18:28,227.41,Withdrawal,ATM Withdrawal,-531.8416126
10531,712961658,3-22-24 19:28,30.39,Deposit,Direct Deposit,-501.4516126
10532,712961658,3-23-24 13:28,84.85,OnlineShopping,AliExpress,-586.3016126
10533,712961658,3-25-24 10:28,48.87,Return,Target Return,-537.4316126
10534,712961658,3-25-24 17:28,210.52,Return,eBay Return,-326.9116126
10535,712961658,3-28-24 15:28,247.43,Return,Store Return,-79.48161258
10536,712961658,3-30-24 22:28,117.71,OutgoingTransfer,Wire Transfer,-197.1916126
10537,712961658,3-31-24 21:28,94.11,Payment,Mortgage Payment,-291.3016126
10538,712961658,3-31-24 21:28,141.93,OutgoingTransfer,Bank Transfer,-433.2316126
10539,712961658,04-01-24 9:28,212.64,Return,Best Buy Return,-220.5916126
10540,712961658,04-03-24 21:28,3100,IncomingTransfer,Salary,2879.408387
10541,712961658,04-08-24 21:28,3000,Payment,Credit Card Payment,-120.5916126
10542,712961658,04-11-24 21:28,1300,Payment,Installment Payment,-1420.591613
10543,712961658,4-13-24 11:28,125.49,Return,Walmart Return,-1295.101613
10544,712961658,4-13-24 19:28,60.04,Purchase,Grocery,-1355.141613
10545,712961658,4-14-24 16:28,55.3,Purchase,Furniture,-1410.441613
10546,712961658,4-14-24 18:28,229.18,Deposit,Check Deposit,-1181.261613
10547,712961658,4-15-24 12:28,147.32,OnlineShopping,Walmart,-1328.581613
10548,712961658,4-16-24 22:28,36.03,Purchase,Electronics,-1364.611613
10549,712961658,4-18-24 23:28,241.23,Withdrawal,ATM Withdrawal,-1605.841613
10550,712961658,4-21-24 11:28,35.26,Purchase,Electronics,-1641.101613
10551,712961658,4-24-24 16:28,203.72,Return,AliExpress Return,-1437.381613
10552,712961658,4-26-24 16:28,145.46,Payment,Bill Payment,-1582.841613
10553,712961658,4-28-24 11:28,102.42,OnlineShopping,AliExpress,-1685.261613
10554,712961658,4-28-24 15:28,67.13,OutgoingTransfer,Bank Transfer,-1752.391613
10555,712961658,05-01-24 14:28,231.47,Withdrawal,Branch Withdrawal,-1983.861613
10556,712961658,05-02-24 12:28,169.26,Withdrawal,ATM Withdrawal,-2153.121613
10557,712961658,05-02-24 13:28,211.25,Purchase,Restaurant,-2364.371613
10558,712961658,05-04-24 21:28,3100,IncomingTransfer,Salary,735.6283874
10559,712961658,05-05-24 11:28,111.09,OutgoingTransfer,International Transfer,624.5383874
10560,712961658,05-05-24 20:28,244.16,Purchase,Clothing,380.3783874
10561,712961658,05-05-24 22:28,41,Purchase,Gas,339.3783874
10562,712961658,05-09-24 21:28,3100,Payment,Credit Card Payment,-2760.621613
10563,712961658,05-10-24 13:28,53.84,OnlineShopping,Etsy,-2814.461613
10564,712961658,05-11-24 20:28,198.41,Payment,Loan Payment,-3012.871613
10565,712961658,05-12-24 16:28,216.51,Purchase,Entertainment,-3229.381613
10566,712961658,5-15-24 21:28,900,Payment,Subscription Payment,-4129.381613
10567,712961658,5-22-24 9:28,73.86,Withdrawal,ATM Withdrawal,-4203.241613
10568,712961658,06-01-24 12:28,242.35,Return,Etsy Return,-3960.891613
10569,712961658,06-01-24 18:28,208.51,Deposit,Cash Deposit,-3752.381613
10570,712961658,06-03-24 21:28,3100,IncomingTransfer,Salary,-652.3816126
10571,712961658,06-04-24 15:28,183.15,OnlineShopping,AliExpress,-835.5316126
10572,712961658,06-08-24 16:28,25.12,Withdrawal,ATM Withdrawal,-860.6516126
10573,712961658,06-08-24 21:28,2700,Payment,Credit Card Payment,-3560.651613
10574,712961658,06-10-24 9:28,17.4,OnlineShopping,Amazon,-3578.051613
10575,712961658,06-10-24 21:28,900,Payment,Installment Payment,-4478.051613
10576,712961658,06-11-24 20:28,53.44,Purchase,Home Improvement,-4531.491613
10577,712961658,6-13-24 14:28,211.3,Deposit,Cash Deposit,-4320.191613
10578,712961658,6-15-24 19:28,25.66,OutgoingTransfer,International Transfer,-4345.851613
10579,712961658,6-26-24 23:28,19.72,Deposit,Cash Deposit,-4326.131613
10580,712961658,6-28-24 13:28,131.32,Deposit,Direct Deposit,-4194.811613
10581,712961658,6-28-24 21:28,211.15,Deposit,Direct Deposit,-3983.661613
10582,712961658,6-29-24 16:28,45.02,Withdrawal,Branch Withdrawal,-4028.681613
10583,712961658,6-29-24 22:28,85.83,Deposit,Check Deposit,-3942.851613
10584,712961658,07-01-24 9:28,142.51,Payment,Loan Payment,-4085.361613
10585,712961658,07-01-24 21:28,3100,IncomingTransfer,Salary,-985.3616126
10586,712961658,07-06-24 21:28,2700,Payment,Credit Card Payment,-3685.361613
10587,712961658,07-09-24 23:28,106.1,Purchase,Entertainment,-3791.461613
10588,712961658,07-11-24 18:28,133.62,IncomingTransfer,Freelance Payment,-3657.841613
10589,712961658,07-12-24 16:28,27.37,Purchase,Electronics,-3685.211613
10590,712961658,7-13-24 20:28,187.99,Deposit,Cash Deposit,-3497.221613
10591,712961658,7-15-24 14:28,190.02,Purchase,Entertainment,-3687.241613
10592,712961658,7-15-24 21:28,1100,Payment,Subscription Payment,-4787.241613
10593,712961658,7-16-24 19:28,149.1,Return,Walmart Return,-4638.141613
10594,712977183,02-03-24 21:28,313.66,OutgoingTransfer,International Transfer,307.3684789
10595,712977183,02-04-24 21:28,4150,IncomingTransfer,Salary,4457.368479
10596,712977183,02-07-24 12:28,56.05,Payment,Bill Payment,4401.318479
10597,712977183,02-08-24 22:28,212.04,Withdrawal,ATM Withdrawal,4189.278479
10598,712977183,02-09-24 21:28,1400,Payment,Credit Card Payment,2789.278479
10599,712977183,2-14-24 21:28,1200,Payment,Installment Payment,1589.278479
10600,712977183,2-29-24 12:28,285.86,Return,Store Return,1875.138479
10601,712977183,03-01-24 21:28,4150,IncomingTransfer,Salary,6025.138479
10602,712977183,03-06-24 21:28,1300,Payment,Credit Card Payment,4725.138479
10603,712977183,03-10-24 21:28,1200,Payment,Insurance Payment,3525.138479
10604,712977183,3-16-24 16:28,215.52,Withdrawal,ATM Withdrawal,3309.618479
10605,712977183,3-17-24 20:28,192.96,OnlineShopping,Walmart,3116.658479
10606,712977183,3-18-24 15:28,244.57,OutgoingTransfer,Bank Transfer,2872.088479
10607,712977183,3-27-24 11:28,103.48,Deposit,Direct Deposit,2975.568479
10608,712977183,04-01-24 18:28,283.9,Deposit,Cash Deposit,3259.468479
10609,712977183,04-02-24 21:28,4150,IncomingTransfer,Salary,7409.468479
10610,712977183,04-04-24 11:28,119.94,Withdrawal,Branch Withdrawal,7289.528479
10611,712977183,04-07-24 21:28,1200,Payment,Credit Card Payment,6089.528479
10612,712977183,04-12-24 20:28,96.6,IncomingTransfer,Freelance Payment,6186.128479
10613,712977183,4-16-24 21:28,1800,Payment,Subscription Payment,4386.128479
10614,712977183,4-26-24 15:28,109.09,Purchase,Restaurant,4277.038479
10615,712977183,4-29-24 13:28,178.68,Purchase,Travel,4098.358479
10616,712977183,05-01-24 21:28,4150,IncomingTransfer,Salary,8248.358479
10617,712977183,05-03-24 15:28,317.1,Return,eBay Return,8565.458479
10618,712977183,05-06-24 19:28,284.77,Deposit,Check Deposit,8850.228479
10619,712977183,05-06-24 21:28,1500,Payment,Credit Card Payment,7350.228479
10620,712977183,05-10-24 21:28,1700,Payment,Subscription Payment,5650.228479
10621,712977183,5-15-24 12:28,48.71,IncomingTransfer,Freelance Payment,5698.938479
10622,712977183,5-21-24 21:28,169.57,Deposit,Cash Deposit,5868.508479
10623,712977183,5-28-24 12:28,117.14,Return,AliExpress Return,5985.648479
10624,712977183,06-04-24 21:28,4150,IncomingTransfer,Salary,10135.64848
10625,712977183,06-09-24 21:28,1400,Payment,Credit Card Payment,8735.648479
10626,712977183,06-12-24 13:28,126.32,OnlineShopping,Walmart,8609.328479
10627,712977183,6-14-24 9:28,21.86,Purchase,Grocery,8587.468479
10628,712977183,6-18-24 21:28,1200,Payment,Installment Payment,7387.468479
10629,712977183,07-05-24 21:28,4150,IncomingTransfer,Salary,11537.46848
10630,712977183,07-08-24 10:28,220.7,Withdrawal,Branch Withdrawal,11316.76848
10631,712977183,07-10-24 21:28,1500,Payment,Credit Card Payment,9816.768479
10632,712977183,07-11-24 21:28,1700,Payment,Insurance Payment,8116.768479
10633,712977183,7-15-24 17:28,368.54,Deposit,Cash Deposit,8485.308479
10634,713016633,1-22-24 16:28,389.66,Deposit,Direct Deposit,1387.9801
10635,713016633,1-25-24 14:28,225.37,Withdrawal,Branch Withdrawal,1162.6101
10636,713016633,1-26-24 10:28,430.39,Deposit,Check Deposit,1593.0001
10637,713016633,1-27-24 18:28,129.78,Deposit,Check Deposit,1722.7801
10638,713016633,02-04-24 11:28,390.18,Return,eBay Return,2112.9601
10639,713016633,02-04-24 21:28,5000,IncomingTransfer,Salary,7112.9601
10640,713016633,02-09-24 21:28,2100,Payment,Credit Card Payment,5012.9601
10641,713016633,02-10-24 15:28,68.51,OutgoingTransfer,International Transfer,4944.4501
10642,713016633,02-10-24 21:28,1800,Payment,Subscription Payment,3144.4501
10643,713016633,2-22-24 17:28,398.14,Withdrawal,ATM Withdrawal,2746.3101
10644,713016633,03-01-24 19:28,112.71,Deposit,Direct Deposit,2859.0201
10645,713016633,03-02-24 21:28,5000,IncomingTransfer,Salary,7859.0201
10646,713016633,03-04-24 12:28,442.72,Purchase,Gas,7416.3001
10647,713016633,03-07-24 21:28,2300,Payment,Credit Card Payment,5116.3001
10648,713016633,03-11-24 21:28,323.47,Withdrawal,Branch Withdrawal,4792.8301
10649,713016633,3-14-24 21:28,93.06,OnlineShopping,eBay,4699.7701
10650,713016633,3-16-24 21:28,2200,Payment,Subscription Payment,2499.7701
10651,713016633,3-18-24 14:28,106.88,IncomingTransfer,Freelance Payment,2606.6501
10652,713016633,3-21-24 14:28,192.55,IncomingTransfer,Freelance Payment,2799.2001
10653,713016633,3-25-24 16:28,190.25,Withdrawal,ATM Withdrawal,2608.9501
10654,713016633,04-02-24 21:28,5000,IncomingTransfer,Salary,7608.9501
10655,713016633,04-05-24 19:28,435.83,Deposit,Cash Deposit,8044.7801
10656,713016633,04-05-24 23:28,147.59,Withdrawal,ATM Withdrawal,7897.1901
10657,713016633,04-07-24 21:28,1800,Payment,Credit Card Payment,6097.1901
10658,713016633,04-09-24 16:28,172.02,OnlineShopping,Walmart,5925.1701
10659,713016633,4-15-24 12:28,380.6,Withdrawal,Mobile App Withdrawal,5544.5701
10660,713016633,4-16-24 21:28,1700,Payment,Installment Payment,3844.5701
10661,713016633,4-20-24 12:28,419.66,OnlineShopping,eBay,3424.9101
10662,713016633,4-27-24 22:28,443.71,IncomingTransfer,Freelance Payment,3868.6201
10663,713016633,05-05-24 21:28,5000,IncomingTransfer,Salary,8868.6201
10664,713016633,05-10-24 21:28,2400,Payment,Credit Card Payment,6468.6201
10665,713016633,05-11-24 11:28,425.04,Purchase,Gas,6043.5801
10666,713016633,05-11-24 21:28,1500,Payment,Subscription Payment,4543.5801
10667,713016633,05-12-24 17:28,378.31,Deposit,Check Deposit,4921.8901
10668,713016633,5-13-24 12:28,270.89,Deposit,Cash Deposit,5192.7801
10669,713016633,5-15-24 15:28,486.56,Purchase,Electronics,4706.2201
10670,713016633,5-22-24 15:28,239.19,OnlineShopping,eBay,4467.0301
10671,713016633,5-23-24 14:28,524.25,Deposit,Cash Deposit,4991.2801
10672,713016633,06-01-24 21:28,5000,IncomingTransfer,Salary,9991.2801
10673,713016633,06-03-24 13:28,178.52,Withdrawal,Branch Withdrawal,9812.7601
10674,713016633,06-03-24 22:28,415.55,Withdrawal,Branch Withdrawal,9397.2101
10675,713016633,06-06-24 21:28,2100,Payment,Credit Card Payment,7297.2101
10676,713016633,06-08-24 22:28,398.28,Purchase,Furniture,6898.9301
10677,713016633,6-13-24 21:28,1500,Payment,Installment Payment,5398.9301
10678,713016633,6-16-24 11:28,72.94,Deposit,Cash Deposit,5471.8701
10679,713016633,6-20-24 19:28,106.11,Return,AliExpress Return,5577.9801
10680,713016633,6-23-24 21:28,380.71,Purchase,Travel,5197.2701
10681,713016633,6-28-24 23:28,319.33,Purchase,Grocery,4877.9401
10682,713016633,07-02-24 13:28,230.11,Deposit,Direct Deposit,5108.0501
10683,713016633,07-03-24 11:28,400.06,Return,Best Buy Return,5508.1101
10684,713016633,07-04-24 21:28,5000,IncomingTransfer,Salary,10508.1101
10685,713016633,07-09-24 21:28,2300,Payment,Credit Card Payment,8208.1101
10686,713016633,7-13-24 20:28,212.92,Withdrawal,ATM Withdrawal,7995.1901
10687,713016633,7-13-24 21:28,2200,Payment,Insurance Payment,5795.1901
10688,713067033,1-28-24 13:28,44.3,OutgoingTransfer,Peer-to-Peer Transfer,1124.902567
10689,713067033,1-30-24 12:28,213.77,Withdrawal,Mobile App Withdrawal,911.132567
10690,713067033,02-02-24 21:28,3200,IncomingTransfer,Salary,4111.132567
10691,713067033,02-07-24 21:28,1700,Payment,Credit Card Payment,2411.132567
10692,713067033,02-10-24 21:28,1200,Payment,Insurance Payment,1211.132567
10693,713067033,2-16-24 19:28,39.47,OutgoingTransfer,Peer-to-Peer Transfer,1171.662567
10694,713067033,2-17-24 11:28,68.38,Return,Best Buy Return,1240.042567
10695,713067033,2-17-24 21:28,474.33,Return,eBay Return,1714.372567
10696,713067033,2-18-24 13:28,288.28,Return,Store Return,2002.652567
10697,713067033,2-22-24 14:28,449.81,Deposit,Direct Deposit,2452.462567
10698,713067033,2-23-24 22:28,323.78,Withdrawal,Branch Withdrawal,2128.682567
10699,713067033,2-25-24 10:28,428.54,Deposit,Direct Deposit,2557.222567
10700,713067033,03-04-24 21:28,3200,IncomingTransfer,Salary,5757.222567
10701,713067033,03-09-24 21:28,1700,Payment,Credit Card Payment,4057.222567
10702,713067033,03-12-24 12:28,195.57,Purchase,Restaurant,3861.652567
10703,713067033,3-13-24 21:28,1400,Payment,Subscription Payment,2461.652567
10704,713067033,3-18-24 13:28,350.68,Deposit,Direct Deposit,2812.332567
10705,713067033,3-18-24 14:28,352.86,Return,AliExpress Return,3165.192567
10706,713067033,3-20-24 17:28,178.7,Payment,Mortgage Payment,2986.492567
10707,713067033,3-24-24 16:28,397.79,Deposit,Cash Deposit,3384.282567
10708,713067033,3-26-24 14:28,202.79,OutgoingTransfer,Wire Transfer,3181.492567
10709,713067033,04-02-24 19:28,159.58,Deposit,Cash Deposit,3341.072567
10710,713067033,04-03-24 21:28,3200,IncomingTransfer,Salary,6541.072567
10711,713067033,04-04-24 13:28,198.34,Withdrawal,ATM Withdrawal,6342.732567
10712,713067033,04-06-24 21:28,301.92,Withdrawal,Mobile App Withdrawal,6040.812567
10713,713067033,04-08-24 21:28,2100,Payment,Credit Card Payment,3940.812567
10714,713067033,04-10-24 15:28,150.27,Withdrawal,ATM Withdrawal,3790.542567
10715,713067033,04-12-24 13:28,357.87,Payment,Mortgage Payment,3432.672567
10716,713067033,4-16-24 21:28,1300,Payment,Installment Payment,2132.672567
10717,713067033,4-16-24 23:28,306.27,Purchase,Gas,1826.402567
10718,713067033,4-18-24 22:28,132.86,Deposit,Direct Deposit,1959.262567
10719,713067033,4-19-24 18:28,106.56,Purchase,Travel,1852.702567
10720,713067033,4-20-24 13:28,47.66,OnlineShopping,Amazon,1805.042567
10721,713067033,4-21-24 17:28,50.1,Deposit,Check Deposit,1855.142567
10722,713067033,4-24-24 22:28,245.28,IncomingTransfer,Freelance Payment,2100.422567
10723,713067033,4-29-24 21:28,347.2,OnlineShopping,eBay,1753.222567
10724,713067033,4-30-24 18:28,404.77,Withdrawal,Mobile App Withdrawal,1348.452567
10725,713067033,05-02-24 21:28,3200,IncomingTransfer,Salary,4548.452567
10726,713067033,05-07-24 21:28,1500,Payment,Credit Card Payment,3048.452567
10727,713067033,05-11-24 20:28,416.87,Payment,Loan Payment,2631.582567
10728,713067033,05-12-24 20:28,388.21,OnlineShopping,Amazon,2243.372567
10729,713067033,5-15-24 9:28,472.37,Withdrawal,Branch Withdrawal,1771.002567
10730,713067033,5-16-24 21:28,1300,Payment,Subscription Payment,471.002567
10731,713067033,5-17-24 9:28,338.37,Return,AliExpress Return,809.372567
10732,713067033,5-22-24 10:28,256.41,Deposit,Check Deposit,1065.782567
10733,713067033,5-23-24 21:28,140.21,Deposit,Cash Deposit,1205.992567
10734,713067033,5-24-24 17:28,442.23,Purchase,Home Improvement,763.762567
10735,713067033,5-29-24 18:28,323.4,Deposit,Check Deposit,1087.162567
10736,713067033,06-01-24 10:28,251.3,Purchase,Clothing,835.862567
10737,713067033,06-01-24 16:28,177.3,Purchase,Electronics,658.562567
10738,713067033,06-04-24 21:28,3200,IncomingTransfer,Salary,3858.562567
10739,713067033,06-05-24 12:28,21.42,Payment,Mortgage Payment,3837.142567
10740,713067033,06-06-24 13:28,79.78,Purchase,Furniture,3757.362567
10741,713067033,06-06-24 15:28,330.37,OnlineShopping,Amazon,3426.992567
10742,713067033,06-09-24 21:28,1900,Payment,Credit Card Payment,1526.992567
10743,713067033,06-12-24 14:28,455.68,Payment,Loan Payment,1071.312567
10744,713067033,06-12-24 21:28,1000,Payment,Subscription Payment,71.31256702
10745,713067033,6-13-24 11:28,400.84,Payment,Bill Payment,-329.527433
10746,713067033,6-17-24 18:28,99.81,Payment,Mortgage Payment,-429.337433
10747,713067033,6-18-24 23:28,368.44,Deposit,Cash Deposit,-60.89743298
10748,713067033,6-19-24 13:28,111.11,Purchase,Entertainment,-172.007433
10749,713067033,6-19-24 18:28,73.57,Withdrawal,ATM Withdrawal,-245.577433
10750,713067033,6-29-24 19:28,52.17,OnlineShopping,Etsy,-297.747433
10751,713067033,07-02-24 21:28,3200,IncomingTransfer,Salary,2902.252567
10752,713067033,07-07-24 21:28,1600,Payment,Credit Card Payment,1302.252567
10753,713067033,07-09-24 21:28,126.35,OutgoingTransfer,Wire Transfer,1175.902567
10754,713067033,07-10-24 21:28,1200,Payment,Insurance Payment,-24.09743298
10755,713067033,7-17-24 14:28,303.49,Withdrawal,Branch Withdrawal,-327.587433
10756,713095533,1-20-24 20:28,180.94,Purchase,Pharmacy,1003.105107
10757,713095533,1-22-24 10:28,32.2,OutgoingTransfer,Peer-to-Peer Transfer,970.9051071
10758,713095533,1-22-24 16:28,115.07,Withdrawal,Branch Withdrawal,855.8351071
10759,713095533,1-29-24 16:28,245.49,OnlineShopping,Amazon,610.3451071
10760,713095533,02-04-24 13:28,167.95,Purchase,Clothing,442.3951071
10761,713095533,02-05-24 21:28,3100,IncomingTransfer,Salary,3542.395107
10762,713095533,02-10-24 21:28,1700,Payment,Credit Card Payment,1842.395107
10763,713095533,02-12-24 18:28,79.38,Withdrawal,Mobile App Withdrawal,1763.015107
10764,713095533,2-14-24 9:28,71.31,Withdrawal,Branch Withdrawal,1691.705107
10765,713095533,2-15-24 10:28,95.64,Withdrawal,Mobile App Withdrawal,1596.065107
10766,713095533,2-17-24 21:28,1100,Payment,Rent Payment,496.0651071
10767,713095533,2-22-24 16:28,41.01,OnlineShopping,Walmart,455.0551071
10768,713095533,2-23-24 14:28,203.84,Purchase,Pharmacy,251.2151071
10769,713095533,2-24-24 15:28,92.6,Return,Amazon Return,343.8151071
10770,713095533,2-27-24 13:28,218.71,Payment,Loan Payment,125.1051071
10771,713095533,03-03-24 21:28,3100,IncomingTransfer,Salary,3225.105107
10772,713095533,03-08-24 21:28,2100,Payment,Credit Card Payment,1125.105107
10773,713095533,03-10-24 18:28,142.38,OnlineShopping,Best Buy,982.7251071
10774,713095533,3-13-24 14:28,197.27,Withdrawal,ATM Withdrawal,785.4551071
10775,713095533,3-13-24 20:28,102.18,Deposit,Check Deposit,887.6351071
10776,713095533,3-16-24 21:28,1400,Payment,Rent Payment,-512.3648929
10777,713095533,3-27-24 23:28,71.33,Payment,Bill Payment,-583.6948929
10778,713095533,04-02-24 17:28,176.9,Deposit,Cash Deposit,-406.7948929
10779,713095533,04-03-24 18:28,148.05,Payment,Bill Payment,-554.8448929
10780,713095533,04-05-24 21:28,3100,IncomingTransfer,Salary,2545.155107
10781,713095533,04-09-24 20:28,195.99,Deposit,Direct Deposit,2741.145107
10782,713095533,04-10-24 21:28,1500,Payment,Credit Card Payment,1241.145107
10783,713095533,04-12-24 21:28,800,Payment,Rent Payment,441.1451071
10784,713095533,04-12-24 21:28,208.7,Purchase,Furniture,232.4451071
10785,713095533,4-17-24 15:28,47.33,Deposit,Direct Deposit,279.7751071
10786,713095533,4-28-24 15:28,184.14,OutgoingTransfer,International Transfer,95.63510711
10787,713095533,05-05-24 21:28,3100,IncomingTransfer,Salary,3195.635107
10788,713095533,05-10-24 21:28,1800,Payment,Credit Card Payment,1395.635107
10789,713095533,05-11-24 21:28,166.49,Return,AliExpress Return,1562.125107
10790,713095533,5-17-24 21:28,1400,Payment,Rent Payment,162.1251071
10791,713095533,5-24-24 15:28,248.45,Deposit,Check Deposit,410.5751071
10792,713095533,5-24-24 23:28,52.2,IncomingTransfer,Freelance Payment,462.7751071
10793,713095533,06-05-24 21:28,3100,IncomingTransfer,Salary,3562.775107
10794,713095533,06-10-24 21:28,1900,Payment,Credit Card Payment,1662.775107
10795,713095533,6-17-24 9:28,93.57,IncomingTransfer,Freelance Payment,1756.345107
10796,713095533,6-17-24 21:28,900,Payment,Rent Payment,856.3451071
10797,713095533,6-18-24 16:28,73.99,Purchase,Travel,782.3551071
10798,713095533,6-21-24 15:28,155.98,Deposit,Cash Deposit,938.3351071
10799,713095533,6-29-24 17:28,204.71,IncomingTransfer,Freelance Payment,1143.045107
10800,713095533,07-01-24 21:28,3100,IncomingTransfer,Salary,4243.045107
10801,713095533,07-06-24 21:28,1800,Payment,Credit Card Payment,2443.045107
10802,713095533,07-09-24 10:28,38.21,Purchase,Electronics,2404.835107
10803,713095533,07-12-24 17:28,103.74,OutgoingTransfer,Peer-to-Peer Transfer,2301.095107
10804,713095533,07-12-24 21:28,1000,Payment,Rent Payment,1301.095107
10805,713166333,1-20-24 16:28,78.45,IncomingTransfer,Freelance Payment,808.1953878
10806,713166333,1-21-24 22:28,294.4,Deposit,Mobile Deposit,1102.595388
10807,713166333,1-23-24 12:28,366.74,OnlineShopping,Amazon,735.8553878
10808,713166333,1-26-24 23:28,22.87,Deposit,Check Deposit,758.7253878
10809,713166333,1-29-24 10:28,48.19,Purchase,Home Improvement,710.5353878
10810,713166333,1-29-24 15:28,190.04,Deposit,Check Deposit,900.5753878
10811,713166333,1-30-24 10:28,167.79,Return,Target Return,1068.365388
10812,713166333,1-31-24 13:28,96.68,Return,AliExpress Return,1165.045388
10813,713166333,1-31-24 14:28,388.74,Purchase,Pharmacy,776.3053878
10814,713166333,02-01-24 17:28,27.59,Return,Store Return,803.8953878
10815,713166333,02-01-24 21:28,4550,IncomingTransfer,Salary,5353.895388
10816,713166333,02-03-24 18:28,282.67,Withdrawal,ATM Withdrawal,5071.225388
10817,713166333,02-04-24 16:28,445.75,OnlineShopping,Etsy,4625.475388
10818,713166333,02-06-24 21:28,1500,Payment,Credit Card Payment,3125.475388
10819,713166333,02-07-24 21:28,49.41,OutgoingTransfer,Wire Transfer,3076.065388
10820,713166333,2-14-24 21:28,2300,Payment,Rent Payment,776.0653878
10821,713166333,2-15-24 10:28,328.36,Payment,Bill Payment,447.7053878
10822,713166333,2-15-24 14:28,471.24,Withdrawal,ATM Withdrawal,-23.53461223
10823,713166333,2-16-24 12:28,250.99,OutgoingTransfer,Wire Transfer,-274.5246122
10824,713166333,2-16-24 12:28,258.47,Return,Amazon Return,-16.05461223
10825,713166333,2-17-24 14:28,150.24,Deposit,Direct Deposit,134.1853878
10826,713166333,2-18-24 15:28,48,Withdrawal,ATM Withdrawal,86.18538777
10827,713166333,2-20-24 21:28,292.21,Purchase,Entertainment,-206.0246122
10828,713166333,03-01-24 9:28,222.62,Deposit,Mobile Deposit,16.59538777
10829,713166333,03-01-24 21:28,4550,IncomingTransfer,Salary,4566.595388
10830,713166333,03-06-24 21:28,1500,Payment,Credit Card Payment,3066.595388
10831,713166333,3-14-24 15:28,91.01,Deposit,Direct Deposit,3157.605388
10832,713166333,3-15-24 21:28,1700,Payment,Rent Payment,1457.605388
10833,713166333,3-23-24 13:28,181.62,Purchase,Furniture,1275.985388
10834,713166333,3-26-24 9:28,419.56,Return,Etsy Return,1695.545388
10835,713166333,3-29-24 9:28,417.31,Withdrawal,ATM Withdrawal,1278.235388
10836,713166333,3-31-24 11:28,357.19,OnlineShopping,Target,921.0453878
10837,713166333,04-03-24 21:28,4550,IncomingTransfer,Salary,5471.045388
10838,713166333,04-04-24 17:28,280.38,OutgoingTransfer,Wire Transfer,5190.665388
10839,713166333,04-06-24 12:28,194.43,Deposit,Mobile Deposit,5385.095388
10840,713166333,04-07-24 11:28,92.53,Purchase,Gas,5292.565388
10841,713166333,04-07-24 13:28,29.32,Payment,Bill Payment,5263.245388
10842,713166333,04-08-24 21:28,1700,Payment,Credit Card Payment,3563.245388
10843,713166333,04-09-24 11:28,92.43,Return,Best Buy Return,3655.675388
10844,713166333,04-10-24 11:28,156.64,Purchase,Furniture,3499.035388
10845,713166333,04-10-24 18:28,267.44,Payment,Bill Payment,3231.595388
10846,713166333,4-13-24 21:28,1700,Payment,Rent Payment,1531.595388
10847,713166333,4-15-24 15:28,85.98,Return,Etsy Return,1617.575388
10848,713166333,4-16-24 12:28,262.05,Payment,Mortgage Payment,1355.525388
10849,713166333,4-19-24 18:28,118.72,Return,Walmart Return,1474.245388
10850,713166333,4-21-24 19:28,258.85,Purchase,Grocery,1215.395388
10851,713166333,4-24-24 13:28,149.5,Return,AliExpress Return,1364.895388
10852,713166333,4-24-24 17:28,292.83,Deposit,Cash Deposit,1657.725388
10853,713166333,4-26-24 14:28,152.94,Deposit,Check Deposit,1810.665388
10854,713166333,4-26-24 19:28,278.75,Purchase,Grocery,1531.915388
10855,713166333,05-02-24 14:28,235.69,Deposit,Check Deposit,1767.605388
10856,713166333,05-05-24 21:28,4550,IncomingTransfer,Salary,6317.605388
10857,713166333,05-10-24 21:28,1400,Payment,Credit Card Payment,4917.605388
10858,713166333,5-13-24 9:28,359.31,Return,Best Buy Return,5276.915388
10859,713166333,5-13-24 15:28,87.38,OutgoingTransfer,Wire Transfer,5189.535388
10860,713166333,5-13-24 15:28,135.63,Return,Target Return,5325.165388
10861,713166333,5-16-24 21:28,2100,Payment,Rent Payment,3225.165388
10862,713166333,5-22-24 14:28,38.84,Deposit,Mobile Deposit,3264.005388
10863,713166333,5-27-24 10:28,262.31,Purchase,Clothing,3001.695388
10864,713166333,5-28-24 22:28,296.08,OnlineShopping,Amazon,2705.615388
10865,713166333,06-01-24 13:28,445.64,Withdrawal,Branch Withdrawal,2259.975388
10866,713166333,06-03-24 11:28,43.64,Deposit,Cash Deposit,2303.615388
10867,713166333,06-03-24 21:28,4550,IncomingTransfer,Salary,6853.615388
10868,713166333,06-06-24 22:28,257.71,Deposit,Cash Deposit,7111.325388
10869,713166333,06-08-24 21:28,1800,Payment,Credit Card Payment,5311.325388
10870,713166333,6-15-24 10:28,389.5,Purchase,Electronics,4921.825388
10871,713166333,6-16-24 14:28,320.66,Purchase,Grocery,4601.165388
10872,713166333,6-18-24 9:28,255.84,OnlineShopping,Best Buy,4345.325388
10873,713166333,6-18-24 9:28,219.51,Return,eBay Return,4564.835388
10874,713166333,6-18-24 21:28,1600,Payment,Rent Payment,2964.835388
10875,713166333,6-20-24 20:28,16.24,IncomingTransfer,Freelance Payment,2981.075388
10876,713166333,6-20-24 22:28,104.13,OnlineShopping,Best Buy,2876.945388
10877,713166333,6-21-24 18:28,95.38,Purchase,Grocery,2781.565388
10878,713166333,6-27-24 12:28,378.2,Withdrawal,Branch Withdrawal,2403.365388
10879,713166333,6-28-24 15:28,160.11,Withdrawal,Mobile App Withdrawal,2243.255388
10880,713166333,6-29-24 14:28,351.64,Return,Store Return,2594.895388
10881,713166333,6-30-24 22:28,114.26,OnlineShopping,Etsy,2480.635388
10882,713166333,07-01-24 22:28,454.7,Purchase,Entertainment,2025.935388
10883,713166333,07-04-24 21:28,4550,IncomingTransfer,Salary,6575.935388
10884,713166333,07-07-24 16:28,383.68,Withdrawal,ATM Withdrawal,6192.255388
10885,713166333,07-08-24 15:28,261.07,Purchase,Clothing,5931.185388
10886,713166333,07-08-24 19:28,489.89,Purchase,Travel,5441.295388
10887,713166333,07-09-24 21:28,1700,Payment,Credit Card Payment,3741.295388
10888,713166333,07-11-24 19:28,441.22,Deposit,Cash Deposit,4182.515388
10889,713166333,7-13-24 13:28,282.57,Return,Best Buy Return,4465.085388
10890,713166333,7-13-24 19:28,198.62,Deposit,Direct Deposit,4663.705388
10891,713166333,7-14-24 14:28,35.83,Deposit,Mobile Deposit,4699.535388
10892,713166333,7-16-24 14:28,364.5,OnlineShopping,Target,4335.035388
10893,713166333,7-16-24 21:28,2600,Payment,Rent Payment,1735.035388
10894,713166333,7-16-24 21:28,495.66,Withdrawal,Mobile App Withdrawal,1239.375388
10895,713166333,7-16-24 23:28,207.31,Payment,Mortgage Payment,1032.065388
10896,713183508,1-22-24 23:28,82.45,Deposit,Mobile Deposit,773.7807133
10897,713183508,1-23-24 16:28,315.58,Withdrawal,ATM Withdrawal,458.2007133
10898,713183508,1-26-24 19:28,490.22,OnlineShopping,eBay,-32.01928673
10899,713183508,1-29-24 13:28,443.75,Deposit,Mobile Deposit,411.7307133
10900,713183508,1-31-24 11:28,121.79,IncomingTransfer,Freelance Payment,533.5207133
10901,713183508,02-04-24 10:28,462.2,Return,AliExpress Return,995.7207133
10902,713183508,02-10-24 17:28,170.83,Purchase,Electronics,824.8907133
10903,713183508,02-10-24 20:28,212.87,Return,Target Return,1037.760713
10904,713183508,2-13-24 21:28,147.79,OnlineShopping,Best Buy,889.9707133
10905,713183508,2-14-24 9:28,159.9,Deposit,Direct Deposit,1049.870713
10906,713183508,2-14-24 20:28,58.67,OnlineShopping,AliExpress,991.2007133
10907,713183508,2-18-24 13:28,50.53,Deposit,Mobile Deposit,1041.730713
10908,713183508,2-20-24 22:28,32.88,Withdrawal,Mobile App Withdrawal,1008.850713
10909,713183508,2-23-24 14:28,41.12,Payment,Bill Payment,967.7307133
10910,713183508,2-24-24 20:28,92.08,OnlineShopping,Best Buy,875.6507133
10911,713183508,2-27-24 18:28,152.45,Deposit,Mobile Deposit,1028.100713
10912,713183508,2-28-24 11:28,89.08,Payment,Mortgage Payment,939.0207133
10913,713183508,03-01-24 9:28,72.89,OutgoingTransfer,Bank Transfer,866.1307133
10914,713183508,03-01-24 20:28,311.3,Withdrawal,Branch Withdrawal,554.8307133
10915,713183508,03-05-24 11:28,232.15,Return,Best Buy Return,786.9807133
10916,713183508,03-06-24 20:28,16.72,Deposit,Mobile Deposit,803.7007133
10917,713183508,03-06-24 23:28,322.39,OutgoingTransfer,Wire Transfer,481.3107133
10918,713183508,03-07-24 22:28,322.67,Deposit,Cash Deposit,803.9807133
10919,713183508,3-17-24 13:28,47.09,Payment,Mortgage Payment,756.8907133
10920,713183508,3-20-24 22:28,291.95,Withdrawal,Mobile App Withdrawal,464.9407133
10921,713183508,3-21-24 14:28,254.17,IncomingTransfer,Freelance Payment,719.1107133
10922,713183508,3-25-24 9:28,323.98,Withdrawal,ATM Withdrawal,395.1307133
10923,713183508,3-25-24 11:28,451.73,Purchase,Entertainment,-56.59928673
10924,713183508,3-25-24 11:28,26.24,OnlineShopping,Etsy,-82.83928673
10925,713183508,3-27-24 17:28,436.66,Deposit,Check Deposit,353.8207133
10926,713183508,3-31-24 14:28,467.18,OutgoingTransfer,International Transfer,-113.3592867
10927,713183508,04-02-24 16:28,219.99,Withdrawal,ATM Withdrawal,-333.3492867
10928,713183508,04-04-24 23:28,236.34,Withdrawal,Mobile App Withdrawal,-569.6892867
10929,713183508,04-08-24 13:28,293.98,Deposit,Check Deposit,-275.7092867
10930,713183508,04-08-24 19:28,253.76,Payment,Bill Payment,-529.4692867
10931,713183508,04-08-24 19:28,132.47,Deposit,Mobile Deposit,-396.9992867
10932,713183508,04-09-24 21:28,328.02,Return,Best Buy Return,-68.97928673
10933,713183508,04-11-24 22:28,270.9,Withdrawal,Mobile App Withdrawal,-339.8792867
10934,713183508,04-12-24 10:28,237.35,Deposit,Direct Deposit,-102.5292867
10935,713183508,04-12-24 13:28,250.72,Purchase,Restaurant,-353.2492867
10936,713183508,4-13-24 20:28,124.77,Deposit,Direct Deposit,-228.4792867
10937,713183508,4-14-24 12:28,126.69,Withdrawal,Branch Withdrawal,-355.1692867
10938,713183508,4-15-24 10:28,273.48,Return,Store Return,-81.68928673
10939,713183508,4-17-24 10:28,462.56,OutgoingTransfer,Wire Transfer,-544.2492867
10940,713183508,4-20-24 21:28,266.78,IncomingTransfer,Freelance Payment,-277.4692867
10941,713183508,4-21-24 15:28,340.15,Deposit,Mobile Deposit,62.68071327
10942,713183508,4-21-24 19:28,389.96,Return,AliExpress Return,452.6407133
10943,713183508,4-25-24 11:28,433.55,Deposit,Mobile Deposit,886.1907133
10944,713183508,05-04-24 12:28,461.17,Withdrawal,Mobile App Withdrawal,425.0207133
10945,713183508,05-04-24 19:28,377.71,Return,Walmart Return,802.7307133
10946,713183508,05-06-24 17:28,466.24,Purchase,Grocery,336.4907133
10947,713183508,05-11-24 11:28,435.99,OutgoingTransfer,Peer-to-Peer Transfer,-99.49928673
10948,713183508,05-12-24 15:28,445.37,Payment,Bill Payment,-544.8692867
10949,713183508,5-13-24 10:28,47.7,Withdrawal,ATM Withdrawal,-592.5692867
10950,713183508,5-14-24 22:28,164.26,Return,Walmart Return,-428.3092867
10951,713183508,5-16-24 20:28,345.03,Deposit,Check Deposit,-83.27928673
10952,713183508,5-18-24 12:28,494.48,Purchase,Entertainment,-577.7592867
10953,713183508,5-18-24 15:28,346.16,Purchase,Electronics,-923.9192867
10954,713183508,5-18-24 16:28,126.36,Payment,Mortgage Payment,-1050.279287
10955,713183508,5-20-24 10:28,121.12,Return,Etsy Return,-929.1592867
10956,713183508,5-20-24 19:28,420.74,Return,Target Return,-508.4192867
10957,713183508,5-25-24 19:28,343.11,OnlineShopping,eBay,-851.5292867
10958,713183508,06-09-24 16:28,343.6,Payment,Loan Payment,-1195.129287
10959,713183508,06-10-24 14:28,425.51,OutgoingTransfer,International Transfer,-1620.639287
10960,713183508,06-12-24 14:28,161.19,Purchase,Entertainment,-1781.829287
10961,713183508,6-14-24 12:28,46.13,Return,Amazon Return,-1735.699287
10962,713183508,6-15-24 21:28,205.37,Payment,Mortgage Payment,-1941.069287
10963,713183508,6-17-24 10:28,82.17,Purchase,Restaurant,-2023.239287
10964,713183508,6-18-24 18:28,260.41,Deposit,Check Deposit,-1762.829287
10965,713183508,6-19-24 13:28,389.77,Deposit,Direct Deposit,-1373.059287
10966,713183508,6-22-24 12:28,98.19,Deposit,Direct Deposit,-1274.869287
10967,713183508,6-22-24 16:28,268.01,Purchase,Entertainment,-1542.879287
10968,713183508,6-23-24 10:28,77.67,Withdrawal,Branch Withdrawal,-1620.549287
10969,713183508,6-26-24 11:28,307.49,Purchase,Clothing,-1928.039287
10970,713183508,6-28-24 16:28,120.96,Deposit,Check Deposit,-1807.079287
10971,713183508,6-29-24 17:28,438.2,Purchase,Travel,-2245.279287
10972,713183508,6-29-24 20:28,192.51,Deposit,Direct Deposit,-2052.769287
10973,713183508,6-29-24 21:28,438.48,Deposit,Direct Deposit,-1614.289287
10974,713183508,07-01-24 10:28,180.7,Payment,Loan Payment,-1794.989287
10975,713183508,07-02-24 11:28,248.59,OutgoingTransfer,Peer-to-Peer Transfer,-2043.579287
10976,713183508,7-13-24 18:28,425.43,Deposit,Check Deposit,-1618.149287
10977,713183508,7-14-24 22:28,357.99,Purchase,Gas,-1976.139287
10978,713206683,1-21-24 18:28,704.91,OnlineShopping,AliExpress,-704.91
10979,713206683,02-01-24 21:28,10000,IncomingTransfer,Salary,9295.09
10980,713206683,02-02-24 18:28,478.64,Deposit,Cash Deposit,9773.73
10981,713206683,2-15-24 12:28,655.78,Deposit,Direct Deposit,10429.51
10982,713206683,2-17-24 21:28,5100,Payment,Rent Payment,5329.51
10983,713206683,2-19-24 20:28,271.18,Withdrawal,Branch Withdrawal,5058.33
10984,713206683,2-27-24 19:28,227.97,Return,Target Return,5286.3
10985,713206683,2-28-24 15:28,358.55,OnlineShopping,Etsy,4927.75
10986,713206683,03-03-24 21:28,10000,IncomingTransfer,Salary,14927.75
10987,713206683,03-12-24 18:28,280.7,Purchase,Furniture,14647.05
10988,713206683,3-13-24 10:28,155.65,OnlineShopping,Etsy,14491.4
10989,713206683,3-14-24 21:28,2900,Payment,Rent Payment,11591.4
10990,713206683,3-20-24 20:28,738.66,OnlineShopping,Walmart,10852.74
10991,713206683,3-21-24 14:28,417.99,IncomingTransfer,Freelance Payment,11270.73
10992,713206683,3-21-24 22:28,471.82,Payment,Mortgage Payment,10798.91
10993,713206683,04-04-24 21:28,10000,IncomingTransfer,Salary,20798.91
10994,713206683,04-05-24 23:28,384.88,Withdrawal,Branch Withdrawal,20414.03
10995,713206683,04-08-24 10:28,242.07,OnlineShopping,Target,20171.96
10996,713206683,04-11-24 15:28,267.49,Withdrawal,ATM Withdrawal,19904.47
10997,713206683,4-17-24 21:28,3700,Payment,Rent Payment,16204.47
10998,713206683,4-21-24 21:28,472.53,Purchase,Gas,15731.94
10999,713206683,4-30-24 20:28,429.24,IncomingTransfer,Freelance Payment,16161.18
11000,713206683,05-04-24 21:28,10000,IncomingTransfer,Salary,26161.18
11001,713206683,05-10-24 10:28,577.97,Purchase,Home Improvement,25583.21
11002,713206683,5-16-24 21:28,4400,Payment,Rent Payment,21183.21
11003,713206683,5-16-24 22:28,742.89,Return,Store Return,21926.1
11004,713206683,06-01-24 18:28,573.36,Purchase,Electronics,21352.74
11005,713206683,06-01-24 21:28,10000,IncomingTransfer,Salary,31352.74
11006,713206683,06-05-24 9:28,376.33,Return,Store Return,31729.07
11007,713206683,06-11-24 10:28,223.32,Deposit,Cash Deposit,31952.39
11008,713206683,6-16-24 21:28,4000,Payment,Rent Payment,27952.39
11009,713206683,6-22-24 15:28,322.57,OutgoingTransfer,Peer-to-Peer Transfer,27629.82
11010,713206683,6-22-24 21:28,743.5,Return,Store Return,28373.32
11011,713206683,6-27-24 12:28,715.29,Payment,Loan Payment,27658.03
11012,713206683,07-02-24 21:28,10000,IncomingTransfer,Salary,37658.03
11013,713206683,07-06-24 13:28,351.16,IncomingTransfer,Freelance Payment,38009.19
11014,713206683,7-14-24 21:28,2700,Payment,Rent Payment,35309.19
11015,713206683,7-16-24 15:28,352.97,Deposit,Cash Deposit,35662.16
11016,713229633,1-22-24 23:28,329.09,Return,Target Return,329.09
11017,713229633,1-24-24 13:28,208.36,Purchase,Gas,120.73
11018,713229633,1-28-24 20:28,368.03,Payment,Mortgage Payment,-247.3
11019,713229633,1-30-24 22:28,187.13,Payment,Mortgage Payment,-434.43
11020,713229633,02-01-24 13:28,344.77,Return,Amazon Return,-89.66
11021,713229633,02-01-24 21:28,268.85,Purchase,Grocery,-358.51
11022,713229633,02-04-24 21:28,3850,IncomingTransfer,Salary,3491.49
11023,713229633,02-07-24 21:28,173.09,Withdrawal,ATM Withdrawal,3318.4
11024,713229633,02-12-24 17:28,312.74,IncomingTransfer,Freelance Payment,3631.14
11025,713229633,2-14-24 9:28,99.02,IncomingTransfer,Freelance Payment,3730.16
11026,713229633,2-18-24 21:28,1300,Payment,Rent Payment,2430.16
11027,713229633,2-22-24 18:28,150.36,Purchase,Pharmacy,2279.8
11028,713229633,2-24-24 18:28,42.46,Deposit,Check Deposit,2322.26
11029,713229633,03-03-24 21:28,3850,IncomingTransfer,Salary,6172.26
11030,713229633,03-10-24 10:28,126.6,Return,eBay Return,6298.86
11031,713229633,03-12-24 21:28,1700,Payment,Rent Payment,4598.86
11032,713229633,3-14-24 20:28,219.85,Withdrawal,ATM Withdrawal,4379.01
11033,713229633,3-15-24 13:28,34.33,Payment,Bill Payment,4344.68
11034,713229633,3-23-24 10:28,251.34,IncomingTransfer,Freelance Payment,4596.02
11035,713229633,3-28-24 16:28,80.43,OnlineShopping,Walmart,4515.59
11036,713229633,3-29-24 10:28,50.27,Purchase,Electronics,4465.32
11037,713229633,3-31-24 22:28,120.24,Deposit,Direct Deposit,4585.56
11038,713229633,04-03-24 21:28,3850,IncomingTransfer,Salary,8435.56
11039,713229633,04-03-24 21:28,101.36,Deposit,Mobile Deposit,8536.92
11040,713229633,04-05-24 11:28,208.64,Deposit,Cash Deposit,8745.56
11041,713229633,04-05-24 22:28,154.25,OutgoingTransfer,International Transfer,8591.31
11042,713229633,04-06-24 15:28,376.84,OnlineShopping,Amazon,8214.47
11043,713229633,04-12-24 16:28,147.3,Payment,Loan Payment,8067.17
11044,713229633,4-17-24 21:28,2000,Payment,Rent Payment,6067.17
11045,713229633,4-18-24 16:28,258.52,Withdrawal,Branch Withdrawal,5808.65
11046,713229633,4-26-24 21:28,243.46,Return,eBay Return,6052.11
11047,713229633,4-27-24 19:28,333.05,Deposit,Mobile Deposit,6385.16
11048,713229633,4-29-24 9:28,21.59,OnlineShopping,eBay,6363.57
11049,713229633,4-29-24 14:28,62.18,Withdrawal,Mobile App Withdrawal,6301.39
11050,713229633,4-29-24 18:28,262.58,OnlineShopping,AliExpress,6038.81
11051,713229633,4-30-24 15:28,127.23,Deposit,Mobile Deposit,6166.04
11052,713229633,05-03-24 21:28,350.78,Purchase,Restaurant,5815.26
11053,713229633,05-05-24 21:28,3850,IncomingTransfer,Salary,9665.26
11054,713229633,05-06-24 15:28,188.3,OutgoingTransfer,Wire Transfer,9476.96
11055,713229633,05-10-24 13:28,366.89,Return,Store Return,9843.85
11056,713229633,05-10-24 21:28,1000,Payment,Rent Payment,8843.85
11057,713229633,05-11-24 14:28,361.87,Deposit,Check Deposit,9205.72
11058,713229633,5-20-24 18:28,388.25,Deposit,Mobile Deposit,9593.97
11059,713229633,06-01-24 21:28,3850,IncomingTransfer,Salary,13443.97
11060,713229633,06-03-24 21:28,176.18,Purchase,Grocery,13267.79
11061,713229633,06-07-24 10:28,324.51,Deposit,Direct Deposit,13592.3
11062,713229633,06-07-24 10:28,364.62,Purchase,Grocery,13227.68
11063,713229633,6-13-24 21:28,198.48,OnlineShopping,Etsy,13029.2
11064,713229633,6-14-24 15:28,324.79,OutgoingTransfer,Peer-to-Peer Transfer,12704.41
11065,713229633,6-18-24 21:28,1000,Payment,Rent Payment,11704.41
11066,713229633,6-19-24 19:28,94.45,Payment,Loan Payment,11609.96
11067,713229633,6-23-24 18:28,180.89,Deposit,Mobile Deposit,11790.85
11068,713229633,6-24-24 18:28,32.52,Deposit,Mobile Deposit,11823.37
11069,713229633,6-27-24 13:28,74.21,Withdrawal,Branch Withdrawal,11749.16
11070,713229633,07-01-24 16:28,348.87,Purchase,Grocery,11400.29
11071,713229633,07-04-24 21:28,3850,IncomingTransfer,Salary,15250.29
11072,713229633,07-05-24 16:28,51,Return,Amazon Return,15301.29
11073,713229633,7-15-24 21:28,1300,Payment,Rent Payment,14001.29
11074,713229633,7-17-24 11:28,189.31,Withdrawal,Mobile App Withdrawal,13811.98
11075,713281833,1-20-24 11:28,398.79,Payment,Loan Payment,1784.219716
11076,713281833,1-20-24 17:28,349.56,Return,Target Return,2133.779716
11077,713281833,1-21-24 16:28,285.29,Withdrawal,Branch Withdrawal,1848.489716
11078,713281833,1-23-24 12:28,284.76,Purchase,Furniture,1563.729716
11079,713281833,1-30-24 21:28,46.22,Purchase,Gas,1517.509716
11080,713281833,1-30-24 22:28,285.66,Return,Store Return,1803.169716
11081,713281833,02-01-24 21:28,4150,IncomingTransfer,Salary,5953.169716
11082,713281833,02-02-24 14:28,298.07,Payment,Loan Payment,5655.099716
11083,713281833,02-06-24 18:28,388.36,Withdrawal,Mobile App Withdrawal,5266.739716
11084,713281833,02-06-24 21:28,2700,Payment,Credit Card Payment,2566.739716
11085,713281833,02-09-24 9:28,246.68,Purchase,Travel,2320.059716
11086,713281833,02-10-24 11:28,191.98,Purchase,Pharmacy,2128.079716
11087,713281833,2-13-24 21:28,2000,Payment,Rent Payment,128.079716
11088,713281833,2-14-24 10:28,324.09,Withdrawal,Mobile App Withdrawal,-196.010284
11089,713281833,2-14-24 11:28,385.34,Payment,Mortgage Payment,-581.350284
11090,713281833,2-15-24 23:28,318.77,Deposit,Cash Deposit,-262.580284
11091,713281833,2-16-24 21:28,231.02,Withdrawal,ATM Withdrawal,-493.600284
11092,713281833,2-17-24 16:28,99.9,Deposit,Check Deposit,-393.700284
11093,713281833,2-24-24 18:28,284.77,Withdrawal,Branch Withdrawal,-678.470284
11094,713281833,2-25-24 10:28,152.7,OutgoingTransfer,Bank Transfer,-831.170284
11095,713281833,2-25-24 14:28,163.26,Return,Store Return,-667.910284
11096,713281833,2-25-24 17:28,131.65,Return,Amazon Return,-536.260284
11097,713281833,2-25-24 22:28,275.9,Return,Amazon Return,-260.360284
11098,713281833,2-29-24 20:28,343.18,OutgoingTransfer,Bank Transfer,-603.540284
11099,713281833,03-01-24 17:28,37.45,Purchase,Restaurant,-640.990284
11100,713281833,03-01-24 21:28,4150,IncomingTransfer,Salary,3509.009716
11101,713281833,03-02-24 10:28,108.23,IncomingTransfer,Freelance Payment,3617.239716
11102,713281833,03-05-24 10:28,61.22,Purchase,Clothing,3556.019716
11103,713281833,03-06-24 21:28,2600,Payment,Credit Card Payment,956.019716
11104,713281833,03-09-24 17:28,116.35,Purchase,Furniture,839.669716
11105,713281833,03-11-24 9:28,242.7,OnlineShopping,Best Buy,596.969716
11106,713281833,03-11-24 15:28,114.32,Payment,Mortgage Payment,482.649716
11107,713281833,03-11-24 20:28,259.82,Deposit,Direct Deposit,742.469716
11108,713281833,3-14-24 21:28,1400,Payment,Rent Payment,-657.530284
11109,713281833,3-18-24 15:28,108.51,Return,Walmart Return,-549.020284
11110,713281833,3-18-24 15:28,354.8,Purchase,Grocery,-903.820284
11111,713281833,3-18-24 16:28,384.47,OnlineShopping,AliExpress,-1288.290284
11112,713281833,3-18-24 22:28,106.69,Deposit,Mobile Deposit,-1181.600284
11113,713281833,3-22-24 17:28,211.77,Withdrawal,ATM Withdrawal,-1393.370284
11114,713281833,3-23-24 10:28,387.84,Deposit,Direct Deposit,-1005.530284
11115,713281833,3-26-24 20:28,318.13,Withdrawal,Mobile App Withdrawal,-1323.660284
11116,713281833,3-27-24 18:28,335.29,Withdrawal,Branch Withdrawal,-1658.950284
11117,713281833,3-31-24 14:28,37.56,Withdrawal,ATM Withdrawal,-1696.510284
11118,713281833,3-31-24 22:28,330.1,OnlineShopping,eBay,-2026.610284
11119,713281833,04-01-24 20:28,312.05,Purchase,Grocery,-2338.660284
11120,713281833,04-01-24 21:28,94.48,Withdrawal,ATM Withdrawal,-2433.140284
11121,713281833,04-02-24 23:28,230.83,IncomingTransfer,Freelance Payment,-2202.310284
11122,713281833,04-03-24 12:28,192.13,Deposit,Cash Deposit,-2010.180284
11123,713281833,04-05-24 21:28,4150,IncomingTransfer,Salary,2139.819716
11124,713281833,04-09-24 21:28,31.08,Deposit,Mobile Deposit,2170.899716
11125,713281833,04-10-24 21:28,3600,Payment,Credit Card Payment,-1429.100284
11126,713281833,04-10-24 22:28,66.18,OnlineShopping,Walmart,-1495.280284
11127,713281833,04-11-24 15:28,187.15,OnlineShopping,Walmart,-1682.430284
11128,713281833,04-12-24 21:28,2100,Payment,Rent Payment,-3782.430284
11129,713281833,04-12-24 21:28,276.23,OutgoingTransfer,International Transfer,-4058.660284
11130,713281833,4-17-24 17:28,29,OnlineShopping,Best Buy,-4087.660284
11131,713281833,4-19-24 9:28,386.36,Withdrawal,Mobile App Withdrawal,-4474.020284
11132,713281833,4-20-24 17:28,158.32,Payment,Bill Payment,-4632.340284
11133,713281833,4-20-24 22:28,109.92,Return,Target Return,-4522.420284
11134,713281833,4-21-24 11:28,337.98,Purchase,Gas,-4860.400284
11135,713281833,4-21-24 21:28,308.19,Purchase,Entertainment,-5168.590284
11136,713281833,4-28-24 18:28,322.84,Payment,Loan Payment,-5491.430284
11137,713281833,05-02-24 21:28,4150,IncomingTransfer,Salary,-1341.430284
11138,713281833,05-07-24 21:28,2900,Payment,Credit Card Payment,-4241.430284
11139,713281833,05-08-24 23:28,125.69,OutgoingTransfer,Peer-to-Peer Transfer,-4367.120284
11140,713281833,05-09-24 23:28,281.81,OnlineShopping,AliExpress,-4648.930284
11141,713281833,5-16-24 18:28,119.75,Payment,Loan Payment,-4768.680284
11142,713281833,5-17-24 21:28,1400,Payment,Rent Payment,-6168.680284
11143,713281833,5-20-24 9:28,328.58,Return,Best Buy Return,-5840.100284
11144,713281833,5-21-24 12:28,44.23,Withdrawal,Mobile App Withdrawal,-5884.330284
11145,713281833,5-22-24 10:28,276.91,Withdrawal,ATM Withdrawal,-6161.240284
11146,713281833,5-23-24 14:28,219.75,OutgoingTransfer,Bank Transfer,-6380.990284
11147,713281833,5-27-24 19:28,336.93,OnlineShopping,AliExpress,-6717.920284
11148,713281833,06-05-24 21:28,4150,IncomingTransfer,Salary,-2567.920284
11149,713281833,06-06-24 14:28,333.21,OutgoingTransfer,Wire Transfer,-2901.130284
11150,713281833,06-08-24 16:28,31.31,Return,eBay Return,-2869.820284
11151,713281833,06-10-24 11:28,326.47,Payment,Loan Payment,-3196.290284
11152,713281833,06-10-24 21:28,3100,Payment,Credit Card Payment,-6296.290284
11153,713281833,6-16-24 19:28,217.74,Purchase,Gas,-6514.030284
11154,713281833,6-17-24 21:28,2400,Payment,Rent Payment,-8914.030284
11155,713281833,6-18-24 13:28,272.95,OutgoingTransfer,Bank Transfer,-9186.980284
11156,713281833,6-21-24 21:28,130.36,Withdrawal,Branch Withdrawal,-9317.340284
11157,713281833,6-22-24 19:28,34.29,OnlineShopping,Target,-9351.630284
11158,713281833,6-23-24 21:28,59.02,Payment,Loan Payment,-9410.650284
11159,713281833,6-24-24 15:28,21.14,Withdrawal,ATM Withdrawal,-9431.790284
11160,713281833,6-30-24 15:28,377.38,Withdrawal,Mobile App Withdrawal,-9809.170284
11161,713281833,07-02-24 14:28,256.57,Payment,Loan Payment,-10065.74028
11162,713281833,07-02-24 21:28,4150,IncomingTransfer,Salary,-5915.740284
11163,713281833,07-03-24 13:28,247.54,Payment,Loan Payment,-6163.280284
11164,713281833,07-06-24 10:28,294.73,Return,Amazon Return,-5868.550284
11165,713281833,07-07-24 18:28,258.73,OutgoingTransfer,Wire Transfer,-6127.280284
11166,713281833,07-07-24 21:28,3100,Payment,Credit Card Payment,-9227.280284
11167,713281833,07-08-24 19:28,381.13,OutgoingTransfer,Peer-to-Peer Transfer,-9608.410284
11168,713281833,07-08-24 22:28,260.84,OutgoingTransfer,International Transfer,-9869.250284
11169,713281833,07-10-24 21:28,2400,Payment,Rent Payment,-12269.25028
11170,713281833,7-16-24 9:28,337.1,Purchase,Pharmacy,-12606.35028
11171,713281833,7-16-24 23:28,38.65,Withdrawal,ATM Withdrawal,-12645.00028
11172,713282733,1-20-24 15:28,102.57,Deposit,Direct Deposit,1323.035456
11173,713282733,1-22-24 16:28,199.39,Purchase,Entertainment,1123.645456
11174,713282733,1-24-24 16:28,363.55,OutgoingTransfer,Wire Transfer,760.0954559
11175,713282733,1-25-24 13:28,386.13,Deposit,Check Deposit,1146.225456
11176,713282733,1-25-24 20:28,77.94,Return,Etsy Return,1224.165456
11177,713282733,1-28-24 13:28,196.53,Purchase,Grocery,1027.635456
11178,713282733,1-28-24 17:28,277.05,Withdrawal,Mobile App Withdrawal,750.5854559
11179,713282733,1-29-24 23:28,188.99,Purchase,Entertainment,561.5954559
11180,713282733,02-02-24 21:28,3700,IncomingTransfer,Salary,4261.595456
11181,713282733,02-02-24 23:28,392.22,Deposit,Check Deposit,4653.815456
11182,713282733,02-04-24 10:28,152.61,Purchase,Pharmacy,4501.205456
11183,713282733,02-04-24 17:28,320.17,Purchase,Home Improvement,4181.035456
11184,713282733,02-07-24 18:28,157.13,OnlineShopping,Amazon,4023.905456
11185,713282733,02-07-24 21:28,2600,Payment,Credit Card Payment,1423.905456
11186,713282733,02-11-24 13:28,152.71,Deposit,Mobile Deposit,1576.615456
11187,713282733,2-13-24 21:28,1800,Payment,Rent Payment,-223.3845441
11188,713282733,2-19-24 12:28,21.61,Return,eBay Return,-201.7745441
11189,713282733,2-22-24 18:28,272.55,Payment,Bill Payment,-474.3245441
11190,713282733,2-24-24 16:28,115.74,OutgoingTransfer,Peer-to-Peer Transfer,-590.0645441
11191,713282733,03-01-24 10:28,301.14,Withdrawal,Branch Withdrawal,-891.2045441
11192,713282733,03-04-24 21:28,3700,IncomingTransfer,Salary,2808.795456
11193,713282733,03-05-24 15:28,289.45,OutgoingTransfer,Wire Transfer,2519.345456
11194,713282733,03-09-24 21:28,2300,Payment,Credit Card Payment,219.3454559
11195,713282733,03-11-24 13:28,328.61,Withdrawal,ATM Withdrawal,-109.2645441
11196,713282733,3-17-24 10:28,375.63,OutgoingTransfer,Peer-to-Peer Transfer,-484.8945441
11197,713282733,3-18-24 21:28,1800,Payment,Rent Payment,-2284.894544
11198,713282733,3-23-24 18:28,394.09,OutgoingTransfer,Bank Transfer,-2678.984544
11199,713282733,3-27-24 21:28,53.33,Deposit,Check Deposit,-2625.654544
11200,713282733,3-28-24 14:28,91.5,Return,Etsy Return,-2534.154544
11201,713282733,3-30-24 10:28,77.53,Purchase,Gas,-2611.684544
11202,713282733,04-02-24 21:28,3700,IncomingTransfer,Salary,1088.315456
11203,713282733,04-04-24 10:28,43.38,Purchase,Entertainment,1044.935456
11204,713282733,04-05-24 9:28,197.85,Deposit,Mobile Deposit,1242.785456
11205,713282733,04-07-24 21:28,2300,Payment,Credit Card Payment,-1057.214544
11206,713282733,04-11-24 9:28,126.22,Purchase,Clothing,-1183.434544
11207,713282733,4-14-24 12:28,368.33,Payment,Bill Payment,-1551.764544
11208,713282733,4-14-24 21:28,1400,Payment,Rent Payment,-2951.764544
11209,713282733,4-17-24 14:28,387.35,Payment,Bill Payment,-3339.114544
11210,713282733,4-17-24 21:28,358.05,Purchase,Furniture,-3697.164544
11211,713282733,4-18-24 22:28,327.49,OnlineShopping,Etsy,-4024.654544
11212,713282733,4-22-24 10:28,46.78,Return,Best Buy Return,-3977.874544
11213,713282733,4-22-24 14:28,380.86,Payment,Loan Payment,-4358.734544
11214,713282733,4-30-24 12:28,155.47,Deposit,Check Deposit,-4203.264544
11215,713282733,05-01-24 13:28,266.65,OnlineShopping,AliExpress,-4469.914544
11216,713282733,05-01-24 23:28,303.65,Deposit,Direct Deposit,-4166.264544
11217,713282733,05-02-24 20:28,76.05,Withdrawal,ATM Withdrawal,-4242.314544
11218,713282733,05-03-24 21:28,3700,IncomingTransfer,Salary,-542.3145441
11219,713282733,05-07-24 9:28,284.45,OnlineShopping,Walmart,-826.7645441
11220,713282733,05-08-24 21:28,1900,Payment,Credit Card Payment,-2726.764544
11221,713282733,05-10-24 22:28,35.65,Purchase,Gas,-2762.414544
11222,713282733,05-12-24 21:28,2100,Payment,Rent Payment,-4862.414544
11223,713282733,5-14-24 21:28,52.35,Withdrawal,Branch Withdrawal,-4914.764544
11224,713282733,5-14-24 22:28,200.44,Purchase,Grocery,-5115.204544
11225,713282733,5-18-24 10:28,279.61,Purchase,Restaurant,-5394.814544
11226,713282733,5-21-24 17:28,234.36,OutgoingTransfer,International Transfer,-5629.174544
11227,713282733,5-23-24 19:28,139.17,Purchase,Furniture,-5768.344544
11228,713282733,5-23-24 23:28,166.41,Withdrawal,Mobile App Withdrawal,-5934.754544
11229,713282733,5-24-24 13:28,396.44,Deposit,Cash Deposit,-5538.314544
11230,713282733,5-28-24 11:28,41.23,Deposit,Check Deposit,-5497.084544
11231,713282733,5-31-24 9:28,68.78,OnlineShopping,Etsy,-5565.864544
11232,713282733,06-01-24 13:28,226.13,IncomingTransfer,Freelance Payment,-5339.734544
11233,713282733,06-02-24 10:28,106.68,Payment,Bill Payment,-5446.414544
11234,713282733,06-03-24 21:28,3700,IncomingTransfer,Salary,-1746.414544
11235,713282733,06-08-24 12:28,33.89,Purchase,Clothing,-1780.304544
11236,713282733,06-08-24 14:28,351.65,OnlineShopping,Target,-2131.954544
11237,713282733,06-08-24 21:28,2100,Payment,Credit Card Payment,-4231.954544
11238,713282733,06-10-24 17:28,319.28,Purchase,Travel,-4551.234544
11239,713282733,6-13-24 11:28,124.32,Payment,Loan Payment,-4675.554544
11240,713282733,6-15-24 20:28,43.59,Withdrawal,ATM Withdrawal,-4719.144544
11241,713282733,6-16-24 12:28,263.36,Return,AliExpress Return,-4455.784544
11242,713282733,6-17-24 21:28,1200,Payment,Rent Payment,-5655.784544
11243,713282733,6-18-24 19:28,286.17,OutgoingTransfer,Wire Transfer,-5941.954544
11244,713282733,6-23-24 17:28,165.94,OnlineShopping,Amazon,-6107.894544
11245,713282733,07-02-24 11:28,117.44,Payment,Loan Payment,-6225.334544
11246,713282733,07-03-24 21:28,3700,IncomingTransfer,Salary,-2525.334544
11247,713282733,07-04-24 18:28,306.99,OnlineShopping,Etsy,-2832.324544
11248,713282733,07-08-24 21:28,2400,Payment,Credit Card Payment,-5232.324544
11249,713282733,07-09-24 10:28,313.42,OnlineShopping,Amazon,-5545.744544
11250,713282733,07-10-24 18:28,269.47,Purchase,Electronics,-5815.214544
11251,713282733,07-10-24 20:28,268.42,OutgoingTransfer,Wire Transfer,-6083.634544
11252,713282733,07-12-24 21:28,2000,Payment,Rent Payment,-8083.634544
11253,713282733,7-13-24 11:28,371.23,Withdrawal,Branch Withdrawal,-8454.864544
11254,713314533,1-29-24 13:28,474.75,Payment,Loan Payment,-474.75
11255,713314533,02-02-24 21:28,6400,IncomingTransfer,Salary,5925.25
11256,713314533,02-03-24 18:28,135.48,Withdrawal,ATM Withdrawal,5789.77
11257,713314533,02-04-24 13:28,472.07,Withdrawal,Branch Withdrawal,5317.7
11258,713314533,02-09-24 13:28,376.13,Deposit,Direct Deposit,5693.83
11259,713314533,2-14-24 21:28,2800,Payment,Rent Payment,2893.83
11260,713314533,2-16-24 14:28,139.37,OutgoingTransfer,Bank Transfer,2754.46
11261,713314533,2-17-24 16:28,466.86,Deposit,Cash Deposit,3221.32
11262,713314533,2-19-24 21:28,495.89,Purchase,Electronics,2725.43
11263,713314533,2-25-24 19:28,534.25,Purchase,Pharmacy,2191.18
11264,713314533,03-01-24 21:28,6400,IncomingTransfer,Salary,8591.18
11265,713314533,3-13-24 9:28,171.21,Deposit,Cash Deposit,8762.39
11266,713314533,3-13-24 14:28,541.73,Return,eBay Return,9304.12
11267,713314533,3-13-24 15:28,158.31,OnlineShopping,Etsy,9145.81
11268,713314533,3-15-24 21:28,2700,Payment,Rent Payment,6445.81
11269,713314533,3-20-24 20:28,383.9,OutgoingTransfer,Peer-to-Peer Transfer,6061.91
11270,713314533,3-24-24 18:28,301.49,Purchase,Travel,5760.42
11271,713314533,3-26-24 15:28,327.4,Purchase,Grocery,5433.02
11272,713314533,3-28-24 13:28,324.37,Deposit,Check Deposit,5757.39
11273,713314533,3-28-24 23:28,87.69,Payment,Loan Payment,5669.7
11274,713314533,04-02-24 16:28,327.71,Purchase,Grocery,5341.99
11275,713314533,04-05-24 21:28,6400,IncomingTransfer,Salary,11741.99
11276,713314533,4-14-24 21:28,4100,Payment,Rent Payment,7641.99
11277,713314533,4-16-24 15:28,482.06,IncomingTransfer,Freelance Payment,8124.05
11278,713314533,4-21-24 12:28,526.28,OnlineShopping,Etsy,7597.77
11279,713314533,4-24-24 20:28,434.94,Deposit,Check Deposit,8032.71
11280,713314533,4-29-24 12:28,420.56,IncomingTransfer,Freelance Payment,8453.27
11281,713314533,4-29-24 12:28,97.99,Withdrawal,ATM Withdrawal,8355.28
11282,713314533,05-02-24 17:28,147.03,Deposit,Mobile Deposit,8502.31
11283,713314533,05-02-24 21:28,6400,IncomingTransfer,Salary,14902.31
11284,713314533,05-08-24 10:28,329.64,Purchase,Entertainment,14572.67
11285,713314533,5-16-24 17:28,243.67,Purchase,Pharmacy,14329
11286,713314533,5-17-24 21:28,1800,Payment,Rent Payment,12529
11287,713314533,5-23-24 14:28,386.02,OnlineShopping,Target,12142.98
11288,713314533,5-24-24 20:28,406.4,Return,AliExpress Return,12549.38
11289,713314533,5-27-24 17:28,195.92,OnlineShopping,Best Buy,12353.46
11290,713314533,06-05-24 21:28,6400,IncomingTransfer,Salary,18753.46
11291,713314533,06-06-24 11:28,108.37,Return,eBay Return,18861.83
11292,713314533,06-07-24 18:28,246.6,Purchase,Pharmacy,18615.23
11293,713314533,06-08-24 22:28,204.68,Withdrawal,ATM Withdrawal,18410.55
11294,713314533,6-14-24 23:28,150.32,Payment,Bill Payment,18260.23
11295,713314533,6-17-24 21:28,2700,Payment,Rent Payment,15560.23
11296,713314533,6-22-24 13:28,519.59,Withdrawal,Mobile App Withdrawal,15040.64
11297,713314533,6-23-24 14:28,413.17,Payment,Loan Payment,14627.47
11298,713314533,6-29-24 12:28,168.51,Purchase,Furniture,14458.96
11299,713314533,07-04-24 10:28,73.87,Withdrawal,ATM Withdrawal,14385.09
11300,713314533,07-04-24 21:28,6400,IncomingTransfer,Salary,20785.09
11301,713314533,07-05-24 15:28,135.39,Deposit,Cash Deposit,20920.48
11302,713314533,07-06-24 13:28,134.83,Withdrawal,Branch Withdrawal,20785.65
11303,713314533,07-09-24 17:28,109.6,Deposit,Direct Deposit,20895.25
11304,713314533,07-11-24 15:28,532.35,Withdrawal,Mobile App Withdrawal,20362.9
11305,713314533,07-12-24 15:28,178.8,Withdrawal,Mobile App Withdrawal,20184.1
11306,713314533,7-17-24 21:28,2200,Payment,Rent Payment,17984.1
11307,713437008,1-21-24 19:28,25.47,Withdrawal,ATM Withdrawal,1199.745933
11308,713437008,1-23-24 13:28,446.57,OnlineShopping,eBay,753.1759332
11309,713437008,1-26-24 20:28,161.78,Deposit,Check Deposit,914.9559332
11310,713437008,1-31-24 14:28,117.71,Return,eBay Return,1032.665933
11311,713437008,1-31-24 17:28,475.64,Deposit,Mobile Deposit,1508.305933
11312,713437008,1-31-24 23:28,170.22,OnlineShopping,Best Buy,1338.085933
11313,713437008,02-03-24 19:28,348.83,Deposit,Check Deposit,1686.915933
11314,713437008,02-05-24 21:28,2600,IncomingTransfer,Salary,4286.915933
11315,713437008,02-06-24 21:28,171.38,Withdrawal,ATM Withdrawal,4115.535933
11316,713437008,02-06-24 23:28,373.52,IncomingTransfer,Freelance Payment,4489.055933
11317,713437008,02-09-24 20:28,168.62,IncomingTransfer,Freelance Payment,4657.675933
11318,713437008,02-10-24 13:28,201.36,Payment,Mortgage Payment,4456.315933
11319,713437008,02-10-24 21:28,2000,Payment,Credit Card Payment,2456.315933
11320,713437008,02-12-24 17:28,149.31,Purchase,Travel,2307.005933
11321,713437008,02-12-24 21:28,1500,Payment,Rent Payment,807.0059332
11322,713437008,2-13-24 12:28,274.31,Withdrawal,Mobile App Withdrawal,532.6959332
11323,713437008,2-14-24 20:28,282.34,Payment,Bill Payment,250.3559332
11324,713437008,2-18-24 12:28,391.36,OnlineShopping,eBay,-141.0040668
11325,713437008,2-19-24 12:28,429.21,Payment,Bill Payment,-570.2140668
11326,713437008,2-23-24 21:28,287.2,Deposit,Cash Deposit,-283.0140668
11327,713437008,2-26-24 19:28,481.91,Purchase,Grocery,-764.9240668
11328,713437008,2-27-24 23:28,359.7,Payment,Loan Payment,-1124.624067
11329,713437008,03-01-24 21:28,2600,IncomingTransfer,Salary,1475.375933
11330,713437008,03-04-24 23:28,447.49,OnlineShopping,Best Buy,1027.885933
11331,713437008,03-06-24 15:28,75.4,Purchase,Home Improvement,952.4859332
11332,713437008,03-06-24 21:28,2700,Payment,Credit Card Payment,-1747.514067
11333,713437008,03-08-24 9:28,95.86,Deposit,Cash Deposit,-1651.654067
11334,713437008,03-11-24 16:28,279.85,Withdrawal,Branch Withdrawal,-1931.504067
11335,713437008,03-11-24 23:28,50.71,OutgoingTransfer,Bank Transfer,-1982.214067
11336,713437008,03-12-24 9:28,244.75,OutgoingTransfer,Peer-to-Peer Transfer,-2226.964067
11337,713437008,3-15-24 11:28,76.45,OnlineShopping,Walmart,-2303.414067
11338,713437008,3-18-24 21:28,1400,Payment,Rent Payment,-3703.414067
11339,713437008,3-24-24 22:28,465,Payment,Bill Payment,-4168.414067
11340,713437008,3-25-24 15:28,188.27,OnlineShopping,Best Buy,-4356.684067
11341,713437008,3-26-24 23:28,475.34,Purchase,Clothing,-4832.024067
11342,713437008,3-27-24 14:28,496.51,IncomingTransfer,Freelance Payment,-4335.514067
11343,713437008,04-02-24 18:28,120.98,Return,Amazon Return,-4214.534067
11344,713437008,04-03-24 21:28,2600,IncomingTransfer,Salary,-1614.534067
11345,713437008,04-08-24 21:28,2700,Payment,Credit Card Payment,-4314.534067
11346,713437008,04-11-24 11:28,20.07,IncomingTransfer,Freelance Payment,-4294.464067
11347,713437008,04-11-24 21:28,1400,Payment,Rent Payment,-5694.464067
11348,713437008,4-14-24 21:28,223.02,IncomingTransfer,Freelance Payment,-5471.444067
11349,713437008,4-28-24 19:28,138.69,OutgoingTransfer,International Transfer,-5610.134067
11350,713437008,05-01-24 21:28,2600,IncomingTransfer,Salary,-3010.134067
11351,713437008,05-03-24 19:28,59.94,Payment,Mortgage Payment,-3070.074067
11352,713437008,05-06-24 21:28,2100,Payment,Credit Card Payment,-5170.074067
11353,713437008,05-07-24 18:28,124.61,OnlineShopping,AliExpress,-5294.684067
11354,713437008,05-11-24 11:28,410.14,Purchase,Home Improvement,-5704.824067
11355,713437008,05-11-24 21:28,800,Payment,Rent Payment,-6504.824067
11356,713437008,5-18-24 19:28,279.92,Withdrawal,Branch Withdrawal,-6784.744067
11357,713437008,5-18-24 21:28,292.49,Payment,Loan Payment,-7077.234067
11358,713437008,5-20-24 10:28,176.98,Withdrawal,Mobile App Withdrawal,-7254.214067
11359,713437008,5-21-24 12:28,69.8,OutgoingTransfer,International Transfer,-7324.014067
11360,713437008,5-21-24 15:28,478.41,Purchase,Electronics,-7802.424067
11361,713437008,5-22-24 16:28,459.19,Purchase,Gas,-8261.614067
11362,713437008,5-23-24 18:28,145.07,Deposit,Direct Deposit,-8116.544067
11363,713437008,5-26-24 21:28,185.77,OnlineShopping,Etsy,-8302.314067
11364,713437008,5-29-24 18:28,149.72,OutgoingTransfer,Bank Transfer,-8452.034067
11365,713437008,5-30-24 10:28,233.56,OutgoingTransfer,Bank Transfer,-8685.594067
11366,713437008,5-30-24 17:28,240.7,Purchase,Pharmacy,-8926.294067
11367,713437008,06-04-24 18:28,80.42,Deposit,Mobile Deposit,-8845.874067
11368,713437008,06-04-24 21:28,2600,IncomingTransfer,Salary,-6245.874067
11369,713437008,06-08-24 10:28,370.18,OnlineShopping,Target,-6616.054067
11370,713437008,06-09-24 14:28,442.79,Deposit,Mobile Deposit,-6173.264067
11371,713437008,06-09-24 21:28,2200,Payment,Credit Card Payment,-8373.264067
11372,713437008,06-10-24 21:28,900,Payment,Rent Payment,-9273.264067
11373,713437008,6-18-24 13:28,469.97,Purchase,Pharmacy,-9743.234067
11374,713437008,6-21-24 13:28,443.37,Deposit,Cash Deposit,-9299.864067
11375,713437008,6-25-24 12:28,19.51,Deposit,Cash Deposit,-9280.354067
11376,713437008,6-26-24 9:28,459.64,OutgoingTransfer,Peer-to-Peer Transfer,-9739.994067
11377,713437008,6-27-24 10:28,393.25,Purchase,Entertainment,-10133.24407
11378,713437008,6-28-24 23:28,114.16,Deposit,Mobile Deposit,-10019.08407
11379,713437008,07-02-24 21:28,2600,IncomingTransfer,Salary,-7419.084067
11380,713437008,07-04-24 11:28,314.42,Payment,Loan Payment,-7733.504067
11381,713437008,07-04-24 19:28,75.23,Purchase,Restaurant,-7808.734067
11382,713437008,07-07-24 21:28,2500,Payment,Credit Card Payment,-10308.73407
11383,713437008,07-08-24 19:28,167.52,Deposit,Cash Deposit,-10141.21407
11384,713437008,07-11-24 9:28,277.82,Withdrawal,ATM Withdrawal,-10419.03407
11385,713437008,07-11-24 21:28,1000,Payment,Rent Payment,-11419.03407
11386,713437008,7-13-24 21:28,254.38,Deposit,Check Deposit,-11164.65407
11387,713437008,7-16-24 16:28,246.37,Withdrawal,Mobile App Withdrawal,-11411.02407
11388,713437008,7-17-24 21:28,224.65,IncomingTransfer,Freelance Payment,-11186.37407
11389,713508333,1-24-24 13:28,19.15,Purchase,Clothing,1004.124659
11390,713508333,1-27-24 12:28,134.9,Payment,Loan Payment,869.2246593
11391,713508333,02-02-24 21:28,3000,IncomingTransfer,Salary,3869.224659
11392,713508333,02-04-24 17:28,68.9,Return,eBay Return,3938.124659
11393,713508333,02-05-24 16:28,158.21,OutgoingTransfer,International Transfer,3779.914659
11394,713508333,02-06-24 11:28,198.12,Payment,Loan Payment,3581.794659
11395,713508333,02-07-24 21:28,1300,Payment,Credit Card Payment,2281.794659
11396,713508333,02-08-24 12:28,195.59,Payment,Loan Payment,2086.204659
11397,713508333,02-09-24 13:28,38.3,Withdrawal,Mobile App Withdrawal,2047.904659
11398,713508333,02-09-24 16:28,87.51,Deposit,Mobile Deposit,2135.414659
11399,713508333,02-10-24 12:28,171,Deposit,Cash Deposit,2306.414659
11400,713508333,02-12-24 21:28,1300,Payment,Rent Payment,1006.414659
11401,713508333,2-14-24 13:28,171.68,Purchase,Gas,834.7346593
11402,713508333,2-14-24 14:28,141.98,Payment,Mortgage Payment,692.7546593
11403,713508333,2-14-24 23:28,133.8,Return,AliExpress Return,826.5546593
11404,713508333,2-21-24 23:28,236.5,OutgoingTransfer,International Transfer,590.0546593
11405,713508333,2-22-24 18:28,30.02,Deposit,Cash Deposit,620.0746593
11406,713508333,2-25-24 11:28,212.24,Payment,Mortgage Payment,407.8346593
11407,713508333,03-04-24 16:28,185.02,Payment,Mortgage Payment,222.8146593
11408,713508333,03-04-24 18:28,227.56,Return,Target Return,450.3746593
11409,713508333,03-04-24 19:28,199.03,IncomingTransfer,Freelance Payment,649.4046593
11410,713508333,03-05-24 21:28,3000,IncomingTransfer,Salary,3649.404659
11411,713508333,03-06-24 14:28,132.45,Deposit,Cash Deposit,3781.854659
11412,713508333,03-07-24 11:28,200.15,IncomingTransfer,Freelance Payment,3982.004659
11413,713508333,03-09-24 21:28,19.41,Deposit,Mobile Deposit,4001.414659
11414,713508333,03-10-24 14:28,10.1,OnlineShopping,Walmart,3991.314659
11415,713508333,03-10-24 17:28,50.83,Withdrawal,ATM Withdrawal,3940.484659
11416,713508333,03-10-24 21:28,1700,Payment,Credit Card Payment,2240.484659
11417,713508333,03-12-24 11:28,154.87,OnlineShopping,Best Buy,2085.614659
11418,713508333,03-12-24 18:28,83.04,Payment,Loan Payment,2002.574659
11419,713508333,3-15-24 17:28,84.21,Withdrawal,ATM Withdrawal,1918.364659
11420,713508333,3-16-24 16:28,103.51,Return,Target Return,2021.874659
11421,713508333,3-16-24 21:28,1200,Payment,Rent Payment,821.8746593
11422,713508333,3-18-24 13:28,238.5,Purchase,Entertainment,583.3746593
11423,713508333,3-19-24 17:28,107.18,Deposit,Mobile Deposit,690.5546593
11424,713508333,3-19-24 18:28,117.84,OnlineShopping,Walmart,572.7146593
11425,713508333,3-21-24 16:28,81.24,IncomingTransfer,Freelance Payment,653.9546593
11426,713508333,3-26-24 9:28,31.24,OnlineShopping,AliExpress,622.7146593
11427,713508333,3-30-24 17:28,205.1,Withdrawal,ATM Withdrawal,417.6146593
11428,713508333,3-30-24 19:28,148.46,Purchase,Gas,269.1546593
11429,713508333,04-03-24 21:28,3000,IncomingTransfer,Salary,3269.154659
11430,713508333,04-04-24 13:28,228.47,Return,Target Return,3497.624659
11431,713508333,04-07-24 12:28,179.63,Return,Amazon Return,3677.254659
11432,713508333,04-08-24 21:28,1300,Payment,Credit Card Payment,2377.254659
11433,713508333,04-10-24 23:28,141.41,OutgoingTransfer,Peer-to-Peer Transfer,2235.844659
11434,713508333,4-17-24 21:28,1000,Payment,Rent Payment,1235.844659
11435,713508333,4-18-24 10:28,229,Payment,Bill Payment,1006.844659
11436,713508333,4-20-24 18:28,224.23,Payment,Bill Payment,782.6146593
11437,713508333,4-25-24 15:28,203.9,Payment,Bill Payment,578.7146593
11438,713508333,4-26-24 12:28,223.65,Purchase,Entertainment,355.0646593
11439,713508333,4-26-24 15:28,175.26,Deposit,Check Deposit,530.3246593
11440,713508333,4-28-24 12:28,144.44,OnlineShopping,Target,385.8846593
11441,713508333,05-03-24 21:28,3000,IncomingTransfer,Salary,3385.884659
11442,713508333,05-04-24 19:28,37.77,Withdrawal,ATM Withdrawal,3348.114659
11443,713508333,05-08-24 21:28,1300,Payment,Credit Card Payment,2048.114659
11444,713508333,05-10-24 11:28,107.12,Deposit,Cash Deposit,2155.234659
11445,713508333,05-10-24 18:28,152.49,Deposit,Check Deposit,2307.724659
11446,713508333,05-10-24 21:28,226.45,Deposit,Check Deposit,2534.174659
11447,713508333,05-12-24 10:28,24.15,Deposit,Mobile Deposit,2558.324659
11448,713508333,5-13-24 17:28,86.73,Purchase,Pharmacy,2471.594659
11449,713508333,5-13-24 22:28,238.08,OnlineShopping,eBay,2233.514659
11450,713508333,5-14-24 20:28,229.35,OnlineShopping,AliExpress,2004.164659
11451,713508333,5-15-24 14:28,177.93,Deposit,Cash Deposit,2182.094659
11452,713508333,5-16-24 21:28,1600,Payment,Rent Payment,582.0946593
11453,713508333,5-17-24 19:28,109.11,Deposit,Mobile Deposit,691.2046593
11454,713508333,5-21-24 15:28,54.65,OnlineShopping,Etsy,636.5546593
11455,713508333,5-21-24 19:28,243.58,Purchase,Electronics,392.9746593
11456,713508333,5-22-24 21:28,96.16,Deposit,Mobile Deposit,489.1346593
11457,713508333,5-25-24 10:28,239.66,Purchase,Furniture,249.4746593
11458,713508333,5-25-24 19:28,99.19,Deposit,Mobile Deposit,348.6646593
11459,713508333,5-30-24 15:28,32.74,OutgoingTransfer,Wire Transfer,315.9246593
11460,713508333,5-31-24 12:28,135.69,OnlineShopping,eBay,180.2346593
11461,713508333,06-03-24 18:28,245.14,OnlineShopping,Best Buy,-64.90534069
11462,713508333,06-04-24 15:28,19.44,Deposit,Cash Deposit,-45.46534069
11463,713508333,06-05-24 14:28,213.34,Deposit,Mobile Deposit,167.8746593
11464,713508333,06-05-24 21:28,3000,IncomingTransfer,Salary,3167.874659
11465,713508333,06-07-24 10:28,26.44,Deposit,Mobile Deposit,3194.314659
11466,713508333,06-10-24 21:28,1600,Payment,Credit Card Payment,1594.314659
11467,713508333,06-12-24 10:28,229.45,OutgoingTransfer,Peer-to-Peer Transfer,1364.864659
11468,713508333,6-13-24 21:28,800,Payment,Rent Payment,564.8646593
11469,713508333,6-13-24 22:28,139.19,Deposit,Direct Deposit,704.0546593
11470,713508333,6-15-24 17:28,118.78,Purchase,Furniture,585.2746593
11471,713508333,6-16-24 14:28,34.76,Purchase,Electronics,550.5146593
11472,713508333,6-17-24 20:28,87.34,Withdrawal,Branch Withdrawal,463.1746593
11473,713508333,6-18-24 12:28,165.68,Withdrawal,Mobile App Withdrawal,297.4946593
11474,713508333,6-18-24 15:28,140.34,Withdrawal,ATM Withdrawal,157.1546593
11475,713508333,6-21-24 15:28,12.84,Payment,Loan Payment,144.3146593
11476,713508333,6-22-24 21:28,246.76,OnlineShopping,eBay,-102.4453407
11477,713508333,6-23-24 19:28,225.14,Deposit,Mobile Deposit,122.6946593
11478,713508333,6-26-24 12:28,64.24,Deposit,Check Deposit,186.9346593
11479,713508333,07-01-24 15:28,21.39,Deposit,Mobile Deposit,208.3246593
11480,713508333,07-01-24 23:28,127.04,OnlineShopping,eBay,81.28465931
11481,713508333,07-02-24 21:28,3000,IncomingTransfer,Salary,3081.284659
11482,713508333,07-03-24 12:28,244.66,Deposit,Mobile Deposit,3325.944659
11483,713508333,07-03-24 14:28,148.66,Deposit,Cash Deposit,3474.604659
11484,713508333,07-05-24 20:28,35.35,OnlineShopping,Best Buy,3439.254659
11485,713508333,07-06-24 11:28,242.75,Deposit,Cash Deposit,3682.004659
11486,713508333,07-07-24 20:28,118.78,OnlineShopping,Best Buy,3563.224659
11487,713508333,07-07-24 21:28,1500,Payment,Credit Card Payment,2063.224659
11488,713508333,07-10-24 13:28,225.54,Purchase,Restaurant,1837.684659
11489,713508333,7-13-24 10:28,160.72,Purchase,Electronics,1676.964659
11490,713508333,7-16-24 21:28,900,Payment,Rent Payment,776.9646593
11491,713508333,7-17-24 15:28,70.6,Payment,Bill Payment,706.3646593
11492,713560758,1-20-24 18:28,211.53,OutgoingTransfer,Peer-to-Peer Transfer,880.2164926
11493,713560758,1-23-24 22:28,29.51,Purchase,Travel,850.7064926
11494,713560758,1-29-24 14:28,103.52,Purchase,Gas,747.1864926
11495,713560758,1-29-24 19:28,161.76,OnlineShopping,Target,585.4264926
11496,713560758,02-03-24 17:28,22.68,OutgoingTransfer,Wire Transfer,562.7464926
11497,713560758,02-03-24 21:28,2600,IncomingTransfer,Salary,3162.746493
11498,713560758,02-04-24 12:28,115.37,Withdrawal,Branch Withdrawal,3047.376493
11499,713560758,02-07-24 16:28,10.58,Payment,Loan Payment,3036.796493
11500,713560758,02-07-24 17:28,37.15,IncomingTransfer,Freelance Payment,3073.946493
11501,713560758,02-08-24 15:28,158.72,Payment,Mortgage Payment,2915.226493
11502,713560758,02-08-24 21:28,2800,Payment,Credit Card Payment,115.2264926
11503,713560758,02-10-24 17:28,145.82,OutgoingTransfer,Wire Transfer,-30.59350743
11504,713560758,02-10-24 22:28,49.03,IncomingTransfer,Freelance Payment,18.43649257
11505,713560758,2-13-24 11:28,128.03,Return,AliExpress Return,146.4664926
11506,713560758,2-15-24 19:28,98.53,OnlineShopping,Etsy,47.93649257
11507,713560758,2-17-24 21:28,800,Payment,Insurance Payment,-752.0635074
11508,713560758,2-18-24 11:28,34.9,Withdrawal,Branch Withdrawal,-786.9635074
11509,713560758,2-20-24 18:28,185.51,OutgoingTransfer,Peer-to-Peer Transfer,-972.4735074
11510,713560758,2-23-24 16:28,37.04,Purchase,Electronics,-1009.513507
11511,713560758,2-24-24 15:28,229.28,Purchase,Entertainment,-1238.793507
11512,713560758,2-24-24 19:28,231.34,Deposit,Mobile Deposit,-1007.453507
11513,713560758,2-25-24 16:28,151.35,OnlineShopping,Best Buy,-1158.803507
11514,713560758,2-28-24 9:28,76.65,Withdrawal,Mobile App Withdrawal,-1235.453507
11515,713560758,03-02-24 21:28,2600,IncomingTransfer,Salary,1364.546493
11516,713560758,03-06-24 17:28,240.86,OnlineShopping,Best Buy,1123.686493
11517,713560758,03-07-24 21:28,2600,Payment,Credit Card Payment,-1476.313507
11518,713560758,03-07-24 21:28,109.91,OutgoingTransfer,Bank Transfer,-1586.223507
11519,713560758,03-09-24 19:28,213.16,IncomingTransfer,Freelance Payment,-1373.063507
11520,713560758,03-10-24 15:28,50.83,Purchase,Gas,-1423.893507
11521,713560758,03-10-24 21:28,700,Payment,Insurance Payment,-2123.893507
11522,713560758,03-10-24 22:28,89.66,Deposit,Direct Deposit,-2034.233507
11523,713560758,3-14-24 9:28,235.79,Deposit,Mobile Deposit,-1798.443507
11524,713560758,3-18-24 23:28,248.76,Withdrawal,Mobile App Withdrawal,-2047.203507
11525,713560758,3-19-24 17:28,160.41,OutgoingTransfer,Bank Transfer,-2207.613507
11526,713560758,3-21-24 19:28,242.74,Deposit,Mobile Deposit,-1964.873507
11527,713560758,3-24-24 13:28,194.14,OnlineShopping,eBay,-2159.013507
11528,713560758,3-25-24 11:28,59.76,Payment,Bill Payment,-2218.773507
11529,713560758,3-26-24 9:28,205.28,Purchase,Electronics,-2424.053507
11530,713560758,3-26-24 13:28,159.29,Purchase,Gas,-2583.343507
11531,713560758,3-28-24 22:28,100.97,Payment,Mortgage Payment,-2684.313507
11532,713560758,3-29-24 15:28,104.78,Purchase,Restaurant,-2789.093507
11533,713560758,04-02-24 11:28,221.84,Payment,Bill Payment,-3010.933507
11534,713560758,04-02-24 16:28,123.23,Return,AliExpress Return,-2887.703507
11535,713560758,04-02-24 21:28,2600,IncomingTransfer,Salary,-287.7035074
11536,713560758,04-03-24 15:28,219.53,Withdrawal,Mobile App Withdrawal,-507.2335074
11537,713560758,04-07-24 15:28,25.9,Return,Best Buy Return,-481.3335074
11538,713560758,04-07-24 21:28,2200,Payment,Credit Card Payment,-2681.333507
11539,713560758,04-12-24 16:28,46.97,Purchase,Travel,-2728.303507
11540,713560758,4-14-24 18:28,213.45,OutgoingTransfer,Bank Transfer,-2941.753507
11541,713560758,4-14-24 21:28,243.22,OnlineShopping,Amazon,-3184.973507
11542,713560758,4-16-24 21:28,700,Payment,Installment Payment,-3884.973507
11543,713560758,4-16-24 22:28,74.31,Payment,Mortgage Payment,-3959.283507
11544,713560758,4-22-24 11:28,33.64,Purchase,Gas,-3992.923507
11545,713560758,4-23-24 11:28,120.52,Deposit,Direct Deposit,-3872.403507
11546,713560758,4-26-24 11:28,26.98,OnlineShopping,Best Buy,-3899.383507
11547,713560758,4-26-24 21:28,139.22,OnlineShopping,Etsy,-4038.603507
11548,713560758,4-27-24 19:28,210.33,OutgoingTransfer,International Transfer,-4248.933507
11549,713560758,4-28-24 17:28,191.51,OutgoingTransfer,Wire Transfer,-4440.443507
11550,713560758,4-29-24 9:28,13.85,Purchase,Pharmacy,-4454.293507
11551,713560758,05-02-24 21:28,175.86,OnlineShopping,eBay,-4630.153507
11552,713560758,05-04-24 16:28,139.29,Purchase,Grocery,-4769.443507
11553,713560758,05-04-24 17:28,164.16,Payment,Loan Payment,-4933.603507
11554,713560758,05-04-24 21:28,2600,IncomingTransfer,Salary,-2333.603507
11555,713560758,05-08-24 14:28,134.37,Purchase,Travel,-2467.973507
11556,713560758,05-09-24 21:28,2600,Payment,Credit Card Payment,-5067.973507
11557,713560758,05-10-24 11:28,124.6,Withdrawal,Branch Withdrawal,-5192.573507
11558,713560758,05-12-24 11:28,247.86,Purchase,Travel,-5440.433507
11559,713560758,5-13-24 17:28,200.49,Payment,Loan Payment,-5640.923507
11560,713560758,5-13-24 23:28,41.37,Withdrawal,Branch Withdrawal,-5682.293507
11561,713560758,5-14-24 21:28,158.97,OnlineShopping,Amazon,-5841.263507
11562,713560758,5-15-24 21:28,900,Payment,Insurance Payment,-6741.263507
11563,713560758,5-17-24 19:28,108.22,Purchase,Travel,-6849.483507
11564,713560758,5-17-24 22:28,179.34,Return,Amazon Return,-6670.143507
11565,713560758,5-18-24 13:28,175.34,Purchase,Home Improvement,-6845.483507
11566,713560758,5-23-24 13:28,30.18,Purchase,Home Improvement,-6875.663507
11567,713560758,5-25-24 15:28,46.27,Deposit,Check Deposit,-6829.393507
11568,713560758,5-25-24 15:28,37.62,Deposit,Mobile Deposit,-6791.773507
11569,713560758,5-31-24 21:28,96.19,Deposit,Direct Deposit,-6695.583507
11570,713560758,06-01-24 10:28,193.68,Purchase,Pharmacy,-6889.263507
11571,713560758,06-01-24 17:28,111.48,Payment,Mortgage Payment,-7000.743507
11572,713560758,06-02-24 18:28,26.41,Withdrawal,Mobile App Withdrawal,-7027.153507
11573,713560758,06-03-24 15:28,78.19,OnlineShopping,AliExpress,-7105.343507
11574,713560758,06-03-24 15:28,245.03,Withdrawal,Branch Withdrawal,-7350.373507
11575,713560758,06-04-24 21:28,2600,IncomingTransfer,Salary,-4750.373507
11576,713560758,06-05-24 11:28,58.87,OutgoingTransfer,Wire Transfer,-4809.243507
11577,713560758,06-07-24 9:28,30.6,OnlineShopping,Etsy,-4839.843507
11578,713560758,06-08-24 21:28,230.32,OnlineShopping,Best Buy,-5070.163507
11579,713560758,06-09-24 21:28,2300,Payment,Credit Card Payment,-7370.163507
11580,713560758,06-12-24 21:28,900,Payment,Installment Payment,-8270.163507
11581,713560758,06-12-24 23:28,174.75,Purchase,Gas,-8444.913507
11582,713560758,6-15-24 19:28,79.15,Purchase,Home Improvement,-8524.063507
11583,713560758,6-18-24 11:28,65.26,Return,Etsy Return,-8458.803507
11584,713560758,6-23-24 12:28,32.35,Withdrawal,Branch Withdrawal,-8491.153507
11585,713560758,6-24-24 20:28,198.38,Payment,Mortgage Payment,-8689.533507
11586,713560758,6-29-24 20:28,66.99,Return,Walmart Return,-8622.543507
11587,713560758,6-29-24 22:28,83.51,Withdrawal,ATM Withdrawal,-8706.053507
11588,713560758,07-02-24 19:28,233.89,Deposit,Mobile Deposit,-8472.163507
11589,713560758,07-03-24 11:28,173.57,Purchase,Restaurant,-8645.733507
11590,713560758,07-04-24 21:28,2600,IncomingTransfer,Salary,-6045.733507
11591,713560758,07-07-24 14:28,17.27,Payment,Bill Payment,-6063.003507
11592,713560758,07-09-24 21:28,2700,Payment,Credit Card Payment,-8763.003507
11593,713560758,07-11-24 12:28,89.92,Withdrawal,ATM Withdrawal,-8852.923507
11594,713560758,7-13-24 18:28,197.53,Deposit,Check Deposit,-8655.393507
11595,713560758,7-13-24 19:28,32.81,OutgoingTransfer,Peer-to-Peer Transfer,-8688.203507
11596,713560758,7-14-24 13:28,26.06,Deposit,Cash Deposit,-8662.143507
11597,713560758,7-14-24 16:28,24.74,Purchase,Pharmacy,-8686.883507
11598,713560758,7-15-24 13:28,211.43,Payment,Mortgage Payment,-8898.313507
11599,713560758,7-15-24 21:28,800,Payment,Insurance Payment,-9698.313507
11600,713560758,7-16-24 23:28,163.46,Return,eBay Return,-9534.853507
11601,713560758,7-17-24 17:28,81.53,Purchase,Furniture,-9616.383507
11602,713569158,1-20-24 20:28,185.55,Deposit,Cash Deposit,1170.090341
11603,713569158,1-23-24 19:28,137.26,OnlineShopping,Etsy,1032.830341
11604,713569158,1-27-24 15:28,85.31,Return,Etsy Return,1118.140341
11605,713569158,02-01-24 22:28,102.92,Withdrawal,Mobile App Withdrawal,1015.220341
11606,713569158,02-03-24 19:28,307.39,Return,Etsy Return,1322.610341
11607,713569158,02-04-24 11:28,261.19,Return,Store Return,1583.800341
11608,713569158,02-05-24 21:28,4300,IncomingTransfer,Salary,5883.800341
11609,713569158,02-10-24 21:28,1600,Payment,Credit Card Payment,4283.800341
11610,713569158,2-15-24 11:28,59.53,Return,Store Return,4343.330341
11611,713569158,2-15-24 21:28,1400,Payment,Installment Payment,2943.330341
11612,713569158,2-22-24 17:28,262.7,Deposit,Cash Deposit,3206.030341
11613,713569158,03-03-24 22:28,127.05,Purchase,Restaurant,3078.980341
11614,713569158,03-04-24 21:28,4300,IncomingTransfer,Salary,7378.980341
11615,713569158,03-06-24 11:28,210.43,OnlineShopping,AliExpress,7168.550341
11616,713569158,03-07-24 11:28,128.01,IncomingTransfer,Freelance Payment,7296.560341
11617,713569158,03-09-24 21:28,1700,Payment,Credit Card Payment,5596.560341
11618,713569158,3-15-24 17:28,81.33,Deposit,Direct Deposit,5677.890341
11619,713569158,3-16-24 21:28,1400,Payment,Subscription Payment,4277.890341
11620,713569158,3-20-24 23:28,201.58,OnlineShopping,AliExpress,4076.310341
11621,713569158,3-25-24 23:28,319.82,OutgoingTransfer,International Transfer,3756.490341
11622,713569158,3-29-24 22:28,212.92,Purchase,Home Improvement,3543.570341
11623,713569158,04-04-24 21:28,4300,IncomingTransfer,Salary,7843.570341
11624,713569158,04-06-24 16:28,168.95,Purchase,Gas,7674.620341
11625,713569158,04-09-24 20:28,307.81,Withdrawal,Mobile App Withdrawal,7366.810341
11626,713569158,04-09-24 21:28,2100,Payment,Credit Card Payment,5266.810341
11627,713569158,04-09-24 23:28,57.27,Purchase,Entertainment,5209.540341
11628,713569158,4-14-24 19:28,148.84,OnlineShopping,Etsy,5060.700341
11629,713569158,4-15-24 21:28,214.38,OutgoingTransfer,Wire Transfer,4846.320341
11630,713569158,4-16-24 21:28,1700,Payment,Subscription Payment,3146.320341
11631,713569158,4-16-24 23:28,208.04,Purchase,Entertainment,2938.280341
11632,713569158,4-17-24 10:28,200.97,Payment,Bill Payment,2737.310341
11633,713569158,4-19-24 10:28,78.3,OutgoingTransfer,Bank Transfer,2659.010341
11634,713569158,4-21-24 16:28,222.95,Deposit,Mobile Deposit,2881.960341
11635,713569158,4-26-24 23:28,322.13,Return,Amazon Return,3204.090341
11636,713569158,05-05-24 13:28,158.56,OnlineShopping,Best Buy,3045.530341
11637,713569158,05-05-24 21:28,4300,IncomingTransfer,Salary,7345.530341
11638,713569158,05-10-24 21:28,1700,Payment,Credit Card Payment,5645.530341
11639,713569158,05-10-24 21:28,1600,Payment,Subscription Payment,4045.530341
11640,713569158,5-13-24 16:28,318.28,Purchase,Furniture,3727.250341
11641,713569158,5-14-24 13:28,239.61,Return,Etsy Return,3966.860341
11642,713569158,5-18-24 17:28,50.39,Withdrawal,Branch Withdrawal,3916.470341
11643,713569158,5-20-24 12:28,126.9,OnlineShopping,Walmart,3789.570341
11644,713569158,5-23-24 20:28,280.68,Payment,Bill Payment,3508.890341
11645,713569158,06-03-24 21:28,4300,IncomingTransfer,Salary,7808.890341
11646,713569158,06-04-24 14:28,273.55,OutgoingTransfer,Bank Transfer,7535.340341
11647,713569158,06-08-24 21:28,2000,Payment,Credit Card Payment,5535.340341
11648,713569158,06-09-24 14:28,103.25,Return,Best Buy Return,5638.590341
11649,713569158,06-11-24 23:28,35.26,Purchase,Gas,5603.330341
11650,713569158,6-14-24 23:28,391.9,Purchase,Home Improvement,5211.430341
11651,713569158,6-16-24 21:28,1400,Payment,Insurance Payment,3811.430341
11652,713569158,6-17-24 23:28,243.34,Deposit,Mobile Deposit,4054.770341
11653,713569158,6-19-24 19:28,236.2,Payment,Bill Payment,3818.570341
11654,713569158,6-21-24 11:28,142.29,Return,Store Return,3960.860341
11655,713569158,6-22-24 11:28,286.24,Purchase,Pharmacy,3674.620341
11656,713569158,6-27-24 17:28,399.55,Deposit,Direct Deposit,4074.170341
11657,713569158,6-30-24 20:28,177.89,Return,eBay Return,4252.060341
11658,713569158,07-01-24 9:28,83.23,OnlineShopping,AliExpress,4168.830341
11659,713569158,07-04-24 21:28,4300,IncomingTransfer,Salary,8468.830341
11660,713569158,07-07-24 21:28,179.47,Withdrawal,Mobile App Withdrawal,8289.360341
11661,713569158,07-09-24 21:28,2100,Payment,Credit Card Payment,6189.360341
11662,713569158,07-10-24 21:28,199.01,Payment,Bill Payment,5990.350341
11663,713569158,07-11-24 10:28,128.38,Purchase,Furniture,5861.970341
11664,713569158,07-11-24 15:28,127.87,Return,Amazon Return,5989.840341
11665,713569158,07-11-24 21:28,1600,Payment,Subscription Payment,4389.840341
11666,713569158,7-14-24 22:28,164.74,OnlineShopping,Amazon,4225.100341
11667,713580633,1-20-24 22:28,65.58,Return,Amazon Return,65.58
11668,713580633,1-25-24 20:28,200.71,Purchase,Grocery,-135.13
11669,713580633,02-01-24 13:28,233.8,Deposit,Mobile Deposit,98.67
11670,713580633,02-04-24 21:28,4800,IncomingTransfer,Salary,4898.67
11671,713580633,02-10-24 21:28,2800,Payment,Rent Payment,2098.67
11672,713580633,2-16-24 16:28,277.47,Purchase,Restaurant,1821.2
11673,713580633,2-23-24 11:28,204.84,Payment,Loan Payment,1616.36
11674,713580633,2-29-24 12:28,275.92,Return,eBay Return,1892.28
11675,713580633,03-01-24 14:28,32.66,Purchase,Clothing,1859.62
11676,713580633,03-01-24 22:28,130.9,Deposit,Check Deposit,1990.52
11677,713580633,03-02-24 21:28,4800,IncomingTransfer,Salary,6790.52
11678,713580633,03-05-24 13:28,172.27,OutgoingTransfer,International Transfer,6618.25
11679,713580633,3-14-24 9:28,93.98,Purchase,Home Improvement,6524.27
11680,713580633,3-15-24 21:28,2000,Payment,Rent Payment,4524.27
11681,713580633,3-19-24 10:28,249.01,Purchase,Restaurant,4275.26
11682,713580633,3-20-24 16:28,63.42,OnlineShopping,Target,4211.84
11683,713580633,3-22-24 17:28,305.59,Return,Walmart Return,4517.43
11684,713580633,3-23-24 19:28,29.04,Deposit,Cash Deposit,4546.47
11685,713580633,3-30-24 12:28,213.45,Purchase,Furniture,4333.02
11686,713580633,04-04-24 21:28,4800,IncomingTransfer,Salary,9133.02
11687,713580633,04-10-24 21:28,2200,Payment,Rent Payment,6933.02
11688,713580633,4-23-24 23:28,341.85,Deposit,Direct Deposit,7274.87
11689,713580633,4-28-24 20:28,180.23,OutgoingTransfer,Bank Transfer,7094.64
11690,713580633,05-01-24 21:28,4800,IncomingTransfer,Salary,11894.64
11691,713580633,05-03-24 21:28,337.98,Payment,Loan Payment,11556.66
11692,713580633,05-04-24 11:28,273.52,OnlineShopping,AliExpress,11283.14
11693,713580633,05-05-24 18:28,319.41,Purchase,Entertainment,10963.73
11694,713580633,5-16-24 17:28,44.67,Withdrawal,Branch Withdrawal,10919.06
11695,713580633,5-18-24 21:28,1700,Payment,Rent Payment,9219.06
11696,713580633,06-03-24 11:28,259.1,OnlineShopping,eBay,8959.96
11697,713580633,06-05-24 21:28,4800,IncomingTransfer,Salary,13759.96
11698,713580633,06-10-24 22:28,329.32,Deposit,Check Deposit,14089.28
11699,713580633,06-12-24 21:28,2800,Payment,Rent Payment,11289.28
11700,713580633,6-13-24 17:28,281.07,Payment,Mortgage Payment,11008.21
11701,713580633,6-20-24 19:28,344.81,Payment,Bill Payment,10663.4
11702,713580633,07-01-24 21:28,4800,IncomingTransfer,Salary,15463.4
11703,713580633,07-03-24 17:28,99.45,Return,Etsy Return,15562.85
11704,713580633,07-09-24 19:28,41.73,Deposit,Check Deposit,15604.58
11705,713580633,07-11-24 21:28,2200,Payment,Rent Payment,13404.58
11706,713709258,1-22-24 15:28,150.6,OutgoingTransfer,Peer-to-Peer Transfer,1040.589445
11707,713709258,1-23-24 15:28,395.52,Payment,Loan Payment,645.0694452
11708,713709258,1-26-24 11:28,93.26,IncomingTransfer,Freelance Payment,738.3294452
11709,713709258,1-28-24 11:28,384.4,OnlineShopping,Walmart,353.9294452
11710,713709258,1-29-24 9:28,131.7,Return,Target Return,485.6294452
11711,713709258,02-01-24 21:28,3350,IncomingTransfer,Salary,3835.629445
11712,713709258,02-04-24 10:28,363.8,OutgoingTransfer,Peer-to-Peer Transfer,3471.829445
11713,713709258,02-05-24 19:28,282.97,Payment,Bill Payment,3188.859445
11714,713709258,02-06-24 21:28,1800,Payment,Credit Card Payment,1388.859445
11715,713709258,02-09-24 11:28,375.95,Deposit,Cash Deposit,1764.809445
11716,713709258,2-14-24 11:28,76.86,Deposit,Direct Deposit,1841.669445
11717,713709258,2-14-24 15:28,264.22,Purchase,Travel,1577.449445
11718,713709258,2-15-24 14:28,296.37,Purchase,Home Improvement,1281.079445
11719,713709258,2-16-24 14:28,125.39,Deposit,Cash Deposit,1406.469445
11720,713709258,2-16-24 21:28,1500,Payment,Rent Payment,-93.53055478
11721,713709258,2-18-24 16:28,398.34,OnlineShopping,Walmart,-491.8705548
11722,713709258,2-19-24 22:28,22.44,Deposit,Check Deposit,-469.4305548
11723,713709258,2-21-24 11:28,338.6,IncomingTransfer,Freelance Payment,-130.8305548
11724,713709258,2-22-24 16:28,131.22,IncomingTransfer,Freelance Payment,0.389445216
11725,713709258,2-22-24 21:28,132.48,Return,Walmart Return,132.8694452
11726,713709258,2-26-24 9:28,393.83,Deposit,Mobile Deposit,526.6994452
11727,713709258,2-27-24 17:28,149.18,Return,Etsy Return,675.8794452
11728,713709258,2-28-24 23:28,64.91,Deposit,Cash Deposit,740.7894452
11729,713709258,03-03-24 21:28,3350,IncomingTransfer,Salary,4090.789445
11730,713709258,03-08-24 16:28,358.17,Deposit,Cash Deposit,4448.959445
11731,713709258,03-08-24 21:28,1600,Payment,Credit Card Payment,2848.959445
11732,713709258,03-12-24 21:28,167.12,Deposit,Check Deposit,3016.079445
11733,713709258,3-15-24 21:28,1600,Payment,Rent Payment,1416.079445
11734,713709258,3-16-24 13:28,58.43,Purchase,Travel,1357.649445
11735,713709258,3-17-24 10:28,147.12,Withdrawal,Mobile App Withdrawal,1210.529445
11736,713709258,3-17-24 13:28,355.54,Purchase,Clothing,854.9894452
11737,713709258,3-18-24 10:28,50.15,OnlineShopping,Target,804.8394452
11738,713709258,3-18-24 13:28,82.15,OnlineShopping,Best Buy,722.6894452
11739,713709258,3-18-24 23:28,127.5,Payment,Bill Payment,595.1894452
11740,713709258,3-22-24 15:28,291.89,Purchase,Furniture,303.2994452
11741,713709258,3-22-24 19:28,329.87,Purchase,Grocery,-26.57055478
11742,713709258,3-23-24 14:28,154.7,OnlineShopping,Amazon,-181.2705548
11743,713709258,3-23-24 15:28,359.07,IncomingTransfer,Freelance Payment,177.7994452
11744,713709258,3-27-24 17:28,249.08,OutgoingTransfer,Bank Transfer,-71.28055478
11745,713709258,3-31-24 19:28,242.38,OnlineShopping,eBay,-313.6605548
11746,713709258,04-01-24 12:28,335.01,Deposit,Mobile Deposit,21.34944522
11747,713709258,04-01-24 13:28,57.52,Deposit,Direct Deposit,78.86944522
11748,713709258,04-02-24 21:28,3350,IncomingTransfer,Salary,3428.869445
11749,713709258,04-03-24 9:28,142.22,Purchase,Travel,3286.649445
11750,713709258,04-07-24 21:28,1500,Payment,Credit Card Payment,1786.649445
11751,713709258,04-08-24 23:28,28.71,Purchase,Restaurant,1757.939445
11752,713709258,04-09-24 20:28,42.25,IncomingTransfer,Freelance Payment,1800.189445
11753,713709258,04-11-24 21:28,1200,Payment,Rent Payment,600.1894452
11754,713709258,04-12-24 13:28,350.68,Withdrawal,Branch Withdrawal,249.5094452
11755,713709258,4-18-24 20:28,100.63,Withdrawal,Mobile App Withdrawal,148.8794452
11756,713709258,4-23-24 20:28,364.61,IncomingTransfer,Freelance Payment,513.4894452
11757,713709258,4-24-24 11:28,211.45,Deposit,Cash Deposit,724.9394452
11758,713709258,4-27-24 13:28,207.94,OnlineShopping,Amazon,516.9994452
11759,713709258,4-30-24 21:28,340.96,OutgoingTransfer,Bank Transfer,176.0394452
11760,713709258,05-01-24 11:28,94.17,IncomingTransfer,Freelance Payment,270.2094452
11761,713709258,05-01-24 21:28,3350,IncomingTransfer,Salary,3620.209445
11762,713709258,05-02-24 19:28,125.12,Payment,Loan Payment,3495.089445
11763,713709258,05-04-24 17:28,238,Withdrawal,Branch Withdrawal,3257.089445
11764,713709258,05-05-24 11:28,229.03,Purchase,Travel,3028.059445
11765,713709258,05-05-24 12:28,353.76,Purchase,Restaurant,2674.299445
11766,713709258,05-05-24 18:28,272.56,IncomingTransfer,Freelance Payment,2946.859445
11767,713709258,05-06-24 21:28,1800,Payment,Credit Card Payment,1146.859445
11768,713709258,05-07-24 11:28,181.9,Return,eBay Return,1328.759445
11769,713709258,05-08-24 21:28,201.92,Withdrawal,Mobile App Withdrawal,1126.839445
11770,713709258,05-10-24 14:28,172.99,Purchase,Electronics,953.8494452
11771,713709258,05-11-24 21:28,1600,Payment,Rent Payment,-646.1505548
11772,713709258,5-13-24 19:28,143.75,Purchase,Furniture,-789.9005548
11773,713709258,5-14-24 18:28,247.98,IncomingTransfer,Freelance Payment,-541.9205548
11774,713709258,5-14-24 19:28,211.26,OutgoingTransfer,International Transfer,-753.1805548
11775,713709258,5-19-24 14:28,194.76,Withdrawal,Branch Withdrawal,-947.9405548
11776,713709258,5-19-24 17:28,296.05,OutgoingTransfer,Bank Transfer,-1243.990555
11777,713709258,5-20-24 23:28,300.16,Payment,Bill Payment,-1544.150555
11778,713709258,5-20-24 23:28,346.04,OnlineShopping,eBay,-1890.190555
11779,713709258,06-01-24 13:28,337.66,Return,Amazon Return,-1552.530555
11780,713709258,06-02-24 21:28,3350,IncomingTransfer,Salary,1797.469445
11781,713709258,06-03-24 14:28,38.06,OutgoingTransfer,Peer-to-Peer Transfer,1759.409445
11782,713709258,06-04-24 23:28,301.76,Purchase,Restaurant,1457.649445
11783,713709258,06-06-24 21:28,217.22,Deposit,Mobile Deposit,1674.869445
11784,713709258,06-07-24 21:28,2000,Payment,Credit Card Payment,-325.1305548
11785,713709258,06-12-24 16:28,369.39,Withdrawal,Mobile App Withdrawal,-694.5205548
11786,713709258,6-13-24 21:28,1000,Payment,Rent Payment,-1694.520555
11787,713709258,6-14-24 10:28,80.84,Deposit,Mobile Deposit,-1613.680555
11788,713709258,6-17-24 14:28,310.82,OnlineShopping,Best Buy,-1924.500555
11789,713709258,6-18-24 21:28,134.2,Deposit,Mobile Deposit,-1790.300555
11790,713709258,6-19-24 20:28,129.1,Purchase,Grocery,-1919.400555
11791,713709258,6-23-24 19:28,147.85,OnlineShopping,Target,-2067.250555
11792,713709258,6-27-24 9:28,25.41,OutgoingTransfer,Bank Transfer,-2092.660555
11793,713709258,6-27-24 17:28,186.79,IncomingTransfer,Freelance Payment,-1905.870555
11794,713709258,6-27-24 23:28,219.56,IncomingTransfer,Freelance Payment,-1686.310555
11795,713709258,6-28-24 19:28,326.35,OnlineShopping,Amazon,-2012.660555
11796,713709258,6-28-24 21:28,276.58,OutgoingTransfer,International Transfer,-2289.240555
11797,713709258,07-05-24 11:28,332.59,Withdrawal,ATM Withdrawal,-2621.830555
11798,713709258,07-05-24 14:28,338.34,Withdrawal,Mobile App Withdrawal,-2960.170555
11799,713709258,07-05-24 21:28,3350,IncomingTransfer,Salary,389.8294452
11800,713709258,07-08-24 17:28,22.6,Return,Best Buy Return,412.4294452
11801,713709258,07-08-24 19:28,256.86,Withdrawal,Mobile App Withdrawal,155.5694452
11802,713709258,07-09-24 16:28,375.99,Withdrawal,Mobile App Withdrawal,-220.4205548
11803,713709258,07-09-24 17:28,121.96,Deposit,Direct Deposit,-98.46055478
11804,713709258,07-10-24 20:28,212.69,Deposit,Mobile Deposit,114.2294452
11805,713709258,07-10-24 21:28,1500,Payment,Credit Card Payment,-1385.770555
11806,713709258,07-11-24 21:28,1500,Payment,Rent Payment,-2885.770555
11807,713709258,7-13-24 21:28,188.2,Return,Walmart Return,-2697.570555
11808,713709258,7-14-24 14:28,226.74,Payment,Loan Payment,-2924.310555
11809,713709258,7-16-24 12:28,87.07,Purchase,Entertainment,-3011.380555
11810,713709258,7-17-24 18:28,56.28,OutgoingTransfer,Bank Transfer,-3067.660555
11811,713709258,7-17-24 22:28,166.07,Return,Store Return,-2901.590555
11812,713732883,1-20-24 12:28,92.7,Payment,Loan Payment,-92.7
11813,713732883,1-21-24 13:28,179.23,Withdrawal,Branch Withdrawal,-271.93
11814,713732883,1-22-24 16:28,165.82,Withdrawal,ATM Withdrawal,-437.75
11815,713732883,02-03-24 21:28,2650,IncomingTransfer,Salary,2212.25
11816,713732883,02-06-24 14:28,37.01,Deposit,Direct Deposit,2249.26
11817,713732883,02-07-24 11:28,54.59,Return,AliExpress Return,2303.85
11818,713732883,02-07-24 12:28,39.08,Withdrawal,Branch Withdrawal,2264.77
11819,713732883,02-08-24 17:28,223.72,IncomingTransfer,Freelance Payment,2488.49
11820,713732883,02-12-24 16:28,133.57,Deposit,Direct Deposit,2622.06
11821,713732883,2-15-24 16:28,186.53,Payment,Bill Payment,2435.53
11822,713732883,2-17-24 21:28,1400,Payment,Rent Payment,1035.53
11823,713732883,2-24-24 22:28,238.58,Withdrawal,Mobile App Withdrawal,796.95
11824,713732883,2-26-24 10:28,225.3,OnlineShopping,Best Buy,571.65
11825,713732883,2-26-24 10:28,39.75,OnlineShopping,AliExpress,531.9
11826,713732883,2-28-24 23:28,136.03,Withdrawal,Branch Withdrawal,395.87
11827,713732883,03-02-24 18:28,220.75,Deposit,Mobile Deposit,616.62
11828,713732883,03-02-24 21:28,2650,IncomingTransfer,Salary,3266.62
11829,713732883,03-03-24 21:28,84.5,Deposit,Direct Deposit,3351.12
11830,713732883,03-04-24 13:28,206.43,Purchase,Pharmacy,3144.69
11831,713732883,03-06-24 11:28,135.94,Deposit,Direct Deposit,3280.63
11832,713732883,03-07-24 19:28,118.11,Payment,Loan Payment,3162.52
11833,713732883,03-10-24 22:28,76.96,Withdrawal,ATM Withdrawal,3085.56
11834,713732883,03-12-24 19:28,52.11,Purchase,Travel,3033.45
11835,713732883,3-13-24 15:28,29.16,Payment,Bill Payment,3004.29
11836,713732883,3-13-24 22:28,198.26,Withdrawal,Branch Withdrawal,2806.03
11837,713732883,3-15-24 9:28,178.17,Return,Store Return,2984.2
11838,713732883,3-16-24 21:28,700,Payment,Rent Payment,2284.2
11839,713732883,3-17-24 20:28,200.97,Deposit,Cash Deposit,2485.17
11840,713732883,3-19-24 10:28,26.01,Deposit,Check Deposit,2511.18
11841,713732883,3-19-24 17:28,242.42,Withdrawal,Branch Withdrawal,2268.76
11842,713732883,3-19-24 22:28,132.72,Deposit,Check Deposit,2401.48
11843,713732883,3-22-24 19:28,43.37,Deposit,Cash Deposit,2444.85
11844,713732883,3-26-24 15:28,186.16,Deposit,Check Deposit,2631.01
11845,713732883,3-28-24 15:28,163.69,OutgoingTransfer,International Transfer,2467.32
11846,713732883,3-30-24 18:28,67.76,Withdrawal,Branch Withdrawal,2399.56
11847,713732883,04-01-24 21:28,2650,IncomingTransfer,Salary,5049.56
11848,713732883,04-02-24 13:28,20.28,OnlineShopping,Best Buy,5029.28
11849,713732883,04-06-24 11:28,52.26,Deposit,Check Deposit,5081.54
11850,713732883,04-09-24 15:28,50.77,OutgoingTransfer,International Transfer,5030.77
11851,713732883,04-10-24 19:28,188.62,IncomingTransfer,Freelance Payment,5219.39
11852,713732883,4-14-24 17:28,57.48,Payment,Bill Payment,5161.91
11853,713732883,4-15-24 21:28,700,Payment,Rent Payment,4461.91
11854,713732883,4-19-24 13:28,63.69,Deposit,Mobile Deposit,4525.6
11855,713732883,4-20-24 12:28,47.71,OnlineShopping,eBay,4477.89
11856,713732883,4-22-24 9:28,145.91,OnlineShopping,Etsy,4331.98
11857,713732883,4-23-24 16:28,241.48,Payment,Loan Payment,4090.5
11858,713732883,05-01-24 21:28,2650,IncomingTransfer,Salary,6740.5
11859,713732883,05-01-24 22:28,186.99,Return,Amazon Return,6927.49
11860,713732883,05-04-24 17:28,212.27,Payment,Mortgage Payment,6715.22
11861,713732883,05-08-24 9:28,170.81,IncomingTransfer,Freelance Payment,6886.03
11862,713732883,05-08-24 10:28,22.16,OnlineShopping,Amazon,6863.87
11863,713732883,05-11-24 17:28,115.63,Purchase,Clothing,6748.24
11864,713732883,05-12-24 16:28,25.23,OutgoingTransfer,Peer-to-Peer Transfer,6723.01
11865,713732883,5-14-24 11:28,141.1,Return,Walmart Return,6864.11
11866,713732883,5-18-24 21:28,1200,Payment,Rent Payment,5664.11
11867,713732883,5-20-24 19:28,67.57,OutgoingTransfer,International Transfer,5596.54
11868,713732883,5-21-24 19:28,134.95,Deposit,Cash Deposit,5731.49
11869,713732883,5-21-24 20:28,40.09,Withdrawal,Mobile App Withdrawal,5691.4
11870,713732883,5-23-24 15:28,151.17,Withdrawal,Mobile App Withdrawal,5540.23
11871,713732883,5-23-24 16:28,181.01,Deposit,Check Deposit,5721.24
11872,713732883,5-23-24 16:28,174.78,Purchase,Restaurant,5546.46
11873,713732883,5-25-24 21:28,33.33,Purchase,Grocery,5513.13
11874,713732883,5-26-24 14:28,36.07,Deposit,Mobile Deposit,5549.2
11875,713732883,5-29-24 22:28,202.23,Withdrawal,Mobile App Withdrawal,5346.97
11876,713732883,5-30-24 12:28,177.16,Purchase,Grocery,5169.81
11877,713732883,5-30-24 22:28,121.45,OutgoingTransfer,Peer-to-Peer Transfer,5048.36
11878,713732883,06-04-24 10:28,145.24,OutgoingTransfer,Bank Transfer,4903.12
11879,713732883,06-04-24 21:28,2650,IncomingTransfer,Salary,7553.12
11880,713732883,06-04-24 22:28,108.21,Deposit,Mobile Deposit,7661.33
11881,713732883,06-06-24 19:28,101.99,Deposit,Check Deposit,7763.32
11882,713732883,06-07-24 10:28,240.45,Purchase,Travel,7522.87
11883,713732883,06-08-24 19:28,189.18,OutgoingTransfer,Bank Transfer,7333.69
11884,713732883,06-11-24 15:28,119.39,Deposit,Mobile Deposit,7453.08
11885,713732883,06-11-24 21:28,1700,Payment,Rent Payment,5753.08
11886,713732883,6-13-24 15:28,191.97,Purchase,Restaurant,5561.11
11887,713732883,6-14-24 19:28,63.62,Purchase,Pharmacy,5497.49
11888,713732883,6-20-24 15:28,169.28,Purchase,Home Improvement,5328.21
11889,713732883,6-21-24 9:28,168.59,Deposit,Mobile Deposit,5496.8
11890,713732883,6-23-24 16:28,39.68,Deposit,Check Deposit,5536.48
11891,713732883,6-23-24 22:28,245.61,Withdrawal,Mobile App Withdrawal,5290.87
11892,713732883,6-25-24 10:28,205.78,Withdrawal,Branch Withdrawal,5085.09
11893,713732883,6-25-24 19:28,96.97,Purchase,Gas,4988.12
11894,713732883,6-28-24 13:28,179.4,Purchase,Restaurant,4808.72
11895,713732883,6-30-24 18:28,121.02,OnlineShopping,Best Buy,4687.7
11896,713732883,07-04-24 11:28,142.94,Withdrawal,Branch Withdrawal,4544.76
11897,713732883,07-05-24 21:28,2650,IncomingTransfer,Salary,7194.76
11898,713732883,07-06-24 18:28,28.22,Deposit,Check Deposit,7222.98
11899,713732883,07-10-24 17:28,70.45,Purchase,Restaurant,7152.53
11900,713732883,07-11-24 13:28,179.83,OnlineShopping,Amazon,6972.7
11901,713732883,7-13-24 22:28,91.61,Purchase,Grocery,6881.09
11902,713732883,7-14-24 21:28,1500,Payment,Rent Payment,5381.09
11903,713732883,7-15-24 16:28,48.62,Deposit,Check Deposit,5429.71
11904,713732883,7-16-24 16:28,72.25,Deposit,Cash Deposit,5501.96
11905,713740533,1-22-24 9:28,346.89,OnlineShopping,Amazon,557.8857073
11906,713740533,1-23-24 16:28,374.48,Payment,Bill Payment,183.4057073
11907,713740533,1-24-24 17:28,386.15,IncomingTransfer,Freelance Payment,569.5557073
11908,713740533,1-26-24 12:28,298.98,OutgoingTransfer,Wire Transfer,270.5757073
11909,713740533,02-02-24 21:28,5200,IncomingTransfer,Salary,5470.575707
11910,713740533,02-07-24 11:28,448.88,OutgoingTransfer,International Transfer,5021.695707
11911,713740533,02-07-24 21:28,2100,Payment,Credit Card Payment,2921.695707
11912,713740533,02-10-24 13:28,177.94,OnlineShopping,eBay,2743.755707
11913,713740533,2-13-24 9:28,220.16,Payment,Bill Payment,2523.595707
11914,713740533,2-13-24 21:28,1800,Payment,Installment Payment,723.5957073
11915,713740533,2-22-24 10:28,141.66,Deposit,Mobile Deposit,865.2557073
11916,713740533,2-22-24 11:28,301.84,Withdrawal,Branch Withdrawal,563.4157073
11917,713740533,2-23-24 17:28,159.48,Return,Target Return,722.8957073
11918,713740533,2-23-24 18:28,115.67,Payment,Mortgage Payment,607.2257073
11919,713740533,2-26-24 22:28,312.71,Payment,Bill Payment,294.5157073
11920,713740533,2-27-24 15:28,95.57,OnlineShopping,Target,198.9457073
11921,713740533,03-02-24 21:28,5200,IncomingTransfer,Salary,5398.945707
11922,713740533,03-03-24 19:28,354.57,OutgoingTransfer,Wire Transfer,5044.375707
11923,713740533,03-07-24 21:28,2000,Payment,Credit Card Payment,3044.375707
11924,713740533,03-11-24 15:28,171.71,OnlineShopping,Amazon,2872.665707
11925,713740533,3-14-24 13:28,341.67,Withdrawal,Mobile App Withdrawal,2530.995707
11926,713740533,3-14-24 15:28,85.29,Deposit,Check Deposit,2616.285707
11927,713740533,3-15-24 21:28,2300,Payment,Subscription Payment,316.2857073
11928,713740533,3-18-24 14:28,213.83,Deposit,Direct Deposit,530.1157073
11929,713740533,3-27-24 17:28,484.71,OutgoingTransfer,Bank Transfer,45.40570728
11930,713740533,3-28-24 17:28,292.06,Purchase,Home Improvement,-246.6542927
11931,713740533,3-29-24 19:28,155.68,Deposit,Cash Deposit,-90.97429272
11932,713740533,04-02-24 18:28,204.5,Deposit,Check Deposit,113.5257073
11933,713740533,04-05-24 21:28,5200,IncomingTransfer,Salary,5313.525707
11934,713740533,04-09-24 12:28,91.16,Purchase,Home Improvement,5222.365707
11935,713740533,04-10-24 21:28,2300,Payment,Credit Card Payment,2922.365707
11936,713740533,04-12-24 11:28,87.17,OnlineShopping,Walmart,2835.195707
11937,713740533,4-13-24 18:28,384.59,Return,Amazon Return,3219.785707
11938,713740533,4-18-24 21:28,1900,Payment,Installment Payment,1319.785707
11939,713740533,4-20-24 11:28,140.6,Return,AliExpress Return,1460.385707
11940,713740533,4-27-24 15:28,213.01,Purchase,Gas,1247.375707
11941,713740533,4-29-24 14:28,72.93,Deposit,Direct Deposit,1320.305707
11942,713740533,05-02-24 21:28,5200,IncomingTransfer,Salary,6520.305707
11943,713740533,05-02-24 21:28,528.15,Purchase,Grocery,5992.155707
11944,713740533,05-04-24 18:28,444.86,Deposit,Check Deposit,6437.015707
11945,713740533,05-04-24 18:28,371.86,Deposit,Mobile Deposit,6808.875707
11946,713740533,05-07-24 21:28,1800,Payment,Credit Card Payment,5008.875707
11947,713740533,5-14-24 21:28,2000,Payment,Insurance Payment,3008.875707
11948,713740533,5-24-24 13:28,435.45,Payment,Loan Payment,2573.425707
11949,713740533,5-27-24 21:28,515.2,Withdrawal,ATM Withdrawal,2058.225707
11950,713740533,06-01-24 11:28,289.21,OnlineShopping,Target,1769.015707
11951,713740533,06-03-24 17:28,525.73,Payment,Loan Payment,1243.285707
11952,713740533,06-03-24 21:28,5200,IncomingTransfer,Salary,6443.285707
11953,713740533,06-04-24 17:28,179.97,Purchase,Electronics,6263.315707
11954,713740533,06-07-24 12:28,457.33,OnlineShopping,eBay,5805.985707
11955,713740533,06-07-24 20:28,241,OutgoingTransfer,Wire Transfer,5564.985707
11956,713740533,06-08-24 21:28,2300,Payment,Credit Card Payment,3264.985707
11957,713740533,06-10-24 11:28,457.27,Deposit,Cash Deposit,3722.255707
11958,713740533,06-10-24 21:28,2300,Payment,Installment Payment,1422.255707
11959,713740533,6-19-24 9:28,381.29,Withdrawal,Mobile App Withdrawal,1040.965707
11960,713740533,6-19-24 20:28,472.15,Return,Best Buy Return,1513.115707
11961,713740533,6-21-24 18:28,145.58,Deposit,Mobile Deposit,1658.695707
11962,713740533,6-27-24 22:28,107.83,Deposit,Mobile Deposit,1766.525707
11963,713740533,6-30-24 10:28,219.16,IncomingTransfer,Freelance Payment,1985.685707
11964,713740533,07-01-24 21:28,5200,IncomingTransfer,Salary,7185.685707
11965,713740533,07-02-24 16:28,106.3,Withdrawal,Mobile App Withdrawal,7079.385707
11966,713740533,07-02-24 16:28,163.27,OnlineShopping,Amazon,6916.115707
11967,713740533,07-03-24 11:28,145.26,Payment,Loan Payment,6770.855707
11968,713740533,07-06-24 21:28,2100,Payment,Credit Card Payment,4670.855707
11969,713740533,07-08-24 20:28,213.65,Deposit,Cash Deposit,4884.505707
11970,713740533,07-12-24 14:28,198.46,OutgoingTransfer,Bank Transfer,4686.045707
11971,713740533,7-14-24 12:28,420.17,Withdrawal,ATM Withdrawal,4265.875707
11972,713740533,7-15-24 21:28,88.04,Deposit,Cash Deposit,4353.915707
11973,713740533,7-16-24 21:28,2100,Payment,Insurance Payment,2253.915707
11974,713740533,7-17-24 22:28,121.93,Purchase,Entertainment,2131.985707
11975,713766183,1-23-24 15:28,213.26,Deposit,Direct Deposit,2441.879091
11976,713766183,1-27-24 22:28,165.56,OnlineShopping,AliExpress,2276.319091
11977,713766183,1-29-24 12:28,584.24,IncomingTransfer,Freelance Payment,2860.559091
11978,713766183,1-31-24 10:28,360.28,Return,Target Return,3220.839091
11979,713766183,1-31-24 18:28,353.38,IncomingTransfer,Freelance Payment,3574.219091
11980,713766183,02-01-24 11:28,121.64,Purchase,Gas,3452.579091
11981,713766183,02-03-24 16:28,504.95,Deposit,Cash Deposit,3957.529091
11982,713766183,02-03-24 21:28,6950,IncomingTransfer,Salary,10907.52909
11983,713766183,02-04-24 14:28,373,Return,Etsy Return,11280.52909
11984,713766183,02-08-24 21:28,2800,Payment,Credit Card Payment,8480.529091
11985,713766183,02-12-24 12:28,285.76,Payment,Bill Payment,8194.769091
11986,713766183,02-12-24 21:28,2500,Payment,Rent Payment,5694.769091
11987,713766183,2-13-24 11:28,699.84,Withdrawal,ATM Withdrawal,4994.929091
11988,713766183,2-13-24 16:28,654.86,Purchase,Restaurant,4340.069091
11989,713766183,2-16-24 10:28,699.63,Deposit,Mobile Deposit,5039.699091
11990,713766183,2-16-24 11:28,334.44,OutgoingTransfer,International Transfer,4705.259091
11991,713766183,2-23-24 9:28,135.22,Payment,Loan Payment,4570.039091
11992,713766183,2-23-24 13:28,527.83,Withdrawal,ATM Withdrawal,4042.209091
11993,713766183,2-28-24 9:28,428.49,Purchase,Travel,3613.719091
11994,713766183,03-02-24 11:28,468.29,Purchase,Pharmacy,3145.429091
11995,713766183,03-04-24 21:28,6950,IncomingTransfer,Salary,10095.42909
11996,713766183,03-07-24 16:28,647.66,Return,Etsy Return,10743.08909
11997,713766183,03-09-24 18:28,476.85,Purchase,Grocery,10266.23909
11998,713766183,03-09-24 20:28,235.6,Withdrawal,Mobile App Withdrawal,10030.63909
11999,713766183,03-09-24 21:28,3300,Payment,Credit Card Payment,6730.639091
12000,713766183,03-10-24 19:28,106.4,Deposit,Cash Deposit,6837.039091
12001,713766183,3-13-24 15:28,236.69,Purchase,Pharmacy,6600.349091
12002,713766183,3-13-24 16:28,443,OnlineShopping,Walmart,6157.349091
12003,713766183,3-15-24 10:28,356.06,OutgoingTransfer,International Transfer,5801.289091
12004,713766183,3-15-24 21:28,3300,Payment,Rent Payment,2501.289091
12005,713766183,3-15-24 23:28,577.63,Purchase,Electronics,1923.659091
12006,713766183,3-16-24 18:28,718.23,OutgoingTransfer,Peer-to-Peer Transfer,1205.429091
12007,713766183,3-18-24 15:28,459.49,OnlineShopping,Best Buy,745.9390906
12008,713766183,3-20-24 23:28,714.84,Withdrawal,Branch Withdrawal,31.09909056
12009,713766183,3-21-24 13:28,305.1,Withdrawal,Branch Withdrawal,-274.0009094
12010,713766183,3-23-24 17:28,640.47,Deposit,Mobile Deposit,366.4690906
12011,713766183,3-23-24 19:28,253.81,OutgoingTransfer,International Transfer,112.6590906
12012,713766183,3-23-24 20:28,446.78,OnlineShopping,Best Buy,-334.1209094
12013,713766183,3-25-24 9:28,698.92,Purchase,Restaurant,-1033.040909
12014,713766183,3-26-24 14:28,457.41,OutgoingTransfer,Peer-to-Peer Transfer,-1490.450909
12015,713766183,3-29-24 14:28,479.22,Purchase,Home Improvement,-1969.670909
12016,713766183,3-29-24 17:28,642.05,Deposit,Cash Deposit,-1327.620909
12017,713766183,3-31-24 19:28,455.35,Purchase,Travel,-1782.970909
12018,713766183,04-04-24 10:28,172.44,Deposit,Mobile Deposit,-1610.530909
12019,713766183,04-05-24 21:28,6950,IncomingTransfer,Salary,5339.469091
12020,713766183,04-06-24 21:28,282.59,Withdrawal,ATM Withdrawal,5056.879091
12021,713766183,04-08-24 22:28,265.72,Withdrawal,Mobile App Withdrawal,4791.159091
12022,713766183,04-09-24 21:28,115.01,OnlineShopping,Best Buy,4676.149091
12023,713766183,04-10-24 21:28,2500,Payment,Credit Card Payment,2176.149091
12024,713766183,04-12-24 11:28,472.68,Purchase,Clothing,1703.469091
12025,713766183,4-13-24 21:28,4100,Payment,Rent Payment,-2396.530909
12026,713766183,4-14-24 19:28,368.65,OutgoingTransfer,Wire Transfer,-2765.180909
12027,713766183,4-19-24 11:28,111.55,Withdrawal,ATM Withdrawal,-2876.730909
12028,713766183,4-30-24 14:28,465.37,Deposit,Mobile Deposit,-2411.360909
12029,713766183,05-02-24 21:28,6950,IncomingTransfer,Salary,4538.639091
12030,713766183,05-06-24 9:28,683.03,Withdrawal,Branch Withdrawal,3855.609091
12031,713766183,05-07-24 15:28,631.01,Payment,Bill Payment,3224.599091
12032,713766183,05-07-24 20:28,261.32,OnlineShopping,Etsy,2963.279091
12033,713766183,05-07-24 21:28,3700,Payment,Credit Card Payment,-736.7209094
12034,713766183,05-07-24 21:28,596.17,OnlineShopping,eBay,-1332.890909
12035,713766183,5-15-24 21:28,4500,Payment,Rent Payment,-5832.890909
12036,713766183,5-16-24 12:28,577.21,Deposit,Direct Deposit,-5255.680909
12037,713766183,5-16-24 19:28,470.97,OutgoingTransfer,Wire Transfer,-5726.650909
12038,713766183,5-17-24 12:28,140.43,Purchase,Pharmacy,-5867.080909
12039,713766183,5-22-24 16:28,181.35,Withdrawal,Branch Withdrawal,-6048.430909
12040,713766183,5-24-24 11:28,494.83,Withdrawal,ATM Withdrawal,-6543.260909
12041,713766183,5-25-24 13:28,237.25,Deposit,Check Deposit,-6306.010909
12042,713766183,5-31-24 9:28,458.25,Purchase,Entertainment,-6764.260909
12043,713766183,5-31-24 11:28,513.69,Payment,Loan Payment,-7277.950909
12044,713766183,06-01-24 19:28,648.18,Withdrawal,Branch Withdrawal,-7926.130909
12045,713766183,06-03-24 21:28,6950,IncomingTransfer,Salary,-976.1309094
12046,713766183,06-05-24 23:28,667.51,Purchase,Pharmacy,-1643.640909
12047,713766183,06-08-24 18:28,668.17,Withdrawal,Mobile App Withdrawal,-2311.810909
12048,713766183,06-08-24 21:28,2600,Payment,Credit Card Payment,-4911.810909
12049,713766183,06-11-24 11:28,481.97,Purchase,Furniture,-5393.780909
12050,713766183,06-11-24 11:28,490.15,Return,Best Buy Return,-4903.630909
12051,713766183,06-12-24 12:28,170.62,Deposit,Check Deposit,-4733.010909
12052,713766183,6-13-24 9:28,717.79,Deposit,Check Deposit,-4015.220909
12053,713766183,6-14-24 21:28,326,Purchase,Clothing,-4341.220909
12054,713766183,6-15-24 21:28,3300,Payment,Rent Payment,-7641.220909
12055,713766183,6-17-24 15:28,341.7,Deposit,Cash Deposit,-7299.520909
12056,713766183,6-21-24 21:28,454.43,Withdrawal,Branch Withdrawal,-7753.950909
12057,713766183,6-24-24 15:28,731.23,OutgoingTransfer,International Transfer,-8485.180909
12058,713766183,6-28-24 15:28,545.36,IncomingTransfer,Freelance Payment,-7939.820909
12059,713766183,6-29-24 17:28,320.45,Deposit,Direct Deposit,-7619.370909
12060,713766183,6-30-24 21:28,230.95,Deposit,Mobile Deposit,-7388.420909
12061,713766183,07-02-24 14:28,459.75,Return,Amazon Return,-6928.670909
12062,713766183,07-03-24 19:28,718.26,Withdrawal,Mobile App Withdrawal,-7646.930909
12063,713766183,07-03-24 21:28,6950,IncomingTransfer,Salary,-696.9309094
12064,713766183,07-05-24 17:28,447.22,Payment,Mortgage Payment,-1144.150909
12065,713766183,07-08-24 9:28,725.59,Deposit,Mobile Deposit,-418.5609094
12066,713766183,07-08-24 11:28,161.56,OutgoingTransfer,Peer-to-Peer Transfer,-580.1209094
12067,713766183,07-08-24 17:28,414.16,Purchase,Grocery,-994.2809094
12068,713766183,07-08-24 21:28,3600,Payment,Credit Card Payment,-4594.280909
12069,713766183,07-09-24 21:28,136.06,OutgoingTransfer,Bank Transfer,-4730.340909
12070,713766183,07-10-24 18:28,115.24,Withdrawal,Mobile App Withdrawal,-4845.580909
12071,713766183,7-14-24 20:28,596.08,Deposit,Direct Deposit,-4249.500909
12072,713766183,7-17-24 21:28,489.22,OnlineShopping,eBay,-4738.720909
12073,713766183,7-18-24 21:28,4000,Payment,Rent Payment,-8738.720909
12074,713815383,1-23-24 21:28,366.98,Deposit,Mobile Deposit,366.98
12075,713815383,1-24-24 18:28,574.01,Payment,Bill Payment,-207.03
12076,713815383,02-02-24 14:28,111.24,Purchase,Restaurant,-318.27
12077,713815383,02-03-24 21:28,7900,IncomingTransfer,Salary,7581.73
12078,713815383,02-06-24 13:28,479.45,Deposit,Check Deposit,8061.18
12079,713815383,2-14-24 22:28,547.97,Purchase,Furniture,7513.21
12080,713815383,2-16-24 12:28,267.6,Purchase,Electronics,7245.61
12081,713815383,2-16-24 19:28,712.96,Return,eBay Return,7958.57
12082,713815383,2-18-24 11:28,647.11,OutgoingTransfer,Peer-to-Peer Transfer,7311.46
12083,713815383,2-18-24 21:28,4500,Payment,Rent Payment,2811.46
12084,713815383,2-21-24 20:28,591.97,Deposit,Direct Deposit,3403.43
12085,713815383,2-23-24 19:28,310.62,Withdrawal,ATM Withdrawal,3092.81
12086,713815383,2-24-24 12:28,454.8,Deposit,Cash Deposit,3547.61
12087,713815383,2-24-24 13:28,443.44,Withdrawal,ATM Withdrawal,3104.17
12088,713815383,2-26-24 9:28,279.81,Withdrawal,ATM Withdrawal,2824.36
12089,713815383,2-29-24 12:28,371.87,Deposit,Cash Deposit,3196.23
12090,713815383,03-01-24 13:28,216.21,OutgoingTransfer,Wire Transfer,2980.02
12091,713815383,03-02-24 21:28,235.91,Payment,Mortgage Payment,2744.11
12092,713815383,03-04-24 21:28,7900,IncomingTransfer,Salary,10644.11
12093,713815383,3-17-24 21:28,2000,Payment,Rent Payment,8644.11
12094,713815383,3-23-24 11:28,356.81,Deposit,Direct Deposit,9000.92
12095,713815383,3-26-24 9:28,706.99,Withdrawal,Mobile App Withdrawal,8293.93
12096,713815383,3-30-24 15:28,469.24,OnlineShopping,AliExpress,7824.69
12097,713815383,04-01-24 10:28,612.17,OnlineShopping,Etsy,7212.52
12098,713815383,04-02-24 11:28,214.12,Withdrawal,ATM Withdrawal,6998.4
12099,713815383,04-04-24 14:28,113.82,Purchase,Furniture,6884.58
12100,713815383,04-05-24 21:28,7900,IncomingTransfer,Salary,14784.58
12101,713815383,04-07-24 16:28,146.04,Payment,Loan Payment,14638.54
12102,713815383,4-13-24 16:28,582.05,Purchase,Home Improvement,14056.49
12103,713815383,4-18-24 21:28,2000,Payment,Rent Payment,12056.49
12104,713815383,4-22-24 14:28,320.35,Return,Best Buy Return,12376.84
12105,713815383,4-24-24 19:28,397.18,Withdrawal,ATM Withdrawal,11979.66
12106,713815383,4-28-24 17:28,577.21,Deposit,Cash Deposit,12556.87
12107,713815383,4-30-24 18:28,492.49,Deposit,Direct Deposit,13049.36
12108,713815383,05-02-24 21:28,7900,IncomingTransfer,Salary,20949.36
12109,713815383,05-05-24 15:28,619.12,Return,Walmart Return,21568.48
12110,713815383,05-08-24 18:28,576.17,Purchase,Travel,20992.31
12111,713815383,5-14-24 21:28,2200,Payment,Rent Payment,18792.31
12112,713815383,5-16-24 23:28,257.46,OnlineShopping,AliExpress,18534.85
12113,713815383,5-23-24 17:28,182.19,Purchase,Restaurant,18352.66
12114,713815383,5-24-24 17:28,464.39,Withdrawal,ATM Withdrawal,17888.27
12115,713815383,5-25-24 17:28,299.4,Deposit,Direct Deposit,18187.67
12116,713815383,5-28-24 9:28,368.02,Return,Best Buy Return,18555.69
12117,713815383,06-01-24 21:28,7900,IncomingTransfer,Salary,26455.69
12118,713815383,06-01-24 22:28,498.46,OnlineShopping,Target,25957.23
12119,713815383,06-09-24 12:28,552.98,Deposit,Check Deposit,26510.21
12120,713815383,06-09-24 14:28,195.31,Deposit,Cash Deposit,26705.52
12121,713815383,06-10-24 20:28,143.77,Purchase,Furniture,26561.75
12122,713815383,06-12-24 20:28,435.9,Withdrawal,ATM Withdrawal,26125.85
12123,713815383,6-16-24 21:28,4800,Payment,Rent Payment,21325.85
12124,713815383,6-22-24 17:28,255.98,OutgoingTransfer,International Transfer,21069.87
12125,713815383,6-25-24 17:28,503.07,Return,Walmart Return,21572.94
12126,713815383,07-04-24 12:28,155.55,Deposit,Mobile Deposit,21728.49
12127,713815383,07-05-24 21:28,7900,IncomingTransfer,Salary,29628.49
12128,713815383,7-14-24 21:28,4200,Payment,Rent Payment,25428.49
12129,713815383,7-15-24 9:28,476.1,OnlineShopping,eBay,24952.39
12130,713872008,1-20-24 10:28,212.44,Purchase,Pharmacy,701.2672751
12131,713872008,1-20-24 16:28,243.51,OutgoingTransfer,International Transfer,457.7572751
12132,713872008,1-27-24 16:28,14.92,Purchase,Pharmacy,442.8372751
12133,713872008,1-29-24 13:28,202.91,IncomingTransfer,Freelance Payment,645.7472751
12134,713872008,1-29-24 18:28,34.39,Deposit,Direct Deposit,680.1372751
12135,713872008,1-31-24 12:28,89.83,OnlineShopping,eBay,590.3072751
12136,713872008,1-31-24 13:28,24.36,Withdrawal,ATM Withdrawal,565.9472751
12137,713872008,02-02-24 15:28,97.73,Deposit,Mobile Deposit,663.6772751
12138,713872008,02-04-24 21:28,1750,IncomingTransfer,Salary,2413.677275
12139,713872008,02-05-24 15:28,199.26,Purchase,Travel,2214.417275
12140,713872008,02-05-24 18:28,198.78,Withdrawal,ATM Withdrawal,2015.637275
12141,713872008,02-07-24 9:28,134.55,Return,Best Buy Return,2150.187275
12142,713872008,02-08-24 10:28,81.04,Withdrawal,Mobile App Withdrawal,2069.147275
12143,713872008,02-09-24 21:28,1800,Payment,Credit Card Payment,269.1472751
12144,713872008,02-09-24 21:28,154.22,Withdrawal,ATM Withdrawal,114.9272751
12145,713872008,02-10-24 21:28,112.24,Return,Target Return,227.1672751
12146,713872008,02-11-24 17:28,140.87,OutgoingTransfer,Wire Transfer,86.29727514
12147,713872008,2-13-24 18:28,98.1,IncomingTransfer,Freelance Payment,184.3972751
12148,713872008,2-14-24 13:28,82.12,Deposit,Direct Deposit,266.5172751
12149,713872008,2-17-24 10:28,41.73,Withdrawal,ATM Withdrawal,224.7872751
12150,713872008,2-17-24 21:28,600,Payment,Rent Payment,-375.2127249
12151,713872008,2-18-24 21:28,216.97,Purchase,Entertainment,-592.1827249
12152,713872008,2-19-24 17:28,27.48,Deposit,Mobile Deposit,-564.7027249
12153,713872008,2-20-24 17:28,153.18,Purchase,Travel,-717.8827249
12154,713872008,2-22-24 11:28,162.64,IncomingTransfer,Freelance Payment,-555.2427249
12155,713872008,2-22-24 19:28,238.82,OnlineShopping,Etsy,-794.0627249
12156,713872008,2-25-24 14:28,107.3,Deposit,Mobile Deposit,-686.7627249
12157,713872008,2-25-24 15:28,67.55,Withdrawal,ATM Withdrawal,-754.3127249
12158,713872008,2-27-24 9:28,142.47,Withdrawal,Branch Withdrawal,-896.7827249
12159,713872008,2-29-24 17:28,198.79,Return,Walmart Return,-697.9927249
12160,713872008,03-03-24 21:28,1750,IncomingTransfer,Salary,1052.007275
12161,713872008,03-05-24 23:28,76.31,Payment,Mortgage Payment,975.6972751
12162,713872008,03-08-24 21:28,1900,Payment,Credit Card Payment,-924.3027249
12163,713872008,3-13-24 23:28,41.57,Deposit,Mobile Deposit,-882.7327249
12164,713872008,3-15-24 19:28,106.36,Withdrawal,Branch Withdrawal,-989.0927249
12165,713872008,3-17-24 16:28,11.49,Purchase,Travel,-1000.582725
12166,713872008,3-18-24 21:28,800,Payment,Rent Payment,-1800.582725
12167,713872008,3-19-24 12:28,190.02,Deposit,Check Deposit,-1610.562725
12168,713872008,3-23-24 19:28,29.85,Deposit,Cash Deposit,-1580.712725
12169,713872008,3-25-24 15:28,151.29,OnlineShopping,Target,-1732.002725
12170,713872008,3-27-24 14:28,235.06,OutgoingTransfer,International Transfer,-1967.062725
12171,713872008,3-31-24 17:28,103.84,Deposit,Check Deposit,-1863.222725
12172,713872008,3-31-24 21:28,123.53,Withdrawal,ATM Withdrawal,-1986.752725
12173,713872008,04-02-24 21:28,170.8,Return,Amazon Return,-1815.952725
12174,713872008,04-03-24 21:28,1750,IncomingTransfer,Salary,-65.95272486
12175,713872008,04-04-24 18:28,74.24,OnlineShopping,Target,-140.1927249
12176,713872008,04-05-24 20:28,120.51,Withdrawal,Mobile App Withdrawal,-260.7027249
12177,713872008,04-08-24 10:28,125.3,Deposit,Direct Deposit,-135.4027249
12178,713872008,04-08-24 21:28,2000,Payment,Credit Card Payment,-2135.402725
12179,713872008,4-16-24 20:28,174.59,Withdrawal,Branch Withdrawal,-2309.992725
12180,713872008,4-17-24 15:28,103.41,Deposit,Check Deposit,-2206.582725
12181,713872008,4-17-24 21:28,900,Payment,Rent Payment,-3106.582725
12182,713872008,4-22-24 13:28,121.45,OnlineShopping,Target,-3228.032725
12183,713872008,4-24-24 23:28,126.94,IncomingTransfer,Freelance Payment,-3101.092725
12184,713872008,4-25-24 12:28,183,Purchase,Gas,-3284.092725
12185,713872008,4-25-24 21:28,131.8,Purchase,Electronics,-3415.892725
12186,713872008,4-27-24 15:28,118.2,OnlineShopping,Walmart,-3534.092725
12187,713872008,05-05-24 18:28,115.44,Payment,Bill Payment,-3649.532725
12188,713872008,05-05-24 21:28,1750,IncomingTransfer,Salary,-1899.532725
12189,713872008,05-07-24 11:28,61.22,Deposit,Check Deposit,-1838.312725
12190,713872008,05-09-24 13:28,169.51,OutgoingTransfer,International Transfer,-2007.822725
12191,713872008,05-10-24 18:28,74.84,Deposit,Cash Deposit,-1932.982725
12192,713872008,05-10-24 21:28,1900,Payment,Credit Card Payment,-3832.982725
12193,713872008,5-18-24 21:28,400,Payment,Rent Payment,-4232.982725
12194,713872008,5-31-24 19:28,58.46,Deposit,Cash Deposit,-4174.522725
12195,713872008,06-02-24 21:28,1750,IncomingTransfer,Salary,-2424.522725
12196,713872008,06-03-24 22:28,146.54,Payment,Bill Payment,-2571.062725
12197,713872008,06-04-24 21:28,210.26,OnlineShopping,Amazon,-2781.322725
12198,713872008,06-04-24 22:28,116.27,Payment,Bill Payment,-2897.592725
12199,713872008,06-05-24 11:28,26.58,Deposit,Direct Deposit,-2871.012725
12200,713872008,06-07-24 21:28,1600,Payment,Credit Card Payment,-4471.012725
12201,713872008,06-11-24 21:28,600,Payment,Rent Payment,-5071.012725
12202,713872008,06-12-24 22:28,69.27,OutgoingTransfer,International Transfer,-5140.282725
12203,713872008,6-19-24 16:28,176.84,Return,Walmart Return,-4963.442725
12204,713872008,6-20-24 16:28,184.09,OutgoingTransfer,Bank Transfer,-5147.532725
12205,713872008,6-22-24 15:28,132.27,Deposit,Mobile Deposit,-5015.262725
12206,713872008,6-22-24 20:28,163.28,Payment,Bill Payment,-5178.542725
12207,713872008,6-28-24 9:28,53.23,OutgoingTransfer,International Transfer,-5231.772725
12208,713872008,07-01-24 19:28,11.93,Payment,Bill Payment,-5243.702725
12209,713872008,07-03-24 21:28,1750,IncomingTransfer,Salary,-3493.702725
12210,713872008,07-04-24 21:28,20.44,Purchase,Entertainment,-3514.142725
12211,713872008,07-05-24 22:28,175.34,Payment,Loan Payment,-3689.482725
12212,713872008,07-07-24 17:28,152.54,Return,Etsy Return,-3536.942725
12213,713872008,07-08-24 18:28,95.91,OnlineShopping,Walmart,-3632.852725
12214,713872008,07-08-24 21:28,1700,Payment,Credit Card Payment,-5332.852725
12215,713872008,07-11-24 15:28,242.69,Deposit,Check Deposit,-5090.162725
12216,713872008,07-11-24 20:28,150.72,Deposit,Direct Deposit,-4939.442725
12217,713872008,07-11-24 21:28,1100,Payment,Rent Payment,-6039.442725
12218,713872008,07-11-24 22:28,59.78,Purchase,Furniture,-6099.222725
12219,713872008,7-14-24 15:28,115.31,Return,Walmart Return,-5983.912725
12220,713895633,1-20-24 12:28,394.78,Deposit,Mobile Deposit,394.78
12221,713895633,1-21-24 12:28,167.82,Payment,Loan Payment,226.96
12222,713895633,1-21-24 13:28,96.66,Withdrawal,Mobile App Withdrawal,130.3
12223,713895633,1-24-24 15:28,162.56,Deposit,Mobile Deposit,292.86
12224,713895633,1-25-24 19:28,136.08,Withdrawal,Branch Withdrawal,156.78
12225,713895633,1-26-24 20:28,60.6,Withdrawal,Branch Withdrawal,96.18
12226,713895633,1-28-24 10:28,307.34,OutgoingTransfer,Wire Transfer,-211.16
12227,713895633,1-28-24 21:28,360.95,Withdrawal,Mobile App Withdrawal,-572.11
12228,713895633,1-29-24 9:28,168.9,Withdrawal,Branch Withdrawal,-741.01
12229,713895633,1-30-24 13:28,379.2,Purchase,Home Improvement,-1120.21
12230,713895633,1-30-24 14:28,365.45,Purchase,Grocery,-1485.66
12231,713895633,02-01-24 10:28,282.23,OnlineShopping,AliExpress,-1767.89
12232,713895633,02-01-24 10:28,224.59,Deposit,Direct Deposit,-1543.3
12233,713895633,02-02-24 11:28,264.42,Deposit,Cash Deposit,-1278.88
12234,713895633,02-02-24 14:28,213.06,Deposit,Direct Deposit,-1065.82
12235,713895633,02-04-24 21:28,4900,IncomingTransfer,Salary,3834.18
12236,713895633,02-07-24 17:28,306.29,Purchase,Travel,3527.89
12237,713895633,02-11-24 21:28,2300,Payment,Rent Payment,1227.89
12238,713895633,2-16-24 22:28,315.97,OnlineShopping,Walmart,911.92
12239,713895633,2-18-24 13:28,139.29,Deposit,Direct Deposit,1051.21
12240,713895633,2-19-24 22:28,318.35,Return,Walmart Return,1369.56
12241,713895633,2-21-24 12:28,112.78,Purchase,Travel,1256.78
12242,713895633,2-23-24 20:28,245.67,OutgoingTransfer,Wire Transfer,1011.11
12243,713895633,2-23-24 23:28,292.05,OutgoingTransfer,Wire Transfer,719.06
12244,713895633,2-25-24 20:28,156.24,Deposit,Check Deposit,875.3
12245,713895633,2-25-24 21:28,243.37,Withdrawal,Branch Withdrawal,631.93
12246,713895633,2-27-24 17:28,176.6,Return,Best Buy Return,808.53
12247,713895633,03-01-24 21:28,4900,IncomingTransfer,Salary,5708.53
12248,713895633,03-02-24 12:28,103.86,Return,AliExpress Return,5812.39
12249,713895633,03-02-24 15:28,171.64,Purchase,Furniture,5640.75
12250,713895633,03-02-24 15:28,395.35,Deposit,Mobile Deposit,6036.1
12251,713895633,03-04-24 11:28,390.77,IncomingTransfer,Freelance Payment,6426.87
12252,713895633,03-05-24 16:28,55.11,Deposit,Cash Deposit,6481.98
12253,713895633,03-06-24 19:28,375.28,Withdrawal,ATM Withdrawal,6106.7
12254,713895633,03-06-24 20:28,84.43,Withdrawal,Mobile App Withdrawal,6022.27
12255,713895633,03-07-24 9:28,152.04,Payment,Mortgage Payment,5870.23
12256,713895633,03-11-24 19:28,63.05,OutgoingTransfer,Wire Transfer,5807.18
12257,713895633,03-12-24 21:28,1900,Payment,Rent Payment,3907.18
12258,713895633,3-13-24 10:28,218.29,Payment,Bill Payment,3688.89
12259,713895633,3-13-24 15:28,337.44,OutgoingTransfer,Bank Transfer,3351.45
12260,713895633,3-15-24 18:28,269.75,Withdrawal,ATM Withdrawal,3081.7
12261,713895633,3-16-24 10:28,167.21,OutgoingTransfer,Bank Transfer,2914.49
12262,713895633,3-17-24 18:28,162.49,Purchase,Furniture,2752
12263,713895633,3-17-24 21:28,311.4,Payment,Loan Payment,2440.6
12264,713895633,3-18-24 11:28,137.87,Deposit,Check Deposit,2578.47
12265,713895633,3-25-24 13:28,69.22,Purchase,Electronics,2509.25
12266,713895633,3-28-24 18:28,307.87,Purchase,Furniture,2201.38
12267,713895633,3-28-24 20:28,231.21,Deposit,Check Deposit,2432.59
12268,713895633,3-29-24 9:28,223.01,Deposit,Direct Deposit,2655.6
12269,713895633,3-30-24 14:28,183.94,OnlineShopping,AliExpress,2471.66
12270,713895633,04-01-24 9:28,368.63,OnlineShopping,eBay,2103.03
12271,713895633,04-01-24 21:28,4900,IncomingTransfer,Salary,7003.03
12272,713895633,04-04-24 13:28,126.07,Return,Best Buy Return,7129.1
12273,713895633,04-05-24 15:28,300.46,Withdrawal,Mobile App Withdrawal,6828.64
12274,713895633,04-06-24 11:28,173.97,OutgoingTransfer,Peer-to-Peer Transfer,6654.67
12275,713895633,04-06-24 16:28,27.5,Withdrawal,ATM Withdrawal,6627.17
12276,713895633,04-10-24 11:28,198.42,Payment,Loan Payment,6428.75
12277,713895633,04-12-24 14:28,281.49,Payment,Mortgage Payment,6147.26
12278,713895633,04-12-24 21:28,1600,Payment,Rent Payment,4547.26
12279,713895633,4-13-24 17:28,370.12,Withdrawal,Branch Withdrawal,4177.14
12280,713895633,4-13-24 22:28,261.17,Purchase,Gas,3915.97
12281,713895633,4-14-24 17:28,136.15,Withdrawal,Branch Withdrawal,3779.82
12282,713895633,4-15-24 10:28,380.48,Deposit,Check Deposit,4160.3
12283,713895633,4-16-24 13:28,123.8,OutgoingTransfer,Peer-to-Peer Transfer,4036.5
12284,713895633,4-17-24 14:28,199.35,Withdrawal,ATM Withdrawal,3837.15
12285,713895633,4-17-24 22:28,270.17,Return,Amazon Return,4107.32
12286,713895633,4-21-24 10:28,209.09,Deposit,Cash Deposit,4316.41
12287,713895633,4-22-24 19:28,360.25,Withdrawal,ATM Withdrawal,3956.16
12288,713895633,4-29-24 13:28,192.97,Payment,Mortgage Payment,3763.19
12289,713895633,4-30-24 22:28,367.2,Return,Etsy Return,4130.39
12290,713895633,05-03-24 21:28,4900,IncomingTransfer,Salary,9030.39
12291,713895633,05-06-24 11:28,382.02,Payment,Bill Payment,8648.37
12292,713895633,05-06-24 21:28,26.24,Purchase,Clothing,8622.13
12293,713895633,05-08-24 22:28,210.01,OnlineShopping,Target,8412.12
12294,713895633,05-10-24 19:28,250.93,Deposit,Cash Deposit,8663.05
12295,713895633,05-10-24 21:28,1800,Payment,Rent Payment,6863.05
12296,713895633,5-14-24 12:28,214.51,OnlineShopping,Amazon,6648.54
12297,713895633,5-16-24 19:28,300.91,Purchase,Electronics,6347.63
12298,713895633,5-17-24 19:28,348.99,Deposit,Direct Deposit,6696.62
12299,713895633,5-20-24 9:28,78.48,OnlineShopping,Walmart,6618.14
12300,713895633,5-27-24 17:28,256.87,Deposit,Direct Deposit,6875.01
12301,713895633,5-27-24 20:28,72.37,Purchase,Gas,6802.64
12302,713895633,5-27-24 22:28,326.74,OnlineShopping,Target,6475.9
12303,713895633,5-28-24 23:28,355.72,Purchase,Furniture,6120.18
12304,713895633,5-31-24 20:28,375.83,Deposit,Mobile Deposit,6496.01
12305,713895633,06-01-24 13:28,295.82,Purchase,Gas,6200.19
12306,713895633,06-05-24 21:28,4900,IncomingTransfer,Salary,11100.19
12307,713895633,06-11-24 12:28,38.35,Deposit,Mobile Deposit,11138.54
12308,713895633,6-13-24 21:28,1400,Payment,Rent Payment,9738.54
12309,713895633,6-16-24 16:28,347.36,Withdrawal,ATM Withdrawal,9391.18
12310,713895633,6-19-24 9:28,349.29,Return,AliExpress Return,9740.47
12311,713895633,6-19-24 21:28,32.68,OutgoingTransfer,International Transfer,9707.79
12312,713895633,6-23-24 17:28,339.67,Purchase,Gas,9368.12
12313,713895633,6-23-24 19:28,36.53,Purchase,Home Improvement,9331.59
12314,713895633,6-24-24 12:28,36.16,Deposit,Direct Deposit,9367.75
12315,713895633,6-28-24 21:28,55.01,Purchase,Electronics,9312.74
12316,713895633,6-30-24 19:28,105.8,Return,Best Buy Return,9418.54
12317,713895633,07-01-24 13:28,143.83,Deposit,Direct Deposit,9562.37
12318,713895633,07-02-24 20:28,214.65,Return,Walmart Return,9777.02
12319,713895633,07-02-24 21:28,4900,IncomingTransfer,Salary,14677.02
12320,713895633,07-05-24 9:28,126.3,Deposit,Direct Deposit,14803.32
12321,713895633,07-05-24 14:28,132.73,OutgoingTransfer,Bank Transfer,14670.59
12322,713895633,07-09-24 9:28,22.95,IncomingTransfer,Freelance Payment,14693.54
12323,713895633,07-09-24 14:28,308.45,OutgoingTransfer,International Transfer,14385.09
12324,713895633,07-10-24 20:28,218.56,Deposit,Cash Deposit,14603.65
12325,713895633,07-11-24 17:28,248.82,Deposit,Direct Deposit,14852.47
12326,713895633,7-14-24 10:28,169.47,Deposit,Mobile Deposit,15021.94
12327,713895633,7-14-24 12:28,48.29,Withdrawal,ATM Withdrawal,14973.65
12328,713895633,7-14-24 15:28,145.5,Payment,Mortgage Payment,14828.15
12329,713895633,7-14-24 18:28,196.66,Withdrawal,Branch Withdrawal,14631.49
12330,713895633,7-14-24 19:28,92.57,Withdrawal,Branch Withdrawal,14538.92
12331,713895633,7-15-24 20:28,235.89,Purchase,Electronics,14303.03
12332,713895633,7-16-24 10:28,108.38,OnlineShopping,AliExpress,14194.65
12333,713895633,7-16-24 12:28,399.25,OutgoingTransfer,Peer-to-Peer Transfer,13795.4
12334,713895633,7-16-24 21:28,1800,Payment,Rent Payment,11995.4
12335,713902983,1-20-24 11:28,174.61,Payment,Loan Payment,559.6583822
12336,713902983,1-21-24 15:28,24.44,Purchase,Pharmacy,535.2183822
12337,713902983,1-23-24 10:28,111.46,OutgoingTransfer,Wire Transfer,423.7583822
12338,713902983,1-23-24 21:28,183.46,OnlineShopping,Best Buy,240.2983822
12339,713902983,1-24-24 9:28,80.78,Purchase,Electronics,159.5183822
12340,713902983,1-30-24 16:28,142.47,Payment,Loan Payment,17.04838222
12341,713902983,1-31-24 11:28,162.58,Payment,Loan Payment,-145.5316178
12342,713902983,02-03-24 17:28,197.13,Deposit,Mobile Deposit,51.59838222
12343,713902983,02-04-24 14:28,141.83,Return,Etsy Return,193.4283822
12344,713902983,02-04-24 21:28,2600,IncomingTransfer,Salary,2793.428382
12345,713902983,02-06-24 21:28,121.97,OutgoingTransfer,Peer-to-Peer Transfer,2671.458382
12346,713902983,02-08-24 13:28,37.78,Payment,Bill Payment,2633.678382
12347,713902983,02-09-24 21:28,1900,Payment,Credit Card Payment,733.6783822
12348,713902983,02-11-24 21:28,160.95,Deposit,Check Deposit,894.6283822
12349,713902983,02-12-24 11:28,186.24,OutgoingTransfer,Peer-to-Peer Transfer,708.3883822
12350,713902983,02-12-24 19:28,177.84,OnlineShopping,AliExpress,530.5483822
12351,713902983,2-13-24 12:28,165.54,Deposit,Direct Deposit,696.0883822
12352,713902983,2-13-24 20:28,152.63,Withdrawal,Mobile App Withdrawal,543.4583822
12353,713902983,2-14-24 15:28,148.7,OutgoingTransfer,International Transfer,394.7583822
12354,713902983,2-16-24 21:28,800,Payment,Insurance Payment,-405.2416178
12355,713902983,2-20-24 13:28,196.36,Purchase,Travel,-601.6016178
12356,713902983,2-20-24 16:28,118.74,Deposit,Check Deposit,-482.8616178
12357,713902983,2-20-24 18:28,81.8,Purchase,Home Improvement,-564.6616178
12358,713902983,2-24-24 11:28,123,Deposit,Direct Deposit,-441.6616178
12359,713902983,2-26-24 10:28,40.74,Deposit,Check Deposit,-400.9216178
12360,713902983,2-27-24 13:28,228.89,Withdrawal,ATM Withdrawal,-629.8116178
12361,713902983,03-05-24 21:28,2600,IncomingTransfer,Salary,1970.188382
12362,713902983,03-05-24 22:28,164.59,Withdrawal,Branch Withdrawal,1805.598382
12363,713902983,03-06-24 9:28,219.19,Purchase,Entertainment,1586.408382
12364,713902983,03-10-24 21:28,1800,Payment,Credit Card Payment,-213.5916178
12365,713902983,03-12-24 21:28,1000,Payment,Subscription Payment,-1213.591618
12366,713902983,3-13-24 19:28,227.71,Payment,Loan Payment,-1441.301618
12367,713902983,3-16-24 19:28,141.61,OutgoingTransfer,Wire Transfer,-1582.911618
12368,713902983,3-17-24 13:28,215.34,OnlineShopping,eBay,-1798.251618
12369,713902983,3-22-24 16:28,188.49,Purchase,Restaurant,-1986.741618
12370,713902983,3-23-24 13:28,133.92,Deposit,Mobile Deposit,-1852.821618
12371,713902983,3-26-24 21:28,235.56,Deposit,Direct Deposit,-1617.261618
12372,713902983,3-28-24 16:28,232.44,OutgoingTransfer,International Transfer,-1849.701618
12373,713902983,3-31-24 21:28,142.22,IncomingTransfer,Freelance Payment,-1707.481618
12374,713902983,04-01-24 21:28,2600,IncomingTransfer,Salary,892.5183822
12375,713902983,04-04-24 22:28,206.77,OutgoingTransfer,Wire Transfer,685.7483822
12376,713902983,04-06-24 21:28,1900,Payment,Credit Card Payment,-1214.251618
12377,713902983,04-12-24 18:28,162.26,Return,Walmart Return,-1051.991618
12378,713902983,4-15-24 23:28,115.54,Withdrawal,Branch Withdrawal,-1167.531618
12379,713902983,4-17-24 21:28,1100,Payment,Installment Payment,-2267.531618
12380,713902983,4-18-24 12:28,15.31,OnlineShopping,Target,-2282.841618
12381,713902983,4-20-24 11:28,182.91,Deposit,Cash Deposit,-2099.931618
12382,713902983,4-20-24 19:28,155.67,OutgoingTransfer,Bank Transfer,-2255.601618
12383,713902983,4-23-24 11:28,90.46,OnlineShopping,Best Buy,-2346.061618
12384,713902983,4-27-24 10:28,225.55,Withdrawal,Branch Withdrawal,-2571.611618
12385,713902983,4-27-24 18:28,186.36,Purchase,Furniture,-2757.971618
12386,713902983,05-01-24 21:28,193.41,Withdrawal,ATM Withdrawal,-2951.381618
12387,713902983,05-04-24 21:28,2600,IncomingTransfer,Salary,-351.3816178
12388,713902983,05-08-24 16:28,213.95,Purchase,Entertainment,-565.3316178
12389,713902983,05-08-24 18:28,149.6,Purchase,Furniture,-714.9316178
12390,713902983,05-09-24 21:28,2000,Payment,Credit Card Payment,-2714.931618
12391,713902983,05-09-24 21:28,175.07,OutgoingTransfer,Peer-to-Peer Transfer,-2890.001618
12392,713902983,05-10-24 12:28,167.55,Deposit,Check Deposit,-2722.451618
12393,713902983,05-10-24 21:28,900,Payment,Subscription Payment,-3622.451618
12394,713902983,5-13-24 10:28,224.18,Return,Best Buy Return,-3398.271618
12395,713902983,5-13-24 20:28,37.8,Deposit,Check Deposit,-3360.471618
12396,713902983,5-18-24 11:28,204.11,Deposit,Check Deposit,-3156.361618
12397,713902983,5-18-24 14:28,210.84,OnlineShopping,Target,-3367.201618
12398,713902983,5-22-24 14:28,222.45,Withdrawal,Branch Withdrawal,-3589.651618
12399,713902983,5-26-24 10:28,188.45,Withdrawal,Branch Withdrawal,-3778.101618
12400,713902983,5-26-24 20:28,223.98,OutgoingTransfer,Bank Transfer,-4002.081618
12401,713902983,5-27-24 22:28,35.22,Deposit,Check Deposit,-3966.861618
12402,713902983,5-27-24 23:28,130.12,OnlineShopping,eBay,-4096.981618
12403,713902983,5-28-24 21:28,17.3,OnlineShopping,Walmart,-4114.281618
12404,713902983,5-31-24 9:28,168.98,OnlineShopping,AliExpress,-4283.261618
12405,713902983,5-31-24 21:28,195.28,Deposit,Direct Deposit,-4087.981618
12406,713902983,06-01-24 12:28,133.65,Return,Target Return,-3954.331618
12407,713902983,06-01-24 13:28,43.16,Purchase,Grocery,-3997.491618
12408,713902983,06-03-24 21:28,2600,IncomingTransfer,Salary,-1397.491618
12409,713902983,06-08-24 16:28,78.29,OnlineShopping,Walmart,-1475.781618
12410,713902983,06-08-24 21:28,1400,Payment,Credit Card Payment,-2875.781618
12411,713902983,6-13-24 20:28,19.76,Payment,Loan Payment,-2895.541618
12412,713902983,6-14-24 21:28,1100,Payment,Subscription Payment,-3995.541618
12413,713902983,6-15-24 10:28,190.36,IncomingTransfer,Freelance Payment,-3805.181618
12414,713902983,6-15-24 19:28,204.39,Payment,Bill Payment,-4009.571618
12415,713902983,6-18-24 22:28,134.34,Return,Etsy Return,-3875.231618
12416,713902983,6-18-24 22:28,227.17,Purchase,Restaurant,-4102.401618
12417,713902983,6-20-24 21:28,51.7,IncomingTransfer,Freelance Payment,-4050.701618
12418,713902983,6-30-24 20:28,79.16,Deposit,Mobile Deposit,-3971.541618
12419,713902983,07-01-24 21:28,2600,IncomingTransfer,Salary,-1371.541618
12420,713902983,07-02-24 13:28,16.31,Return,Amazon Return,-1355.231618
12421,713902983,07-04-24 18:28,155.01,Deposit,Mobile Deposit,-1200.221618
12422,713902983,07-05-24 14:28,161.71,Withdrawal,ATM Withdrawal,-1361.931618
12423,713902983,07-06-24 21:28,1700,Payment,Credit Card Payment,-3061.931618
12424,713902983,07-07-24 14:28,133.38,Deposit,Mobile Deposit,-2928.551618
12425,713902983,07-10-24 12:28,27.01,Purchase,Restaurant,-2955.561618
12426,713902983,7-13-24 21:28,700,Payment,Installment Payment,-3655.561618
12427,713902983,7-15-24 23:28,46.21,Purchase,Gas,-3701.771618
12428,713902983,7-16-24 14:28,131.46,Purchase,Gas,-3833.231618
12429,713902983,7-17-24 19:28,242.65,Purchase,Pharmacy,-4075.881618
12430,713908683,1-26-24 19:28,515.71,Purchase,Travel,305.5199746
12431,713908683,1-26-24 19:28,398.07,Deposit,Check Deposit,703.5899746
12432,713908683,02-02-24 16:28,186.45,Purchase,Gas,517.1399746
12433,713908683,02-03-24 21:28,7250,IncomingTransfer,Salary,7767.139975
12434,713908683,02-07-24 16:28,690.92,OnlineShopping,Walmart,7076.219975
12435,713908683,02-08-24 21:28,1700,Payment,Credit Card Payment,5376.219975
12436,713908683,02-11-24 12:28,722.03,Payment,Bill Payment,4654.189975
12437,713908683,02-11-24 21:28,1900,Payment,Rent Payment,2754.189975
12438,713908683,2-14-24 21:28,541.2,Withdrawal,Mobile App Withdrawal,2212.989975
12439,713908683,2-17-24 17:28,103.34,Purchase,Pharmacy,2109.649975
12440,713908683,2-25-24 10:28,179.97,Deposit,Cash Deposit,2289.619975
12441,713908683,03-01-24 22:28,224.36,Payment,Mortgage Payment,2065.259975
12442,713908683,03-04-24 21:28,7250,IncomingTransfer,Salary,9315.259975
12443,713908683,03-09-24 21:28,1700,Payment,Credit Card Payment,7615.259975
12444,713908683,3-14-24 17:28,279.63,Deposit,Mobile Deposit,7894.889975
12445,713908683,3-14-24 21:28,4500,Payment,Rent Payment,3394.889975
12446,713908683,3-24-24 11:28,210.71,Payment,Bill Payment,3184.179975
12447,713908683,3-24-24 21:28,447.34,Withdrawal,Branch Withdrawal,2736.839975
12448,713908683,3-25-24 16:28,106.52,Withdrawal,Branch Withdrawal,2630.319975
12449,713908683,3-31-24 15:28,399.96,Deposit,Mobile Deposit,3030.279975
12450,713908683,04-01-24 21:28,7250,IncomingTransfer,Salary,10280.27997
12451,713908683,04-06-24 21:28,1700,Payment,Credit Card Payment,8580.279975
12452,713908683,04-08-24 14:28,304.93,Deposit,Mobile Deposit,8885.209975
12453,713908683,04-11-24 18:28,373.42,Withdrawal,Branch Withdrawal,8511.789975
12454,713908683,4-14-24 18:28,747.56,IncomingTransfer,Freelance Payment,9259.349975
12455,713908683,4-15-24 15:28,660.85,Purchase,Entertainment,8598.499975
12456,713908683,4-17-24 15:28,111.23,Payment,Loan Payment,8487.269975
12457,713908683,4-18-24 21:28,4100,Payment,Rent Payment,4387.269975
12458,713908683,4-19-24 16:28,599.53,Withdrawal,Branch Withdrawal,3787.739975
12459,713908683,4-19-24 17:28,126.84,OnlineShopping,AliExpress,3660.899975
12460,713908683,4-23-24 10:28,436.7,Withdrawal,Mobile App Withdrawal,3224.199975
12461,713908683,4-24-24 23:28,689.24,OutgoingTransfer,Peer-to-Peer Transfer,2534.959975
12462,713908683,05-02-24 19:28,367.25,Deposit,Check Deposit,2902.209975
12463,713908683,05-04-24 21:28,7250,IncomingTransfer,Salary,10152.20997
12464,713908683,05-09-24 21:28,1900,Payment,Credit Card Payment,8252.209975
12465,713908683,05-12-24 19:28,225.22,Payment,Mortgage Payment,8026.989975
12466,713908683,5-18-24 21:28,1900,Payment,Rent Payment,6126.989975
12467,713908683,5-19-24 17:28,248.75,Withdrawal,ATM Withdrawal,5878.239975
12468,713908683,5-29-24 23:28,633.21,Purchase,Electronics,5245.029975
12469,713908683,06-01-24 21:28,7250,IncomingTransfer,Salary,12495.02997
12470,713908683,06-05-24 20:28,369.78,OutgoingTransfer,Peer-to-Peer Transfer,12125.24997
12471,713908683,06-06-24 21:28,1700,Payment,Credit Card Payment,10425.24997
12472,713908683,06-12-24 16:28,489.61,Purchase,Gas,9935.639975
12473,713908683,06-12-24 21:28,3700,Payment,Rent Payment,6235.639975
12474,713908683,6-18-24 21:28,327.37,Withdrawal,Mobile App Withdrawal,5908.269975
12475,713908683,6-29-24 21:28,673.57,Deposit,Direct Deposit,6581.839975
12476,713908683,07-03-24 10:28,309.24,Deposit,Cash Deposit,6891.079975
12477,713908683,07-05-24 21:28,7250,IncomingTransfer,Salary,14141.07997
12478,713908683,07-10-24 21:28,2000,Payment,Credit Card Payment,12141.07997
12479,713908683,07-11-24 17:28,546.06,IncomingTransfer,Freelance Payment,12687.13997
12480,713908683,07-11-24 21:28,2600,Payment,Rent Payment,10087.13997
12481,713929533,1-24-24 11:28,70.26,Deposit,Mobile Deposit,70.26
12482,713929533,1-27-24 16:28,118.96,Withdrawal,Mobile App Withdrawal,-48.7
12483,713929533,1-28-24 11:28,242.85,Withdrawal,ATM Withdrawal,-291.55
12484,713929533,1-28-24 15:28,137.15,Purchase,Gas,-428.7
12485,713929533,1-30-24 15:28,13.75,Deposit,Direct Deposit,-414.95
12486,713929533,1-31-24 14:28,245.91,Withdrawal,ATM Withdrawal,-660.86
12487,713929533,1-31-24 18:28,42.1,Return,Store Return,-618.76
12488,713929533,02-03-24 21:28,2350,IncomingTransfer,Salary,1731.24
12489,713929533,02-04-24 13:28,195.52,Deposit,Check Deposit,1926.76
12490,713929533,02-05-24 17:28,38.56,Deposit,Cash Deposit,1965.32
12491,713929533,02-08-24 11:28,155.7,Return,eBay Return,2121.02
12492,713929533,02-12-24 16:28,126.33,Deposit,Cash Deposit,2247.35
12493,713929533,2-13-24 22:28,246.82,Return,eBay Return,2494.17
12494,713929533,2-14-24 21:28,1000,Payment,Rent Payment,1494.17
12495,713929533,2-25-24 17:28,199.94,Deposit,Direct Deposit,1694.11
12496,713929533,03-01-24 21:28,2350,IncomingTransfer,Salary,4044.11
12497,713929533,03-05-24 23:28,85.56,OutgoingTransfer,Wire Transfer,3958.55
12498,713929533,03-06-24 15:28,108.19,Withdrawal,ATM Withdrawal,3850.36
12499,713929533,03-08-24 17:28,194.54,Payment,Mortgage Payment,3655.82
12500,713929533,03-09-24 20:28,87.19,Payment,Mortgage Payment,3568.63
12501,713929533,3-13-24 10:28,239.55,IncomingTransfer,Freelance Payment,3808.18
12502,713929533,3-13-24 10:28,69.48,IncomingTransfer,Freelance Payment,3877.66
12503,713929533,3-15-24 21:28,54.82,Purchase,Travel,3822.84
12504,713929533,3-16-24 10:28,109.62,Return,Walmart Return,3932.46
12505,713929533,3-16-24 10:28,154.73,Purchase,Pharmacy,3777.73
12506,713929533,3-16-24 21:28,1400,Payment,Rent Payment,2377.73
12507,713929533,3-26-24 9:28,212.53,Deposit,Cash Deposit,2590.26
12508,713929533,04-01-24 21:28,2350,IncomingTransfer,Salary,4940.26
12509,713929533,04-05-24 16:28,107.89,Purchase,Pharmacy,4832.37
12510,713929533,04-07-24 21:28,72.37,Purchase,Home Improvement,4760
12511,713929533,04-07-24 22:28,20.05,Withdrawal,ATM Withdrawal,4739.95
12512,713929533,04-10-24 21:28,58.9,Purchase,Travel,4681.05
12513,713929533,04-11-24 21:28,1300,Payment,Rent Payment,3381.05
12514,713929533,04-12-24 11:28,160.85,OutgoingTransfer,Peer-to-Peer Transfer,3220.2
12515,713929533,04-12-24 23:28,87.1,Purchase,Clothing,3133.1
12516,713929533,4-13-24 10:28,183.67,Withdrawal,Branch Withdrawal,2949.43
12517,713929533,4-17-24 10:28,179.92,Return,Walmart Return,3129.35
12518,713929533,4-23-24 10:28,122.12,Return,Best Buy Return,3251.47
12519,713929533,4-24-24 12:28,166.41,Purchase,Pharmacy,3085.06
12520,713929533,05-04-24 21:28,2350,IncomingTransfer,Salary,5435.06
12521,713929533,05-06-24 12:28,139.34,Purchase,Home Improvement,5295.72
12522,713929533,05-06-24 13:28,115.05,Purchase,Grocery,5180.67
12523,713929533,05-10-24 20:28,232.56,Deposit,Cash Deposit,5413.23
12524,713929533,5-13-24 23:28,166,OutgoingTransfer,Bank Transfer,5247.23
12525,713929533,5-16-24 16:28,47.54,OnlineShopping,AliExpress,5199.69
12526,713929533,5-18-24 21:28,1400,Payment,Rent Payment,3799.69
12527,713929533,5-20-24 19:28,85.63,Payment,Loan Payment,3714.06
12528,713929533,5-21-24 13:28,221.61,Return,Amazon Return,3935.67
12529,713929533,5-25-24 22:28,129.89,Withdrawal,Mobile App Withdrawal,3805.78
12530,713929533,06-01-24 21:28,2350,IncomingTransfer,Salary,6155.78
12531,713929533,06-04-24 20:28,92.96,Withdrawal,ATM Withdrawal,6062.82
12532,713929533,06-05-24 12:28,29.51,OnlineShopping,Amazon,6033.31
12533,713929533,6-17-24 9:28,88.27,Payment,Loan Payment,5945.04
12534,713929533,6-18-24 21:28,1000,Payment,Rent Payment,4945.04
12535,713929533,6-22-24 18:28,166.72,Purchase,Entertainment,4778.32
12536,713929533,6-22-24 19:28,177.72,Deposit,Direct Deposit,4956.04
12537,713929533,6-25-24 22:28,245.91,Payment,Loan Payment,4710.13
12538,713929533,6-28-24 18:28,116.9,Deposit,Direct Deposit,4827.03
12539,713929533,07-03-24 10:28,229.23,Purchase,Travel,4597.8
12540,713929533,07-03-24 21:28,2350,IncomingTransfer,Salary,6947.8
12541,713929533,07-09-24 9:28,40.24,OnlineShopping,eBay,6907.56
12542,713929533,7-14-24 21:28,1200,Payment,Rent Payment,5707.56
12543,713929533,7-15-24 21:28,177.55,Purchase,Gas,5530.01
12544,713929533,7-17-24 22:28,79.72,Purchase,Clothing,5450.29
12545,714002658,02-03-24 21:28,15650,IncomingTransfer,Salary,16792.82545
12546,714002658,02-08-24 21:28,2000,Payment,Credit Card Payment,14792.82545
12547,714002658,02-11-24 15:28,590.17,IncomingTransfer,Freelance Payment,15382.99545
12548,714002658,02-12-24 12:28,928.89,Withdrawal,Branch Withdrawal,14454.10545
12549,714002658,2-14-24 21:28,7200,Payment,Rent Payment,7254.105452
12550,714002658,2-26-24 11:28,302.93,Deposit,Check Deposit,7557.035452
12551,714002658,03-02-24 21:28,15650,IncomingTransfer,Salary,23207.03545
12552,714002658,03-07-24 21:28,2400,Payment,Credit Card Payment,20807.03545
12553,714002658,3-14-24 16:28,939.67,Payment,Mortgage Payment,19867.36545
12554,714002658,3-14-24 21:28,6200,Payment,Rent Payment,13667.36545
12555,714002658,3-27-24 22:28,934.75,Return,Store Return,14602.11545
12556,714002658,3-28-24 10:28,408.23,Deposit,Cash Deposit,15010.34545
12557,714002658,3-28-24 21:28,494.22,OnlineShopping,Etsy,14516.12545
12558,714002658,04-02-24 20:28,743.6,IncomingTransfer,Freelance Payment,15259.72545
12559,714002658,04-03-24 13:28,276.52,Withdrawal,Mobile App Withdrawal,14983.20545
12560,714002658,04-05-24 20:28,314.23,Purchase,Entertainment,14668.97545
12561,714002658,04-05-24 21:28,15650,IncomingTransfer,Salary,30318.97545
12562,714002658,04-09-24 18:28,875.17,Withdrawal,Branch Withdrawal,29443.80545
12563,714002658,04-10-24 21:28,2300,Payment,Credit Card Payment,27143.80545
12564,714002658,4-14-24 21:28,8000,Payment,Rent Payment,19143.80545
12565,714002658,4-14-24 22:28,384.01,Deposit,Check Deposit,19527.81545
12566,714002658,4-20-24 11:28,354.3,Deposit,Cash Deposit,19882.11545
12567,714002658,4-20-24 12:28,276.31,Return,Best Buy Return,20158.42545
12568,714002658,4-21-24 14:28,847.9,Payment,Bill Payment,19310.52545
12569,714002658,05-02-24 21:28,15650,IncomingTransfer,Salary,34960.52545
12570,714002658,05-05-24 20:28,801.02,Deposit,Cash Deposit,35761.54545
12571,714002658,05-05-24 20:28,329.73,Purchase,Electronics,35431.81545
12572,714002658,05-07-24 21:28,1700,Payment,Credit Card Payment,33731.81545
12573,714002658,5-15-24 13:28,745.9,Purchase,Pharmacy,32985.91545
12574,714002658,5-17-24 21:28,4900,Payment,Rent Payment,28085.91545
12575,714002658,5-18-24 18:28,795.92,Return,Store Return,28881.83545
12576,714002658,5-20-24 20:28,651.75,Withdrawal,ATM Withdrawal,28230.08545
12577,714002658,5-27-24 16:28,417.52,Deposit,Check Deposit,28647.60545
12578,714002658,5-28-24 11:28,223.07,Payment,Loan Payment,28424.53545
12579,714002658,06-05-24 15:28,428.05,Purchase,Home Improvement,27996.48545
12580,714002658,06-05-24 18:28,416.39,Return,Best Buy Return,28412.87545
12581,714002658,06-05-24 21:28,15650,IncomingTransfer,Salary,44062.87545
12582,714002658,06-10-24 21:28,2300,Payment,Credit Card Payment,41762.87545
12583,714002658,06-10-24 21:28,7600,Payment,Rent Payment,34162.87545
12584,714002658,6-20-24 11:28,364.85,Withdrawal,ATM Withdrawal,33798.02545
12585,714002658,6-20-24 15:28,859.14,Withdrawal,ATM Withdrawal,32938.88545
12586,714002658,6-25-24 10:28,731.16,OutgoingTransfer,Wire Transfer,32207.72545
12587,714002658,6-26-24 15:28,570.75,Purchase,Grocery,31636.97545
12588,714002658,6-29-24 20:28,858.17,OutgoingTransfer,Peer-to-Peer Transfer,30778.80545
12589,714002658,6-30-24 18:28,445.35,Return,Store Return,31224.15545
12590,714002658,07-01-24 11:28,584.08,OnlineShopping,eBay,30640.07545
12591,714002658,07-04-24 21:28,15650,IncomingTransfer,Salary,46290.07545
12592,714002658,07-09-24 21:28,1800,Payment,Credit Card Payment,44490.07545
12593,714002658,7-18-24 21:28,6100,Payment,Rent Payment,38390.07545
12594,714077583,1-20-24 21:28,73.12,OutgoingTransfer,Peer-to-Peer Transfer,362.6561907
12595,714077583,1-22-24 19:28,22.46,Payment,Loan Payment,340.1961907
12596,714077583,1-23-24 16:28,314.37,Payment,Loan Payment,25.82619075
12597,714077583,1-23-24 22:28,156.55,IncomingTransfer,Freelance Payment,182.3761907
12598,714077583,1-26-24 23:28,301.33,Payment,Loan Payment,-118.9538093
12599,714077583,1-27-24 20:28,282.73,OnlineShopping,Best Buy,-401.6838093
12600,714077583,1-30-24 14:28,306.74,Deposit,Check Deposit,-94.94380925
12601,714077583,1-31-24 15:28,23.89,Withdrawal,Branch Withdrawal,-118.8338093
12602,714077583,1-31-24 23:28,37.41,IncomingTransfer,Freelance Payment,-81.42380925
12603,714077583,02-01-24 22:28,198.71,Return,Etsy Return,117.2861907
12604,714077583,02-03-24 21:28,3650,IncomingTransfer,Salary,3767.286191
12605,714077583,02-05-24 16:28,42.68,Purchase,Gas,3724.606191
12606,714077583,02-05-24 21:28,183.4,Payment,Mortgage Payment,3541.206191
12607,714077583,02-08-24 21:28,700,Payment,Credit Card Payment,2841.206191
12608,714077583,02-09-24 12:28,288.25,Purchase,Furniture,2552.956191
12609,714077583,02-11-24 17:28,317.87,Return,Etsy Return,2870.826191
12610,714077583,2-13-24 21:28,1700,Payment,Rent Payment,1170.826191
12611,714077583,2-15-24 15:28,269.01,Withdrawal,Mobile App Withdrawal,901.8161907
12612,714077583,2-15-24 18:28,333.42,Purchase,Home Improvement,568.3961907
12613,714077583,2-19-24 20:28,342.05,Purchase,Entertainment,226.3461907
12614,714077583,2-19-24 21:28,362.93,Purchase,Pharmacy,-136.5838093
12615,714077583,2-20-24 13:28,131.29,Deposit,Mobile Deposit,-5.293809252
12616,714077583,2-21-24 15:28,281.43,Withdrawal,Branch Withdrawal,-286.7238093
12617,714077583,2-26-24 19:28,52.31,IncomingTransfer,Freelance Payment,-234.4138093
12618,714077583,2-27-24 21:28,63.32,Deposit,Mobile Deposit,-171.0938093
12619,714077583,03-02-24 13:28,183.34,Return,Etsy Return,12.24619075
12620,714077583,03-02-24 13:28,48.76,Deposit,Cash Deposit,61.00619075
12621,714077583,03-03-24 21:28,3650,IncomingTransfer,Salary,3711.006191
12622,714077583,03-08-24 21:28,800,Payment,Credit Card Payment,2911.006191
12623,714077583,03-12-24 21:28,1700,Payment,Rent Payment,1211.006191
12624,714077583,3-14-24 10:28,324.28,Deposit,Check Deposit,1535.286191
12625,714077583,3-18-24 9:28,165.12,OutgoingTransfer,Bank Transfer,1370.166191
12626,714077583,3-20-24 22:28,189.68,Return,Walmart Return,1559.846191
12627,714077583,3-21-24 13:28,59.76,Payment,Loan Payment,1500.086191
12628,714077583,3-25-24 19:28,141.78,Deposit,Check Deposit,1641.866191
12629,714077583,3-28-24 12:28,290.05,Return,AliExpress Return,1931.916191
12630,714077583,3-29-24 22:28,100.14,Return,Store Return,2032.056191
12631,714077583,3-31-24 22:28,243.47,Withdrawal,Mobile App Withdrawal,1788.586191
12632,714077583,04-01-24 19:28,30.63,Purchase,Grocery,1757.956191
12633,714077583,04-01-24 21:28,295.21,IncomingTransfer,Freelance Payment,2053.166191
12634,714077583,04-03-24 12:28,306.3,Deposit,Cash Deposit,2359.466191
12635,714077583,04-05-24 21:28,3650,IncomingTransfer,Salary,6009.466191
12636,714077583,04-09-24 13:28,393.05,Return,Store Return,6402.516191
12637,714077583,04-10-24 11:28,132.42,IncomingTransfer,Freelance Payment,6534.936191
12638,714077583,04-10-24 19:28,204.18,Deposit,Check Deposit,6739.116191
12639,714077583,04-10-24 21:28,600,Payment,Credit Card Payment,6139.116191
12640,714077583,4-14-24 20:28,327.21,OnlineShopping,Amazon,5811.906191
12641,714077583,4-17-24 21:28,2300,Payment,Rent Payment,3511.906191
12642,714077583,4-18-24 20:28,395.46,Purchase,Grocery,3116.446191
12643,714077583,4-19-24 13:28,260.01,OnlineShopping,eBay,2856.436191
12644,714077583,4-22-24 10:28,387.47,Withdrawal,ATM Withdrawal,2468.966191
12645,714077583,4-26-24 11:28,266.15,Purchase,Electronics,2202.816191
12646,714077583,05-04-24 15:28,154.46,Withdrawal,ATM Withdrawal,2048.356191
12647,714077583,05-04-24 20:28,311.52,Return,Etsy Return,2359.876191
12648,714077583,05-04-24 21:28,3650,IncomingTransfer,Salary,6009.876191
12649,714077583,05-05-24 13:28,179.79,OutgoingTransfer,International Transfer,5830.086191
12650,714077583,05-07-24 22:28,56.61,Deposit,Mobile Deposit,5886.696191
12651,714077583,05-08-24 21:28,28.87,Payment,Mortgage Payment,5857.826191
12652,714077583,05-08-24 22:28,199.19,Purchase,Furniture,5658.636191
12653,714077583,05-09-24 21:28,600,Payment,Credit Card Payment,5058.636191
12654,714077583,05-12-24 19:28,124.5,OutgoingTransfer,Wire Transfer,4934.136191
12655,714077583,05-12-24 21:28,1700,Payment,Rent Payment,3234.136191
12656,714077583,5-23-24 20:28,279.04,OnlineShopping,eBay,2955.096191
12657,714077583,5-24-24 9:28,20.4,IncomingTransfer,Freelance Payment,2975.496191
12658,714077583,5-30-24 23:28,238.03,Deposit,Cash Deposit,3213.526191
12659,714077583,06-03-24 12:28,277.36,Purchase,Pharmacy,2936.166191
12660,714077583,06-03-24 21:28,3650,IncomingTransfer,Salary,6586.166191
12661,714077583,06-08-24 21:28,700,Payment,Credit Card Payment,5886.166191
12662,714077583,06-10-24 21:28,1800,Payment,Rent Payment,4086.166191
12663,714077583,6-23-24 10:28,94.21,Purchase,Grocery,3991.956191
12664,714077583,6-23-24 13:28,327.48,Return,AliExpress Return,4319.436191
12665,714077583,6-24-24 13:28,132.12,Return,eBay Return,4451.556191
12666,714077583,6-26-24 19:28,134.44,Purchase,Travel,4317.116191
12667,714077583,07-02-24 11:28,358.08,Return,Best Buy Return,4675.196191
12668,714077583,07-04-24 18:28,262.04,Deposit,Direct Deposit,4937.236191
12669,714077583,07-05-24 21:28,3650,IncomingTransfer,Salary,8587.236191
12670,714077583,07-06-24 15:28,221.07,Withdrawal,ATM Withdrawal,8366.166191
12671,714077583,07-10-24 21:28,600,Payment,Credit Card Payment,7766.166191
12672,714077583,07-10-24 23:28,183.72,OnlineShopping,Target,7582.446191
12673,714077583,07-12-24 16:28,132.2,OnlineShopping,AliExpress,7450.246191
12674,714077583,07-12-24 19:28,67.06,Purchase,Travel,7383.186191
12675,714077583,7-14-24 20:28,176.41,Purchase,Restaurant,7206.776191
12676,714077583,7-16-24 21:28,2200,Payment,Rent Payment,5006.776191
12677,714120258,1-20-24 18:28,748.48,Purchase,Gas,447.5629106
12678,714120258,1-23-24 11:28,620.88,Purchase,Furniture,-173.3170894
12679,714120258,1-27-24 13:28,382.78,IncomingTransfer,Freelance Payment,209.4629106
12680,714120258,1-31-24 21:28,554.98,OnlineShopping,eBay,-345.5170894
12681,714120258,02-03-24 15:28,177.84,Deposit,Direct Deposit,-167.6770894
12682,714120258,02-05-24 21:28,7100,IncomingTransfer,Salary,6932.322911
12683,714120258,02-06-24 11:28,149.23,Deposit,Direct Deposit,7081.552911
12684,714120258,02-07-24 19:28,585.62,IncomingTransfer,Freelance Payment,7667.172911
12685,714120258,02-08-24 10:28,154.8,Deposit,Direct Deposit,7821.972911
12686,714120258,02-10-24 17:28,148.86,Payment,Bill Payment,7673.112911
12687,714120258,02-10-24 21:28,1700,Payment,Credit Card Payment,5973.112911
12688,714120258,2-15-24 18:28,708.68,Payment,Bill Payment,5264.432911
12689,714120258,2-17-24 21:28,2700,Payment,Subscription Payment,2564.432911
12690,714120258,2-19-24 19:28,549.45,Deposit,Cash Deposit,3113.882911
12691,714120258,2-21-24 15:28,504.87,Deposit,Cash Deposit,3618.752911
12692,714120258,03-02-24 19:28,620.92,Return,AliExpress Return,4239.672911
12693,714120258,03-04-24 12:28,199.78,Purchase,Entertainment,4039.892911
12694,714120258,03-04-24 21:28,7100,IncomingTransfer,Salary,11139.89291
12695,714120258,03-04-24 22:28,569.01,Deposit,Cash Deposit,11708.90291
12696,714120258,03-08-24 15:28,709.4,Purchase,Home Improvement,10999.50291
12697,714120258,03-09-24 21:28,2100,Payment,Credit Card Payment,8899.502911
12698,714120258,03-11-24 17:28,278.57,Return,Best Buy Return,9178.072911
12699,714120258,3-14-24 21:28,3100,Payment,Insurance Payment,6078.072911
12700,714120258,3-19-24 10:28,440.53,OutgoingTransfer,Peer-to-Peer Transfer,5637.542911
12701,714120258,3-22-24 22:28,215.26,Withdrawal,ATM Withdrawal,5422.282911
12702,714120258,3-22-24 23:28,596.32,Withdrawal,ATM Withdrawal,4825.962911
12703,714120258,3-24-24 11:28,713.68,OutgoingTransfer,International Transfer,4112.282911
12704,714120258,3-29-24 12:28,528.64,Withdrawal,ATM Withdrawal,3583.642911
12705,714120258,3-31-24 18:28,566.66,Return,Amazon Return,4150.302911
12706,714120258,04-04-24 17:28,133.62,Withdrawal,Branch Withdrawal,4016.682911
12707,714120258,04-05-24 21:28,7100,IncomingTransfer,Salary,11116.68291
12708,714120258,04-07-24 19:28,283.28,Deposit,Mobile Deposit,11399.96291
12709,714120258,04-10-24 21:28,2300,Payment,Credit Card Payment,9099.962911
12710,714120258,04-10-24 21:28,2500,Payment,Installment Payment,6599.962911
12711,714120258,4-13-24 20:28,610.35,Purchase,Entertainment,5989.612911
12712,714120258,4-14-24 13:28,173.86,Withdrawal,Mobile App Withdrawal,5815.752911
12713,714120258,4-16-24 22:28,254.51,Deposit,Mobile Deposit,6070.262911
12714,714120258,4-18-24 10:28,648.81,OutgoingTransfer,Bank Transfer,5421.452911
12715,714120258,4-22-24 16:28,666.01,OutgoingTransfer,Wire Transfer,4755.442911
12716,714120258,4-24-24 15:28,246.98,Deposit,Check Deposit,5002.422911
12717,714120258,4-26-24 10:28,387.26,OutgoingTransfer,International Transfer,4615.162911
12718,714120258,4-27-24 20:28,720.12,Purchase,Entertainment,3895.042911
12719,714120258,4-28-24 17:28,231.81,Purchase,Travel,3663.232911
12720,714120258,05-03-24 16:28,732.75,Withdrawal,ATM Withdrawal,2930.482911
12721,714120258,05-03-24 21:28,7100,IncomingTransfer,Salary,10030.48291
12722,714120258,05-04-24 15:28,261.53,Withdrawal,Branch Withdrawal,9768.952911
12723,714120258,05-05-24 17:28,560.85,Deposit,Mobile Deposit,10329.80291
12724,714120258,05-08-24 21:28,2500,Payment,Credit Card Payment,7829.802911
12725,714120258,05-09-24 12:28,242.06,Deposit,Check Deposit,8071.862911
12726,714120258,05-12-24 22:28,265.09,Return,Store Return,8336.952911
12727,714120258,5-15-24 10:28,748.04,OnlineShopping,AliExpress,7588.912911
12728,714120258,5-18-24 21:28,2700,Payment,Installment Payment,4888.912911
12729,714120258,5-25-24 12:28,423.63,Purchase,Grocery,4465.282911
12730,714120258,5-30-24 21:28,262.7,OutgoingTransfer,Peer-to-Peer Transfer,4202.582911
12731,714120258,06-02-24 12:28,176.02,Withdrawal,Branch Withdrawal,4026.562911
12732,714120258,06-05-24 21:28,7100,IncomingTransfer,Salary,11126.56291
12733,714120258,06-08-24 19:28,285.51,OutgoingTransfer,Peer-to-Peer Transfer,10841.05291
12734,714120258,06-09-24 12:28,308.97,Deposit,Check Deposit,11150.02291
12735,714120258,06-09-24 18:28,620.1,Withdrawal,Branch Withdrawal,10529.92291
12736,714120258,06-10-24 21:28,2500,Payment,Credit Card Payment,8029.922911
12737,714120258,06-10-24 21:28,2900,Payment,Installment Payment,5129.922911
12738,714120258,6-15-24 21:28,438.15,OutgoingTransfer,Peer-to-Peer Transfer,4691.772911
12739,714120258,6-16-24 16:28,586.56,Withdrawal,Mobile App Withdrawal,4105.212911
12740,714120258,6-18-24 12:28,200.31,OnlineShopping,Walmart,3904.902911
12741,714120258,6-19-24 10:28,393.92,IncomingTransfer,Freelance Payment,4298.822911
12742,714120258,6-25-24 9:28,117.26,OutgoingTransfer,Wire Transfer,4181.562911
12743,714120258,07-02-24 16:28,611.67,Deposit,Direct Deposit,4793.232911
12744,714120258,07-02-24 21:28,7100,IncomingTransfer,Salary,11893.23291
12745,714120258,07-07-24 21:28,2200,Payment,Credit Card Payment,9693.232911
12746,714120258,07-09-24 21:28,550.32,Return,Amazon Return,10243.55291
12747,714120258,07-10-24 21:28,732.21,Payment,Bill Payment,9511.342911
12748,714120258,07-10-24 22:28,118.91,Deposit,Check Deposit,9630.252911
12749,714120258,07-11-24 12:28,515.15,Purchase,Clothing,9115.102911
12750,714120258,7-14-24 13:28,595.2,Payment,Mortgage Payment,8519.902911
12751,714120258,7-15-24 21:28,2800,Payment,Installment Payment,5719.902911
12752,714120258,7-17-24 11:28,295.7,Withdrawal,Branch Withdrawal,5424.202911
12753,714139308,1-22-24 17:28,472.48,Purchase,Clothing,-472.48
12754,714139308,1-24-24 9:28,174.53,Withdrawal,ATM Withdrawal,-647.01
12755,714139308,1-26-24 13:28,385.15,Deposit,Cash Deposit,-261.86
12756,714139308,1-27-24 16:28,367.88,Deposit,Mobile Deposit,106.02
12757,714139308,1-27-24 21:28,296.34,Purchase,Travel,-190.32
12758,714139308,1-29-24 10:28,297.87,Purchase,Clothing,-488.19
12759,714139308,1-29-24 22:28,539.5,Withdrawal,ATM Withdrawal,-1027.69
12760,714139308,02-01-24 20:28,479.43,Deposit,Check Deposit,-548.26
12761,714139308,02-01-24 23:28,531.77,Return,Etsy Return,-16.49
12762,714139308,02-04-24 21:28,6150,IncomingTransfer,Salary,6133.51
12763,714139308,02-06-24 10:28,175.83,Return,Target Return,6309.34
12764,714139308,02-12-24 9:28,297.09,OutgoingTransfer,Peer-to-Peer Transfer,6012.25
12765,714139308,2-15-24 20:28,258.47,Withdrawal,Branch Withdrawal,5753.78
12766,714139308,2-17-24 21:28,3500,Payment,Rent Payment,2253.78
12767,714139308,2-17-24 21:28,517.26,Withdrawal,Branch Withdrawal,1736.52
12768,714139308,2-19-24 16:28,275.4,Deposit,Mobile Deposit,2011.92
12769,714139308,2-26-24 12:28,458.57,Payment,Mortgage Payment,1553.35
12770,714139308,2-29-24 22:28,412.38,Deposit,Mobile Deposit,1965.73
12771,714139308,03-01-24 19:28,456.62,IncomingTransfer,Freelance Payment,2422.35
12772,714139308,03-02-24 20:28,356.73,OnlineShopping,Target,2065.62
12773,714139308,03-02-24 21:28,6150,IncomingTransfer,Salary,8215.62
12774,714139308,03-04-24 13:28,486.59,Return,Best Buy Return,8702.21
12775,714139308,03-09-24 10:28,339.28,Withdrawal,Mobile App Withdrawal,8362.93
12776,714139308,3-15-24 12:28,434.24,Payment,Mortgage Payment,7928.69
12777,714139308,3-16-24 19:28,98.34,Deposit,Mobile Deposit,8027.03
12778,714139308,3-18-24 19:28,174.12,Return,Amazon Return,8201.15
12779,714139308,3-18-24 21:28,3400,Payment,Rent Payment,4801.15
12780,714139308,3-20-24 14:28,276.4,Payment,Bill Payment,4524.75
12781,714139308,3-20-24 23:28,277.47,Deposit,Check Deposit,4802.22
12782,714139308,3-21-24 22:28,186.67,Return,Store Return,4988.89
12783,714139308,3-26-24 15:28,398.86,Deposit,Mobile Deposit,5387.75
12784,714139308,3-28-24 15:28,68.48,Deposit,Mobile Deposit,5456.23
12785,714139308,3-29-24 14:28,162.26,IncomingTransfer,Freelance Payment,5618.49
12786,714139308,04-01-24 22:28,106.61,Return,Store Return,5725.1
12787,714139308,04-02-24 9:28,427.54,OnlineShopping,AliExpress,5297.56
12788,714139308,04-03-24 18:28,270.89,Purchase,Gas,5026.67
12789,714139308,04-04-24 21:28,6150,IncomingTransfer,Salary,11176.67
12790,714139308,04-05-24 12:28,388.5,Deposit,Cash Deposit,11565.17
12791,714139308,04-05-24 21:28,418.73,Withdrawal,Mobile App Withdrawal,11146.44
12792,714139308,04-06-24 19:28,145.37,Payment,Bill Payment,11001.07
12793,714139308,04-08-24 20:28,386.47,Purchase,Restaurant,10614.6
12794,714139308,04-09-24 21:28,282.88,Deposit,Cash Deposit,10897.48
12795,714139308,04-09-24 23:28,81.72,OutgoingTransfer,Bank Transfer,10815.76
12796,714139308,04-10-24 14:28,432.98,Deposit,Mobile Deposit,11248.74
12797,714139308,4-14-24 21:28,1700,Payment,Rent Payment,9548.74
12798,714139308,4-16-24 20:28,428.55,OnlineShopping,Walmart,9120.19
12799,714139308,4-18-24 13:28,416.88,Payment,Mortgage Payment,8703.31
12800,714139308,4-18-24 21:28,52.93,IncomingTransfer,Freelance Payment,8756.24
12801,714139308,4-22-24 19:28,522.01,Payment,Mortgage Payment,8234.23
12802,714139308,4-24-24 10:28,273.78,Withdrawal,Mobile App Withdrawal,7960.45
12803,714139308,4-24-24 14:28,406.02,Purchase,Furniture,7554.43
12804,714139308,4-29-24 19:28,270.87,IncomingTransfer,Freelance Payment,7825.3
12805,714139308,05-01-24 19:28,182.84,Deposit,Cash Deposit,8008.14
12806,714139308,05-01-24 21:28,6150,IncomingTransfer,Salary,14158.14
12807,714139308,05-02-24 23:28,481.6,Deposit,Mobile Deposit,14639.74
12808,714139308,05-03-24 21:28,338.89,Withdrawal,ATM Withdrawal,14300.85
12809,714139308,05-06-24 23:28,424.37,OutgoingTransfer,Bank Transfer,13876.48
12810,714139308,05-07-24 9:28,489.56,Deposit,Mobile Deposit,14366.04
12811,714139308,05-10-24 16:28,163.74,Purchase,Grocery,14202.3
12812,714139308,05-11-24 17:28,477.06,Purchase,Gas,13725.24
12813,714139308,5-14-24 11:28,271.23,OnlineShopping,Target,13454.01
12814,714139308,5-15-24 10:28,170.39,Purchase,Gas,13283.62
12815,714139308,5-16-24 21:28,1600,Payment,Rent Payment,11683.62
12816,714139308,5-16-24 23:28,118.81,IncomingTransfer,Freelance Payment,11802.43
12817,714139308,5-17-24 16:28,492.7,Return,Etsy Return,12295.13
12818,714139308,5-18-24 21:28,334.97,Deposit,Mobile Deposit,12630.1
12819,714139308,5-20-24 19:28,235.55,Return,Etsy Return,12865.65
12820,714139308,5-24-24 19:28,413.09,Purchase,Electronics,12452.56
12821,714139308,5-25-24 17:28,412.93,Purchase,Travel,12039.63
12822,714139308,5-25-24 21:28,327.69,OnlineShopping,eBay,11711.94
12823,714139308,5-27-24 14:28,324.7,Withdrawal,Branch Withdrawal,11387.24
12824,714139308,5-28-24 12:28,369.43,Deposit,Direct Deposit,11756.67
12825,714139308,06-01-24 20:28,347.46,OutgoingTransfer,Wire Transfer,11409.21
12826,714139308,06-02-24 17:28,320.79,Purchase,Pharmacy,11088.42
12827,714139308,06-02-24 21:28,6150,IncomingTransfer,Salary,17238.42
12828,714139308,06-04-24 20:28,259.77,Purchase,Entertainment,16978.65
12829,714139308,06-08-24 12:28,71.31,OutgoingTransfer,Bank Transfer,16907.34
12830,714139308,06-10-24 12:28,200.78,Withdrawal,Branch Withdrawal,16706.56
12831,714139308,06-11-24 21:28,2900,Payment,Rent Payment,13806.56
12832,714139308,6-17-24 11:28,487.95,OutgoingTransfer,International Transfer,13318.61
12833,714139308,6-18-24 16:28,515,Deposit,Mobile Deposit,13833.61
12834,714139308,6-22-24 11:28,122.85,Return,Etsy Return,13956.46
12835,714139308,6-23-24 16:28,314.67,Purchase,Gas,13641.79
12836,714139308,6-24-24 11:28,513.28,OnlineShopping,Best Buy,13128.51
12837,714139308,6-27-24 17:28,296.68,Payment,Bill Payment,12831.83
12838,714139308,07-02-24 17:28,300.82,Purchase,Entertainment,12531.01
12839,714139308,07-03-24 21:28,6150,IncomingTransfer,Salary,18681.01
12840,714139308,07-05-24 23:28,216.16,Withdrawal,Branch Withdrawal,18464.85
12841,714139308,07-07-24 10:28,112.05,IncomingTransfer,Freelance Payment,18576.9
12842,714139308,07-07-24 11:28,379.72,Purchase,Pharmacy,18197.18
12843,714139308,7-14-24 10:28,370.33,Withdrawal,Mobile App Withdrawal,17826.85
12844,714139308,7-16-24 21:28,2800,Payment,Rent Payment,15026.85
12845,714139308,7-17-24 11:28,290.3,Withdrawal,Branch Withdrawal,14736.55
12846,714171108,1-21-24 16:28,26.24,Purchase,Clothing,601.1783281
12847,714171108,1-26-24 19:28,328.58,OutgoingTransfer,Peer-to-Peer Transfer,272.5983281
12848,714171108,02-05-24 21:28,3650,IncomingTransfer,Salary,3922.598328
12849,714171108,02-08-24 9:28,229.28,Withdrawal,Mobile App Withdrawal,3693.318328
12850,714171108,02-10-24 21:28,1300,Payment,Credit Card Payment,2393.318328
12851,714171108,02-10-24 21:28,1400,Payment,Insurance Payment,993.3183281
12852,714171108,02-12-24 13:28,169.86,Return,Amazon Return,1163.178328
12853,714171108,2-15-24 12:28,263.62,Return,AliExpress Return,1426.798328
12854,714171108,03-05-24 21:28,3650,IncomingTransfer,Salary,5076.798328
12855,714171108,03-10-24 21:28,1500,Payment,Credit Card Payment,3576.798328
12856,714171108,03-11-24 21:28,1300,Payment,Subscription Payment,2276.798328
12857,714171108,3-13-24 19:28,226.1,Payment,Loan Payment,2050.698328
12858,714171108,3-21-24 15:28,175.7,Return,Store Return,2226.398328
12859,714171108,3-23-24 22:28,284.15,Purchase,Clothing,1942.248328
12860,714171108,3-25-24 18:28,193.36,Purchase,Restaurant,1748.888328
12861,714171108,04-04-24 21:28,3650,IncomingTransfer,Salary,5398.888328
12862,714171108,04-06-24 20:28,334.43,OutgoingTransfer,International Transfer,5064.458328
12863,714171108,04-09-24 21:28,1500,Payment,Credit Card Payment,3564.458328
12864,714171108,4-16-24 9:28,324.77,Return,Etsy Return,3889.228328
12865,714171108,4-17-24 21:28,1000,Payment,Insurance Payment,2889.228328
12866,714171108,4-24-24 14:28,57.36,OutgoingTransfer,Wire Transfer,2831.868328
12867,714171108,4-30-24 11:28,233.77,Deposit,Direct Deposit,3065.638328
12868,714171108,05-01-24 13:28,34.08,Purchase,Clothing,3031.558328
12869,714171108,05-03-24 21:28,3650,IncomingTransfer,Salary,6681.558328
12870,714171108,05-08-24 21:28,1500,Payment,Credit Card Payment,5181.558328
12871,714171108,05-12-24 21:28,1500,Payment,Subscription Payment,3681.558328
12872,714171108,5-17-24 20:28,287.99,Payment,Bill Payment,3393.568328
12873,714171108,5-21-24 11:28,186.52,Purchase,Electronics,3207.048328
12874,714171108,06-05-24 21:28,3650,IncomingTransfer,Salary,6857.048328
12875,714171108,06-10-24 21:28,1400,Payment,Credit Card Payment,5457.048328
12876,714171108,6-15-24 21:28,1100,Payment,Insurance Payment,4357.048328
12877,714171108,6-26-24 14:28,241.13,Return,Store Return,4598.178328
12878,714171108,6-28-24 15:28,166.17,IncomingTransfer,Freelance Payment,4764.348328
12879,714171108,07-02-24 21:28,3650,IncomingTransfer,Salary,8414.348328
12880,714171108,07-05-24 12:28,210.22,IncomingTransfer,Freelance Payment,8624.568328
12881,714171108,07-07-24 21:28,1600,Payment,Credit Card Payment,7024.568328
12882,714171108,07-12-24 21:28,1500,Payment,Subscription Payment,5524.568328
12883,714171108,7-13-24 12:28,115.26,Payment,Loan Payment,5409.308328
12884,714230808,1-24-24 10:28,22.66,Deposit,Cash Deposit,1118.633516
12885,714230808,1-26-24 22:28,240.58,Payment,Bill Payment,878.0535161
12886,714230808,02-02-24 23:28,91.93,Purchase,Grocery,786.1235161
12887,714230808,02-03-24 16:28,120.83,Deposit,Cash Deposit,906.9535161
12888,714230808,02-04-24 12:28,205.27,Payment,Loan Payment,701.6835161
12889,714230808,02-04-24 20:28,124.68,Deposit,Cash Deposit,826.3635161
12890,714230808,02-05-24 21:28,2750,IncomingTransfer,Salary,3576.363516
12891,714230808,02-07-24 11:28,159.66,Withdrawal,ATM Withdrawal,3416.703516
12892,714230808,02-10-24 14:28,58.79,Deposit,Direct Deposit,3475.493516
12893,714230808,02-10-24 17:28,195.96,Deposit,Cash Deposit,3671.453516
12894,714230808,02-10-24 21:28,2200,Payment,Credit Card Payment,1471.453516
12895,714230808,02-11-24 21:28,800,Payment,Rent Payment,671.4535161
12896,714230808,2-15-24 19:28,132.55,Withdrawal,Mobile App Withdrawal,538.9035161
12897,714230808,2-17-24 16:28,127.42,Purchase,Restaurant,411.4835161
12898,714230808,2-25-24 18:28,17.89,IncomingTransfer,Freelance Payment,429.3735161
12899,714230808,2-27-24 22:28,63.46,Purchase,Clothing,365.9135161
12900,714230808,2-28-24 19:28,46.74,OnlineShopping,Best Buy,319.1735161
12901,714230808,2-29-24 16:28,87.08,Purchase,Restaurant,232.0935161
12902,714230808,03-03-24 21:28,54.17,OutgoingTransfer,Peer-to-Peer Transfer,177.9235161
12903,714230808,03-04-24 21:28,2750,IncomingTransfer,Salary,2927.923516
12904,714230808,03-08-24 20:28,65.69,Purchase,Clothing,2862.233516
12905,714230808,03-09-24 21:28,2600,Payment,Credit Card Payment,262.2335161
12906,714230808,3-13-24 12:28,200.95,Withdrawal,ATM Withdrawal,61.28351607
12907,714230808,3-13-24 18:28,194.81,Deposit,Cash Deposit,256.0935161
12908,714230808,3-13-24 22:28,21.36,OutgoingTransfer,International Transfer,234.7335161
12909,714230808,3-15-24 14:28,244.22,Deposit,Mobile Deposit,478.9535161
12910,714230808,3-16-24 14:28,66.62,OnlineShopping,eBay,412.3335161
12911,714230808,3-17-24 21:28,1400,Payment,Rent Payment,-987.6664839
12912,714230808,3-23-24 10:28,240.72,OnlineShopping,Target,-1228.386484
12913,714230808,3-23-24 20:28,39.72,Return,Store Return,-1188.666484
12914,714230808,3-24-24 17:28,100.18,Withdrawal,Branch Withdrawal,-1288.846484
12915,714230808,3-28-24 10:28,18,Withdrawal,ATM Withdrawal,-1306.846484
12916,714230808,3-30-24 10:28,208.37,Deposit,Direct Deposit,-1098.476484
12917,714230808,3-31-24 22:28,224.68,Payment,Loan Payment,-1323.156484
12918,714230808,04-01-24 11:28,137.37,Purchase,Gas,-1460.526484
12919,714230808,04-01-24 12:28,139.29,Withdrawal,Branch Withdrawal,-1599.816484
12920,714230808,04-04-24 9:28,79.11,Return,eBay Return,-1520.706484
12921,714230808,04-04-24 21:28,2750,IncomingTransfer,Salary,1229.293516
12922,714230808,04-07-24 14:28,121.32,Purchase,Home Improvement,1107.973516
12923,714230808,04-08-24 15:28,73.89,Deposit,Direct Deposit,1181.863516
12924,714230808,04-08-24 18:28,128.19,Payment,Bill Payment,1053.673516
12925,714230808,04-09-24 21:28,1800,Payment,Credit Card Payment,-746.3264839
12926,714230808,04-11-24 21:28,1300,Payment,Rent Payment,-2046.326484
12927,714230808,4-16-24 11:28,169.35,Purchase,Pharmacy,-2215.676484
12928,714230808,4-18-24 22:28,228.06,Return,Amazon Return,-1987.616484
12929,714230808,4-19-24 9:28,244.39,Payment,Mortgage Payment,-2232.006484
12930,714230808,4-21-24 15:28,68.31,OutgoingTransfer,Wire Transfer,-2300.316484
12931,714230808,4-22-24 18:28,35.81,OnlineShopping,Amazon,-2336.126484
12932,714230808,4-22-24 21:28,151.87,Deposit,Check Deposit,-2184.256484
12933,714230808,4-25-24 14:28,46.77,OutgoingTransfer,Wire Transfer,-2231.026484
12934,714230808,4-29-24 21:28,141.2,Return,Etsy Return,-2089.826484
12935,714230808,4-30-24 23:28,157.3,Purchase,Furniture,-2247.126484
12936,714230808,05-01-24 21:28,2750,IncomingTransfer,Salary,502.8735161
12937,714230808,05-04-24 13:28,156.48,OnlineShopping,eBay,346.3935161
12938,714230808,05-04-24 15:28,35.44,OutgoingTransfer,Bank Transfer,310.9535161
12939,714230808,05-06-24 21:28,2600,Payment,Credit Card Payment,-2289.046484
12940,714230808,05-11-24 21:28,700,Payment,Rent Payment,-2989.046484
12941,714230808,5-15-24 16:28,198.97,Deposit,Check Deposit,-2790.076484
12942,714230808,5-16-24 20:28,156.3,Purchase,Home Improvement,-2946.376484
12943,714230808,5-19-24 17:28,181.24,Deposit,Cash Deposit,-2765.136484
12944,714230808,5-21-24 10:28,12.93,Deposit,Cash Deposit,-2752.206484
12945,714230808,5-21-24 11:28,155.97,Payment,Loan Payment,-2908.176484
12946,714230808,5-26-24 13:28,123.27,Withdrawal,ATM Withdrawal,-3031.446484
12947,714230808,5-30-24 11:28,166.27,Deposit,Cash Deposit,-2865.176484
12948,714230808,06-01-24 10:28,19.37,Withdrawal,ATM Withdrawal,-2884.546484
12949,714230808,06-01-24 19:28,248.66,Purchase,Clothing,-3133.206484
12950,714230808,06-01-24 22:28,86.38,Return,Store Return,-3046.826484
12951,714230808,06-02-24 21:28,2750,IncomingTransfer,Salary,-296.8264839
12952,714230808,06-02-24 21:28,181.46,OutgoingTransfer,Peer-to-Peer Transfer,-478.2864839
12953,714230808,06-04-24 9:28,249.23,OutgoingTransfer,Peer-to-Peer Transfer,-727.5164839
12954,714230808,06-06-24 9:28,151.13,Deposit,Cash Deposit,-576.3864839
12955,714230808,06-07-24 21:28,1800,Payment,Credit Card Payment,-2376.386484
12956,714230808,06-09-24 13:28,140.32,Withdrawal,ATM Withdrawal,-2516.706484
12957,714230808,06-10-24 17:28,182.41,Deposit,Cash Deposit,-2334.296484
12958,714230808,06-11-24 14:28,69.98,OutgoingTransfer,Wire Transfer,-2404.276484
12959,714230808,06-12-24 21:28,1600,Payment,Rent Payment,-4004.276484
12960,714230808,6-14-24 10:28,10.68,Payment,Mortgage Payment,-4014.956484
12961,714230808,6-14-24 22:28,36.16,Withdrawal,ATM Withdrawal,-4051.116484
12962,714230808,6-17-24 23:28,113.15,Deposit,Mobile Deposit,-3937.966484
12963,714230808,6-22-24 14:28,234.15,OnlineShopping,Etsy,-4172.116484
12964,714230808,6-26-24 21:28,98.11,Purchase,Home Improvement,-4270.226484
12965,714230808,6-29-24 14:28,130.95,Return,Target Return,-4139.276484
12966,714230808,6-30-24 13:28,176.93,Deposit,Mobile Deposit,-3962.346484
12967,714230808,07-02-24 17:28,159.9,Purchase,Pharmacy,-4122.246484
12968,714230808,07-02-24 21:28,2750,IncomingTransfer,Salary,-1372.246484
12969,714230808,07-04-24 20:28,113.92,Deposit,Direct Deposit,-1258.326484
12970,714230808,07-07-24 21:28,1900,Payment,Credit Card Payment,-3158.326484
12971,714230808,07-08-24 22:28,68.61,Deposit,Cash Deposit,-3089.716484
12972,714230808,07-09-24 22:28,76.93,Withdrawal,Branch Withdrawal,-3166.646484
12973,714230808,07-11-24 12:28,249.29,Deposit,Cash Deposit,-2917.356484
12974,714230808,07-12-24 11:28,213.08,Deposit,Direct Deposit,-2704.276484
12975,714230808,07-12-24 20:28,97.7,Purchase,Travel,-2801.976484
12976,714230808,7-14-24 14:28,145.72,Purchase,Furniture,-2947.696484
12977,714230808,7-16-24 21:28,1500,Payment,Rent Payment,-4447.696484
12978,714320358,1-28-24 16:28,159.31,Deposit,Cash Deposit,1303.954306
12979,714320358,1-30-24 9:28,68.27,Withdrawal,Branch Withdrawal,1235.684306
12980,714320358,1-31-24 15:28,64.36,Return,AliExpress Return,1300.044306
12981,714320358,02-01-24 15:28,28.35,OnlineShopping,Etsy,1271.694306
12982,714320358,02-01-24 21:28,2900,IncomingTransfer,Salary,4171.694306
12983,714320358,02-06-24 21:28,1800,Payment,Credit Card Payment,2371.694306
12984,714320358,02-12-24 21:28,1300,Payment,Rent Payment,1071.694306
12985,714320358,2-14-24 19:28,126.92,Withdrawal,Mobile App Withdrawal,944.7743064
12986,714320358,2-17-24 22:28,134.74,Deposit,Mobile Deposit,1079.514306
12987,714320358,2-18-24 20:28,149.78,Return,Walmart Return,1229.294306
12988,714320358,2-22-24 17:28,111.14,OutgoingTransfer,Bank Transfer,1118.154306
12989,714320358,2-28-24 15:28,37.07,Deposit,Cash Deposit,1155.224306
12990,714320358,03-01-24 21:28,2900,IncomingTransfer,Salary,4055.224306
12991,714320358,03-03-24 20:28,47.57,Purchase,Grocery,4007.654306
12992,714320358,03-05-24 19:28,211.56,Deposit,Direct Deposit,4219.214306
12993,714320358,03-06-24 21:28,1400,Payment,Credit Card Payment,2819.214306
12994,714320358,03-10-24 14:28,92.82,Purchase,Entertainment,2726.394306
12995,714320358,3-15-24 19:28,195.69,IncomingTransfer,Freelance Payment,2922.084306
12996,714320358,3-17-24 21:28,1900,Payment,Rent Payment,1022.084306
12997,714320358,3-18-24 21:28,81.22,IncomingTransfer,Freelance Payment,1103.304306
12998,714320358,3-19-24 10:28,197.15,OutgoingTransfer,International Transfer,906.1543064
12999,714320358,3-22-24 22:28,196.39,Purchase,Home Improvement,709.7643064
13000,714320358,3-28-24 9:28,30.3,Deposit,Mobile Deposit,740.0643064
13001,714320358,3-29-24 13:28,194.07,OutgoingTransfer,International Transfer,545.9943064
13002,714320358,3-30-24 13:28,91.17,Purchase,Restaurant,454.8243064
13003,714320358,04-01-24 16:28,64.12,Deposit,Direct Deposit,518.9443064
13004,714320358,04-02-24 21:28,2900,IncomingTransfer,Salary,3418.944306
13005,714320358,04-02-24 23:28,10.81,Return,Best Buy Return,3429.754306
13006,714320358,04-05-24 20:28,246.18,Withdrawal,Branch Withdrawal,3183.574306
13007,714320358,04-07-24 12:28,100.08,Deposit,Mobile Deposit,3283.654306
13008,714320358,04-07-24 21:28,1800,Payment,Credit Card Payment,1483.654306
13009,714320358,04-09-24 15:28,146.9,Withdrawal,Branch Withdrawal,1336.754306
13010,714320358,04-10-24 13:28,173.52,Deposit,Direct Deposit,1510.274306
13011,714320358,04-11-24 23:28,123.82,OnlineShopping,eBay,1386.454306
13012,714320358,4-14-24 15:28,121.32,OnlineShopping,Best Buy,1265.134306
13013,714320358,4-14-24 19:28,197.59,Deposit,Cash Deposit,1462.724306
13014,714320358,4-17-24 21:28,1000,Payment,Rent Payment,462.7243064
13015,714320358,4-19-24 16:28,131.36,Deposit,Mobile Deposit,594.0843064
13016,714320358,4-23-24 13:28,175.91,Purchase,Entertainment,418.1743064
13017,714320358,4-26-24 22:28,188.58,OutgoingTransfer,Bank Transfer,229.5943064
13018,714320358,4-28-24 14:28,241.93,OnlineShopping,Target,-12.33569364
13019,714320358,4-30-24 17:28,83.38,Withdrawal,ATM Withdrawal,-95.71569364
13020,714320358,05-01-24 15:28,44.43,Payment,Loan Payment,-140.1456936
13021,714320358,05-01-24 17:28,209.41,Withdrawal,Branch Withdrawal,-349.5556936
13022,714320358,05-02-24 21:28,2900,IncomingTransfer,Salary,2550.444306
13023,714320358,05-03-24 14:28,101.56,Payment,Bill Payment,2448.884306
13024,714320358,05-04-24 14:28,227.04,Payment,Loan Payment,2221.844306
13025,714320358,05-05-24 15:28,39.69,Deposit,Mobile Deposit,2261.534306
13026,714320358,05-05-24 17:28,120.44,Return,eBay Return,2381.974306
13027,714320358,05-07-24 21:28,1400,Payment,Credit Card Payment,981.9743064
13028,714320358,05-10-24 23:28,176.05,Withdrawal,ATM Withdrawal,805.9243064
13029,714320358,05-12-24 20:28,217.69,Return,Best Buy Return,1023.614306
13030,714320358,05-12-24 21:28,1200,Payment,Rent Payment,-176.3856936
13031,714320358,5-13-24 15:28,233.74,Deposit,Check Deposit,57.35430636
13032,714320358,5-15-24 17:28,49.79,Purchase,Restaurant,7.564306361
13033,714320358,5-17-24 13:28,106.04,Withdrawal,ATM Withdrawal,-98.47569364
13034,714320358,5-21-24 12:28,94.88,OnlineShopping,Etsy,-193.3556936
13035,714320358,5-29-24 17:28,152.88,Deposit,Mobile Deposit,-40.47569364
13036,714320358,06-03-24 12:28,248.75,OutgoingTransfer,Bank Transfer,-289.2256936
13037,714320358,06-04-24 21:28,2900,IncomingTransfer,Salary,2610.774306
13038,714320358,06-07-24 19:28,92.56,Purchase,Gas,2518.214306
13039,714320358,06-09-24 21:28,1600,Payment,Credit Card Payment,918.2143064
13040,714320358,06-10-24 21:28,109.51,Deposit,Direct Deposit,1027.724306
13041,714320358,6-16-24 17:28,225.46,Payment,Mortgage Payment,802.2643064
13042,714320358,6-16-24 21:28,900,Payment,Rent Payment,-97.73569364
13043,714320358,6-21-24 17:28,113.64,Purchase,Entertainment,-211.3756936
13044,714320358,6-22-24 10:28,237.3,Deposit,Check Deposit,25.92430636
13045,714320358,6-25-24 12:28,21.53,Withdrawal,Branch Withdrawal,4.394306361
13046,714320358,6-26-24 10:28,232.16,OutgoingTransfer,Wire Transfer,-227.7656936
13047,714320358,07-01-24 21:28,2900,IncomingTransfer,Salary,2672.234306
13048,714320358,07-06-24 21:28,1600,Payment,Credit Card Payment,1072.234306
13049,714320358,07-11-24 21:28,1300,Payment,Rent Payment,-227.7656936
13050,714320358,7-15-24 18:28,74.07,Payment,Mortgage Payment,-301.8356936
13051,714320358,7-17-24 14:28,90.57,OnlineShopping,Best Buy,-392.4056936
13052,714365883,1-20-24 10:28,46.72,Purchase,Restaurant,735.8820659
13053,714365883,1-21-24 19:28,166.18,Return,AliExpress Return,902.0620659
13054,714365883,1-21-24 20:28,75.55,OnlineShopping,eBay,826.5120659
13055,714365883,1-21-24 21:28,174.19,Payment,Mortgage Payment,652.3220659
13056,714365883,1-22-24 18:28,247.45,Purchase,Restaurant,404.8720659
13057,714365883,1-26-24 14:28,52.91,Purchase,Entertainment,351.9620659
13058,714365883,1-27-24 20:28,217.22,IncomingTransfer,Freelance Payment,569.1820659
13059,714365883,1-28-24 12:28,143.13,Deposit,Direct Deposit,712.3120659
13060,714365883,02-05-24 21:28,1800,IncomingTransfer,Salary,2512.312066
13061,714365883,02-10-24 21:28,1200,Payment,Credit Card Payment,1312.312066
13062,714365883,02-11-24 22:28,191.33,Deposit,Mobile Deposit,1503.642066
13063,714365883,2-14-24 18:28,101.79,OnlineShopping,AliExpress,1401.852066
13064,714365883,2-16-24 21:28,600,Payment,Installment Payment,801.8520659
13065,714365883,2-18-24 13:28,95.79,Deposit,Mobile Deposit,897.6420659
13066,714365883,2-18-24 17:28,162.15,Payment,Mortgage Payment,735.4920659
13067,714365883,2-21-24 12:28,21.04,Purchase,Clothing,714.4520659
13068,714365883,2-24-24 20:28,37.54,OutgoingTransfer,Peer-to-Peer Transfer,676.9120659
13069,714365883,2-24-24 21:28,76.52,Return,Walmart Return,753.4320659
13070,714365883,2-27-24 14:28,28.23,Purchase,Electronics,725.2020659
13071,714365883,2-29-24 17:28,232.64,Withdrawal,Mobile App Withdrawal,492.5620659
13072,714365883,03-05-24 21:28,1800,IncomingTransfer,Salary,2292.562066
13073,714365883,03-07-24 13:28,21.42,Withdrawal,ATM Withdrawal,2271.142066
13074,714365883,03-08-24 9:28,38.45,Return,Walmart Return,2309.592066
13075,714365883,03-08-24 22:28,231.33,Deposit,Mobile Deposit,2540.922066
13076,714365883,03-09-24 14:28,245.99,OutgoingTransfer,International Transfer,2294.932066
13077,714365883,03-10-24 21:28,1300,Payment,Credit Card Payment,994.9320659
13078,714365883,03-10-24 21:28,500,Payment,Insurance Payment,494.9320659
13079,714365883,3-15-24 21:28,149.57,Payment,Bill Payment,345.3620659
13080,714365883,3-18-24 11:28,89.94,Deposit,Cash Deposit,435.3020659
13081,714365883,3-19-24 19:28,235.12,Deposit,Mobile Deposit,670.4220659
13082,714365883,3-19-24 22:28,44.77,OutgoingTransfer,Bank Transfer,625.6520659
13083,714365883,3-23-24 16:28,96.57,Return,Walmart Return,722.2220659
13084,714365883,3-25-24 23:28,54.72,Purchase,Gas,667.5020659
13085,714365883,3-26-24 21:28,203.58,Withdrawal,ATM Withdrawal,463.9220659
13086,714365883,3-29-24 17:28,198.32,Purchase,Entertainment,265.6020659
13087,714365883,04-03-24 21:28,1800,IncomingTransfer,Salary,2065.602066
13088,714365883,04-04-24 22:28,59.21,Deposit,Mobile Deposit,2124.812066
13089,714365883,04-06-24 22:28,20.81,OutgoingTransfer,Peer-to-Peer Transfer,2104.002066
13090,714365883,04-07-24 14:28,116.59,Withdrawal,Mobile App Withdrawal,1987.412066
13091,714365883,04-08-24 11:28,181.35,Return,Amazon Return,2168.762066
13092,714365883,04-08-24 21:28,1000,Payment,Credit Card Payment,1168.762066
13093,714365883,04-11-24 17:28,240.69,Withdrawal,Branch Withdrawal,928.0720659
13094,714365883,4-13-24 21:28,500,Payment,Insurance Payment,428.0720659
13095,714365883,4-17-24 9:28,23.48,Purchase,Pharmacy,404.5920659
13096,714365883,4-19-24 9:28,106.25,Deposit,Check Deposit,510.8420659
13097,714365883,4-20-24 16:28,228.4,Withdrawal,ATM Withdrawal,282.4420659
13098,714365883,4-23-24 22:28,52.5,IncomingTransfer,Freelance Payment,334.9420659
13099,714365883,4-26-24 13:28,103.08,Withdrawal,Mobile App Withdrawal,231.8620659
13100,714365883,4-27-24 20:28,37.39,Deposit,Cash Deposit,269.2520659
13101,714365883,05-01-24 16:28,239.44,OnlineShopping,Amazon,29.81206585
13102,714365883,05-01-24 21:28,1800,IncomingTransfer,Salary,1829.812066
13103,714365883,05-04-24 10:28,51.21,OutgoingTransfer,International Transfer,1778.602066
13104,714365883,05-06-24 21:28,1200,Payment,Credit Card Payment,578.6020659
13105,714365883,5-14-24 10:28,224.9,OnlineShopping,Etsy,353.7020659
13106,714365883,5-14-24 15:28,88.6,IncomingTransfer,Freelance Payment,442.3020659
13107,714365883,5-16-24 9:28,203.76,OnlineShopping,Amazon,238.5420659
13108,714365883,5-16-24 15:28,192.36,Purchase,Furniture,46.18206585
13109,714365883,5-17-24 21:28,600,Payment,Insurance Payment,-553.8179341
13110,714365883,5-18-24 14:28,235.03,Payment,Bill Payment,-788.8479341
13111,714365883,5-18-24 19:28,134.66,OnlineShopping,Best Buy,-923.5079341
13112,714365883,5-19-24 16:28,192.6,Purchase,Restaurant,-1116.107934
13113,714365883,5-21-24 10:28,89.79,Purchase,Grocery,-1205.897934
13114,714365883,5-21-24 16:28,124.95,Deposit,Check Deposit,-1080.947934
13115,714365883,5-23-24 9:28,82.83,Payment,Bill Payment,-1163.777934
13116,714365883,5-28-24 9:28,130.83,Payment,Mortgage Payment,-1294.607934
13117,714365883,5-30-24 18:28,188.96,Return,Best Buy Return,-1105.647934
13118,714365883,5-31-24 19:28,60.07,Withdrawal,Mobile App Withdrawal,-1165.717934
13119,714365883,06-01-24 21:28,1800,IncomingTransfer,Salary,634.2820659
13120,714365883,06-02-24 14:28,196.5,Withdrawal,ATM Withdrawal,437.7820659
13121,714365883,06-03-24 16:28,193.29,Deposit,Cash Deposit,631.0720659
13122,714365883,06-04-24 23:28,18.54,Purchase,Clothing,612.5320659
13123,714365883,06-05-24 18:28,124.66,Return,eBay Return,737.1920659
13124,714365883,06-06-24 21:28,1400,Payment,Credit Card Payment,-662.8079341
13125,714365883,06-07-24 9:28,58.62,Deposit,Mobile Deposit,-604.1879341
13126,714365883,06-11-24 23:28,166.51,Payment,Bill Payment,-770.6979341
13127,714365883,06-12-24 18:28,183.66,Purchase,Pharmacy,-954.3579341
13128,714365883,06-12-24 21:28,500,Payment,Installment Payment,-1454.357934
13129,714365883,6-18-24 20:28,141.93,Deposit,Mobile Deposit,-1312.427934
13130,714365883,6-19-24 10:28,57.01,Withdrawal,ATM Withdrawal,-1369.437934
13131,714365883,6-21-24 16:28,27.13,Withdrawal,ATM Withdrawal,-1396.567934
13132,714365883,6-21-24 22:28,45.16,Purchase,Grocery,-1441.727934
13133,714365883,6-24-24 17:28,145.19,Withdrawal,Mobile App Withdrawal,-1586.917934
13134,714365883,6-26-24 10:28,87.05,Deposit,Mobile Deposit,-1499.867934
13135,714365883,6-28-24 10:28,42.84,Deposit,Check Deposit,-1457.027934
13136,714365883,07-04-24 21:28,1800,IncomingTransfer,Salary,342.9720659
13137,714365883,07-05-24 23:28,198.07,Deposit,Mobile Deposit,541.0420659
13138,714365883,07-06-24 13:28,205.54,OutgoingTransfer,Bank Transfer,335.5020659
13139,714365883,07-09-24 21:28,1000,Payment,Credit Card Payment,-664.4979341
13140,714365883,07-10-24 13:28,18.99,Withdrawal,ATM Withdrawal,-683.4879341
13141,714365883,07-12-24 18:28,99.17,Purchase,Clothing,-782.6579341
13142,714365883,07-12-24 22:28,60.24,Return,Target Return,-722.4179341
13143,714365883,7-16-24 13:28,208.07,Withdrawal,ATM Withdrawal,-930.4879341
13144,714365883,7-17-24 21:28,800,Payment,Subscription Payment,-1730.487934
13145,714388158,1-28-24 11:28,454.48,Purchase,Grocery,10.14440184
13146,714388158,1-29-24 23:28,91.15,Withdrawal,ATM Withdrawal,-81.00559816
13147,714388158,1-30-24 9:28,299.27,Payment,Mortgage Payment,-380.2755982
13148,714388158,1-30-24 19:28,170.5,Payment,Bill Payment,-550.7755982
13149,714388158,1-30-24 21:28,439.08,Deposit,Cash Deposit,-111.6955982
13150,714388158,02-02-24 21:28,4900,IncomingTransfer,Salary,4788.304402
13151,714388158,02-07-24 10:28,95.04,OnlineShopping,Amazon,4693.264402
13152,714388158,02-07-24 21:28,900,Payment,Credit Card Payment,3793.264402
13153,714388158,02-10-24 19:28,360.5,Deposit,Mobile Deposit,4153.764402
13154,714388158,02-12-24 17:28,18.54,IncomingTransfer,Freelance Payment,4172.304402
13155,714388158,2-15-24 18:28,295.73,Purchase,Restaurant,3876.574402
13156,714388158,2-16-24 21:28,2600,Payment,Rent Payment,1276.574402
13157,714388158,2-19-24 9:28,77.87,Purchase,Electronics,1198.704402
13158,714388158,2-20-24 11:28,41.76,OnlineShopping,Walmart,1156.944402
13159,714388158,03-01-24 21:28,4900,IncomingTransfer,Salary,6056.944402
13160,714388158,03-02-24 11:28,234.49,Purchase,Pharmacy,5822.454402
13161,714388158,03-03-24 17:28,77.79,Deposit,Direct Deposit,5900.244402
13162,714388158,03-04-24 14:28,155.73,Purchase,Pharmacy,5744.514402
13163,714388158,03-05-24 9:28,458.24,OnlineShopping,Target,5286.274402
13164,714388158,03-06-24 21:28,1000,Payment,Credit Card Payment,4286.274402
13165,714388158,03-11-24 19:28,93.66,Payment,Bill Payment,4192.614402
13166,714388158,03-11-24 20:28,305.89,OutgoingTransfer,Peer-to-Peer Transfer,3886.724402
13167,714388158,3-13-24 12:28,125.22,Purchase,Travel,3761.504402
13168,714388158,3-16-24 21:28,2300,Payment,Rent Payment,1461.504402
13169,714388158,3-18-24 16:28,402.27,Purchase,Electronics,1059.234402
13170,714388158,3-23-24 15:28,21.72,Deposit,Cash Deposit,1080.954402
13171,714388158,3-26-24 19:28,373.43,Deposit,Check Deposit,1454.384402
13172,714388158,3-31-24 14:28,241.3,Deposit,Cash Deposit,1695.684402
13173,714388158,04-03-24 21:28,491.81,Return,eBay Return,2187.494402
13174,714388158,04-03-24 21:28,16.72,OutgoingTransfer,International Transfer,2170.774402
13175,714388158,04-04-24 21:28,4900,IncomingTransfer,Salary,7070.774402
13176,714388158,04-09-24 10:28,489.64,Deposit,Cash Deposit,7560.414402
13177,714388158,04-09-24 21:28,900,Payment,Credit Card Payment,6660.414402
13178,714388158,04-12-24 22:28,332.25,Withdrawal,ATM Withdrawal,6328.164402
13179,714388158,4-17-24 21:28,1900,Payment,Rent Payment,4428.164402
13180,714388158,4-18-24 14:28,260.25,OutgoingTransfer,International Transfer,4167.914402
13181,714388158,4-18-24 16:28,436.59,Purchase,Pharmacy,3731.324402
13182,714388158,4-19-24 15:28,347.29,Withdrawal,Mobile App Withdrawal,3384.034402
13183,714388158,4-21-24 14:28,237.62,OnlineShopping,Target,3146.414402
13184,714388158,4-24-24 17:28,120.72,Return,Best Buy Return,3267.134402
13185,714388158,4-27-24 11:28,447.92,Purchase,Gas,2819.214402
13186,714388158,4-28-24 18:28,41.67,Deposit,Cash Deposit,2860.884402
13187,714388158,05-02-24 17:28,128.47,Purchase,Entertainment,2732.414402
13188,714388158,05-05-24 21:28,4900,IncomingTransfer,Salary,7632.414402
13189,714388158,05-08-24 16:28,318.76,Payment,Bill Payment,7313.654402
13190,714388158,05-08-24 20:28,276.12,OutgoingTransfer,Peer-to-Peer Transfer,7037.534402
13191,714388158,05-08-24 23:28,286.65,OutgoingTransfer,Wire Transfer,6750.884402
13192,714388158,05-09-24 9:28,372.8,Payment,Loan Payment,6378.084402
13193,714388158,05-09-24 10:28,389.97,Deposit,Mobile Deposit,6768.054402
13194,714388158,05-10-24 13:28,463.68,Return,Best Buy Return,7231.734402
13195,714388158,05-10-24 21:28,700,Payment,Credit Card Payment,6531.734402
13196,714388158,5-16-24 12:28,237.38,Purchase,Clothing,6294.354402
13197,714388158,5-16-24 23:28,467.16,OnlineShopping,Amazon,5827.194402
13198,714388158,5-18-24 21:28,1400,Payment,Rent Payment,4427.194402
13199,714388158,5-19-24 13:28,383.88,Payment,Mortgage Payment,4043.314402
13200,714388158,5-19-24 17:28,301.9,OutgoingTransfer,Peer-to-Peer Transfer,3741.414402
13201,714388158,5-19-24 22:28,171.37,Purchase,Grocery,3570.044402
13202,714388158,5-21-24 21:28,228.82,Payment,Bill Payment,3341.224402
13203,714388158,5-21-24 21:28,379.92,Withdrawal,ATM Withdrawal,2961.304402
13204,714388158,5-22-24 14:28,471.39,Withdrawal,Mobile App Withdrawal,2489.914402
13205,714388158,5-23-24 17:28,193.05,Purchase,Clothing,2296.864402
13206,714388158,5-24-24 9:28,215.61,OnlineShopping,Amazon,2081.254402
13207,714388158,5-24-24 9:28,262.12,Withdrawal,ATM Withdrawal,1819.134402
13208,714388158,5-25-24 14:28,64.93,Withdrawal,Mobile App Withdrawal,1754.204402
13209,714388158,5-30-24 11:28,244.89,Purchase,Furniture,1509.314402
13210,714388158,06-03-24 21:28,4900,IncomingTransfer,Salary,6409.314402
13211,714388158,06-04-24 9:28,175.14,Payment,Loan Payment,6234.174402
13212,714388158,06-08-24 21:28,800,Payment,Credit Card Payment,5434.174402
13213,714388158,06-12-24 14:28,195,Deposit,Cash Deposit,5629.174402
13214,714388158,6-13-24 21:28,1200,Payment,Rent Payment,4429.174402
13215,714388158,6-14-24 10:28,497.68,Deposit,Cash Deposit,4926.854402
13216,714388158,6-15-24 14:28,137.75,Purchase,Restaurant,4789.104402
13217,714388158,6-17-24 16:28,463.56,OutgoingTransfer,Wire Transfer,4325.544402
13218,714388158,6-17-24 20:28,306.99,Payment,Loan Payment,4018.554402
13219,714388158,6-17-24 23:28,232.61,OnlineShopping,Walmart,3785.944402
13220,714388158,6-18-24 13:28,56.13,Deposit,Cash Deposit,3842.074402
13221,714388158,6-19-24 23:28,256.68,Payment,Mortgage Payment,3585.394402
13222,714388158,6-23-24 17:28,396.02,OnlineShopping,AliExpress,3189.374402
13223,714388158,6-26-24 16:28,331.51,Deposit,Mobile Deposit,3520.884402
13224,714388158,6-28-24 9:28,182.15,Return,Walmart Return,3703.034402
13225,714388158,07-02-24 21:28,4900,IncomingTransfer,Salary,8603.034402
13226,714388158,07-02-24 23:28,204.35,IncomingTransfer,Freelance Payment,8807.384402
13227,714388158,07-05-24 13:28,400.59,OnlineShopping,Walmart,8406.794402
13228,714388158,07-07-24 21:28,700,Payment,Credit Card Payment,7706.794402
13229,714388158,07-08-24 22:28,435.85,Payment,Bill Payment,7270.944402
13230,714388158,07-10-24 10:28,491.15,Deposit,Check Deposit,7762.094402
13231,714388158,07-10-24 18:28,377.68,Payment,Loan Payment,7384.414402
13232,714388158,07-11-24 21:28,298,Return,Best Buy Return,7682.414402
13233,714388158,7-14-24 21:28,251.7,Payment,Loan Payment,7430.714402
13234,714388158,7-17-24 15:28,334.32,Purchase,Electronics,7096.394402
13235,714388158,7-17-24 21:28,2200,Payment,Rent Payment,4896.394402
13236,714492783,1-21-24 10:28,164.81,OnlineShopping,eBay,-164.81
13237,714492783,1-21-24 12:28,168.04,Purchase,Entertainment,-332.85
13238,714492783,1-21-24 13:28,91.93,Withdrawal,Mobile App Withdrawal,-424.78
13239,714492783,1-29-24 10:28,219.6,Purchase,Clothing,-644.38
13240,714492783,02-04-24 21:28,3300,IncomingTransfer,Salary,2655.62
13241,714492783,02-10-24 10:28,129.44,OnlineShopping,AliExpress,2526.18
13242,714492783,2-13-24 14:28,221.11,Withdrawal,Branch Withdrawal,2305.07
13243,714492783,2-14-24 21:28,57.04,Deposit,Cash Deposit,2362.11
13244,714492783,2-15-24 12:28,37.05,OnlineShopping,AliExpress,2325.06
13245,714492783,2-17-24 21:28,1100,Payment,Rent Payment,1225.06
13246,714492783,2-27-24 17:28,21.33,Withdrawal,ATM Withdrawal,1203.73
13247,714492783,03-01-24 21:28,3300,IncomingTransfer,Salary,4503.73
13248,714492783,03-03-24 13:28,94.64,Withdrawal,ATM Withdrawal,4409.09
13249,714492783,03-12-24 13:28,140.85,Deposit,Mobile Deposit,4549.94
13250,714492783,3-16-24 21:28,1900,Payment,Rent Payment,2649.94
13251,714492783,3-21-24 14:28,178.92,Purchase,Entertainment,2471.02
13252,714492783,3-23-24 16:28,84,Purchase,Grocery,2387.02
13253,714492783,3-25-24 13:28,181.01,Withdrawal,ATM Withdrawal,2206.01
13254,714492783,04-03-24 19:28,73.99,Deposit,Direct Deposit,2280
13255,714492783,04-03-24 21:28,3300,IncomingTransfer,Salary,5580
13256,714492783,04-04-24 20:28,149.89,Deposit,Direct Deposit,5729.89
13257,714492783,04-06-24 17:28,156.03,Purchase,Restaurant,5573.86
13258,714492783,04-08-24 11:28,52.11,Withdrawal,Branch Withdrawal,5521.75
13259,714492783,04-12-24 21:28,1300,Payment,Rent Payment,4221.75
13260,714492783,4-13-24 16:28,130.96,OutgoingTransfer,Peer-to-Peer Transfer,4090.79
13261,714492783,4-16-24 17:28,81.25,Deposit,Check Deposit,4172.04
13262,714492783,4-20-24 21:28,240.16,Return,Store Return,4412.2
13263,714492783,4-22-24 14:28,211.56,Deposit,Mobile Deposit,4623.76
13264,714492783,4-22-24 15:28,68.01,Purchase,Gas,4555.75
13265,714492783,4-23-24 9:28,203.42,Purchase,Travel,4352.33
13266,714492783,4-25-24 10:28,138.39,OutgoingTransfer,Bank Transfer,4213.94
13267,714492783,05-01-24 21:28,3300,IncomingTransfer,Salary,7513.94
13268,714492783,05-03-24 20:28,71.48,Withdrawal,Mobile App Withdrawal,7442.46
13269,714492783,05-10-24 11:28,169.19,Withdrawal,Branch Withdrawal,7273.27
13270,714492783,5-14-24 21:28,1500,Payment,Rent Payment,5773.27
13271,714492783,5-15-24 22:28,177.95,Deposit,Direct Deposit,5951.22
13272,714492783,5-24-24 21:28,153.07,Deposit,Check Deposit,6104.29
13273,714492783,06-03-24 21:28,3300,IncomingTransfer,Salary,9404.29
13274,714492783,06-08-24 11:28,101.78,IncomingTransfer,Freelance Payment,9506.07
13275,714492783,06-08-24 14:28,235.97,Deposit,Direct Deposit,9742.04
13276,714492783,6-14-24 22:28,188.12,OutgoingTransfer,Peer-to-Peer Transfer,9553.92
13277,714492783,6-15-24 21:28,1900,Payment,Rent Payment,7653.92
13278,714492783,6-17-24 9:28,131.56,OutgoingTransfer,Bank Transfer,7522.36
13279,714492783,6-22-24 15:28,115.35,OnlineShopping,Amazon,7407.01
13280,714492783,6-24-24 15:28,96.7,Return,Walmart Return,7503.71
13281,714492783,07-01-24 16:28,26.27,Deposit,Cash Deposit,7529.98
13282,714492783,07-04-24 21:28,3300,IncomingTransfer,Salary,10829.98
13283,714492783,7-13-24 16:28,114.43,Purchase,Travel,10715.55
13284,714492783,7-14-24 15:28,86.6,Deposit,Check Deposit,10802.15
13285,714492783,7-16-24 21:28,2000,Payment,Rent Payment,8802.15
13286,714499908,1-22-24 10:28,239.7,OutgoingTransfer,Bank Transfer,697.5069074
13287,714499908,1-26-24 12:28,91.28,Purchase,Clothing,606.2269074
13288,714499908,1-29-24 10:28,246.25,Return,Walmart Return,852.4769074
13289,714499908,1-30-24 20:28,57.09,OnlineShopping,eBay,795.3869074
13290,714499908,1-30-24 23:28,149.75,Deposit,Mobile Deposit,945.1369074
13291,714499908,1-31-24 15:28,318.17,Withdrawal,Mobile App Withdrawal,626.9669074
13292,714499908,02-03-24 13:28,379.91,Withdrawal,Mobile App Withdrawal,247.0569074
13293,714499908,02-03-24 21:28,3850,IncomingTransfer,Salary,4097.056907
13294,714499908,02-07-24 16:28,123.82,Return,Etsy Return,4220.876907
13295,714499908,02-08-24 21:28,1600,Payment,Credit Card Payment,2620.876907
13296,714499908,02-10-24 14:28,263.65,Deposit,Cash Deposit,2884.526907
13297,714499908,02-10-24 15:28,158.23,Withdrawal,Branch Withdrawal,2726.296907
13298,714499908,2-13-24 10:28,158.07,Deposit,Direct Deposit,2884.366907
13299,714499908,2-14-24 18:28,355.52,Deposit,Cash Deposit,3239.886907
13300,714499908,2-14-24 20:28,43.14,Return,eBay Return,3283.026907
13301,714499908,2-14-24 21:28,2300,Payment,Rent Payment,983.0269074
13302,714499908,2-15-24 20:28,252.94,Deposit,Mobile Deposit,1235.966907
13303,714499908,2-17-24 17:28,193.54,Return,Amazon Return,1429.506907
13304,714499908,2-26-24 14:28,30.66,Withdrawal,Mobile App Withdrawal,1398.846907
13305,714499908,2-28-24 20:28,30.27,Deposit,Mobile Deposit,1429.116907
13306,714499908,03-02-24 11:28,332.03,IncomingTransfer,Freelance Payment,1761.146907
13307,714499908,03-04-24 14:28,165.37,OutgoingTransfer,Wire Transfer,1595.776907
13308,714499908,03-05-24 21:28,3850,IncomingTransfer,Salary,5445.776907
13309,714499908,03-09-24 16:28,274.03,Return,Best Buy Return,5719.806907
13310,714499908,03-10-24 21:28,1600,Payment,Credit Card Payment,4119.806907
13311,714499908,03-11-24 21:28,1300,Payment,Rent Payment,2819.806907
13312,714499908,3-16-24 11:28,151.87,Withdrawal,Branch Withdrawal,2667.936907
13313,714499908,3-24-24 14:28,109.89,OnlineShopping,eBay,2558.046907
13314,714499908,04-04-24 21:28,3850,IncomingTransfer,Salary,6408.046907
13315,714499908,04-06-24 21:28,143.11,IncomingTransfer,Freelance Payment,6551.156907
13316,714499908,04-09-24 21:28,1700,Payment,Credit Card Payment,4851.156907
13317,714499908,04-11-24 12:28,228.93,OutgoingTransfer,Peer-to-Peer Transfer,4622.226907
13318,714499908,4-15-24 18:28,287.32,Payment,Mortgage Payment,4334.906907
13319,714499908,4-17-24 18:28,397.97,Deposit,Direct Deposit,4732.876907
13320,714499908,4-17-24 19:28,251.97,Payment,Mortgage Payment,4480.906907
13321,714499908,4-17-24 21:28,379.63,Purchase,Home Improvement,4101.276907
13322,714499908,4-18-24 21:28,2200,Payment,Rent Payment,1901.276907
13323,714499908,4-26-24 23:28,244.2,Purchase,Pharmacy,1657.076907
13324,714499908,4-28-24 10:28,386.49,Purchase,Restaurant,1270.586907
13325,714499908,4-29-24 23:28,308.59,Withdrawal,ATM Withdrawal,961.9969074
13326,714499908,05-02-24 19:28,255.3,Purchase,Pharmacy,706.6969074
13327,714499908,05-04-24 21:28,3850,IncomingTransfer,Salary,4556.696907
13328,714499908,05-08-24 13:28,316.54,Deposit,Check Deposit,4873.236907
13329,714499908,05-09-24 21:28,1500,Payment,Credit Card Payment,3373.236907
13330,714499908,05-11-24 20:28,109.06,OnlineShopping,Target,3264.176907
13331,714499908,5-15-24 21:28,2000,Payment,Rent Payment,1264.176907
13332,714499908,5-15-24 21:28,74.38,Purchase,Home Improvement,1189.796907
13333,714499908,5-16-24 9:28,102.59,Deposit,Mobile Deposit,1292.386907
13334,714499908,5-17-24 11:28,208.27,IncomingTransfer,Freelance Payment,1500.656907
13335,714499908,5-26-24 17:28,388.61,OnlineShopping,Walmart,1112.046907
13336,714499908,5-26-24 17:28,85.27,Payment,Bill Payment,1026.776907
13337,714499908,5-29-24 17:28,122.22,Purchase,Electronics,904.5569074
13338,714499908,06-01-24 21:28,3850,IncomingTransfer,Salary,4754.556907
13339,714499908,06-02-24 12:28,121.45,OnlineShopping,Etsy,4633.106907
13340,714499908,06-02-24 18:28,85.43,Payment,Loan Payment,4547.676907
13341,714499908,06-06-24 21:28,1600,Payment,Credit Card Payment,2947.676907
13342,714499908,06-11-24 12:28,150.06,Purchase,Clothing,2797.616907
13343,714499908,6-13-24 20:28,62.27,Withdrawal,Branch Withdrawal,2735.346907
13344,714499908,6-13-24 22:28,280.73,Deposit,Check Deposit,3016.076907
13345,714499908,6-16-24 20:28,115.98,OutgoingTransfer,Wire Transfer,2900.096907
13346,714499908,6-17-24 18:28,229.52,Purchase,Grocery,2670.576907
13347,714499908,6-18-24 21:28,2100,Payment,Rent Payment,570.5769074
13348,714499908,6-20-24 10:28,28.34,Payment,Mortgage Payment,542.2369074
13349,714499908,6-20-24 15:28,40.42,Deposit,Check Deposit,582.6569074
13350,714499908,6-21-24 10:28,58.94,Purchase,Pharmacy,523.7169074
13351,714499908,6-21-24 17:28,315.16,Purchase,Clothing,208.5569074
13352,714499908,6-22-24 19:28,120.94,Deposit,Check Deposit,329.4969074
13353,714499908,6-23-24 22:28,335.3,Withdrawal,Branch Withdrawal,-5.803092591
13354,714499908,6-26-24 14:28,383.67,Deposit,Cash Deposit,377.8669074
13355,714499908,6-26-24 20:28,353.14,Purchase,Restaurant,24.72690741
13356,714499908,6-26-24 23:28,113.83,OutgoingTransfer,Wire Transfer,-89.10309259
13357,714499908,07-02-24 12:28,303.49,Deposit,Mobile Deposit,214.3869074
13358,714499908,07-03-24 15:28,174.49,Deposit,Cash Deposit,388.8769074
13359,714499908,07-03-24 18:28,291.41,OnlineShopping,AliExpress,97.46690741
13360,714499908,07-03-24 19:28,170.28,OnlineShopping,AliExpress,-72.81309259
13361,714499908,07-03-24 21:28,3850,IncomingTransfer,Salary,3777.186907
13362,714499908,07-05-24 9:28,117.37,Withdrawal,ATM Withdrawal,3659.816907
13363,714499908,07-08-24 21:28,1800,Payment,Credit Card Payment,1859.816907
13364,714499908,07-11-24 21:28,1300,Payment,Rent Payment,559.8169074
13365,714499908,07-12-24 13:28,42.64,Deposit,Check Deposit,602.4569074
13366,714499908,7-16-24 11:28,208.93,OutgoingTransfer,Peer-to-Peer Transfer,393.5269074
13367,714537258,1-24-24 11:28,164.79,Purchase,Home Improvement,841.4430031
13368,714537258,1-25-24 23:28,445.7,Payment,Bill Payment,395.7430031
13369,714537258,1-26-24 11:28,388.39,Purchase,Gas,7.353003145
13370,714537258,1-26-24 15:28,286.07,Withdrawal,Mobile App Withdrawal,-278.7169969
13371,714537258,1-27-24 15:28,219.18,IncomingTransfer,Freelance Payment,-59.53699685
13372,714537258,1-28-24 14:28,251.68,OnlineShopping,eBay,-311.2169969
13373,714537258,1-30-24 14:28,391.78,Deposit,Mobile Deposit,80.56300315
13374,714537258,1-30-24 15:28,200.19,Deposit,Cash Deposit,280.7530031
13375,714537258,02-01-24 21:28,6500,IncomingTransfer,Salary,6780.753003
13376,714537258,02-02-24 18:28,399.78,Return,Store Return,7180.533003
13377,714537258,02-02-24 19:28,353.52,Deposit,Check Deposit,7534.053003
13378,714537258,02-05-24 23:28,423.48,Purchase,Home Improvement,7110.573003
13379,714537258,02-06-24 21:28,1200,Payment,Credit Card Payment,5910.573003
13380,714537258,02-07-24 19:28,153.21,Purchase,Home Improvement,5757.363003
13381,714537258,02-10-24 10:28,185.56,Deposit,Cash Deposit,5942.923003
13382,714537258,02-11-24 10:28,424.49,OnlineShopping,Target,5518.433003
13383,714537258,02-11-24 21:28,3100,Payment,Rent Payment,2418.433003
13384,714537258,2-13-24 23:28,385.01,OutgoingTransfer,International Transfer,2033.423003
13385,714537258,2-14-24 16:28,458.69,Return,Target Return,2492.113003
13386,714537258,2-19-24 10:28,455.23,Payment,Loan Payment,2036.883003
13387,714537258,2-23-24 10:28,357.58,OnlineShopping,eBay,1679.303003
13388,714537258,2-23-24 17:28,315.61,OutgoingTransfer,Peer-to-Peer Transfer,1363.693003
13389,714537258,2-23-24 22:28,113.57,Return,Amazon Return,1477.263003
13390,714537258,2-26-24 14:28,93.05,Deposit,Direct Deposit,1570.313003
13391,714537258,2-29-24 15:28,168.98,OutgoingTransfer,International Transfer,1401.333003
13392,714537258,03-02-24 21:28,6500,IncomingTransfer,Salary,7901.333003
13393,714537258,03-07-24 21:28,1600,Payment,Credit Card Payment,6301.333003
13394,714537258,03-08-24 19:28,387.83,Withdrawal,Branch Withdrawal,5913.503003
13395,714537258,03-08-24 23:28,276.86,Withdrawal,Branch Withdrawal,5636.643003
13396,714537258,3-15-24 12:28,382.58,Withdrawal,ATM Withdrawal,5254.063003
13397,714537258,3-15-24 22:28,120.84,Withdrawal,ATM Withdrawal,5133.223003
13398,714537258,3-16-24 18:28,251.26,Purchase,Grocery,4881.963003
13399,714537258,3-17-24 21:28,2200,Payment,Rent Payment,2681.963003
13400,714537258,3-18-24 9:28,133.43,OnlineShopping,eBay,2548.533003
13401,714537258,3-18-24 16:28,308.91,OutgoingTransfer,International Transfer,2239.623003
13402,714537258,3-19-24 11:28,88.63,Purchase,Home Improvement,2150.993003
13403,714537258,3-19-24 15:28,535.1,Return,Best Buy Return,2686.093003
13404,714537258,3-19-24 23:28,146.54,Purchase,Furniture,2539.553003
13405,714537258,3-21-24 15:28,217.96,Payment,Loan Payment,2321.593003
13406,714537258,3-26-24 12:28,357.6,Return,Store Return,2679.193003
13407,714537258,3-29-24 9:28,189.29,Withdrawal,Mobile App Withdrawal,2489.903003
13408,714537258,3-29-24 20:28,428.88,Purchase,Clothing,2061.023003
13409,714537258,3-29-24 21:28,321.39,Payment,Bill Payment,1739.633003
13410,714537258,04-02-24 23:28,139.72,Deposit,Direct Deposit,1879.353003
13411,714537258,04-05-24 21:28,6500,IncomingTransfer,Salary,8379.353003
13412,714537258,04-10-24 21:28,1600,Payment,Credit Card Payment,6779.353003
13413,714537258,04-12-24 15:28,111.13,Purchase,Pharmacy,6668.223003
13414,714537258,4-14-24 21:28,4100,Payment,Rent Payment,2568.223003
13415,714537258,4-15-24 16:28,519.18,Return,Amazon Return,3087.403003
13416,714537258,4-16-24 14:28,549.88,OnlineShopping,Etsy,2537.523003
13417,714537258,4-17-24 19:28,184.86,Withdrawal,ATM Withdrawal,2352.663003
13418,714537258,4-19-24 14:28,61.7,OnlineShopping,AliExpress,2290.963003
13419,714537258,4-22-24 9:28,353.58,OutgoingTransfer,Peer-to-Peer Transfer,1937.383003
13420,714537258,4-22-24 19:28,371.57,Withdrawal,Mobile App Withdrawal,1565.813003
13421,714537258,4-22-24 21:28,94.04,OutgoingTransfer,Wire Transfer,1471.773003
13422,714537258,05-02-24 20:28,303.96,Deposit,Mobile Deposit,1775.733003
13423,714537258,05-02-24 21:28,6500,IncomingTransfer,Salary,8275.733003
13424,714537258,05-02-24 22:28,222.5,Withdrawal,Branch Withdrawal,8053.233003
13425,714537258,05-04-24 19:28,188.51,Withdrawal,Mobile App Withdrawal,7864.723003
13426,714537258,05-06-24 13:28,363.24,OnlineShopping,AliExpress,7501.483003
13427,714537258,05-07-24 13:28,351.24,Payment,Loan Payment,7150.243003
13428,714537258,05-07-24 21:28,1200,Payment,Credit Card Payment,5950.243003
13429,714537258,05-09-24 16:28,197.57,Return,eBay Return,6147.813003
13430,714537258,05-10-24 15:28,534.33,Withdrawal,ATM Withdrawal,5613.483003
13431,714537258,5-15-24 12:28,257.17,OnlineShopping,Amazon,5356.313003
13432,714537258,5-17-24 21:28,4200,Payment,Rent Payment,1156.313003
13433,714537258,5-22-24 20:28,109.52,Deposit,Cash Deposit,1265.833003
13434,714537258,5-23-24 13:28,515.69,Deposit,Direct Deposit,1781.523003
13435,714537258,5-24-24 18:28,309.26,Withdrawal,Mobile App Withdrawal,1472.263003
13436,714537258,5-24-24 21:28,294.88,Purchase,Home Improvement,1177.383003
13437,714537258,5-29-24 19:28,130.94,Deposit,Check Deposit,1308.323003
13438,714537258,06-01-24 15:28,126.7,Deposit,Cash Deposit,1435.023003
13439,714537258,06-02-24 10:28,104.02,Withdrawal,ATM Withdrawal,1331.003003
13440,714537258,06-04-24 16:28,222.35,Purchase,Gas,1108.653003
13441,714537258,06-05-24 16:28,114.05,Withdrawal,Branch Withdrawal,994.6030031
13442,714537258,06-05-24 21:28,6500,IncomingTransfer,Salary,7494.603003
13443,714537258,06-07-24 15:28,548.83,Withdrawal,Branch Withdrawal,6945.773003
13444,714537258,06-08-24 11:28,133.55,Payment,Bill Payment,6812.223003
13445,714537258,06-08-24 14:28,227.45,Deposit,Mobile Deposit,7039.673003
13446,714537258,06-09-24 16:28,486.14,IncomingTransfer,Freelance Payment,7525.813003
13447,714537258,06-10-24 21:28,1500,Payment,Credit Card Payment,6025.813003
13448,714537258,6-18-24 21:28,1700,Payment,Rent Payment,4325.813003
13449,714537258,6-19-24 18:28,512.15,Deposit,Mobile Deposit,4837.963003
13450,714537258,6-20-24 18:28,228.25,Deposit,Mobile Deposit,5066.213003
13451,714537258,6-20-24 18:28,497.24,OutgoingTransfer,Wire Transfer,4568.973003
13452,714537258,6-22-24 11:28,422.07,OutgoingTransfer,Bank Transfer,4146.903003
13453,714537258,6-22-24 16:28,419.35,Withdrawal,ATM Withdrawal,3727.553003
13454,714537258,6-28-24 12:28,461.8,OnlineShopping,Etsy,3265.753003
13455,714537258,07-01-24 14:28,358.13,Withdrawal,ATM Withdrawal,2907.623003
13456,714537258,07-03-24 9:28,115.89,Return,eBay Return,3023.513003
13457,714537258,07-04-24 16:28,473.93,OnlineShopping,eBay,2549.583003
13458,714537258,07-05-24 21:28,6500,IncomingTransfer,Salary,9049.583003
13459,714537258,07-09-24 23:28,275.19,OutgoingTransfer,International Transfer,8774.393003
13460,714537258,07-10-24 21:28,1100,Payment,Credit Card Payment,7674.393003
13461,714537258,7-13-24 16:28,246.52,Purchase,Home Improvement,7427.873003
13462,714537258,7-13-24 21:28,3300,Payment,Rent Payment,4127.873003
13463,714614133,1-24-24 17:28,168.03,IncomingTransfer,Freelance Payment,168.03
13464,714614133,1-25-24 13:28,217.62,Withdrawal,ATM Withdrawal,-49.59
13465,714614133,1-30-24 9:28,88.21,Payment,Loan Payment,-137.8
13466,714614133,02-02-24 14:28,213.43,Payment,Loan Payment,-351.23
13467,714614133,02-04-24 21:28,2950,IncomingTransfer,Salary,2598.77
13468,714614133,02-06-24 9:28,37.32,OnlineShopping,Target,2561.45
13469,714614133,02-10-24 13:28,245.44,Withdrawal,Mobile App Withdrawal,2316.01
13470,714614133,2-13-24 13:28,35.79,Return,AliExpress Return,2351.8
13471,714614133,2-14-24 14:28,218.07,OnlineShopping,Best Buy,2133.73
13472,714614133,2-14-24 20:28,96.74,OnlineShopping,Walmart,2036.99
13473,714614133,2-14-24 21:28,900,Payment,Installment Payment,1136.99
13474,714614133,2-17-24 21:28,225.32,OutgoingTransfer,Bank Transfer,911.67
13475,714614133,2-23-24 11:28,136.63,Withdrawal,ATM Withdrawal,775.04
13476,714614133,2-27-24 13:28,105.7,Withdrawal,ATM Withdrawal,669.34
13477,714614133,03-03-24 21:28,2950,IncomingTransfer,Salary,3619.34
13478,714614133,03-06-24 16:28,20.98,Purchase,Clothing,3598.36
13479,714614133,3-16-24 18:28,188.01,OnlineShopping,Best Buy,3410.35
13480,714614133,3-16-24 21:28,1000,Payment,Subscription Payment,2410.35
13481,714614133,3-21-24 16:28,154.5,Deposit,Direct Deposit,2564.85
13482,714614133,3-26-24 12:28,199.89,OutgoingTransfer,Bank Transfer,2364.96
13483,714614133,3-31-24 19:28,238.95,OutgoingTransfer,International Transfer,2126.01
13484,714614133,04-02-24 9:28,214.72,OutgoingTransfer,Wire Transfer,1911.29
13485,714614133,04-02-24 21:28,2950,IncomingTransfer,Salary,4861.29
13486,714614133,04-07-24 14:28,51.82,Withdrawal,Branch Withdrawal,4809.47
13487,714614133,4-13-24 21:28,800,Payment,Subscription Payment,4009.47
13488,714614133,4-13-24 21:28,190.21,Purchase,Clothing,3819.26
13489,714614133,4-18-24 14:28,109.33,Withdrawal,ATM Withdrawal,3709.93
13490,714614133,4-24-24 19:28,182.55,OnlineShopping,Amazon,3527.38
13491,714614133,4-27-24 15:28,184.66,Withdrawal,Branch Withdrawal,3342.72
13492,714614133,05-02-24 21:28,2950,IncomingTransfer,Salary,6292.72
13493,714614133,05-08-24 19:28,20.56,Purchase,Gas,6272.16
13494,714614133,5-16-24 21:28,800,Payment,Insurance Payment,5472.16
13495,714614133,5-17-24 9:28,87.14,Deposit,Check Deposit,5559.3
13496,714614133,5-20-24 13:28,200.21,Purchase,Restaurant,5359.09
13497,714614133,5-27-24 21:28,76.6,IncomingTransfer,Freelance Payment,5435.69
13498,714614133,5-28-24 20:28,40.68,OutgoingTransfer,Wire Transfer,5395.01
13499,714614133,5-29-24 20:28,170.38,Return,AliExpress Return,5565.39
13500,714614133,06-02-24 20:28,125.34,Payment,Mortgage Payment,5440.05
13501,714614133,06-04-24 11:28,76.63,Purchase,Home Improvement,5363.42
13502,714614133,06-05-24 21:28,2950,IncomingTransfer,Salary,8313.42
13503,714614133,06-11-24 13:28,103.77,OutgoingTransfer,Peer-to-Peer Transfer,8209.65
13504,714614133,06-11-24 21:28,1200,Payment,Installment Payment,7009.65
13505,714614133,6-13-24 14:28,53.26,Withdrawal,Branch Withdrawal,6956.39
13506,714614133,6-15-24 16:28,108.34,Purchase,Travel,6848.05
13507,714614133,6-18-24 14:28,204.8,Return,Walmart Return,7052.85
13508,714614133,07-02-24 21:28,2950,IncomingTransfer,Salary,10002.85
13509,714614133,07-03-24 17:28,115.51,Withdrawal,Branch Withdrawal,9887.34
13510,714614133,07-04-24 16:28,43.74,Deposit,Direct Deposit,9931.08
13511,714614133,07-04-24 19:28,218.99,Purchase,Travel,9712.09
13512,714614133,07-08-24 10:28,112.24,Withdrawal,Mobile App Withdrawal,9599.85
13513,714614133,07-12-24 21:28,1100,Payment,Insurance Payment,8499.85
13514,714724908,1-26-24 20:28,85.79,Payment,Loan Payment,1072.196899
13515,714724908,1-30-24 22:28,190.96,Deposit,Direct Deposit,1263.156899
13516,714724908,1-31-24 23:28,255.67,IncomingTransfer,Freelance Payment,1518.826899
13517,714724908,02-02-24 19:28,303.99,Purchase,Electronics,1214.836899
13518,714724908,02-03-24 15:28,24.17,OnlineShopping,eBay,1190.666899
13519,714724908,02-05-24 21:28,3700,IncomingTransfer,Salary,4890.666899
13520,714724908,02-06-24 19:28,361,Purchase,Entertainment,4529.666899
13521,714724908,02-10-24 21:28,2500,Payment,Credit Card Payment,2029.666899
13522,714724908,02-11-24 21:28,335.77,Withdrawal,Mobile App Withdrawal,1693.896899
13523,714724908,02-12-24 17:28,123.63,Deposit,Direct Deposit,1817.526899
13524,714724908,2-14-24 18:28,258.04,OutgoingTransfer,International Transfer,1559.486899
13525,714724908,2-15-24 21:28,1100,Payment,Rent Payment,459.486899
13526,714724908,2-16-24 13:28,72.18,Purchase,Furniture,387.306899
13527,714724908,2-16-24 18:28,322.47,Return,Amazon Return,709.776899
13528,714724908,2-16-24 18:28,131.96,IncomingTransfer,Freelance Payment,841.736899
13529,714724908,2-20-24 12:28,130.06,Purchase,Electronics,711.676899
13530,714724908,2-22-24 21:28,153.44,Deposit,Mobile Deposit,865.116899
13531,714724908,2-23-24 16:28,86.91,OutgoingTransfer,Wire Transfer,778.206899
13532,714724908,2-26-24 23:28,362.36,Deposit,Check Deposit,1140.566899
13533,714724908,2-29-24 22:28,39.3,Return,Walmart Return,1179.866899
13534,714724908,03-01-24 12:28,112.63,Purchase,Furniture,1067.236899
13535,714724908,03-01-24 21:28,3700,IncomingTransfer,Salary,4767.236899
13536,714724908,03-03-24 18:28,221.51,Deposit,Mobile Deposit,4988.746899
13537,714724908,03-05-24 10:28,64.34,Purchase,Entertainment,4924.406899
13538,714724908,03-05-24 18:28,294.02,Payment,Mortgage Payment,4630.386899
13539,714724908,03-06-24 11:28,386.11,Withdrawal,ATM Withdrawal,4244.276899
13540,714724908,03-06-24 21:28,2500,Payment,Credit Card Payment,1744.276899
13541,714724908,03-07-24 15:28,72.85,Return,AliExpress Return,1817.126899
13542,714724908,03-12-24 13:28,212.98,Deposit,Check Deposit,2030.106899
13543,714724908,3-17-24 21:28,2200,Payment,Rent Payment,-169.893101
13544,714724908,3-18-24 14:28,364.14,IncomingTransfer,Freelance Payment,194.246899
13545,714724908,3-18-24 16:28,341.01,Withdrawal,ATM Withdrawal,-146.763101
13546,714724908,3-19-24 18:28,146.85,Deposit,Cash Deposit,0.086899042
13547,714724908,3-22-24 13:28,316.98,Payment,Mortgage Payment,-316.893101
13548,714724908,3-26-24 19:28,285.1,OnlineShopping,Walmart,-601.993101
13549,714724908,3-28-24 10:28,172.08,Return,Amazon Return,-429.913101
13550,714724908,3-30-24 11:28,190.64,Deposit,Direct Deposit,-239.273101
13551,714724908,3-30-24 11:28,46.77,Payment,Loan Payment,-286.043101
13552,714724908,3-30-24 18:28,173.76,Payment,Bill Payment,-459.803101
13553,714724908,04-01-24 10:28,194.27,Deposit,Cash Deposit,-265.533101
13554,714724908,04-02-24 13:28,105.14,Deposit,Cash Deposit,-160.393101
13555,714724908,04-04-24 19:28,24.45,Return,Walmart Return,-135.943101
13556,714724908,04-05-24 15:28,243.8,Payment,Mortgage Payment,-379.743101
13557,714724908,04-05-24 20:28,350.21,Purchase,Furniture,-729.953101
13558,714724908,04-05-24 21:28,3700,IncomingTransfer,Salary,2970.046899
13559,714724908,04-07-24 21:28,270.29,OnlineShopping,AliExpress,2699.756899
13560,714724908,04-10-24 21:28,1700,Payment,Credit Card Payment,999.756899
13561,714724908,04-11-24 12:28,339.46,Deposit,Check Deposit,1339.216899
13562,714724908,4-14-24 14:28,204.61,OutgoingTransfer,Wire Transfer,1134.606899
13563,714724908,4-17-24 16:28,97.79,Purchase,Pharmacy,1036.816899
13564,714724908,4-17-24 21:28,1200,Payment,Rent Payment,-163.183101
13565,714724908,4-18-24 12:28,218.35,Purchase,Electronics,-381.533101
13566,714724908,4-18-24 16:28,190.45,OnlineShopping,Target,-571.983101
13567,714724908,4-19-24 13:28,227.17,OnlineShopping,eBay,-799.153101
13568,714724908,4-20-24 22:28,181.47,Return,eBay Return,-617.683101
13569,714724908,4-21-24 11:28,132.26,Payment,Bill Payment,-749.943101
13570,714724908,4-26-24 17:28,392.51,Payment,Bill Payment,-1142.453101
13571,714724908,4-30-24 23:28,388.52,Payment,Loan Payment,-1530.973101
13572,714724908,05-01-24 21:28,3700,IncomingTransfer,Salary,2169.026899
13573,714724908,05-06-24 21:28,2500,Payment,Credit Card Payment,-330.973101
13574,714724908,05-07-24 20:28,166.93,Purchase,Home Improvement,-497.903101
13575,714724908,05-07-24 22:28,264.42,OutgoingTransfer,International Transfer,-762.323101
13576,714724908,05-12-24 15:28,85.88,Deposit,Check Deposit,-676.443101
13577,714724908,05-12-24 21:28,1600,Payment,Rent Payment,-2276.443101
13578,714724908,5-13-24 10:28,124.16,Payment,Loan Payment,-2400.603101
13579,714724908,5-14-24 15:28,75.83,IncomingTransfer,Freelance Payment,-2324.773101
13580,714724908,5-17-24 16:28,325.94,Withdrawal,ATM Withdrawal,-2650.713101
13581,714724908,5-23-24 19:28,74.09,Deposit,Check Deposit,-2576.623101
13582,714724908,06-03-24 21:28,3700,IncomingTransfer,Salary,1123.376899
13583,714724908,06-05-24 11:28,357.67,Withdrawal,Mobile App Withdrawal,765.706899
13584,714724908,06-06-24 11:28,105.27,IncomingTransfer,Freelance Payment,870.976899
13585,714724908,06-08-24 21:28,2100,Payment,Credit Card Payment,-1229.023101
13586,714724908,06-10-24 16:28,123.15,Payment,Loan Payment,-1352.173101
13587,714724908,06-11-24 15:28,368.41,OutgoingTransfer,International Transfer,-1720.583101
13588,714724908,6-13-24 17:28,122.19,OutgoingTransfer,Wire Transfer,-1842.773101
13589,714724908,6-15-24 21:28,1800,Payment,Rent Payment,-3642.773101
13590,714724908,6-17-24 17:28,161.5,Deposit,Mobile Deposit,-3481.273101
13591,714724908,6-19-24 10:28,76.7,Purchase,Home Improvement,-3557.973101
13592,714724908,6-20-24 9:28,169.17,OnlineShopping,Walmart,-3727.143101
13593,714724908,6-21-24 18:28,81.56,Withdrawal,Mobile App Withdrawal,-3808.703101
13594,714724908,6-21-24 23:28,356.51,Deposit,Mobile Deposit,-3452.193101
13595,714724908,6-23-24 13:28,53.12,Deposit,Direct Deposit,-3399.073101
13596,714724908,6-23-24 20:28,249.92,Purchase,Travel,-3648.993101
13597,714724908,6-26-24 11:28,359.52,Purchase,Entertainment,-4008.513101
13598,714724908,6-28-24 11:28,323.1,Withdrawal,Mobile App Withdrawal,-4331.613101
13599,714724908,6-29-24 17:28,37.16,Purchase,Gas,-4368.773101
13600,714724908,07-03-24 18:28,28.14,OnlineShopping,Amazon,-4396.913101
13601,714724908,07-05-24 21:28,3700,IncomingTransfer,Salary,-696.913101
13602,714724908,07-07-24 16:28,329.03,Deposit,Mobile Deposit,-367.883101
13603,714724908,07-09-24 19:28,103.23,Withdrawal,ATM Withdrawal,-471.113101
13604,714724908,07-10-24 15:28,123.52,Purchase,Furniture,-594.633101
13605,714724908,07-10-24 21:28,2400,Payment,Credit Card Payment,-2994.633101
13606,714724908,07-11-24 14:28,48.79,Deposit,Cash Deposit,-2945.843101
13607,714724908,07-12-24 18:28,37.25,Purchase,Clothing,-2983.093101
13608,714724908,7-13-24 21:28,2000,Payment,Rent Payment,-4983.093101
13609,714724908,7-14-24 13:28,378.96,Purchase,Travel,-5362.053101
13610,714724908,7-17-24 22:28,107.34,OnlineShopping,eBay,-5469.393101
13611,714816258,1-23-24 20:28,77.5,Withdrawal,ATM Withdrawal,462.0850009
13612,714816258,1-25-24 13:28,367.07,Payment,Mortgage Payment,95.01500092
13613,714816258,02-02-24 21:28,5750,IncomingTransfer,Salary,5845.015001
13614,714816258,02-04-24 12:28,176.33,Return,Store Return,6021.345001
13615,714816258,02-05-24 9:28,191.83,Deposit,Check Deposit,6213.175001
13616,714816258,02-06-24 12:28,287.37,Return,Walmart Return,6500.545001
13617,714816258,02-06-24 23:28,156.52,Purchase,Gas,6344.025001
13618,714816258,02-07-24 21:28,1000,Payment,Credit Card Payment,5344.025001
13619,714816258,02-11-24 17:28,450.8,Withdrawal,ATM Withdrawal,4893.225001
13620,714816258,02-12-24 21:28,2300,Payment,Installment Payment,2593.225001
13621,714816258,2-13-24 17:28,208.73,Payment,Mortgage Payment,2384.495001
13622,714816258,2-17-24 10:28,109.96,OnlineShopping,Target,2274.535001
13623,714816258,2-20-24 12:28,443.22,IncomingTransfer,Freelance Payment,2717.755001
13624,714816258,2-25-24 18:28,353.94,Deposit,Check Deposit,3071.695001
13625,714816258,2-26-24 15:28,91.28,Deposit,Check Deposit,3162.975001
13626,714816258,03-05-24 21:28,5750,IncomingTransfer,Salary,8912.975001
13627,714816258,03-10-24 21:28,1100,Payment,Credit Card Payment,7812.975001
13628,714816258,3-13-24 20:28,197.13,Purchase,Restaurant,7615.845001
13629,714816258,3-15-24 21:28,1900,Payment,Subscription Payment,5715.845001
13630,714816258,3-16-24 12:28,443.62,Purchase,Pharmacy,5272.225001
13631,714816258,3-17-24 11:28,257.68,Return,Store Return,5529.905001
13632,714816258,3-20-24 22:28,298.84,OutgoingTransfer,Bank Transfer,5231.065001
13633,714816258,3-29-24 14:28,186.83,Withdrawal,Mobile App Withdrawal,5044.235001
13634,714816258,04-01-24 19:28,159.63,Return,Amazon Return,5203.865001
13635,714816258,04-03-24 21:28,5750,IncomingTransfer,Salary,10953.865
13636,714816258,04-05-24 9:28,184.67,Withdrawal,Branch Withdrawal,10769.195
13637,714816258,04-06-24 16:28,100.16,OutgoingTransfer,Bank Transfer,10669.035
13638,714816258,04-06-24 17:28,347.28,Purchase,Home Improvement,10321.755
13639,714816258,04-06-24 21:28,255.31,OutgoingTransfer,Peer-to-Peer Transfer,10066.445
13640,714816258,04-07-24 11:28,329.33,Payment,Loan Payment,9737.115001
13641,714816258,04-08-24 21:28,1000,Payment,Credit Card Payment,8737.115001
13642,714816258,04-08-24 21:28,187.4,Purchase,Restaurant,8549.715001
13643,714816258,04-11-24 17:28,366.65,OnlineShopping,Target,8183.065001
13644,714816258,4-14-24 10:28,370.02,Deposit,Direct Deposit,8553.085001
13645,714816258,4-17-24 14:28,289.66,Purchase,Gas,8263.425001
13646,714816258,4-17-24 19:28,257.23,Deposit,Direct Deposit,8520.655001
13647,714816258,4-18-24 18:28,522.17,Purchase,Furniture,7998.485001
13648,714816258,4-18-24 21:28,2500,Payment,Installment Payment,5498.485001
13649,714816258,4-19-24 18:28,491.78,Deposit,Mobile Deposit,5990.265001
13650,714816258,4-21-24 22:28,54.14,Purchase,Furniture,5936.125001
13651,714816258,4-26-24 19:28,180.89,OnlineShopping,Amazon,5755.235001
13652,714816258,4-28-24 14:28,332.09,Deposit,Cash Deposit,6087.325001
13653,714816258,4-29-24 22:28,325.42,Purchase,Restaurant,5761.905001
13654,714816258,05-02-24 13:28,402.74,Payment,Bill Payment,5359.165001
13655,714816258,05-02-24 21:28,5750,IncomingTransfer,Salary,11109.165
13656,714816258,05-05-24 16:28,431.66,OnlineShopping,Target,10677.505
13657,714816258,05-06-24 9:28,316.56,Deposit,Cash Deposit,10994.065
13658,714816258,05-07-24 21:28,1000,Payment,Credit Card Payment,9994.065001
13659,714816258,05-10-24 21:28,129.31,Withdrawal,Mobile App Withdrawal,9864.755001
13660,714816258,05-11-24 12:28,146.27,Purchase,Clothing,9718.485001
13661,714816258,5-13-24 9:28,59.2,Deposit,Direct Deposit,9777.685001
13662,714816258,5-14-24 17:28,93.22,OnlineShopping,Target,9684.465001
13663,714816258,5-16-24 21:28,2300,Payment,Subscription Payment,7384.465001
13664,714816258,5-18-24 13:28,87.58,Purchase,Home Improvement,7296.885001
13665,714816258,5-21-24 13:28,276.31,Purchase,Entertainment,7020.575001
13666,714816258,5-24-24 22:28,465.4,Payment,Bill Payment,6555.175001
13667,714816258,5-26-24 20:28,258.97,Payment,Mortgage Payment,6296.205001
13668,714816258,5-27-24 20:28,449.15,Deposit,Check Deposit,6745.355001
13669,714816258,06-04-24 21:28,5750,IncomingTransfer,Salary,12495.355
13670,714816258,06-09-24 21:28,1200,Payment,Credit Card Payment,11295.355
13671,714816258,06-10-24 23:28,114.58,OutgoingTransfer,Peer-to-Peer Transfer,11180.775
13672,714816258,06-12-24 19:28,322.05,OnlineShopping,Walmart,10858.725
13673,714816258,6-18-24 21:28,2500,Payment,Insurance Payment,8358.725001
13674,714816258,6-27-24 13:28,535.16,Deposit,Cash Deposit,8893.885001
13675,714816258,6-28-24 9:28,348.39,Purchase,Gas,8545.495001
13676,714816258,07-04-24 21:28,5750,IncomingTransfer,Salary,14295.495
13677,714816258,07-06-24 18:28,536.01,Purchase,Home Improvement,13759.485
13678,714816258,07-08-24 20:28,383,Payment,Loan Payment,13376.485
13679,714816258,07-09-24 21:28,1000,Payment,Credit Card Payment,12376.485
13680,714816258,07-10-24 22:28,400.77,Deposit,Direct Deposit,12777.255
13681,714816258,07-11-24 9:28,100.46,Payment,Mortgage Payment,12676.795
13682,714816258,07-11-24 10:28,182.27,Return,Etsy Return,12859.065
13683,714816258,7-14-24 18:28,497.85,IncomingTransfer,Freelance Payment,13356.915
13684,714816258,7-14-24 19:28,521.29,Payment,Mortgage Payment,12835.625
13685,714816258,7-15-24 13:28,228.38,Return,Store Return,13064.005
13686,714816258,7-17-24 21:28,1900,Payment,Insurance Payment,11164.005
13687,714831033,1-26-24 12:28,200.04,OutgoingTransfer,Bank Transfer,1291.611461
13688,714831033,1-30-24 13:28,697.22,Purchase,Electronics,594.3914606
13689,714831033,02-03-24 21:28,7500,IncomingTransfer,Salary,8094.391461
13690,714831033,02-08-24 21:28,2400,Payment,Credit Card Payment,5694.391461
13691,714831033,02-10-24 21:28,2700,Payment,Rent Payment,2994.391461
13692,714831033,2-23-24 9:28,176.14,Deposit,Cash Deposit,3170.531461
13693,714831033,03-01-24 21:28,7500,IncomingTransfer,Salary,10670.53146
13694,714831033,03-04-24 11:28,608.2,OutgoingTransfer,Peer-to-Peer Transfer,10062.33146
13695,714831033,03-06-24 21:28,2300,Payment,Credit Card Payment,7762.331461
13696,714831033,03-09-24 19:28,494.76,Purchase,Entertainment,7267.571461
13697,714831033,3-13-24 21:28,3800,Payment,Rent Payment,3467.571461
13698,714831033,3-19-24 17:28,106.39,Deposit,Direct Deposit,3573.961461
13699,714831033,3-24-24 17:28,677.77,Purchase,Grocery,2896.191461
13700,714831033,3-26-24 23:28,146.88,Withdrawal,Mobile App Withdrawal,2749.311461
13701,714831033,3-29-24 13:28,535.01,Payment,Bill Payment,2214.301461
13702,714831033,04-03-24 21:28,7500,IncomingTransfer,Salary,9714.301461
13703,714831033,04-04-24 21:28,690.37,IncomingTransfer,Freelance Payment,10404.67146
13704,714831033,04-06-24 12:28,400.42,Deposit,Direct Deposit,10805.09146
13705,714831033,04-08-24 21:28,2100,Payment,Credit Card Payment,8705.091461
13706,714831033,04-09-24 17:28,449.07,Payment,Loan Payment,8256.021461
13707,714831033,04-10-24 21:28,3200,Payment,Rent Payment,5056.021461
13708,714831033,4-13-24 12:28,133.69,OutgoingTransfer,Wire Transfer,4922.331461
13709,714831033,4-13-24 16:28,271.72,Deposit,Check Deposit,5194.051461
13710,714831033,4-18-24 9:28,612.57,Payment,Bill Payment,4581.481461
13711,714831033,4-29-24 16:28,407.65,Purchase,Pharmacy,4173.831461
13712,714831033,05-04-24 21:28,7500,IncomingTransfer,Salary,11673.83146
13713,714831033,05-09-24 21:28,1900,Payment,Credit Card Payment,9773.831461
13714,714831033,05-11-24 19:28,690.49,Purchase,Home Improvement,9083.341461
13715,714831033,05-12-24 14:28,235.74,Withdrawal,ATM Withdrawal,8847.601461
13716,714831033,5-17-24 21:28,2900,Payment,Rent Payment,5947.601461
13717,714831033,5-21-24 22:28,286.7,OnlineShopping,Target,5660.901461
13718,714831033,5-28-24 20:28,230.11,Withdrawal,ATM Withdrawal,5430.791461
13719,714831033,06-02-24 16:28,168.84,Withdrawal,ATM Withdrawal,5261.951461
13720,714831033,06-04-24 13:28,317.53,Purchase,Grocery,4944.421461
13721,714831033,06-05-24 21:28,7500,IncomingTransfer,Salary,12444.42146
13722,714831033,06-06-24 16:28,458,Purchase,Restaurant,11986.42146
13723,714831033,06-09-24 21:28,350.39,Withdrawal,Mobile App Withdrawal,11636.03146
13724,714831033,06-10-24 21:28,2300,Payment,Credit Card Payment,9336.031461
13725,714831033,6-15-24 21:28,2500,Payment,Rent Payment,6836.031461
13726,714831033,6-17-24 17:28,188.99,Withdrawal,Branch Withdrawal,6647.041461
13727,714831033,6-17-24 20:28,260.29,Withdrawal,Branch Withdrawal,6386.751461
13728,714831033,07-02-24 21:28,7500,IncomingTransfer,Salary,13886.75146
13729,714831033,07-07-24 21:28,1800,Payment,Credit Card Payment,12086.75146
13730,714831033,07-09-24 11:28,419.16,Purchase,Travel,11667.59146
13731,714831033,07-10-24 21:28,3000,Payment,Rent Payment,8667.591461
13732,714888633,1-21-24 13:28,514.14,OutgoingTransfer,International Transfer,498.4946795
13733,714888633,1-23-24 16:28,458.6,Payment,Loan Payment,39.89467951
13734,714888633,1-25-24 12:28,526.2,Purchase,Travel,-486.3053205
13735,714888633,1-30-24 23:28,721.83,Withdrawal,Branch Withdrawal,-1208.13532
13736,714888633,02-02-24 20:28,489.78,OutgoingTransfer,International Transfer,-1697.91532
13737,714888633,02-02-24 21:28,10000,IncomingTransfer,Salary,8302.08468
13738,714888633,02-02-24 22:28,144.89,Withdrawal,Mobile App Withdrawal,8157.19468
13739,714888633,02-07-24 13:28,500.55,Withdrawal,Branch Withdrawal,7656.64468
13740,714888633,02-07-24 21:28,1500,Payment,Credit Card Payment,6156.64468
13741,714888633,02-09-24 20:28,394.64,Withdrawal,Mobile App Withdrawal,5762.00468
13742,714888633,02-09-24 20:28,120.21,Withdrawal,Branch Withdrawal,5641.79468
13743,714888633,02-11-24 21:28,5100,Payment,Rent Payment,541.7946795
13744,714888633,2-13-24 21:28,298.81,OutgoingTransfer,International Transfer,242.9846795
13745,714888633,2-14-24 13:28,730.82,Deposit,Check Deposit,973.8046795
13746,714888633,2-17-24 18:28,617.65,OutgoingTransfer,Bank Transfer,356.1546795
13747,714888633,2-18-24 12:28,485.7,Withdrawal,Branch Withdrawal,-129.5453205
13748,714888633,2-18-24 17:28,530.04,OnlineShopping,Best Buy,-659.5853205
13749,714888633,03-01-24 21:28,10000,IncomingTransfer,Salary,9340.41468
13750,714888633,03-04-24 20:28,537.79,Return,AliExpress Return,9878.20468
13751,714888633,03-06-24 21:28,1500,Payment,Credit Card Payment,8378.20468
13752,714888633,03-07-24 16:28,431.84,Purchase,Entertainment,7946.36468
13753,714888633,3-17-24 16:28,717.64,Purchase,Pharmacy,7228.72468
13754,714888633,3-18-24 21:28,4700,Payment,Rent Payment,2528.72468
13755,714888633,3-25-24 15:28,738.9,Deposit,Direct Deposit,3267.62468
13756,714888633,3-27-24 15:28,138.22,Return,Best Buy Return,3405.84468
13757,714888633,3-28-24 18:28,474.5,OnlineShopping,eBay,2931.34468
13758,714888633,3-28-24 18:28,443.33,Deposit,Check Deposit,3374.67468
13759,714888633,04-03-24 21:28,10000,IncomingTransfer,Salary,13374.67468
13760,714888633,04-04-24 9:28,462.48,Withdrawal,Branch Withdrawal,12912.19468
13761,714888633,04-07-24 11:28,409.87,OutgoingTransfer,Peer-to-Peer Transfer,12502.32468
13762,714888633,04-08-24 21:28,1200,Payment,Credit Card Payment,11302.32468
13763,714888633,04-09-24 10:28,560.68,Return,Amazon Return,11863.00468
13764,714888633,04-12-24 9:28,621.7,OutgoingTransfer,Wire Transfer,11241.30468
13765,714888633,4-13-24 21:28,4300,Payment,Rent Payment,6941.30468
13766,714888633,4-14-24 19:28,347.04,Purchase,Entertainment,6594.26468
13767,714888633,4-15-24 19:28,732.22,Withdrawal,ATM Withdrawal,5862.04468
13768,714888633,4-16-24 23:28,652.49,Return,Best Buy Return,6514.53468
13769,714888633,4-17-24 14:28,521.12,Withdrawal,ATM Withdrawal,5993.41468
13770,714888633,4-20-24 21:28,176.77,OnlineShopping,Target,5816.64468
13771,714888633,4-26-24 20:28,397.88,Deposit,Cash Deposit,6214.52468
13772,714888633,4-28-24 14:28,746.15,Deposit,Direct Deposit,6960.67468
13773,714888633,4-29-24 9:28,361.08,Deposit,Direct Deposit,7321.75468
13774,714888633,4-30-24 13:28,699.86,Payment,Loan Payment,6621.89468
13775,714888633,4-30-24 22:28,332.3,Withdrawal,Branch Withdrawal,6289.59468
13776,714888633,05-01-24 15:28,627.15,OutgoingTransfer,Wire Transfer,5662.44468
13777,714888633,05-03-24 21:28,10000,IncomingTransfer,Salary,15662.44468
13778,714888633,05-08-24 21:28,1600,Payment,Credit Card Payment,14062.44468
13779,714888633,05-09-24 14:28,220.71,Withdrawal,Mobile App Withdrawal,13841.73468
13780,714888633,05-10-24 22:28,335.37,IncomingTransfer,Freelance Payment,14177.10468
13781,714888633,05-12-24 21:28,3200,Payment,Rent Payment,10977.10468
13782,714888633,5-18-24 14:28,394.3,OnlineShopping,Best Buy,10582.80468
13783,714888633,5-26-24 22:28,171.19,Withdrawal,ATM Withdrawal,10411.61468
13784,714888633,5-28-24 20:28,238.23,IncomingTransfer,Freelance Payment,10649.84468
13785,714888633,06-01-24 10:28,220.31,Purchase,Grocery,10429.53468
13786,714888633,06-01-24 16:28,360.21,OutgoingTransfer,Bank Transfer,10069.32468
13787,714888633,06-02-24 11:28,726.78,Deposit,Check Deposit,10796.10468
13788,714888633,06-03-24 9:28,681.28,Deposit,Check Deposit,11477.38468
13789,714888633,06-05-24 21:28,10000,IncomingTransfer,Salary,21477.38468
13790,714888633,06-07-24 20:28,489.92,OnlineShopping,Best Buy,20987.46468
13791,714888633,06-10-24 21:28,1600,Payment,Credit Card Payment,19387.46468
13792,714888633,06-11-24 15:28,466.49,OutgoingTransfer,Peer-to-Peer Transfer,18920.97468
13793,714888633,6-13-24 20:28,606.98,Withdrawal,Branch Withdrawal,18313.99468
13794,714888633,6-15-24 16:28,514.72,Payment,Bill Payment,17799.27468
13795,714888633,6-18-24 21:28,3400,Payment,Rent Payment,14399.27468
13796,714888633,6-23-24 17:28,392.91,Purchase,Travel,14006.36468
13797,714888633,6-25-24 18:28,432.49,OnlineShopping,Best Buy,13573.87468
13798,714888633,6-28-24 9:28,277.86,OutgoingTransfer,International Transfer,13296.01468
13799,714888633,6-29-24 21:28,465.44,Purchase,Grocery,12830.57468
13800,714888633,07-05-24 16:28,444.01,Deposit,Mobile Deposit,13274.58468
13801,714888633,07-05-24 21:28,10000,IncomingTransfer,Salary,23274.58468
13802,714888633,07-08-24 16:28,266.87,Purchase,Entertainment,23007.71468
13803,714888633,07-10-24 21:28,1200,Payment,Credit Card Payment,21807.71468
13804,714888633,7-13-24 21:28,668.33,Payment,Bill Payment,21139.38468
13805,714888633,7-14-24 18:28,498.4,Return,eBay Return,21637.78468
13806,714888633,7-14-24 21:28,3100,Payment,Rent Payment,18537.78468
13807,714926508,1-22-24 14:28,287,Deposit,Mobile Deposit,1502.140011
13808,714926508,1-26-24 15:28,105.07,Deposit,Cash Deposit,1607.210011
13809,714926508,1-28-24 13:28,728.02,Purchase,Gas,879.1900105
13810,714926508,02-03-24 13:28,561.7,OnlineShopping,Etsy,317.4900105
13811,714926508,02-05-24 18:28,221.57,Payment,Mortgage Payment,95.92001053
13812,714926508,02-05-24 21:28,9500,IncomingTransfer,Salary,9595.920011
13813,714926508,02-06-24 10:28,694.04,Payment,Loan Payment,8901.880011
13814,714926508,02-06-24 12:28,165.95,Withdrawal,Mobile App Withdrawal,8735.930011
13815,714926508,02-07-24 10:28,166.37,Payment,Loan Payment,8569.560011
13816,714926508,02-09-24 20:28,203.22,Deposit,Cash Deposit,8772.780011
13817,714926508,02-10-24 21:28,2400,Payment,Credit Card Payment,6372.780011
13818,714926508,2-17-24 21:28,3200,Payment,Subscription Payment,3172.780011
13819,714926508,2-19-24 13:28,592.91,Deposit,Direct Deposit,3765.690011
13820,714926508,2-20-24 10:28,720.92,Deposit,Cash Deposit,4486.610011
13821,714926508,2-26-24 19:28,609.92,Withdrawal,Mobile App Withdrawal,3876.690011
13822,714926508,2-27-24 23:28,530.16,Payment,Loan Payment,3346.530011
13823,714926508,03-05-24 21:28,9500,IncomingTransfer,Salary,12846.53001
13824,714926508,03-10-24 21:28,2400,Payment,Credit Card Payment,10446.53001
13825,714926508,3-15-24 21:28,2600,Payment,Insurance Payment,7846.530011
13826,714926508,3-16-24 11:28,287.78,Withdrawal,Branch Withdrawal,7558.750011
13827,714926508,3-18-24 21:28,634.74,OutgoingTransfer,International Transfer,6924.010011
13828,714926508,3-27-24 10:28,396.28,OutgoingTransfer,Peer-to-Peer Transfer,6527.730011
13829,714926508,3-28-24 19:28,647.41,Deposit,Mobile Deposit,7175.140011
13830,714926508,04-02-24 19:28,229.11,OutgoingTransfer,Peer-to-Peer Transfer,6946.030011
13831,714926508,04-03-24 12:28,746.2,OnlineShopping,AliExpress,6199.830011
13832,714926508,04-05-24 21:28,9500,IncomingTransfer,Salary,15699.83001
13833,714926508,04-10-24 21:28,2800,Payment,Credit Card Payment,12899.83001
13834,714926508,4-13-24 21:28,3400,Payment,Subscription Payment,9499.830011
13835,714926508,4-15-24 10:28,511.66,OnlineShopping,Best Buy,8988.170011
13836,714926508,4-17-24 16:28,110.8,Payment,Bill Payment,8877.370011
13837,714926508,4-23-24 12:28,177.4,Withdrawal,Mobile App Withdrawal,8699.970011
13838,714926508,4-23-24 19:28,663.02,Withdrawal,Branch Withdrawal,8036.950011
13839,714926508,05-01-24 20:28,553.21,Purchase,Home Improvement,7483.740011
13840,714926508,05-02-24 21:28,9500,IncomingTransfer,Salary,16983.74001
13841,714926508,05-07-24 21:28,2400,Payment,Credit Card Payment,14583.74001
13842,714926508,05-08-24 9:28,263.59,Return,Etsy Return,14847.33001
13843,714926508,05-10-24 10:28,436.04,OnlineShopping,Target,14411.29001
13844,714926508,05-11-24 14:28,569.5,OnlineShopping,AliExpress,13841.79001
13845,714926508,05-11-24 18:28,622.9,Purchase,Entertainment,13218.89001
13846,714926508,05-12-24 17:28,470.85,Withdrawal,Mobile App Withdrawal,12748.04001
13847,714926508,5-15-24 21:28,3100,Payment,Installment Payment,9648.040011
13848,714926508,5-19-24 21:28,405.67,OutgoingTransfer,Peer-to-Peer Transfer,9242.370011
13849,714926508,5-21-24 12:28,364.88,Withdrawal,ATM Withdrawal,8877.490011
13850,714926508,06-01-24 21:28,9500,IncomingTransfer,Salary,18377.49001
13851,714926508,06-01-24 21:28,712.93,Return,Walmart Return,19090.42001
13852,714926508,06-06-24 21:28,2500,Payment,Credit Card Payment,16590.42001
13853,714926508,06-11-24 16:28,317.88,OnlineShopping,Etsy,16272.54001
13854,714926508,6-13-24 17:28,633.69,Purchase,Grocery,15638.85001
13855,714926508,6-14-24 13:28,170.78,Deposit,Mobile Deposit,15809.63001
13856,714926508,6-17-24 15:28,675.35,IncomingTransfer,Freelance Payment,16484.98001
13857,714926508,6-17-24 21:28,3400,Payment,Installment Payment,13084.98001
13858,714926508,6-21-24 13:28,125.74,Withdrawal,Branch Withdrawal,12959.24001
13859,714926508,6-21-24 18:28,589.97,Return,Target Return,13549.21001
13860,714926508,6-27-24 18:28,263.55,Withdrawal,ATM Withdrawal,13285.66001
13861,714926508,6-30-24 21:28,284.43,Deposit,Mobile Deposit,13570.09001
13862,714926508,07-04-24 21:28,9500,IncomingTransfer,Salary,23070.09001
13863,714926508,07-05-24 19:28,120.82,Payment,Mortgage Payment,22949.27001
13864,714926508,07-09-24 14:28,121.77,Return,Etsy Return,23071.04001
13865,714926508,07-09-24 21:28,2100,Payment,Credit Card Payment,20971.04001
13866,714926508,07-10-24 20:28,481.47,Purchase,Gas,20489.57001
13867,714926508,07-11-24 21:28,3900,Payment,Subscription Payment,16589.57001
13868,714926508,7-15-24 10:28,696.97,Deposit,Cash Deposit,17286.54001
13869,714926508,7-15-24 15:28,266.25,Purchase,Clothing,17020.29001
13870,714926508,7-16-24 19:28,249.84,Purchase,Gas,16770.45001
13871,715004808,1-23-24 13:28,66.36,OnlineShopping,Etsy,1458.451165
13872,715004808,1-24-24 17:28,69.78,Purchase,Travel,1388.671165
13873,715004808,1-26-24 16:28,160.4,Return,Best Buy Return,1549.071165
13874,715004808,1-27-24 22:28,170.32,Purchase,Clothing,1378.751165
13875,715004808,02-02-24 22:28,22.67,Payment,Bill Payment,1356.081165
13876,715004808,02-04-24 21:28,2550,IncomingTransfer,Salary,3906.081165
13877,715004808,02-05-24 18:28,213.41,Deposit,Direct Deposit,4119.491165
13878,715004808,02-07-24 14:28,56.85,Purchase,Furniture,4062.641165
13879,715004808,02-07-24 19:28,21.22,OnlineShopping,Amazon,4041.421165
13880,715004808,02-09-24 19:28,14.59,Deposit,Direct Deposit,4056.011165
13881,715004808,02-09-24 21:28,2100,Payment,Credit Card Payment,1956.011165
13882,715004808,02-12-24 14:28,97.02,Deposit,Check Deposit,2053.031165
13883,715004808,02-12-24 21:28,1100,Payment,Rent Payment,953.0311653
13884,715004808,2-14-24 16:28,202.89,IncomingTransfer,Freelance Payment,1155.921165
13885,715004808,2-15-24 11:28,167.05,Withdrawal,Mobile App Withdrawal,988.8711653
13886,715004808,2-17-24 22:28,184.26,OnlineShopping,Amazon,804.6111653
13887,715004808,2-18-24 10:28,112.78,Purchase,Gas,691.8311653
13888,715004808,2-19-24 13:28,197.97,Deposit,Mobile Deposit,889.8011653
13889,715004808,2-20-24 15:28,42.64,Purchase,Electronics,847.1611653
13890,715004808,2-21-24 23:28,116.62,Deposit,Mobile Deposit,963.7811653
13891,715004808,2-26-24 15:28,24.15,Deposit,Direct Deposit,987.9311653
13892,715004808,2-26-24 22:28,39.03,Deposit,Direct Deposit,1026.961165
13893,715004808,2-27-24 11:28,217.18,Withdrawal,Mobile App Withdrawal,809.7811653
13894,715004808,2-27-24 14:28,112.96,Payment,Bill Payment,696.8211653
13895,715004808,03-01-24 14:28,247.34,Deposit,Direct Deposit,944.1611653
13896,715004808,03-01-24 15:28,219.17,Deposit,Cash Deposit,1163.331165
13897,715004808,03-02-24 13:28,166.83,OnlineShopping,Target,996.5011653
13898,715004808,03-02-24 17:28,180.99,Deposit,Cash Deposit,1177.491165
13899,715004808,03-03-24 13:28,72.83,OnlineShopping,eBay,1104.661165
13900,715004808,03-04-24 13:28,162.62,OnlineShopping,Walmart,942.0411653
13901,715004808,03-05-24 12:28,149.6,OnlineShopping,Best Buy,792.4411653
13902,715004808,03-05-24 21:28,2550,IncomingTransfer,Salary,3342.441165
13903,715004808,03-08-24 22:28,117.88,Deposit,Mobile Deposit,3460.321165
13904,715004808,03-10-24 19:28,78.43,Withdrawal,Mobile App Withdrawal,3381.891165
13905,715004808,03-10-24 21:28,2000,Payment,Credit Card Payment,1381.891165
13906,715004808,03-12-24 20:28,235.85,OutgoingTransfer,Wire Transfer,1146.041165
13907,715004808,3-13-24 21:28,1000,Payment,Rent Payment,146.0411653
13908,715004808,3-16-24 17:28,29.66,Purchase,Clothing,116.3811653
13909,715004808,3-17-24 16:28,177.37,OutgoingTransfer,International Transfer,-60.98883468
13910,715004808,3-18-24 21:28,226.21,IncomingTransfer,Freelance Payment,165.2211653
13911,715004808,3-19-24 11:28,67,Return,Target Return,232.2211653
13912,715004808,3-24-24 12:28,190.29,Return,Amazon Return,422.5111653
13913,715004808,3-25-24 22:28,228.95,OutgoingTransfer,Peer-to-Peer Transfer,193.5611653
13914,715004808,3-27-24 17:28,171.58,OnlineShopping,Walmart,21.98116532
13915,715004808,3-28-24 10:28,162.73,Deposit,Cash Deposit,184.7111653
13916,715004808,3-30-24 21:28,194.88,Return,Best Buy Return,379.5911653
13917,715004808,3-30-24 22:28,120.3,Purchase,Restaurant,259.2911653
13918,715004808,04-01-24 18:28,62.5,IncomingTransfer,Freelance Payment,321.7911653
13919,715004808,04-03-24 11:28,225.8,Purchase,Furniture,95.99116532
13920,715004808,04-03-24 16:28,14.87,Deposit,Cash Deposit,110.8611653
13921,715004808,04-03-24 21:28,2550,IncomingTransfer,Salary,2660.861165
13922,715004808,04-04-24 13:28,22.95,Purchase,Travel,2637.911165
13923,715004808,04-05-24 14:28,163.51,Deposit,Cash Deposit,2801.421165
13924,715004808,04-08-24 16:28,208.82,Deposit,Cash Deposit,3010.241165
13925,715004808,04-08-24 21:28,2400,Payment,Credit Card Payment,610.2411653
13926,715004808,04-09-24 20:28,140.01,Return,Best Buy Return,750.2511653
13927,715004808,04-11-24 23:28,180.81,Deposit,Cash Deposit,931.0611653
13928,715004808,04-12-24 17:28,211.18,Withdrawal,Branch Withdrawal,719.8811653
13929,715004808,4-13-24 12:28,208.25,OnlineShopping,AliExpress,511.6311653
13930,715004808,4-13-24 21:28,1400,Payment,Rent Payment,-888.3688347
13931,715004808,4-21-24 22:28,134.34,Purchase,Furniture,-1022.708835
13932,715004808,4-22-24 15:28,70.56,Payment,Bill Payment,-1093.268835
13933,715004808,4-23-24 15:28,47.88,OutgoingTransfer,Wire Transfer,-1141.148835
13934,715004808,4-24-24 18:28,188.45,OutgoingTransfer,International Transfer,-1329.598835
13935,715004808,4-24-24 19:28,97.37,Deposit,Mobile Deposit,-1232.228835
13936,715004808,4-27-24 14:28,117.89,OnlineShopping,eBay,-1350.118835
13937,715004808,4-27-24 20:28,74.85,Purchase,Furniture,-1424.968835
13938,715004808,05-05-24 21:28,2550,IncomingTransfer,Salary,1125.031165
13939,715004808,05-07-24 23:28,84.69,Deposit,Direct Deposit,1209.721165
13940,715004808,05-10-24 21:28,2000,Payment,Credit Card Payment,-790.2788347
13941,715004808,05-11-24 21:28,1500,Payment,Rent Payment,-2290.278835
13942,715004808,05-11-24 21:28,83.24,Deposit,Check Deposit,-2207.038835
13943,715004808,5-13-24 21:28,24.74,Payment,Loan Payment,-2231.778835
13944,715004808,5-13-24 21:28,140.06,Withdrawal,Branch Withdrawal,-2371.838835
13945,715004808,5-17-24 16:28,48.79,Return,Walmart Return,-2323.048835
13946,715004808,5-17-24 18:28,162.25,Withdrawal,Mobile App Withdrawal,-2485.298835
13947,715004808,5-20-24 12:28,179.93,Purchase,Clothing,-2665.228835
13948,715004808,5-24-24 14:28,184.28,Deposit,Mobile Deposit,-2480.948835
13949,715004808,5-26-24 19:28,215.27,Withdrawal,Branch Withdrawal,-2696.218835
13950,715004808,06-01-24 21:28,2550,IncomingTransfer,Salary,-146.2188347
13951,715004808,06-03-24 15:28,206.05,IncomingTransfer,Freelance Payment,59.83116532
13952,715004808,06-06-24 9:28,76.72,Withdrawal,Mobile App Withdrawal,-16.88883468
13953,715004808,06-06-24 18:28,230.43,IncomingTransfer,Freelance Payment,213.5411653
13954,715004808,06-06-24 21:28,2300,Payment,Credit Card Payment,-2086.458835
13955,715004808,6-16-24 21:28,1400,Payment,Rent Payment,-3486.458835
13956,715004808,6-19-24 11:28,169.68,Deposit,Direct Deposit,-3316.778835
13957,715004808,6-20-24 14:28,61.43,Purchase,Restaurant,-3378.208835
13958,715004808,6-22-24 20:28,21.89,Deposit,Mobile Deposit,-3356.318835
13959,715004808,6-23-24 15:28,99.71,OnlineShopping,eBay,-3456.028835
13960,715004808,6-25-24 18:28,142.5,IncomingTransfer,Freelance Payment,-3313.528835
13961,715004808,6-25-24 21:28,134.4,Purchase,Furniture,-3447.928835
13962,715004808,6-27-24 23:28,180.15,Deposit,Cash Deposit,-3267.778835
13963,715004808,6-29-24 14:28,19.62,Withdrawal,ATM Withdrawal,-3287.398835
13964,715004808,6-29-24 22:28,133.49,Purchase,Restaurant,-3420.888835
13965,715004808,07-01-24 11:28,137.13,Return,Etsy Return,-3283.758835
13966,715004808,07-01-24 14:28,230.55,IncomingTransfer,Freelance Payment,-3053.208835
13967,715004808,07-01-24 21:28,2550,IncomingTransfer,Salary,-503.2088347
13968,715004808,07-02-24 16:28,53.24,IncomingTransfer,Freelance Payment,-449.9688347
13969,715004808,07-02-24 20:28,197.93,Withdrawal,ATM Withdrawal,-647.8988347
13970,715004808,07-03-24 20:28,172.95,Return,AliExpress Return,-474.9488347
13971,715004808,07-06-24 21:28,1900,Payment,Credit Card Payment,-2374.948835
13972,715004808,07-11-24 21:28,1600,Payment,Rent Payment,-3974.948835
13973,715033533,1-24-24 19:28,180.44,Purchase,Travel,1819.894406
13974,715033533,1-27-24 17:28,224.4,Deposit,Check Deposit,2044.294406
13975,715033533,02-01-24 16:28,136.88,OutgoingTransfer,International Transfer,1907.414406
13976,715033533,02-02-24 11:28,124.24,Deposit,Cash Deposit,2031.654406
13977,715033533,02-02-24 20:28,100.9,Return,Target Return,2132.554406
13978,715033533,02-02-24 21:28,2500,IncomingTransfer,Salary,4632.554406
13979,715033533,02-07-24 21:28,2900,Payment,Credit Card Payment,1732.554406
13980,715033533,02-09-24 20:28,201.92,Deposit,Cash Deposit,1934.474406
13981,715033533,2-13-24 17:28,35.98,OnlineShopping,eBay,1898.494406
13982,715033533,2-15-24 15:28,238.58,Deposit,Mobile Deposit,2137.074406
13983,715033533,2-17-24 21:28,1000,Payment,Subscription Payment,1137.074406
13984,715033533,2-23-24 20:28,51.31,Deposit,Cash Deposit,1188.384406
13985,715033533,2-27-24 21:28,66.95,Deposit,Check Deposit,1255.334406
13986,715033533,03-01-24 13:28,230.87,Purchase,Restaurant,1024.464406
13987,715033533,03-01-24 21:28,2500,IncomingTransfer,Salary,3524.464406
13988,715033533,03-03-24 22:28,207.25,IncomingTransfer,Freelance Payment,3731.714406
13989,715033533,03-05-24 19:28,30.77,OutgoingTransfer,Peer-to-Peer Transfer,3700.944406
13990,715033533,03-06-24 21:28,3500,Payment,Credit Card Payment,200.9444063
13991,715033533,03-09-24 22:28,37.64,Return,Etsy Return,238.5844063
13992,715033533,03-11-24 15:28,33.85,Purchase,Gas,204.7344063
13993,715033533,03-12-24 21:28,900,Payment,Installment Payment,-695.2655937
13994,715033533,3-13-24 13:28,49.66,Withdrawal,Branch Withdrawal,-744.9255937
13995,715033533,3-18-24 10:28,191.5,Withdrawal,ATM Withdrawal,-936.4255937
13996,715033533,3-22-24 19:28,56.52,Return,Store Return,-879.9055937
13997,715033533,3-24-24 12:28,40.57,Payment,Bill Payment,-920.4755937
13998,715033533,3-25-24 18:28,126.32,Return,Amazon Return,-794.1555937
13999,715033533,3-25-24 23:28,30.12,Payment,Loan Payment,-824.2755937
14000,715033533,3-31-24 11:28,114.95,Deposit,Direct Deposit,-709.3255937
14001,715033533,04-01-24 21:28,2500,IncomingTransfer,Salary,1790.674406
14002,715033533,04-04-24 9:28,80.03,OutgoingTransfer,International Transfer,1710.644406
14003,715033533,04-06-24 17:28,223.94,OnlineShopping,Best Buy,1486.704406
14004,715033533,04-06-24 21:28,3200,Payment,Credit Card Payment,-1713.295594
14005,715033533,04-07-24 15:28,77.6,OnlineShopping,AliExpress,-1790.895594
14006,715033533,04-07-24 18:28,235,OutgoingTransfer,International Transfer,-2025.895594
14007,715033533,04-07-24 20:28,198.52,Payment,Loan Payment,-2224.415594
14008,715033533,04-08-24 13:28,217.48,Withdrawal,Mobile App Withdrawal,-2441.895594
14009,715033533,04-08-24 22:28,153.21,OnlineShopping,Target,-2595.105594
14010,715033533,04-09-24 23:28,44.75,Deposit,Mobile Deposit,-2550.355594
14011,715033533,04-11-24 13:28,51.37,Return,Best Buy Return,-2498.985594
14012,715033533,04-11-24 22:28,99.62,Deposit,Check Deposit,-2399.365594
14013,715033533,04-12-24 10:28,99.36,Withdrawal,Mobile App Withdrawal,-2498.725594
14014,715033533,4-16-24 17:28,162.05,Deposit,Direct Deposit,-2336.675594
14015,715033533,4-17-24 12:28,99.46,Return,Walmart Return,-2237.215594
14016,715033533,4-17-24 21:28,700,Payment,Installment Payment,-2937.215594
14017,715033533,4-18-24 17:28,41.52,Purchase,Entertainment,-2978.735594
14018,715033533,4-18-24 18:28,77.34,Purchase,Home Improvement,-3056.075594
14019,715033533,4-19-24 14:28,78.84,Purchase,Pharmacy,-3134.915594
14020,715033533,4-21-24 10:28,79.47,Deposit,Mobile Deposit,-3055.445594
14021,715033533,4-27-24 10:28,22.66,Payment,Bill Payment,-3078.105594
14022,715033533,05-02-24 14:28,20.49,Withdrawal,Mobile App Withdrawal,-3098.595594
14023,715033533,05-02-24 17:28,94.16,OutgoingTransfer,Bank Transfer,-3192.755594
14024,715033533,05-03-24 13:28,210.07,Return,Store Return,-2982.685594
14025,715033533,05-04-24 12:28,236.91,OutgoingTransfer,International Transfer,-3219.595594
14026,715033533,05-04-24 21:28,2500,IncomingTransfer,Salary,-719.5955937
14027,715033533,05-05-24 15:28,79.94,OutgoingTransfer,Wire Transfer,-799.5355937
14028,715033533,05-06-24 21:28,21.95,Return,Amazon Return,-777.5855937
14029,715033533,05-09-24 21:28,3500,Payment,Credit Card Payment,-4277.585594
14030,715033533,5-14-24 11:28,147.58,Withdrawal,ATM Withdrawal,-4425.165594
14031,715033533,5-14-24 21:28,1000,Payment,Insurance Payment,-5425.165594
14032,715033533,5-15-24 9:28,158.18,Purchase,Grocery,-5583.345594
14033,715033533,5-18-24 13:28,45.91,OnlineShopping,Amazon,-5629.255594
14034,715033533,5-23-24 16:28,156.84,Deposit,Cash Deposit,-5472.415594
14035,715033533,5-23-24 19:28,36.21,Purchase,Travel,-5508.625594
14036,715033533,06-01-24 14:28,237.05,Deposit,Check Deposit,-5271.575594
14037,715033533,06-04-24 21:28,2500,IncomingTransfer,Salary,-2771.575594
14038,715033533,06-07-24 16:28,215.44,OnlineShopping,Target,-2987.015594
14039,715033533,06-09-24 21:28,2900,Payment,Credit Card Payment,-5887.015594
14040,715033533,6-13-24 13:28,71.43,Deposit,Cash Deposit,-5815.585594
14041,715033533,6-13-24 14:28,102.62,Deposit,Direct Deposit,-5712.965594
14042,715033533,6-15-24 21:28,700,Payment,Installment Payment,-6412.965594
14043,715033533,6-16-24 11:28,198.53,Purchase,Entertainment,-6611.495594
14044,715033533,6-18-24 20:28,226.84,Return,AliExpress Return,-6384.655594
14045,715033533,6-19-24 23:28,130.73,Purchase,Gas,-6515.385594
14046,715033533,6-24-24 16:28,128.55,OnlineShopping,Etsy,-6643.935594
14047,715033533,6-27-24 17:28,100.73,Withdrawal,ATM Withdrawal,-6744.665594
14048,715033533,6-30-24 19:28,227.4,Payment,Mortgage Payment,-6972.065594
14049,715033533,07-01-24 21:28,2500,IncomingTransfer,Salary,-4472.065594
14050,715033533,07-01-24 22:28,135.99,Withdrawal,ATM Withdrawal,-4608.055594
14051,715033533,07-03-24 10:28,45.62,IncomingTransfer,Freelance Payment,-4562.435594
14052,715033533,07-04-24 22:28,34.39,Purchase,Travel,-4596.825594
14053,715033533,07-04-24 23:28,246.73,Deposit,Check Deposit,-4350.095594
14054,715033533,07-05-24 9:28,216.25,Purchase,Grocery,-4566.345594
14055,715033533,07-06-24 11:28,168.82,Return,Best Buy Return,-4397.525594
14056,715033533,07-06-24 21:28,2800,Payment,Credit Card Payment,-7197.525594
14057,715033533,07-09-24 20:28,62.39,Withdrawal,Mobile App Withdrawal,-7259.915594
14058,715033533,07-10-24 15:28,31.24,Deposit,Direct Deposit,-7228.675594
14059,715033533,07-10-24 20:28,124.03,Deposit,Direct Deposit,-7104.645594
14060,715033533,7-13-24 21:28,700,Payment,Subscription Payment,-7804.645594
14061,715033533,7-17-24 17:28,137.74,Deposit,Cash Deposit,-7666.905594
14062,715047333,1-21-24 17:28,27.18,Withdrawal,Mobile App Withdrawal,571.2536557
14063,715047333,1-23-24 23:28,270.28,Deposit,Cash Deposit,841.5336557
14064,715047333,1-25-24 13:28,88.64,Withdrawal,Mobile App Withdrawal,752.8936557
14065,715047333,1-25-24 21:28,378.83,Purchase,Electronics,374.0636557
14066,715047333,1-26-24 15:28,15.3,Purchase,Electronics,358.7636557
14067,715047333,1-28-24 22:28,497.6,OutgoingTransfer,Bank Transfer,-138.8363443
14068,715047333,1-30-24 10:28,291.48,OnlineShopping,Etsy,-430.3163443
14069,715047333,02-02-24 11:28,148.01,Withdrawal,Branch Withdrawal,-578.3263443
14070,715047333,02-03-24 10:28,435.58,Payment,Bill Payment,-1013.906344
14071,715047333,02-04-24 11:28,396.31,Purchase,Electronics,-1410.216344
14072,715047333,02-08-24 23:28,423.57,OutgoingTransfer,Bank Transfer,-1833.786344
14073,715047333,02-09-24 15:28,221.1,OnlineShopping,eBay,-2054.886344
14074,715047333,2-14-24 15:28,322.78,Deposit,Check Deposit,-1732.106344
14075,715047333,2-14-24 17:28,64.25,Purchase,Home Improvement,-1796.356344
14076,715047333,2-18-24 12:28,97.67,OutgoingTransfer,Bank Transfer,-1894.026344
14077,715047333,2-19-24 13:28,41.3,Purchase,Furniture,-1935.326344
14078,715047333,2-21-24 11:28,168.43,OutgoingTransfer,Wire Transfer,-2103.756344
14079,715047333,2-24-24 12:28,154.32,Purchase,Entertainment,-2258.076344
14080,715047333,03-05-24 20:28,87.48,Deposit,Check Deposit,-2170.596344
14081,715047333,03-11-24 16:28,228.68,OnlineShopping,Best Buy,-2399.276344
14082,715047333,03-12-24 16:28,318.45,Purchase,Grocery,-2717.726344
14083,715047333,3-13-24 18:28,436.43,Deposit,Mobile Deposit,-2281.296344
14084,715047333,3-13-24 20:28,424.91,Deposit,Direct Deposit,-1856.386344
14085,715047333,3-16-24 12:28,125.77,Deposit,Direct Deposit,-1730.616344
14086,715047333,3-18-24 15:28,43.41,OutgoingTransfer,Bank Transfer,-1774.026344
14087,715047333,3-21-24 16:28,76.16,Purchase,Home Improvement,-1850.186344
14088,715047333,3-21-24 22:28,158.28,Purchase,Travel,-2008.466344
14089,715047333,3-22-24 12:28,340.78,Purchase,Clothing,-2349.246344
14090,715047333,3-23-24 17:28,241,Deposit,Check Deposit,-2108.246344
14091,715047333,3-26-24 12:28,331.13,Withdrawal,Mobile App Withdrawal,-2439.376344
14092,715047333,3-30-24 13:28,83.64,Withdrawal,ATM Withdrawal,-2523.016344
14093,715047333,04-01-24 11:28,95.71,Deposit,Mobile Deposit,-2427.306344
14094,715047333,04-01-24 21:28,403.66,Payment,Loan Payment,-2830.966344
14095,715047333,04-06-24 12:28,36.06,Payment,Mortgage Payment,-2867.026344
14096,715047333,04-07-24 11:28,333.25,Purchase,Pharmacy,-3200.276344
14097,715047333,04-10-24 19:28,374.8,Payment,Loan Payment,-3575.076344
14098,715047333,4-16-24 11:28,478.55,Deposit,Cash Deposit,-3096.526344
14099,715047333,4-18-24 10:28,257.79,Deposit,Cash Deposit,-2838.736344
14100,715047333,4-18-24 13:28,140.68,Withdrawal,Mobile App Withdrawal,-2979.416344
14101,715047333,4-19-24 11:28,479.07,Purchase,Home Improvement,-3458.486344
14102,715047333,4-19-24 18:28,404.61,Deposit,Mobile Deposit,-3053.876344
14103,715047333,4-21-24 11:28,199.43,Purchase,Restaurant,-3253.306344
14104,715047333,4-22-24 17:28,309.05,Purchase,Pharmacy,-3562.356344
14105,715047333,4-23-24 10:28,490.32,Purchase,Electronics,-4052.676344
14106,715047333,4-29-24 15:28,162.75,Withdrawal,Branch Withdrawal,-4215.426344
14107,715047333,05-05-24 14:28,463.69,Deposit,Check Deposit,-3751.736344
14108,715047333,05-05-24 16:28,35.54,Withdrawal,ATM Withdrawal,-3787.276344
14109,715047333,05-06-24 15:28,272.79,Purchase,Home Improvement,-4060.066344
14110,715047333,05-06-24 21:28,173.34,Payment,Bill Payment,-4233.406344
14111,715047333,05-07-24 10:28,360.9,Purchase,Home Improvement,-4594.306344
14112,715047333,05-07-24 12:28,228.49,Return,Amazon Return,-4365.816344
14113,715047333,05-08-24 10:28,107.54,Purchase,Restaurant,-4473.356344
14114,715047333,5-18-24 13:28,379.58,Payment,Bill Payment,-4852.936344
14115,715047333,5-20-24 22:28,391.33,Deposit,Check Deposit,-4461.606344
14116,715047333,5-22-24 18:28,143.32,Withdrawal,Branch Withdrawal,-4604.926344
14117,715047333,5-23-24 12:28,41.38,Payment,Loan Payment,-4646.306344
14118,715047333,5-23-24 16:28,39.82,Payment,Bill Payment,-4686.126344
14119,715047333,5-24-24 18:28,284.53,OutgoingTransfer,International Transfer,-4970.656344
14120,715047333,5-29-24 18:28,190.17,Withdrawal,Branch Withdrawal,-5160.826344
14121,715047333,5-30-24 21:28,273.69,Withdrawal,Branch Withdrawal,-5434.516344
14122,715047333,5-31-24 17:28,455.3,IncomingTransfer,Freelance Payment,-4979.216344
14123,715047333,06-03-24 9:28,58.02,Return,Target Return,-4921.196344
14124,715047333,06-03-24 18:28,120.75,Withdrawal,ATM Withdrawal,-5041.946344
14125,715047333,06-08-24 22:28,334.37,OnlineShopping,Etsy,-5376.316344
14126,715047333,06-10-24 9:28,306.32,Withdrawal,ATM Withdrawal,-5682.636344
14127,715047333,06-12-24 12:28,171.95,Deposit,Cash Deposit,-5510.686344
14128,715047333,6-15-24 20:28,107.24,Purchase,Home Improvement,-5617.926344
14129,715047333,6-16-24 17:28,216.73,Deposit,Direct Deposit,-5401.196344
14130,715047333,6-19-24 21:28,343.9,Return,Target Return,-5057.296344
14131,715047333,6-20-24 10:28,469.34,Deposit,Direct Deposit,-4587.956344
14132,715047333,6-21-24 22:28,330.55,IncomingTransfer,Freelance Payment,-4257.406344
14133,715047333,6-22-24 19:28,24.81,Payment,Loan Payment,-4282.216344
14134,715047333,6-23-24 17:28,220.91,Purchase,Restaurant,-4503.126344
14135,715047333,6-24-24 18:28,361.42,Withdrawal,Branch Withdrawal,-4864.546344
14136,715047333,6-25-24 20:28,451.28,IncomingTransfer,Freelance Payment,-4413.266344
14137,715047333,6-26-24 22:28,479.06,Deposit,Mobile Deposit,-3934.206344
14138,715047333,6-27-24 14:28,10.95,Purchase,Grocery,-3945.156344
14139,715047333,6-27-24 17:28,451.17,Withdrawal,ATM Withdrawal,-4396.326344
14140,715047333,6-28-24 19:28,34.55,IncomingTransfer,Freelance Payment,-4361.776344
14141,715047333,6-30-24 13:28,348.77,OnlineShopping,Etsy,-4710.546344
14142,715047333,07-02-24 15:28,50,Withdrawal,Branch Withdrawal,-4760.546344
14143,715047333,07-06-24 19:28,145.04,Withdrawal,Branch Withdrawal,-4905.586344
14144,715047333,07-07-24 16:28,464.73,Withdrawal,Mobile App Withdrawal,-5370.316344
14145,715047333,07-08-24 22:28,375.8,Deposit,Mobile Deposit,-4994.516344
14146,715047333,07-09-24 13:28,163.71,Payment,Loan Payment,-5158.226344
14147,715047333,07-09-24 22:28,72.81,OutgoingTransfer,Peer-to-Peer Transfer,-5231.036344
14148,715047333,07-12-24 10:28,81.88,Withdrawal,ATM Withdrawal,-5312.916344
14149,715047333,7-13-24 14:28,64.66,Purchase,Clothing,-5377.576344
14150,715047333,7-13-24 20:28,298.99,Withdrawal,Branch Withdrawal,-5676.566344
14151,715047333,7-14-24 18:28,412.13,Purchase,Clothing,-6088.696344
14152,715047333,7-15-24 21:28,40.44,OutgoingTransfer,International Transfer,-6129.136344
14153,715047333,7-16-24 21:28,287.97,Purchase,Electronics,-6417.106344
14154,715072533,1-20-24 16:28,325.23,OutgoingTransfer,International Transfer,-325.23
14155,715072533,1-23-24 12:28,25.18,Purchase,Pharmacy,-350.41
14156,715072533,1-27-24 13:28,257.31,Purchase,Entertainment,-607.72
14157,715072533,1-27-24 14:28,185.25,Withdrawal,Branch Withdrawal,-792.97
14158,715072533,1-28-24 11:28,302.41,Withdrawal,Branch Withdrawal,-1095.38
14159,715072533,1-31-24 11:28,35.4,OutgoingTransfer,Wire Transfer,-1130.78
14160,715072533,02-03-24 20:28,40.14,Deposit,Mobile Deposit,-1090.64
14161,715072533,02-05-24 21:28,4000,IncomingTransfer,Salary,2909.36
14162,715072533,02-05-24 23:28,131.26,Return,Amazon Return,3040.62
14163,715072533,02-08-24 11:28,115.42,Withdrawal,Mobile App Withdrawal,2925.2
14164,715072533,02-09-24 10:28,342.07,Withdrawal,Branch Withdrawal,2583.13
14165,715072533,02-09-24 21:28,160.51,Withdrawal,Branch Withdrawal,2422.62
14166,715072533,02-11-24 13:28,92.77,Purchase,Pharmacy,2329.85
14167,715072533,02-12-24 10:28,265.64,Return,AliExpress Return,2595.49
14168,715072533,2-14-24 18:28,119.25,Purchase,Electronics,2476.24
14169,715072533,2-17-24 14:28,197,Return,Amazon Return,2673.24
14170,715072533,2-17-24 21:28,1700,Payment,Subscription Payment,973.24
14171,715072533,2-21-24 9:28,232.5,Withdrawal,Mobile App Withdrawal,740.74
14172,715072533,2-21-24 23:28,184.5,Payment,Bill Payment,556.24
14173,715072533,2-23-24 23:28,93.11,OutgoingTransfer,Bank Transfer,463.13
14174,715072533,03-01-24 16:28,133.94,Purchase,Home Improvement,329.19
14175,715072533,03-02-24 22:28,231.24,Purchase,Restaurant,97.95
14176,715072533,03-03-24 21:28,4000,IncomingTransfer,Salary,4097.95
14177,715072533,03-06-24 13:28,173.91,Deposit,Check Deposit,4271.86
14178,715072533,03-07-24 21:28,272.68,Deposit,Direct Deposit,4544.54
14179,715072533,03-08-24 9:28,60,Withdrawal,Branch Withdrawal,4484.54
14180,715072533,03-09-24 12:28,101.67,Deposit,Direct Deposit,4586.21
14181,715072533,03-10-24 12:28,398.41,Deposit,Mobile Deposit,4984.62
14182,715072533,03-12-24 14:28,229.31,Return,Etsy Return,5213.93
14183,715072533,03-12-24 20:28,263,Withdrawal,Mobile App Withdrawal,4950.93
14184,715072533,3-13-24 13:28,187.96,OnlineShopping,Etsy,4762.97
14185,715072533,3-13-24 13:28,140.27,OnlineShopping,Best Buy,4622.7
14186,715072533,3-17-24 20:28,79.6,OutgoingTransfer,International Transfer,4543.1
14187,715072533,3-17-24 21:28,1700,Payment,Subscription Payment,2843.1
14188,715072533,3-17-24 21:28,323.62,IncomingTransfer,Freelance Payment,3166.72
14189,715072533,3-20-24 11:28,60.19,Return,Walmart Return,3226.91
14190,715072533,3-21-24 20:28,309.42,OnlineShopping,eBay,2917.49
14191,715072533,3-23-24 17:28,205.46,Payment,Mortgage Payment,2712.03
14192,715072533,3-24-24 17:28,359.95,Deposit,Check Deposit,3071.98
14193,715072533,3-25-24 23:28,196.53,Withdrawal,Mobile App Withdrawal,2875.45
14194,715072533,3-26-24 18:28,174.56,Withdrawal,Branch Withdrawal,2700.89
14195,715072533,04-04-24 21:28,4000,IncomingTransfer,Salary,6700.89
14196,715072533,04-07-24 19:28,263.05,Withdrawal,Branch Withdrawal,6437.84
14197,715072533,04-08-24 15:28,134.19,OutgoingTransfer,Wire Transfer,6303.65
14198,715072533,04-10-24 18:28,135.31,Deposit,Cash Deposit,6438.96
14199,715072533,04-11-24 21:28,1700,Payment,Insurance Payment,4738.96
14200,715072533,04-12-24 16:28,25.46,Purchase,Home Improvement,4713.5
14201,715072533,4-14-24 10:28,396.27,OnlineShopping,Walmart,4317.23
14202,715072533,4-26-24 20:28,229.01,Purchase,Home Improvement,4088.22
14203,715072533,4-26-24 23:28,72.05,Purchase,Entertainment,4016.17
14204,715072533,4-30-24 16:28,380.94,Withdrawal,ATM Withdrawal,3635.23
14205,715072533,05-01-24 21:28,4000,IncomingTransfer,Salary,7635.23
14206,715072533,05-08-24 12:28,242.21,Purchase,Electronics,7393.02
14207,715072533,05-09-24 11:28,212.92,Withdrawal,Mobile App Withdrawal,7180.1
14208,715072533,05-10-24 21:28,1700,Payment,Subscription Payment,5480.1
14209,715072533,05-11-24 11:28,224.11,OnlineShopping,Target,5255.99
14210,715072533,5-15-24 9:28,398.12,Deposit,Direct Deposit,5654.11
14211,715072533,5-15-24 21:28,182.53,IncomingTransfer,Freelance Payment,5836.64
14212,715072533,5-20-24 17:28,302.87,OutgoingTransfer,Bank Transfer,5533.77
14213,715072533,5-24-24 11:28,196.34,Purchase,Home Improvement,5337.43
14214,715072533,5-27-24 12:28,386.95,Purchase,Electronics,4950.48
14215,715072533,5-30-24 22:28,353.38,Deposit,Cash Deposit,5303.86
14216,715072533,06-02-24 16:28,117.61,Payment,Mortgage Payment,5186.25
14217,715072533,06-02-24 21:28,4000,IncomingTransfer,Salary,9186.25
14218,715072533,06-07-24 12:28,399.38,OutgoingTransfer,Bank Transfer,8786.87
14219,715072533,06-11-24 17:28,316.05,Withdrawal,Mobile App Withdrawal,8470.82
14220,715072533,06-12-24 21:28,1100,Payment,Subscription Payment,7370.82
14221,715072533,06-12-24 23:28,105.81,Deposit,Cash Deposit,7476.63
14222,715072533,6-16-24 19:28,356.92,Payment,Mortgage Payment,7119.71
14223,715072533,6-16-24 19:28,336.5,Deposit,Mobile Deposit,7456.21
14224,715072533,6-17-24 20:28,49.48,OnlineShopping,Target,7406.73
14225,715072533,6-20-24 18:28,210.9,Deposit,Check Deposit,7617.63
14226,715072533,6-21-24 12:28,205.31,OutgoingTransfer,Wire Transfer,7412.32
14227,715072533,6-22-24 16:28,219.47,Withdrawal,ATM Withdrawal,7192.85
14228,715072533,6-28-24 11:28,134.19,Return,Target Return,7327.04
14229,715072533,6-29-24 10:28,36.89,OutgoingTransfer,Peer-to-Peer Transfer,7290.15
14230,715072533,07-01-24 10:28,149.78,Deposit,Mobile Deposit,7439.93
14231,715072533,07-01-24 21:28,342.86,Payment,Mortgage Payment,7097.07
14232,715072533,07-04-24 21:28,4000,IncomingTransfer,Salary,11097.07
14233,715072533,07-06-24 14:28,67.36,Withdrawal,ATM Withdrawal,11029.71
14234,715072533,07-07-24 19:28,154.84,OnlineShopping,AliExpress,10874.87
14235,715072533,07-07-24 22:28,133,OnlineShopping,Target,10741.87
14236,715072533,07-10-24 20:28,24.49,Deposit,Check Deposit,10766.36
14237,715072533,07-12-24 21:28,1200,Payment,Insurance Payment,9566.36
14238,715072533,7-13-24 10:28,85.75,Payment,Bill Payment,9480.61
14239,715072533,7-15-24 17:28,52.49,Purchase,Restaurant,9428.12
14240,715072533,7-17-24 12:28,108.41,Withdrawal,ATM Withdrawal,9319.71
14241,715077483,1-20-24 15:28,182.08,OnlineShopping,Amazon,404.3507804
14242,715077483,1-23-24 18:28,55.2,Payment,Mortgage Payment,349.1507804
14243,715077483,1-27-24 10:28,195.38,Purchase,Gas,153.7707804
14244,715077483,1-31-24 9:28,47.06,Payment,Loan Payment,106.7107804
14245,715077483,1-31-24 16:28,38.48,OnlineShopping,eBay,68.23078042
14246,715077483,02-01-24 19:28,96.7,Deposit,Direct Deposit,164.9307804
14247,715077483,02-02-24 21:28,2650,IncomingTransfer,Salary,2814.93078
14248,715077483,02-03-24 19:28,22.4,Deposit,Cash Deposit,2837.33078
14249,715077483,02-07-24 21:28,1000,Payment,Credit Card Payment,1837.33078
14250,715077483,2-18-24 21:28,1000,Payment,Subscription Payment,837.3307804
14251,715077483,03-03-24 21:28,2650,IncomingTransfer,Salary,3487.33078
14252,715077483,03-05-24 13:28,154.07,OnlineShopping,Walmart,3333.26078
14253,715077483,03-07-24 12:28,208.15,Withdrawal,Mobile App Withdrawal,3125.11078
14254,715077483,03-08-24 21:28,900,Payment,Credit Card Payment,2225.11078
14255,715077483,03-12-24 9:28,174.33,Withdrawal,ATM Withdrawal,2050.78078
14256,715077483,3-14-24 9:28,238.07,Withdrawal,Mobile App Withdrawal,1812.71078
14257,715077483,3-18-24 21:28,1000,Payment,Insurance Payment,812.7107804
14258,715077483,3-20-24 10:28,15.66,Payment,Mortgage Payment,797.0507804
14259,715077483,3-20-24 13:28,220.7,Payment,Mortgage Payment,576.3507804
14260,715077483,3-20-24 22:28,189.65,Return,Amazon Return,766.0007804
14261,715077483,3-22-24 20:28,150.27,Purchase,Pharmacy,615.7307804
14262,715077483,3-25-24 20:28,218.45,OutgoingTransfer,International Transfer,397.2807804
14263,715077483,3-27-24 14:28,214.96,Purchase,Gas,182.3207804
14264,715077483,04-02-24 21:28,2650,IncomingTransfer,Salary,2832.32078
14265,715077483,04-05-24 21:28,104.57,Return,Best Buy Return,2936.89078
14266,715077483,04-07-24 17:28,155.6,IncomingTransfer,Freelance Payment,3092.49078
14267,715077483,04-07-24 21:28,1200,Payment,Credit Card Payment,1892.49078
14268,715077483,4-15-24 15:28,172.56,Deposit,Check Deposit,2065.05078
14269,715077483,4-17-24 16:28,175.29,Deposit,Direct Deposit,2240.34078
14270,715077483,4-18-24 21:28,1200,Payment,Installment Payment,1040.34078
14271,715077483,4-19-24 12:28,193.92,Withdrawal,ATM Withdrawal,846.4207804
14272,715077483,4-27-24 21:28,143.76,OutgoingTransfer,Wire Transfer,702.6607804
14273,715077483,05-01-24 21:28,2650,IncomingTransfer,Salary,3352.66078
14274,715077483,05-06-24 21:28,800,Payment,Credit Card Payment,2552.66078
14275,715077483,05-08-24 22:28,189.26,Purchase,Travel,2363.40078
14276,715077483,05-11-24 17:28,133.42,Deposit,Direct Deposit,2496.82078
14277,715077483,5-14-24 21:28,1100,Payment,Subscription Payment,1396.82078
14278,715077483,5-15-24 12:28,58.64,IncomingTransfer,Freelance Payment,1455.46078
14279,715077483,5-18-24 14:28,195.87,Return,Target Return,1651.33078
14280,715077483,5-22-24 12:28,55.42,Deposit,Cash Deposit,1706.75078
14281,715077483,5-22-24 20:28,45.59,IncomingTransfer,Freelance Payment,1752.34078
14282,715077483,5-23-24 9:28,197.06,Purchase,Restaurant,1555.28078
14283,715077483,06-01-24 21:28,2650,IncomingTransfer,Salary,4205.28078
14284,715077483,06-02-24 21:28,17.42,Purchase,Home Improvement,4187.86078
14285,715077483,06-03-24 14:28,245.21,Deposit,Cash Deposit,4433.07078
14286,715077483,06-04-24 23:28,248.43,OutgoingTransfer,International Transfer,4184.64078
14287,715077483,06-06-24 21:28,900,Payment,Credit Card Payment,3284.64078
14288,715077483,06-07-24 15:28,20.87,Withdrawal,ATM Withdrawal,3263.77078
14289,715077483,06-11-24 10:28,11.74,Deposit,Cash Deposit,3275.51078
14290,715077483,06-12-24 22:28,205.35,Return,Amazon Return,3480.86078
14291,715077483,6-13-24 22:28,56.11,Payment,Mortgage Payment,3424.75078
14292,715077483,6-15-24 18:28,49.23,Return,Amazon Return,3473.98078
14293,715077483,6-16-24 21:28,700,Payment,Insurance Payment,2773.98078
14294,715077483,6-18-24 23:28,231.92,Payment,Mortgage Payment,2542.06078
14295,715077483,07-03-24 21:28,2650,IncomingTransfer,Salary,5192.06078
14296,715077483,07-08-24 21:28,1000,Payment,Credit Card Payment,4192.06078
14297,715077483,07-11-24 13:28,46.33,Payment,Mortgage Payment,4145.73078
14298,715077483,7-15-24 21:28,800,Payment,Installment Payment,3345.73078
14299,715129983,1-20-24 22:28,442.92,Purchase,Restaurant,-442.92
14300,715129983,1-21-24 20:28,472.49,Purchase,Gas,-915.41
14301,715129983,1-23-24 14:28,482.63,OutgoingTransfer,International Transfer,-1398.04
14302,715129983,1-23-24 14:28,221.74,Deposit,Cash Deposit,-1176.3
14303,715129983,1-23-24 19:28,391.63,OutgoingTransfer,International Transfer,-1567.93
14304,715129983,1-24-24 18:28,475.96,IncomingTransfer,Freelance Payment,-1091.97
14305,715129983,1-24-24 21:28,178.95,Deposit,Mobile Deposit,-913.02
14306,715129983,1-25-24 9:28,231.03,Withdrawal,Branch Withdrawal,-1144.05
14307,715129983,1-25-24 17:28,216.65,Withdrawal,Mobile App Withdrawal,-1360.7
14308,715129983,1-25-24 23:28,129.64,Purchase,Furniture,-1490.34
14309,715129983,1-27-24 19:28,292.75,Deposit,Check Deposit,-1197.59
14310,715129983,1-30-24 9:28,119.88,Deposit,Mobile Deposit,-1077.71
14311,715129983,1-30-24 10:28,228.8,OnlineShopping,AliExpress,-1306.51
14312,715129983,1-31-24 23:28,480.14,Withdrawal,Mobile App Withdrawal,-1786.65
14313,715129983,02-05-24 21:28,2300,IncomingTransfer,Salary,513.35
14314,715129983,02-05-24 23:28,291.24,Deposit,Mobile Deposit,804.59
14315,715129983,02-06-24 11:28,462.55,Withdrawal,Branch Withdrawal,342.04
14316,715129983,02-06-24 21:28,183.49,Payment,Loan Payment,158.55
14317,715129983,02-07-24 12:28,370.19,OnlineShopping,eBay,-211.64
14318,715129983,02-10-24 19:28,381.83,Return,Target Return,170.19
14319,715129983,02-11-24 10:28,485.61,Withdrawal,Mobile App Withdrawal,-315.42
14320,715129983,02-12-24 10:28,398.83,Deposit,Cash Deposit,83.41
14321,715129983,02-12-24 10:28,88.24,OutgoingTransfer,Peer-to-Peer Transfer,-4.83
14322,715129983,02-12-24 20:28,77.47,Purchase,Grocery,-82.3
14323,715129983,2-13-24 21:28,1200,Payment,Rent Payment,-1282.3
14324,715129983,2-19-24 10:28,414.53,OnlineShopping,Amazon,-1696.83
14325,715129983,2-21-24 21:28,493.8,Payment,Loan Payment,-2190.63
14326,715129983,2-24-24 11:28,135.37,Deposit,Mobile Deposit,-2055.26
14327,715129983,2-25-24 10:28,433.08,OnlineShopping,Target,-2488.34
14328,715129983,2-26-24 18:28,27.22,Purchase,Pharmacy,-2515.56
14329,715129983,2-26-24 20:28,497.18,Purchase,Grocery,-3012.74
14330,715129983,2-27-24 13:28,226.06,Purchase,Grocery,-3238.8
14331,715129983,2-28-24 13:28,178.91,Purchase,Restaurant,-3417.71
14332,715129983,2-28-24 18:28,135.76,OnlineShopping,AliExpress,-3553.47
14333,715129983,2-29-24 9:28,203.98,Purchase,Restaurant,-3757.45
14334,715129983,03-01-24 21:28,2300,IncomingTransfer,Salary,-1457.45
14335,715129983,03-02-24 12:28,187.25,Payment,Loan Payment,-1644.7
14336,715129983,03-02-24 15:28,94.69,Deposit,Cash Deposit,-1550.01
14337,715129983,03-04-24 15:28,407.83,Purchase,Clothing,-1957.84
14338,715129983,03-09-24 20:28,219.4,Withdrawal,ATM Withdrawal,-2177.24
14339,715129983,03-10-24 11:28,223.9,Withdrawal,ATM Withdrawal,-2401.14
14340,715129983,03-12-24 16:28,394.69,Purchase,Clothing,-2795.83
14341,715129983,03-12-24 19:28,50.73,Return,Best Buy Return,-2745.1
14342,715129983,3-14-24 19:28,286.46,Purchase,Home Improvement,-3031.56
14343,715129983,3-15-24 21:28,1500,Payment,Rent Payment,-4531.56
14344,715129983,3-21-24 11:28,58.58,Purchase,Gas,-4590.14
14345,715129983,3-22-24 10:28,185.61,IncomingTransfer,Freelance Payment,-4404.53
14346,715129983,3-23-24 16:28,109.1,Deposit,Check Deposit,-4295.43
14347,715129983,3-26-24 12:28,349.4,OnlineShopping,Target,-4644.83
14348,715129983,3-27-24 12:28,78.99,IncomingTransfer,Freelance Payment,-4565.84
14349,715129983,3-29-24 20:28,401.62,Return,eBay Return,-4164.22
14350,715129983,3-31-24 13:28,321.36,Deposit,Check Deposit,-3842.86
14351,715129983,04-03-24 12:28,79.17,Withdrawal,Branch Withdrawal,-3922.03
14352,715129983,04-03-24 21:28,2300,IncomingTransfer,Salary,-1622.03
14353,715129983,04-03-24 22:28,182.42,Deposit,Check Deposit,-1439.61
14354,715129983,04-03-24 23:28,194.81,Deposit,Direct Deposit,-1244.8
14355,715129983,04-04-24 19:28,130.01,Deposit,Cash Deposit,-1114.79
14356,715129983,04-04-24 20:28,477.64,Deposit,Direct Deposit,-637.15
14357,715129983,04-06-24 11:28,385,Withdrawal,Branch Withdrawal,-1022.15
14358,715129983,04-09-24 19:28,205.74,Withdrawal,ATM Withdrawal,-1227.89
14359,715129983,04-09-24 19:28,122.12,Deposit,Check Deposit,-1105.77
14360,715129983,04-10-24 11:28,19.53,Withdrawal,Mobile App Withdrawal,-1125.3
14361,715129983,04-10-24 15:28,394.46,Deposit,Cash Deposit,-730.84
14362,715129983,04-10-24 21:28,1400,Payment,Rent Payment,-2130.84
14363,715129983,4-14-24 16:28,454.22,OnlineShopping,Amazon,-2585.06
14364,715129983,4-16-24 22:28,55.78,Withdrawal,Branch Withdrawal,-2640.84
14365,715129983,4-18-24 17:28,224.03,Return,Best Buy Return,-2416.81
14366,715129983,4-20-24 17:28,256.87,Return,Best Buy Return,-2159.94
14367,715129983,4-24-24 15:28,332.56,Deposit,Check Deposit,-1827.38
14368,715129983,4-24-24 22:28,89.77,IncomingTransfer,Freelance Payment,-1737.61
14369,715129983,4-27-24 22:28,361.48,Deposit,Mobile Deposit,-1376.13
14370,715129983,05-02-24 21:28,2300,IncomingTransfer,Salary,923.87
14371,715129983,05-03-24 16:28,387.93,Deposit,Check Deposit,1311.8
14372,715129983,05-03-24 17:28,267.14,OutgoingTransfer,Wire Transfer,1044.66
14373,715129983,05-05-24 15:28,222.53,Purchase,Entertainment,822.13
14374,715129983,05-05-24 21:28,323.53,OnlineShopping,eBay,498.6
14375,715129983,05-06-24 10:28,434.46,Purchase,Restaurant,64.14
14376,715129983,05-06-24 14:28,89.91,Purchase,Furniture,-25.77
14377,715129983,05-07-24 20:28,117.19,Withdrawal,Branch Withdrawal,-142.96
14378,715129983,05-07-24 22:28,481.49,Deposit,Cash Deposit,338.53
14379,715129983,05-09-24 21:28,179.97,OutgoingTransfer,Peer-to-Peer Transfer,158.56
14380,715129983,05-10-24 18:28,180.49,Purchase,Pharmacy,-21.93
14381,715129983,05-10-24 21:28,900,Payment,Rent Payment,-921.93
14382,715129983,05-12-24 16:28,181.33,Deposit,Cash Deposit,-740.6
14383,715129983,5-13-24 14:28,451.16,Purchase,Furniture,-1191.76
14384,715129983,5-13-24 21:28,180.41,Deposit,Direct Deposit,-1011.35
14385,715129983,5-13-24 23:28,25.81,Deposit,Check Deposit,-985.54
14386,715129983,5-16-24 9:28,316.5,Withdrawal,ATM Withdrawal,-1302.04
14387,715129983,5-16-24 18:28,92.24,OutgoingTransfer,Wire Transfer,-1394.28
14388,715129983,5-22-24 18:28,217.75,OnlineShopping,Best Buy,-1612.03
14389,715129983,5-23-24 9:28,496.86,Purchase,Grocery,-2108.89
14390,715129983,5-26-24 13:28,148.63,OnlineShopping,Amazon,-2257.52
14391,715129983,5-26-24 14:28,329.82,Return,Etsy Return,-1927.7
14392,715129983,5-30-24 9:28,46.55,Withdrawal,Branch Withdrawal,-1974.25
14393,715129983,5-30-24 12:28,471.42,Purchase,Pharmacy,-2445.67
14394,715129983,06-01-24 19:28,408.26,Return,Target Return,-2037.41
14395,715129983,06-03-24 11:28,235.08,Deposit,Check Deposit,-1802.33
14396,715129983,06-03-24 13:28,39.15,Purchase,Restaurant,-1841.48
14397,715129983,06-04-24 21:28,2300,IncomingTransfer,Salary,458.52
14398,715129983,06-07-24 15:28,467.49,Purchase,Home Improvement,-8.97
14399,715129983,06-10-24 12:28,431.18,Deposit,Check Deposit,422.21
14400,715129983,06-10-24 16:28,230.02,Withdrawal,ATM Withdrawal,192.19
14401,715129983,06-11-24 14:28,168.04,OutgoingTransfer,Wire Transfer,24.15
14402,715129983,6-13-24 21:28,800,Payment,Rent Payment,-775.85
14403,715129983,6-13-24 22:28,58.1,OnlineShopping,Walmart,-833.95
14404,715129983,6-16-24 16:28,435.19,Return,Etsy Return,-398.76
14405,715129983,6-16-24 21:28,111.32,Deposit,Check Deposit,-287.44
14406,715129983,6-19-24 17:28,43.56,Purchase,Restaurant,-331
14407,715129983,6-19-24 22:28,126.72,OnlineShopping,Walmart,-457.72
14408,715129983,6-25-24 13:28,481.99,OnlineShopping,Target,-939.71
14409,715129983,6-25-24 20:28,371.52,Purchase,Home Improvement,-1311.23
14410,715129983,6-27-24 13:28,189.93,Return,Target Return,-1121.3
14411,715129983,6-28-24 15:28,109.23,Withdrawal,Branch Withdrawal,-1230.53
14412,715129983,6-28-24 16:28,162.86,OutgoingTransfer,Peer-to-Peer Transfer,-1393.39
14413,715129983,6-28-24 20:28,156.85,Deposit,Check Deposit,-1236.54
14414,715129983,6-30-24 19:28,298.8,Deposit,Check Deposit,-937.74
14415,715129983,07-01-24 21:28,2300,IncomingTransfer,Salary,1362.26
14416,715129983,07-03-24 13:28,76.56,Purchase,Travel,1285.7
14417,715129983,07-05-24 13:28,66.85,Deposit,Mobile Deposit,1352.55
14418,715129983,07-07-24 20:28,349.81,Purchase,Gas,1002.74
14419,715129983,07-08-24 12:28,255.11,Deposit,Check Deposit,1257.85
14420,715129983,07-09-24 23:28,76.18,Purchase,Home Improvement,1181.67
14421,715129983,07-10-24 9:28,110.85,Deposit,Check Deposit,1292.52
14422,715129983,07-10-24 16:28,497.7,IncomingTransfer,Freelance Payment,1790.22
14423,715129983,7-13-24 20:28,263.15,Deposit,Cash Deposit,2053.37
14424,715129983,7-14-24 21:28,900,Payment,Rent Payment,1153.37
14425,715129983,7-15-24 23:28,12.11,Withdrawal,Mobile App Withdrawal,1141.26
14426,715129983,7-17-24 17:28,165.4,Withdrawal,Branch Withdrawal,975.86
14427,715154058,1-21-24 13:28,76.05,Deposit,Mobile Deposit,2140.798642
14428,715154058,1-25-24 10:28,58.57,Withdrawal,ATM Withdrawal,2082.228642
14429,715154058,1-27-24 19:28,149.66,Return,Walmart Return,2231.888642
14430,715154058,02-02-24 21:28,1800,IncomingTransfer,Salary,4031.888642
14431,715154058,02-06-24 17:28,212.92,Purchase,Gas,3818.968642
14432,715154058,02-06-24 19:28,139.02,Withdrawal,Mobile App Withdrawal,3679.948642
14433,715154058,02-07-24 21:28,3000,Payment,Credit Card Payment,679.9486421
14434,715154058,02-09-24 10:28,55.18,Deposit,Cash Deposit,735.1286421
14435,715154058,2-14-24 19:28,106.42,Purchase,Electronics,628.7086421
14436,715154058,2-16-24 22:28,163.03,Payment,Bill Payment,465.6786421
14437,715154058,2-17-24 21:28,165.17,OnlineShopping,Walmart,300.5086421
14438,715154058,2-18-24 21:28,1100,Payment,Rent Payment,-799.4913579
14439,715154058,2-19-24 21:28,215.46,Deposit,Direct Deposit,-584.0313579
14440,715154058,2-22-24 9:28,192.61,Return,Etsy Return,-391.4213579
14441,715154058,2-28-24 17:28,99.44,Payment,Loan Payment,-490.8613579
14442,715154058,03-01-24 21:28,22.36,Deposit,Cash Deposit,-468.5013579
14443,715154058,03-04-24 21:28,1800,IncomingTransfer,Salary,1331.498642
14444,715154058,03-05-24 22:28,217.83,Withdrawal,Branch Withdrawal,1113.668642
14445,715154058,03-09-24 20:28,64.5,OnlineShopping,AliExpress,1049.168642
14446,715154058,03-09-24 21:28,3400,Payment,Credit Card Payment,-2350.831358
14447,715154058,03-12-24 21:28,800,Payment,Rent Payment,-3150.831358
14448,715154058,3-14-24 15:28,89.58,Payment,Mortgage Payment,-3240.411358
14449,715154058,3-15-24 19:28,59.94,Withdrawal,Mobile App Withdrawal,-3300.351358
14450,715154058,3-16-24 22:28,198.93,Deposit,Cash Deposit,-3101.421358
14451,715154058,3-22-24 17:28,64.24,Payment,Mortgage Payment,-3165.661358
14452,715154058,3-25-24 10:28,175.31,OutgoingTransfer,International Transfer,-3340.971358
14453,715154058,3-25-24 16:28,79.93,IncomingTransfer,Freelance Payment,-3261.041358
14454,715154058,3-27-24 20:28,101.95,Deposit,Check Deposit,-3159.091358
14455,715154058,3-29-24 9:28,64.13,IncomingTransfer,Freelance Payment,-3094.961358
14456,715154058,3-29-24 17:28,24.09,OutgoingTransfer,International Transfer,-3119.051358
14457,715154058,3-29-24 17:28,248.13,Purchase,Travel,-3367.181358
14458,715154058,3-31-24 12:28,183.19,Purchase,Pharmacy,-3550.371358
14459,715154058,3-31-24 14:28,177.76,Deposit,Check Deposit,-3372.611358
14460,715154058,3-31-24 22:28,156.56,OnlineShopping,Best Buy,-3529.171358
14461,715154058,04-02-24 11:28,126.52,Withdrawal,Branch Withdrawal,-3655.691358
14462,715154058,04-05-24 11:28,86.26,Payment,Bill Payment,-3741.951358
14463,715154058,04-05-24 19:28,120.36,Deposit,Direct Deposit,-3621.591358
14464,715154058,04-05-24 21:28,1800,IncomingTransfer,Salary,-1821.591358
14465,715154058,04-07-24 17:28,234.97,Withdrawal,ATM Withdrawal,-2056.561358
14466,715154058,04-09-24 14:28,245.11,OnlineShopping,Best Buy,-2301.671358
14467,715154058,04-10-24 21:28,3700,Payment,Credit Card Payment,-6001.671358
14468,715154058,04-11-24 14:28,63.78,Return,Best Buy Return,-5937.891358
14469,715154058,04-11-24 16:28,153.73,Deposit,Cash Deposit,-5784.161358
14470,715154058,4-14-24 21:28,700,Payment,Rent Payment,-6484.161358
14471,715154058,4-19-24 23:28,17.39,Return,Walmart Return,-6466.771358
14472,715154058,4-20-24 20:28,135.88,Return,Walmart Return,-6330.891358
14473,715154058,4-24-24 17:28,87.2,IncomingTransfer,Freelance Payment,-6243.691358
14474,715154058,4-26-24 13:28,209.62,Withdrawal,ATM Withdrawal,-6453.311358
14475,715154058,4-28-24 14:28,229.74,Deposit,Direct Deposit,-6223.571358
14476,715154058,05-03-24 21:28,1800,IncomingTransfer,Salary,-4423.571358
14477,715154058,05-08-24 21:28,3500,Payment,Credit Card Payment,-7923.571358
14478,715154058,05-08-24 22:28,75.63,Payment,Loan Payment,-7999.201358
14479,715154058,05-12-24 12:28,80.15,Withdrawal,Mobile App Withdrawal,-8079.351358
14480,715154058,5-16-24 21:28,1100,Payment,Rent Payment,-9179.351358
14481,715154058,5-16-24 23:28,204.9,Withdrawal,ATM Withdrawal,-9384.251358
14482,715154058,5-25-24 18:28,17.31,Payment,Mortgage Payment,-9401.561358
14483,715154058,5-26-24 10:28,173.42,Withdrawal,Mobile App Withdrawal,-9574.981358
14484,715154058,5-29-24 10:28,96.98,Deposit,Cash Deposit,-9478.001358
14485,715154058,06-05-24 21:28,1800,IncomingTransfer,Salary,-7678.001358
14486,715154058,06-08-24 19:28,141.73,Deposit,Mobile Deposit,-7536.271358
14487,715154058,06-10-24 9:28,41.19,Purchase,Gas,-7577.461358
14488,715154058,06-10-24 10:28,182.71,Withdrawal,ATM Withdrawal,-7760.171358
14489,715154058,06-10-24 21:28,3200,Payment,Credit Card Payment,-10960.17136
14490,715154058,06-12-24 11:28,144.18,Purchase,Restaurant,-11104.35136
14491,715154058,06-12-24 21:28,800,Payment,Rent Payment,-11904.35136
14492,715154058,6-14-24 14:28,220.04,Deposit,Direct Deposit,-11684.31136
14493,715154058,6-17-24 15:28,39.76,Return,Best Buy Return,-11644.55136
14494,715154058,6-18-24 21:28,210.94,Deposit,Cash Deposit,-11433.61136
14495,715154058,6-22-24 19:28,195.54,Return,Walmart Return,-11238.07136
14496,715154058,6-25-24 10:28,162.42,Return,eBay Return,-11075.65136
14497,715154058,6-27-24 12:28,133.95,Deposit,Cash Deposit,-10941.70136
14498,715154058,07-01-24 19:28,161.06,Deposit,Check Deposit,-10780.64136
14499,715154058,07-03-24 21:28,1800,IncomingTransfer,Salary,-8980.641358
14500,715154058,07-06-24 12:28,176.51,Deposit,Check Deposit,-8804.131358
14501,715154058,07-08-24 12:28,99.8,Purchase,Grocery,-8903.931358
14502,715154058,07-08-24 21:28,3300,Payment,Credit Card Payment,-12203.93136
14503,715154058,07-10-24 22:28,128.73,Withdrawal,ATM Withdrawal,-12332.66136
14504,715154058,07-11-24 22:28,178.54,Deposit,Cash Deposit,-12154.12136
14505,715154058,7-13-24 19:28,37.09,Return,Amazon Return,-12117.03136
14506,715154058,7-14-24 22:28,104.46,IncomingTransfer,Freelance Payment,-12012.57136
14507,715154058,7-15-24 18:28,16.51,Payment,Bill Payment,-12029.08136
14508,715154058,7-17-24 16:28,191.42,OutgoingTransfer,Peer-to-Peer Transfer,-12220.50136
14509,715154058,7-18-24 21:28,800,Payment,Rent Payment,-13020.50136
14510,715327683,1-26-24 10:28,205.56,Withdrawal,Mobile App Withdrawal,1472.800575
14511,715327683,1-29-24 16:28,12.75,OutgoingTransfer,Bank Transfer,1460.050575
14512,715327683,1-31-24 10:28,163.83,Deposit,Check Deposit,1623.880575
14513,715327683,1-31-24 16:28,96.71,Deposit,Check Deposit,1720.590575
14514,715327683,02-02-24 13:28,120.21,Purchase,Pharmacy,1600.380575
14515,715327683,02-03-24 20:28,185.21,Purchase,Clothing,1415.170575
14516,715327683,02-05-24 12:28,87.18,Payment,Loan Payment,1327.990575
14517,715327683,02-05-24 18:28,83.83,IncomingTransfer,Freelance Payment,1411.820575
14518,715327683,02-07-24 9:28,166.85,OutgoingTransfer,Peer-to-Peer Transfer,1244.970575
14519,715327683,02-10-24 11:28,202.08,Purchase,Travel,1042.890575
14520,715327683,02-10-24 15:28,34.04,Purchase,Restaurant,1008.850575
14521,715327683,2-14-24 12:28,177.19,Deposit,Mobile Deposit,1186.040575
14522,715327683,2-15-24 12:28,244.61,Deposit,Cash Deposit,1430.650575
14523,715327683,2-20-24 11:28,95.2,Withdrawal,Branch Withdrawal,1335.450575
14524,715327683,2-20-24 17:28,113.86,IncomingTransfer,Freelance Payment,1449.310575
14525,715327683,2-27-24 11:28,111.49,Withdrawal,ATM Withdrawal,1337.820575
14526,715327683,2-29-24 13:28,241.12,Withdrawal,ATM Withdrawal,1096.700575
14527,715327683,03-08-24 15:28,41.43,Purchase,Travel,1055.270575
14528,715327683,3-21-24 9:28,198.74,Withdrawal,Branch Withdrawal,856.5305749
14529,715327683,3-22-24 22:28,232.92,Purchase,Pharmacy,623.6105749
14530,715327683,3-26-24 12:28,63.84,Purchase,Entertainment,559.7705749
14531,715327683,3-30-24 13:28,163.37,Purchase,Furniture,396.4005749
14532,715327683,3-31-24 13:28,21.76,Deposit,Cash Deposit,418.1605749
14533,715327683,04-08-24 13:28,44.45,Purchase,Travel,373.7105749
14534,715327683,04-09-24 13:28,223.66,OutgoingTransfer,International Transfer,150.0505749
14535,715327683,04-10-24 12:28,231.62,Withdrawal,ATM Withdrawal,-81.5694251
14536,715327683,04-12-24 13:28,16.17,Payment,Loan Payment,-97.7394251
14537,715327683,4-13-24 15:28,184.35,OutgoingTransfer,Peer-to-Peer Transfer,-282.0894251
14538,715327683,4-14-24 12:28,156.49,OnlineShopping,AliExpress,-438.5794251
14539,715327683,4-14-24 18:28,28.74,Withdrawal,Mobile App Withdrawal,-467.3194251
14540,715327683,4-15-24 10:28,201.96,Deposit,Cash Deposit,-265.3594251
14541,715327683,4-17-24 23:28,10.39,Purchase,Furniture,-275.7494251
14542,715327683,4-18-24 10:28,98.59,Purchase,Gas,-374.3394251
14543,715327683,4-18-24 15:28,152.19,OnlineShopping,Target,-526.5294251
14544,715327683,4-18-24 19:28,230.31,Purchase,Restaurant,-756.8394251
14545,715327683,4-19-24 12:28,229.86,Purchase,Travel,-986.6994251
14546,715327683,4-24-24 16:28,162.23,Deposit,Cash Deposit,-824.4694251
14547,715327683,4-29-24 15:28,18.36,OutgoingTransfer,Peer-to-Peer Transfer,-842.8294251
14548,715327683,05-05-24 10:28,194.38,Return,AliExpress Return,-648.4494251
14549,715327683,05-09-24 9:28,109.69,Deposit,Cash Deposit,-538.7594251
14550,715327683,05-12-24 19:28,114.12,Deposit,Direct Deposit,-424.6394251
14551,715327683,5-15-24 14:28,162.54,OnlineShopping,Target,-587.1794251
14552,715327683,5-19-24 20:28,65.69,OutgoingTransfer,Peer-to-Peer Transfer,-652.8694251
14553,715327683,5-21-24 18:28,224.94,Withdrawal,Mobile App Withdrawal,-877.8094251
14554,715327683,5-23-24 18:28,180.99,IncomingTransfer,Freelance Payment,-696.8194251
14555,715327683,5-30-24 19:28,95.9,Payment,Bill Payment,-792.7194251
14556,715327683,5-31-24 15:28,170.57,Withdrawal,Branch Withdrawal,-963.2894251
14557,715327683,06-08-24 21:28,246.74,Deposit,Direct Deposit,-716.5494251
14558,715327683,06-08-24 22:28,88.06,Deposit,Check Deposit,-628.4894251
14559,715327683,6-22-24 10:28,59.99,OutgoingTransfer,Wire Transfer,-688.4794251
14560,715327683,6-23-24 16:28,131.04,OutgoingTransfer,Peer-to-Peer Transfer,-819.5194251
14561,715327683,07-04-24 20:28,50.83,Payment,Bill Payment,-870.3494251
14562,715327683,07-07-24 22:28,125.31,Return,Walmart Return,-745.0394251
14563,715327683,07-09-24 9:28,68.66,OutgoingTransfer,Wire Transfer,-813.6994251
14564,715327683,7-16-24 15:28,37.87,OutgoingTransfer,Wire Transfer,-851.5694251
14565,715340733,1-20-24 12:28,262.73,Purchase,Home Improvement,-262.73
14566,715340733,02-02-24 16:28,171.8,OutgoingTransfer,Peer-to-Peer Transfer,-434.53
14567,715340733,02-05-24 19:28,34.78,Purchase,Pharmacy,-469.31
14568,715340733,02-05-24 21:28,3450,IncomingTransfer,Salary,2980.69
14569,715340733,2-15-24 21:28,1000,Payment,Installment Payment,1980.69
14570,715340733,2-18-24 18:28,244.48,OnlineShopping,AliExpress,1736.21
14571,715340733,2-20-24 18:28,277.67,Purchase,Pharmacy,1458.54
14572,715340733,2-25-24 12:28,253.19,Purchase,Electronics,1205.35
14573,715340733,2-27-24 18:28,51.73,Purchase,Travel,1153.62
14574,715340733,2-28-24 19:28,250.72,Deposit,Direct Deposit,1404.34
14575,715340733,2-28-24 23:28,332.09,Purchase,Furniture,1072.25
14576,715340733,03-01-24 23:28,318.47,Purchase,Travel,753.78
14577,715340733,03-04-24 10:28,196.92,Return,AliExpress Return,950.7
14578,715340733,03-04-24 21:28,3450,IncomingTransfer,Salary,4400.7
14579,715340733,03-06-24 23:28,65.43,OutgoingTransfer,Bank Transfer,4335.27
14580,715340733,3-13-24 17:28,390.7,Payment,Bill Payment,3944.57
14581,715340733,3-14-24 13:28,181.13,Payment,Mortgage Payment,3763.44
14582,715340733,3-14-24 14:28,95.64,Deposit,Direct Deposit,3859.08
14583,715340733,3-15-24 10:28,187.67,Return,Store Return,4046.75
14584,715340733,3-17-24 10:28,230.76,Payment,Bill Payment,3815.99
14585,715340733,3-18-24 19:28,158.44,Withdrawal,ATM Withdrawal,3657.55
14586,715340733,3-18-24 21:28,900,Payment,Subscription Payment,2757.55
14587,715340733,3-21-24 14:28,116.45,OnlineShopping,Walmart,2641.1
14588,715340733,3-23-24 10:28,240.42,Purchase,Travel,2400.68
14589,715340733,3-26-24 23:28,233.15,Payment,Mortgage Payment,2167.53
14590,715340733,3-28-24 11:28,329.56,Deposit,Cash Deposit,2497.09
14591,715340733,3-31-24 10:28,58.76,Purchase,Pharmacy,2438.33
14592,715340733,04-04-24 16:28,210.56,OnlineShopping,Best Buy,2227.77
14593,715340733,04-05-24 21:28,3450,IncomingTransfer,Salary,5677.77
14594,715340733,04-06-24 15:28,260.98,Purchase,Clothing,5416.79
14595,715340733,04-08-24 22:28,351.03,Deposit,Direct Deposit,5767.82
14596,715340733,04-09-24 21:28,369.65,Purchase,Travel,5398.17
14597,715340733,04-11-24 19:28,137.01,Purchase,Travel,5261.16
14598,715340733,4-15-24 20:28,84.17,Withdrawal,ATM Withdrawal,5176.99
14599,715340733,4-18-24 21:28,1400,Payment,Subscription Payment,3776.99
14600,715340733,4-23-24 16:28,340.94,Purchase,Entertainment,3436.05
14601,715340733,4-23-24 16:28,293.06,OnlineShopping,Target,3142.99
14602,715340733,4-24-24 14:28,135.53,Purchase,Restaurant,3007.46
14603,715340733,4-27-24 10:28,187.15,Withdrawal,Mobile App Withdrawal,2820.31
14604,715340733,05-01-24 21:28,3450,IncomingTransfer,Salary,6270.31
14605,715340733,05-01-24 21:28,114.21,OnlineShopping,Walmart,6156.1
14606,715340733,05-03-24 17:28,277.4,Purchase,Clothing,5878.7
14607,715340733,05-04-24 13:28,157.66,OutgoingTransfer,Bank Transfer,5721.04
14608,715340733,05-04-24 20:28,249.21,Purchase,Electronics,5471.83
14609,715340733,05-10-24 16:28,109.86,Return,Store Return,5581.69
14610,715340733,05-10-24 21:28,1500,Payment,Subscription Payment,4081.69
14611,715340733,5-16-24 16:28,399.14,Purchase,Furniture,3682.55
14612,715340733,5-17-24 20:28,357.62,Purchase,Furniture,3324.93
14613,715340733,5-17-24 22:28,126.81,OutgoingTransfer,Peer-to-Peer Transfer,3198.12
14614,715340733,5-22-24 12:28,349.54,Purchase,Gas,2848.58
14615,715340733,5-24-24 20:28,90.83,Return,Amazon Return,2939.41
14616,715340733,5-27-24 11:28,345.8,Payment,Bill Payment,2593.61
14617,715340733,5-28-24 18:28,312.33,Purchase,Restaurant,2281.28
14618,715340733,5-31-24 10:28,152.83,Withdrawal,Branch Withdrawal,2128.45
14619,715340733,06-01-24 18:28,271.43,OutgoingTransfer,International Transfer,1857.02
14620,715340733,06-02-24 12:28,343.48,Payment,Bill Payment,1513.54
14621,715340733,06-04-24 21:28,3450,IncomingTransfer,Salary,4963.54
14622,715340733,06-05-24 13:28,78.11,Deposit,Cash Deposit,5041.65
14623,715340733,06-07-24 9:28,339.6,IncomingTransfer,Freelance Payment,5381.25
14624,715340733,06-08-24 14:28,200.44,IncomingTransfer,Freelance Payment,5581.69
14625,715340733,06-10-24 12:28,129.08,IncomingTransfer,Freelance Payment,5710.77
14626,715340733,06-10-24 14:28,235.77,Deposit,Check Deposit,5946.54
14627,715340733,06-12-24 11:28,159.34,Withdrawal,Mobile App Withdrawal,5787.2
14628,715340733,6-16-24 21:28,900,Payment,Insurance Payment,4887.2
14629,715340733,6-19-24 18:28,286.14,IncomingTransfer,Freelance Payment,5173.34
14630,715340733,6-21-24 22:28,227.76,Purchase,Entertainment,4945.58
14631,715340733,6-26-24 12:28,43.78,Payment,Mortgage Payment,4901.8
14632,715340733,6-27-24 9:28,77.24,Return,Target Return,4979.04
14633,715340733,07-03-24 22:28,279.28,Deposit,Direct Deposit,5258.32
14634,715340733,07-04-24 10:28,247.75,Purchase,Home Improvement,5010.57
14635,715340733,07-04-24 21:28,3450,IncomingTransfer,Salary,8460.57
14636,715340733,07-09-24 18:28,116.65,Deposit,Mobile Deposit,8577.22
14637,715340733,07-11-24 19:28,113.86,Deposit,Cash Deposit,8691.08
14638,715340733,07-11-24 21:28,1200,Payment,Installment Payment,7491.08
14639,715356258,1-24-24 12:28,176.46,Deposit,Cash Deposit,1472.248511
14640,715356258,1-25-24 21:28,194.27,Payment,Bill Payment,1277.978511
14641,715356258,1-26-24 20:28,151.09,Deposit,Cash Deposit,1429.068511
14642,715356258,1-29-24 18:28,113.71,Deposit,Direct Deposit,1542.778511
14643,715356258,1-31-24 20:28,106.94,Purchase,Gas,1435.838511
14644,715356258,02-02-24 15:28,142.83,Purchase,Gas,1293.008511
14645,715356258,02-04-24 21:28,1800,IncomingTransfer,Salary,3093.008511
14646,715356258,02-06-24 11:28,109.66,Purchase,Grocery,2983.348511
14647,715356258,02-07-24 19:28,140.08,Payment,Bill Payment,2843.268511
14648,715356258,02-08-24 19:28,167.7,Return,Best Buy Return,3010.968511
14649,715356258,02-09-24 21:28,1900,Payment,Credit Card Payment,1110.968511
14650,715356258,2-13-24 21:28,700,Payment,Subscription Payment,410.9685114
14651,715356258,2-14-24 18:28,68.42,IncomingTransfer,Freelance Payment,479.3885114
14652,715356258,2-16-24 12:28,191.24,Withdrawal,ATM Withdrawal,288.1485114
14653,715356258,2-16-24 19:28,24.33,Withdrawal,Branch Withdrawal,263.8185114
14654,715356258,2-23-24 20:28,175.04,Payment,Bill Payment,88.7785114
14655,715356258,2-25-24 10:28,146.35,IncomingTransfer,Freelance Payment,235.1285114
14656,715356258,2-25-24 16:28,247.62,Payment,Mortgage Payment,-12.4914886
14657,715356258,2-27-24 10:28,233.59,Purchase,Entertainment,-246.0814886
14658,715356258,2-28-24 11:28,114.55,Purchase,Home Improvement,-360.6314886
14659,715356258,2-29-24 21:28,97.47,Withdrawal,Mobile App Withdrawal,-458.1014886
14660,715356258,03-01-24 21:28,1800,IncomingTransfer,Salary,1341.898511
14661,715356258,03-02-24 19:28,157.54,Deposit,Mobile Deposit,1499.438511
14662,715356258,03-06-24 11:28,145.43,Purchase,Furniture,1354.008511
14663,715356258,03-06-24 21:28,2300,Payment,Credit Card Payment,-945.9914886
14664,715356258,03-08-24 12:28,69.19,IncomingTransfer,Freelance Payment,-876.8014886
14665,715356258,03-08-24 12:28,36.19,Withdrawal,Mobile App Withdrawal,-912.9914886
14666,715356258,03-10-24 13:28,74.97,Deposit,Direct Deposit,-838.0214886
14667,715356258,03-11-24 9:28,214.85,Withdrawal,Mobile App Withdrawal,-1052.871489
14668,715356258,03-12-24 21:28,700,Payment,Insurance Payment,-1752.871489
14669,715356258,3-19-24 9:28,233.36,Deposit,Check Deposit,-1519.511489
14670,715356258,3-25-24 9:28,156.4,Withdrawal,Mobile App Withdrawal,-1675.911489
14671,715356258,3-25-24 20:28,244.66,Purchase,Furniture,-1920.571489
14672,715356258,3-27-24 11:28,87.93,Withdrawal,Branch Withdrawal,-2008.501489
14673,715356258,3-29-24 12:28,183.85,Deposit,Check Deposit,-1824.651489
14674,715356258,3-29-24 15:28,189.56,IncomingTransfer,Freelance Payment,-1635.091489
14675,715356258,3-30-24 12:28,241.71,Purchase,Furniture,-1876.801489
14676,715356258,3-31-24 22:28,122.88,Purchase,Home Improvement,-1999.681489
14677,715356258,04-03-24 11:28,52.67,Payment,Bill Payment,-2052.351489
14678,715356258,04-03-24 21:28,1800,IncomingTransfer,Salary,-252.3514886
14679,715356258,04-08-24 21:28,1800,Payment,Credit Card Payment,-2052.351489
14680,715356258,04-10-24 20:28,160.73,Deposit,Check Deposit,-1891.621489
14681,715356258,04-11-24 14:28,59,Payment,Bill Payment,-1950.621489
14682,715356258,4-13-24 18:28,137.73,Withdrawal,Mobile App Withdrawal,-2088.351489
14683,715356258,4-13-24 21:28,500,Payment,Installment Payment,-2588.351489
14684,715356258,4-18-24 13:28,137.2,Purchase,Entertainment,-2725.551489
14685,715356258,4-21-24 10:28,130.38,OnlineShopping,Amazon,-2855.931489
14686,715356258,4-21-24 18:28,56.4,Withdrawal,ATM Withdrawal,-2912.331489
14687,715356258,4-23-24 22:28,12.46,OutgoingTransfer,Bank Transfer,-2924.791489
14688,715356258,4-24-24 17:28,133.61,OnlineShopping,Amazon,-3058.401489
14689,715356258,4-28-24 19:28,76.24,Deposit,Check Deposit,-2982.161489
14690,715356258,4-29-24 9:28,141.69,Purchase,Electronics,-3123.851489
14691,715356258,4-30-24 23:28,165.36,Deposit,Mobile Deposit,-2958.491489
14692,715356258,05-01-24 13:28,67.08,Withdrawal,ATM Withdrawal,-3025.571489
14693,715356258,05-03-24 21:28,96.79,OutgoingTransfer,International Transfer,-3122.361489
14694,715356258,05-05-24 21:28,1800,IncomingTransfer,Salary,-1322.361489
14695,715356258,05-06-24 20:28,160.63,Purchase,Gas,-1482.991489
14696,715356258,05-08-24 13:28,132.44,OnlineShopping,Best Buy,-1615.431489
14697,715356258,05-09-24 10:28,81.96,Deposit,Cash Deposit,-1533.471489
14698,715356258,05-10-24 21:28,2000,Payment,Credit Card Payment,-3533.471489
14699,715356258,05-11-24 20:28,32.12,Purchase,Electronics,-3565.591489
14700,715356258,5-17-24 21:28,800,Payment,Installment Payment,-4365.591489
14701,715356258,5-19-24 10:28,142.66,Purchase,Grocery,-4508.251489
14702,715356258,5-20-24 23:28,149.67,Withdrawal,ATM Withdrawal,-4657.921489
14703,715356258,5-21-24 18:28,138.98,Withdrawal,ATM Withdrawal,-4796.901489
14704,715356258,5-23-24 9:28,217.8,Purchase,Restaurant,-5014.701489
14705,715356258,5-26-24 21:28,13.68,Deposit,Check Deposit,-5001.021489
14706,715356258,5-31-24 16:28,118.07,Deposit,Cash Deposit,-4882.951489
14707,715356258,06-03-24 15:28,129.21,Withdrawal,Mobile App Withdrawal,-5012.161489
14708,715356258,06-03-24 21:28,1800,IncomingTransfer,Salary,-3212.161489
14709,715356258,06-08-24 20:28,59.37,Return,Amazon Return,-3152.791489
14710,715356258,06-08-24 21:28,1800,Payment,Credit Card Payment,-4952.791489
14711,715356258,06-09-24 13:28,183.43,Withdrawal,Branch Withdrawal,-5136.221489
14712,715356258,06-10-24 16:28,164.48,OutgoingTransfer,Bank Transfer,-5300.701489
14713,715356258,06-10-24 19:28,154.76,Deposit,Cash Deposit,-5145.941489
14714,715356258,06-12-24 15:28,24.54,Deposit,Mobile Deposit,-5121.401489
14715,715356258,6-13-24 19:28,229.9,Payment,Bill Payment,-5351.301489
14716,715356258,6-15-24 16:28,132.11,Withdrawal,Mobile App Withdrawal,-5483.411489
14717,715356258,6-16-24 21:28,600,Payment,Insurance Payment,-6083.411489
14718,715356258,6-19-24 9:28,249.84,Purchase,Electronics,-6333.251489
14719,715356258,6-23-24 10:28,40.1,OnlineShopping,Amazon,-6373.351489
14720,715356258,6-24-24 16:28,222.75,Withdrawal,Branch Withdrawal,-6596.101489
14721,715356258,6-27-24 18:28,45.26,Purchase,Restaurant,-6641.361489
14722,715356258,6-28-24 15:28,107.21,Deposit,Cash Deposit,-6534.151489
14723,715356258,07-04-24 18:28,74.19,Deposit,Check Deposit,-6459.961489
14724,715356258,07-04-24 21:28,1800,IncomingTransfer,Salary,-4659.961489
14725,715356258,07-06-24 11:28,157.43,Deposit,Direct Deposit,-4502.531489
14726,715356258,07-06-24 12:28,92.23,Deposit,Mobile Deposit,-4410.301489
14727,715356258,07-08-24 23:28,190.17,Purchase,Travel,-4600.471489
14728,715356258,07-09-24 21:28,1700,Payment,Credit Card Payment,-6300.471489
14729,715356258,07-12-24 23:28,152.85,Withdrawal,ATM Withdrawal,-6453.321489
14730,715356258,7-14-24 10:28,110.12,OutgoingTransfer,Bank Transfer,-6563.441489
14731,715356258,7-16-24 14:28,141.88,Return,Amazon Return,-6421.561489
14732,715356258,7-16-24 21:28,700,Payment,Insurance Payment,-7121.561489
14733,715356258,7-16-24 23:28,184.22,OnlineShopping,eBay,-7305.781489
14734,715356258,7-17-24 20:28,162.56,OutgoingTransfer,Bank Transfer,-7468.341489
14735,715395933,1-20-24 17:28,327.32,Purchase,Home Improvement,1690.378185
14736,715395933,1-21-24 13:28,19.85,Return,AliExpress Return,1710.228185
14737,715395933,1-22-24 16:28,182.94,Withdrawal,Mobile App Withdrawal,1527.288185
14738,715395933,1-25-24 12:28,17.18,Return,Store Return,1544.468185
14739,715395933,1-28-24 15:28,187.41,OnlineShopping,Etsy,1357.058185
14740,715395933,1-29-24 18:28,75.36,Deposit,Direct Deposit,1432.418185
14741,715395933,1-30-24 17:28,90.84,Deposit,Check Deposit,1523.258185
14742,715395933,1-31-24 16:28,177.75,Withdrawal,ATM Withdrawal,1345.508185
14743,715395933,02-02-24 17:28,312.84,Payment,Loan Payment,1032.668185
14744,715395933,02-02-24 21:28,4900,IncomingTransfer,Salary,5932.668185
14745,715395933,02-04-24 15:28,252.59,Purchase,Furniture,5680.078185
14746,715395933,02-05-24 16:28,494.3,Withdrawal,Mobile App Withdrawal,5185.778185
14747,715395933,02-07-24 21:28,3200,Payment,Credit Card Payment,1985.778185
14748,715395933,02-08-24 22:28,186.88,Deposit,Check Deposit,2172.658185
14749,715395933,02-08-24 23:28,457.34,Withdrawal,Branch Withdrawal,1715.318185
14750,715395933,02-10-24 12:28,485.11,OnlineShopping,AliExpress,1230.208185
14751,715395933,2-13-24 21:28,1200,Payment,Subscription Payment,30.20818492
14752,715395933,2-17-24 11:28,287.21,OutgoingTransfer,Bank Transfer,-257.0018151
14753,715395933,2-23-24 18:28,32.7,Deposit,Direct Deposit,-224.3018151
14754,715395933,2-27-24 9:28,231.7,Deposit,Direct Deposit,7.398184916
14755,715395933,2-28-24 19:28,90.81,Withdrawal,Branch Withdrawal,-83.41181508
14756,715395933,03-02-24 16:28,283.34,Deposit,Check Deposit,199.9281849
14757,715395933,03-03-24 22:28,242.81,Deposit,Mobile Deposit,442.7381849
14758,715395933,03-05-24 14:28,287.3,Return,Store Return,730.0381849
14759,715395933,03-05-24 21:28,4900,IncomingTransfer,Salary,5630.038185
14760,715395933,03-09-24 20:28,462.96,Deposit,Mobile Deposit,6092.998185
14761,715395933,03-10-24 21:28,2500,Payment,Credit Card Payment,3592.998185
14762,715395933,03-11-24 18:28,162.92,Deposit,Mobile Deposit,3755.918185
14763,715395933,3-13-24 21:28,459.43,Purchase,Grocery,3296.488185
14764,715395933,3-14-24 21:28,1800,Payment,Insurance Payment,1496.488185
14765,715395933,3-15-24 20:28,10.21,OnlineShopping,Etsy,1486.278185
14766,715395933,3-16-24 19:28,226.24,OnlineShopping,Walmart,1260.038185
14767,715395933,3-19-24 11:28,122.26,Withdrawal,Branch Withdrawal,1137.778185
14768,715395933,3-20-24 14:28,260.94,OnlineShopping,Target,876.8381849
14769,715395933,3-22-24 9:28,34.99,Deposit,Cash Deposit,911.8281849
14770,715395933,3-28-24 11:28,211.22,Deposit,Direct Deposit,1123.048185
14771,715395933,04-01-24 21:28,393.01,Payment,Bill Payment,730.0381849
14772,715395933,04-04-24 14:28,135.49,Return,Walmart Return,865.5281849
14773,715395933,04-04-24 21:28,4900,IncomingTransfer,Salary,5765.528185
14774,715395933,04-06-24 20:28,279.01,Purchase,Grocery,5486.518185
14775,715395933,04-07-24 17:28,37.23,OutgoingTransfer,Wire Transfer,5449.288185
14776,715395933,04-08-24 21:28,329.85,Deposit,Mobile Deposit,5779.138185
14777,715395933,04-09-24 21:28,3400,Payment,Credit Card Payment,2379.138185
14778,715395933,04-10-24 18:28,49.78,IncomingTransfer,Freelance Payment,2428.918185
14779,715395933,04-12-24 12:28,29.97,Purchase,Entertainment,2398.948185
14780,715395933,4-13-24 19:28,21.11,Payment,Bill Payment,2377.838185
14781,715395933,4-17-24 21:28,2000,Payment,Subscription Payment,377.8381849
14782,715395933,4-21-24 13:28,495.06,Return,Target Return,872.8981849
14783,715395933,4-22-24 19:28,325.63,Withdrawal,Branch Withdrawal,547.2681849
14784,715395933,4-23-24 21:28,347.58,Deposit,Mobile Deposit,894.8481849
14785,715395933,4-24-24 10:28,337.86,Payment,Mortgage Payment,556.9881849
14786,715395933,4-24-24 23:28,150.33,Purchase,Home Improvement,406.6581849
14787,715395933,4-25-24 19:28,91.1,Payment,Mortgage Payment,315.5581849
14788,715395933,4-25-24 22:28,420.05,Purchase,Furniture,-104.4918151
14789,715395933,4-26-24 12:28,106.26,Withdrawal,Mobile App Withdrawal,-210.7518151
14790,715395933,05-02-24 14:28,126.36,Withdrawal,Branch Withdrawal,-337.1118151
14791,715395933,05-04-24 21:28,4900,IncomingTransfer,Salary,4562.888185
14792,715395933,05-09-24 21:28,2600,Payment,Credit Card Payment,1962.888185
14793,715395933,05-11-24 22:28,288.72,OnlineShopping,eBay,1674.168185
14794,715395933,5-13-24 23:28,155.43,Purchase,Travel,1518.738185
14795,715395933,5-14-24 21:28,1900,Payment,Subscription Payment,-381.2618151
14796,715395933,5-16-24 12:28,112.22,Deposit,Direct Deposit,-269.0418151
14797,715395933,5-16-24 15:28,329.33,OutgoingTransfer,Bank Transfer,-598.3718151
14798,715395933,5-28-24 11:28,275.74,Purchase,Furniture,-874.1118151
14799,715395933,06-01-24 10:28,102.8,OutgoingTransfer,Peer-to-Peer Transfer,-976.9118151
14800,715395933,06-02-24 21:28,4900,IncomingTransfer,Salary,3923.088185
14801,715395933,06-05-24 18:28,201.43,Return,Best Buy Return,4124.518185
14802,715395933,06-06-24 20:28,54.87,Purchase,Home Improvement,4069.648185
14803,715395933,06-07-24 21:28,2600,Payment,Credit Card Payment,1469.648185
14804,715395933,06-09-24 13:28,79.56,IncomingTransfer,Freelance Payment,1549.208185
14805,715395933,6-13-24 21:28,1600,Payment,Installment Payment,-50.79181508
14806,715395933,6-14-24 14:28,293.6,OutgoingTransfer,Wire Transfer,-344.3918151
14807,715395933,6-19-24 22:28,69.81,Deposit,Mobile Deposit,-274.5818151
14808,715395933,6-23-24 19:28,109.88,Purchase,Travel,-384.4618151
14809,715395933,6-24-24 9:28,139.36,Deposit,Check Deposit,-245.1018151
14810,715395933,6-24-24 19:28,428.18,OnlineShopping,AliExpress,-673.2818151
14811,715395933,6-25-24 9:28,281.18,IncomingTransfer,Freelance Payment,-392.1018151
14812,715395933,6-25-24 17:28,62.59,Deposit,Check Deposit,-329.5118151
14813,715395933,6-25-24 20:28,457.91,Payment,Loan Payment,-787.4218151
14814,715395933,6-29-24 13:28,252.15,Return,eBay Return,-535.2718151
14815,715395933,07-03-24 21:28,4900,IncomingTransfer,Salary,4364.728185
14816,715395933,07-08-24 14:28,128.45,Deposit,Cash Deposit,4493.178185
14817,715395933,07-08-24 21:28,3100,Payment,Credit Card Payment,1393.178185
14818,715395933,07-10-24 23:28,393.09,Purchase,Restaurant,1000.088185
14819,715395933,07-12-24 16:28,106.45,Return,Store Return,1106.538185
14820,715395933,7-14-24 13:28,35.99,Withdrawal,Mobile App Withdrawal,1070.548185
14821,715395933,7-14-24 16:28,102.54,Deposit,Mobile Deposit,1173.088185
14822,715395933,7-14-24 21:28,1700,Payment,Insurance Payment,-526.9118151
14823,715436883,1-20-24 15:28,150.94,IncomingTransfer,Freelance Payment,1046.070138
14824,715436883,1-25-24 19:28,68.76,Withdrawal,Mobile App Withdrawal,977.3101375
14825,715436883,1-26-24 14:28,248.47,Purchase,Electronics,728.8401375
14826,715436883,1-28-24 10:28,220.1,Deposit,Direct Deposit,948.9401375
14827,715436883,1-30-24 16:28,42.47,OnlineShopping,Etsy,906.4701375
14828,715436883,1-31-24 9:28,205.7,Purchase,Grocery,700.7701375
14829,715436883,02-10-24 14:28,187.82,Deposit,Check Deposit,888.5901375
14830,715436883,02-11-24 17:28,82.36,OnlineShopping,Etsy,806.2301375
14831,715436883,02-12-24 10:28,158.25,Withdrawal,ATM Withdrawal,647.9801375
14832,715436883,2-14-24 18:28,120.34,OutgoingTransfer,Peer-to-Peer Transfer,527.6401375
14833,715436883,2-17-24 12:28,192.23,Payment,Loan Payment,335.4101375
14834,715436883,2-17-24 16:28,159.14,Withdrawal,Mobile App Withdrawal,176.2701375
14835,715436883,2-17-24 16:28,205.42,Purchase,Gas,-29.14986249
14836,715436883,2-21-24 11:28,158.93,OutgoingTransfer,Wire Transfer,-188.0798625
14837,715436883,2-21-24 11:28,244.73,Deposit,Cash Deposit,56.65013751
14838,715436883,2-21-24 23:28,116.3,OnlineShopping,Amazon,-59.64986249
14839,715436883,2-23-24 18:28,89.07,Purchase,Clothing,-148.7198625
14840,715436883,2-25-24 12:28,60.52,Payment,Bill Payment,-209.2398625
14841,715436883,2-28-24 10:28,112.01,IncomingTransfer,Freelance Payment,-97.22986249
14842,715436883,2-28-24 12:28,38.48,Withdrawal,Mobile App Withdrawal,-135.7098625
14843,715436883,2-29-24 11:28,93.45,Purchase,Restaurant,-229.1598625
14844,715436883,03-07-24 23:28,83.94,Purchase,Pharmacy,-313.0998625
14845,715436883,03-12-24 22:28,117.13,Purchase,Restaurant,-430.2298625
14846,715436883,3-16-24 14:28,183.5,Deposit,Direct Deposit,-246.7298625
14847,715436883,3-22-24 13:28,100.58,Withdrawal,Mobile App Withdrawal,-347.3098625
14848,715436883,3-23-24 13:28,50.14,OnlineShopping,eBay,-397.4498625
14849,715436883,3-23-24 22:28,97.32,Purchase,Home Improvement,-494.7698625
14850,715436883,3-26-24 21:28,223.53,OnlineShopping,eBay,-718.2998625
14851,715436883,3-27-24 11:28,108.39,OutgoingTransfer,Wire Transfer,-826.6898625
14852,715436883,3-27-24 13:28,230.95,OutgoingTransfer,Wire Transfer,-1057.639862
14853,715436883,3-28-24 20:28,130.84,Withdrawal,ATM Withdrawal,-1188.479862
14854,715436883,04-02-24 14:28,247.7,OnlineShopping,Target,-1436.179862
14855,715436883,04-03-24 18:28,58.55,Deposit,Direct Deposit,-1377.629862
14856,715436883,04-03-24 23:28,237.05,Withdrawal,Branch Withdrawal,-1614.679862
14857,715436883,04-05-24 22:28,84.61,Deposit,Check Deposit,-1530.069862
14858,715436883,04-05-24 22:28,68.29,Payment,Mortgage Payment,-1598.359862
14859,715436883,04-06-24 13:28,151.68,Withdrawal,ATM Withdrawal,-1750.039862
14860,715436883,04-11-24 11:28,54.61,Withdrawal,ATM Withdrawal,-1804.649862
14861,715436883,4-13-24 13:28,166.88,Deposit,Check Deposit,-1637.769862
14862,715436883,4-15-24 18:28,34.87,Withdrawal,Branch Withdrawal,-1672.639862
14863,715436883,4-16-24 20:28,56.66,Purchase,Electronics,-1729.299862
14864,715436883,4-17-24 21:28,10.01,Deposit,Direct Deposit,-1719.289862
14865,715436883,4-20-24 14:28,218.44,Purchase,Electronics,-1937.729862
14866,715436883,4-22-24 13:28,121.01,Withdrawal,Mobile App Withdrawal,-2058.739862
14867,715436883,4-24-24 13:28,17.29,Purchase,Grocery,-2076.029862
14868,715436883,4-25-24 17:28,236.85,OnlineShopping,Etsy,-2312.879862
14869,715436883,4-27-24 14:28,89.27,Payment,Loan Payment,-2402.149862
14870,715436883,4-28-24 11:28,172.26,Withdrawal,Branch Withdrawal,-2574.409862
14871,715436883,4-28-24 19:28,209.4,Deposit,Check Deposit,-2365.009862
14872,715436883,4-29-24 12:28,74.8,Withdrawal,Branch Withdrawal,-2439.809862
14873,715436883,05-03-24 19:28,173.83,Deposit,Check Deposit,-2265.979862
14874,715436883,05-03-24 19:28,23.38,Deposit,Direct Deposit,-2242.599862
14875,715436883,05-04-24 11:28,88.7,Return,Walmart Return,-2153.899862
14876,715436883,05-05-24 16:28,23.17,Deposit,Cash Deposit,-2130.729862
14877,715436883,05-08-24 11:28,102.96,OnlineShopping,Target,-2233.689862
14878,715436883,5-15-24 11:28,187.83,Purchase,Travel,-2421.519862
14879,715436883,5-16-24 9:28,18.69,Deposit,Direct Deposit,-2402.829862
14880,715436883,5-17-24 15:28,216.16,Return,Amazon Return,-2186.669862
14881,715436883,5-18-24 13:28,191.21,IncomingTransfer,Freelance Payment,-1995.459862
14882,715436883,5-20-24 23:28,165.98,Withdrawal,Mobile App Withdrawal,-2161.439862
14883,715436883,5-21-24 10:28,119.11,Purchase,Clothing,-2280.549862
14884,715436883,5-30-24 11:28,205.52,Withdrawal,ATM Withdrawal,-2486.069862
14885,715436883,5-30-24 16:28,129.55,Return,eBay Return,-2356.519862
14886,715436883,5-30-24 16:28,130.17,OutgoingTransfer,Peer-to-Peer Transfer,-2486.689862
14887,715436883,06-03-24 21:28,229.53,Purchase,Restaurant,-2716.219862
14888,715436883,06-05-24 10:28,68.66,Return,Etsy Return,-2647.559862
14889,715436883,06-06-24 10:28,201.12,Deposit,Direct Deposit,-2446.439862
14890,715436883,06-07-24 18:28,222.67,Deposit,Cash Deposit,-2223.769862
14891,715436883,06-08-24 18:28,215.83,Deposit,Cash Deposit,-2007.939862
14892,715436883,06-10-24 12:28,92.14,Purchase,Entertainment,-2100.079862
14893,715436883,06-12-24 15:28,234.64,Withdrawal,Mobile App Withdrawal,-2334.719862
14894,715436883,6-14-24 16:28,181.08,Deposit,Direct Deposit,-2153.639862
14895,715436883,6-18-24 16:28,32.51,Return,Store Return,-2121.129862
14896,715436883,6-21-24 9:28,140.02,Withdrawal,Branch Withdrawal,-2261.149862
14897,715436883,6-21-24 21:28,106.59,Deposit,Cash Deposit,-2154.559862
14898,715436883,6-25-24 21:28,81.83,Withdrawal,ATM Withdrawal,-2236.389862
14899,715436883,6-27-24 15:28,10.99,IncomingTransfer,Freelance Payment,-2225.399862
14900,715436883,6-28-24 20:28,31.42,IncomingTransfer,Freelance Payment,-2193.979862
14901,715436883,6-29-24 22:28,136.32,Purchase,Travel,-2330.299862
14902,715436883,07-02-24 18:28,198.6,Payment,Bill Payment,-2528.899862
14903,715436883,07-04-24 23:28,189.03,Purchase,Grocery,-2717.929862
14904,715436883,7-15-24 11:28,220.69,Purchase,Clothing,-2938.619862
14905,715436883,7-15-24 17:28,54.87,IncomingTransfer,Freelance Payment,-2883.749862
14906,715436883,7-16-24 9:28,161.58,Withdrawal,Mobile App Withdrawal,-3045.329862
14907,715436883,7-16-24 14:28,240.56,Purchase,Clothing,-3285.889862
14908,715436883,7-17-24 13:28,219.52,Withdrawal,Mobile App Withdrawal,-3505.409862
14909,715482483,1-22-24 12:28,389.24,Payment,Loan Payment,717.4558243
14910,715482483,02-01-24 14:28,456.73,Withdrawal,Branch Withdrawal,260.7258243
14911,715482483,02-02-24 20:28,398.98,OnlineShopping,Amazon,-138.2541757
14912,715482483,02-04-24 21:28,2400,IncomingTransfer,Salary,2261.745824
14913,715482483,02-09-24 21:28,1700,Payment,Credit Card Payment,561.7458243
14914,715482483,2-14-24 23:28,326.68,OnlineShopping,Walmart,235.0658243
14915,715482483,2-16-24 21:28,800,Payment,Installment Payment,-564.9341757
14916,715482483,2-17-24 17:28,351.38,OnlineShopping,Amazon,-916.3141757
14917,715482483,2-19-24 15:28,21.47,OnlineShopping,Target,-937.7841757
14918,715482483,2-19-24 17:28,96.04,Purchase,Travel,-1033.824176
14919,715482483,2-21-24 12:28,412.85,IncomingTransfer,Freelance Payment,-620.9741757
14920,715482483,2-22-24 21:28,65.1,Return,Etsy Return,-555.8741757
14921,715482483,2-26-24 20:28,126.66,Withdrawal,Branch Withdrawal,-682.5341757
14922,715482483,2-26-24 21:28,260.94,Purchase,Travel,-943.4741757
14923,715482483,03-03-24 21:28,2400,IncomingTransfer,Salary,1456.525824
14924,715482483,03-04-24 22:28,365.72,OnlineShopping,Amazon,1090.805824
14925,715482483,03-08-24 21:28,2100,Payment,Credit Card Payment,-1009.194176
14926,715482483,03-09-24 17:28,251.79,IncomingTransfer,Freelance Payment,-757.4041757
14927,715482483,03-10-24 13:28,124.84,IncomingTransfer,Freelance Payment,-632.5641757
14928,715482483,3-13-24 20:28,331.86,Return,Store Return,-300.7041757
14929,715482483,3-14-24 9:28,372.25,OnlineShopping,Best Buy,-672.9541757
14930,715482483,3-14-24 11:28,247.71,Purchase,Home Improvement,-920.6641757
14931,715482483,3-15-24 16:28,137.34,Deposit,Check Deposit,-783.3241757
14932,715482483,3-17-24 10:28,452.98,OnlineShopping,AliExpress,-1236.304176
14933,715482483,3-18-24 21:28,600,Payment,Insurance Payment,-1836.304176
14934,715482483,3-19-24 13:28,490.41,Purchase,Restaurant,-2326.714176
14935,715482483,3-20-24 12:28,51.21,Deposit,Check Deposit,-2275.504176
14936,715482483,3-27-24 9:28,313.2,Deposit,Mobile Deposit,-1962.304176
14937,715482483,3-27-24 11:28,299.65,Return,Best Buy Return,-1662.654176
14938,715482483,3-27-24 14:28,138.03,OnlineShopping,Walmart,-1800.684176
14939,715482483,3-29-24 22:28,450.01,Deposit,Mobile Deposit,-1350.674176
14940,715482483,04-05-24 21:28,2400,IncomingTransfer,Salary,1049.325824
14941,715482483,04-08-24 18:28,455.18,Purchase,Pharmacy,594.1458243
14942,715482483,04-10-24 21:28,1900,Payment,Credit Card Payment,-1305.854176
14943,715482483,4-13-24 12:28,489.26,Withdrawal,Branch Withdrawal,-1795.114176
14944,715482483,4-15-24 12:28,467.77,IncomingTransfer,Freelance Payment,-1327.344176
14945,715482483,4-15-24 22:28,181.92,Purchase,Pharmacy,-1509.264176
14946,715482483,4-16-24 21:28,700,Payment,Insurance Payment,-2209.264176
14947,715482483,4-20-24 18:28,188.63,Deposit,Mobile Deposit,-2020.634176
14948,715482483,4-21-24 19:28,192.55,Deposit,Cash Deposit,-1828.084176
14949,715482483,4-26-24 20:28,437.51,Withdrawal,Mobile App Withdrawal,-2265.594176
14950,715482483,4-26-24 22:28,475.32,Purchase,Travel,-2740.914176
14951,715482483,4-28-24 15:28,445.49,OnlineShopping,eBay,-3186.404176
14952,715482483,4-30-24 17:28,105.99,Payment,Bill Payment,-3292.394176
14953,715482483,05-03-24 18:28,107.59,Deposit,Check Deposit,-3184.804176
14954,715482483,05-05-24 21:28,2400,IncomingTransfer,Salary,-784.8041757
14955,715482483,05-10-24 21:28,1800,Payment,Credit Card Payment,-2584.804176
14956,715482483,05-11-24 21:28,366,Deposit,Cash Deposit,-2218.804176
14957,715482483,5-15-24 19:28,207.02,Withdrawal,Mobile App Withdrawal,-2425.824176
14958,715482483,5-17-24 16:28,311.44,OnlineShopping,Target,-2737.264176
14959,715482483,5-18-24 21:28,700,Payment,Subscription Payment,-3437.264176
14960,715482483,5-18-24 22:28,290.69,Deposit,Check Deposit,-3146.574176
14961,715482483,5-20-24 14:28,176.02,IncomingTransfer,Freelance Payment,-2970.554176
14962,715482483,5-20-24 21:28,252.45,Return,Walmart Return,-2718.104176
14963,715482483,5-27-24 12:28,170.42,Purchase,Furniture,-2888.524176
14964,715482483,5-30-24 16:28,328.93,Deposit,Cash Deposit,-2559.594176
14965,715482483,06-02-24 11:28,459.88,Withdrawal,ATM Withdrawal,-3019.474176
14966,715482483,06-05-24 21:28,2400,IncomingTransfer,Salary,-619.4741757
14967,715482483,06-07-24 22:28,319.05,Purchase,Restaurant,-938.5241757
14968,715482483,06-08-24 17:28,95.05,Deposit,Mobile Deposit,-843.4741757
14969,715482483,06-08-24 19:28,139.66,Deposit,Mobile Deposit,-703.8141757
14970,715482483,06-09-24 15:28,88.77,OnlineShopping,Target,-792.5841757
14971,715482483,06-10-24 21:28,2100,Payment,Credit Card Payment,-2892.584176
14972,715482483,06-12-24 13:28,315.63,Withdrawal,Branch Withdrawal,-3208.214176
14973,715482483,6-14-24 11:28,311.79,OnlineShopping,Best Buy,-3520.004176
14974,715482483,6-15-24 20:28,149.95,Payment,Loan Payment,-3669.954176
14975,715482483,6-15-24 21:28,1000,Payment,Installment Payment,-4669.954176
14976,715482483,6-16-24 21:28,98.76,Withdrawal,Mobile App Withdrawal,-4768.714176
14977,715482483,6-19-24 22:28,97.69,Deposit,Cash Deposit,-4671.024176
14978,715482483,6-26-24 10:28,291.31,Withdrawal,Mobile App Withdrawal,-4962.334176
14979,715482483,6-28-24 12:28,23.73,Return,Walmart Return,-4938.604176
14980,715482483,07-01-24 21:28,2400,IncomingTransfer,Salary,-2538.604176
14981,715482483,07-02-24 9:28,323.52,Withdrawal,Mobile App Withdrawal,-2862.124176
14982,715482483,07-02-24 10:28,96.78,Deposit,Direct Deposit,-2765.344176
14983,715482483,07-06-24 21:28,1700,Payment,Credit Card Payment,-4465.344176
14984,715482483,07-12-24 21:28,1000,Payment,Insurance Payment,-5465.344176
14985,715482483,7-16-24 22:28,222.68,Withdrawal,Branch Withdrawal,-5688.024176
14986,715485483,1-22-24 17:28,171.26,OnlineShopping,AliExpress,-171.26
14987,715485483,1-23-24 20:28,147.63,Purchase,Furniture,-318.89
14988,715485483,1-28-24 11:28,172.54,Return,Walmart Return,-146.35
14989,715485483,02-05-24 19:28,158.99,Purchase,Travel,-305.34
14990,715485483,02-05-24 21:28,2650,IncomingTransfer,Salary,2344.66
14991,715485483,02-07-24 22:28,180.23,OnlineShopping,Etsy,2164.43
14992,715485483,2-18-24 21:28,800,Payment,Rent Payment,1364.43
14993,715485483,2-19-24 18:28,242.61,Deposit,Cash Deposit,1607.04
14994,715485483,2-22-24 12:28,89.59,OutgoingTransfer,Wire Transfer,1517.45
14995,715485483,03-02-24 21:28,2650,IncomingTransfer,Salary,4167.45
14996,715485483,03-10-24 17:28,60.8,Deposit,Direct Deposit,4228.25
14997,715485483,3-15-24 21:28,1100,Payment,Rent Payment,3128.25
14998,715485483,3-18-24 14:28,29.7,OnlineShopping,Target,3098.55
14999,715485483,3-20-24 10:28,166.48,Withdrawal,Branch Withdrawal,2932.07
15000,715485483,04-02-24 12:28,116.76,Deposit,Cash Deposit,3048.83
15001,715485483,04-04-24 10:28,35.94,Purchase,Home Improvement,3012.89
15002,715485483,04-05-24 21:28,2650,IncomingTransfer,Salary,5662.89
15003,715485483,04-06-24 21:28,60.34,Return,Best Buy Return,5723.23
15004,715485483,04-10-24 15:28,204.59,Purchase,Pharmacy,5518.64
15005,715485483,04-11-24 17:28,20.74,Deposit,Cash Deposit,5539.38
15006,715485483,4-14-24 13:28,81.62,IncomingTransfer,Freelance Payment,5621
15007,715485483,4-14-24 21:28,800,Payment,Rent Payment,4821
15008,715485483,4-16-24 17:28,75.84,OnlineShopping,Amazon,4745.16
15009,715485483,4-18-24 17:28,50.79,Purchase,Gas,4694.37
15010,715485483,4-19-24 16:28,153.99,OnlineShopping,AliExpress,4540.38
15011,715485483,4-19-24 18:28,216.57,OutgoingTransfer,Bank Transfer,4323.81
15012,715485483,4-20-24 16:28,200.39,Withdrawal,Branch Withdrawal,4123.42
15013,715485483,4-21-24 10:28,81.42,Deposit,Check Deposit,4204.84
15014,715485483,05-04-24 21:28,2650,IncomingTransfer,Salary,6854.84
15015,715485483,05-06-24 12:28,52.56,Deposit,Cash Deposit,6907.4
15016,715485483,05-10-24 10:28,49.71,Deposit,Check Deposit,6957.11
15017,715485483,05-12-24 21:28,1200,Payment,Rent Payment,5757.11
15018,715485483,5-16-24 10:28,201.97,Withdrawal,Mobile App Withdrawal,5555.14
15019,715485483,5-16-24 23:28,202.95,OutgoingTransfer,Wire Transfer,5352.19
15020,715485483,5-18-24 22:28,54.63,Purchase,Home Improvement,5297.56
15021,715485483,5-20-24 18:28,160.19,Purchase,Entertainment,5137.37
15022,715485483,5-25-24 10:28,120.58,OnlineShopping,Best Buy,5016.79
15023,715485483,5-28-24 15:28,107.19,Purchase,Grocery,4909.6
15024,715485483,5-31-24 13:28,182.07,Deposit,Cash Deposit,5091.67
15025,715485483,06-02-24 15:28,203.46,OnlineShopping,Amazon,4888.21
15026,715485483,06-05-24 17:28,106.27,Withdrawal,ATM Withdrawal,4781.94
15027,715485483,06-05-24 21:28,2650,IncomingTransfer,Salary,7431.94
15028,715485483,06-10-24 20:28,224.57,Withdrawal,Mobile App Withdrawal,7207.37
15029,715485483,06-10-24 21:28,1300,Payment,Rent Payment,5907.37
15030,715485483,6-17-24 10:28,207.08,Payment,Bill Payment,5700.29
15031,715485483,6-20-24 21:28,69.32,Return,AliExpress Return,5769.61
15032,715485483,6-22-24 15:28,50.6,Deposit,Check Deposit,5820.21
15033,715485483,6-30-24 12:28,202.24,Return,Best Buy Return,6022.45
15034,715485483,07-02-24 12:28,191.56,Deposit,Mobile Deposit,6214.01
15035,715485483,07-02-24 21:28,2650,IncomingTransfer,Salary,8864.01
15036,715485483,07-02-24 22:28,217.28,Deposit,Direct Deposit,9081.29
15037,715485483,07-03-24 17:28,94.06,Deposit,Check Deposit,9175.35
15038,715485483,07-08-24 12:28,243.23,OutgoingTransfer,Wire Transfer,8932.12
15039,715485483,07-10-24 21:28,1500,Payment,Rent Payment,7432.12
15040,715485483,07-11-24 22:28,65.02,Deposit,Cash Deposit,7497.14
15041,715485483,7-17-24 9:28,127.83,OutgoingTransfer,Bank Transfer,7369.31
15042,715551783,1-20-24 17:28,70.79,IncomingTransfer,Freelance Payment,1039.938907
15043,715551783,1-23-24 21:28,104.29,Purchase,Pharmacy,935.6489074
15044,715551783,1-25-24 17:28,296.88,Purchase,Pharmacy,638.7689074
15045,715551783,1-26-24 14:28,159.79,Withdrawal,Branch Withdrawal,478.9789074
15046,715551783,1-26-24 22:28,152.83,Payment,Mortgage Payment,326.1489074
15047,715551783,1-28-24 17:28,180.18,Withdrawal,Mobile App Withdrawal,145.9689074
15048,715551783,1-30-24 14:28,20.34,Return,eBay Return,166.3089074
15049,715551783,1-30-24 17:28,63.96,Purchase,Electronics,102.3489074
15050,715551783,1-31-24 18:28,399.22,Deposit,Mobile Deposit,501.5689074
15051,715551783,02-02-24 18:28,436.03,OutgoingTransfer,International Transfer,65.53890737
15052,715551783,02-02-24 20:28,157.32,Deposit,Mobile Deposit,222.8589074
15053,715551783,02-05-24 17:28,154.54,OnlineShopping,Etsy,68.31890737
15054,715551783,02-05-24 21:28,7600,IncomingTransfer,Salary,7668.318907
15055,715551783,02-06-24 13:28,257.66,Withdrawal,Mobile App Withdrawal,7410.658907
15056,715551783,02-06-24 16:28,358.2,Deposit,Direct Deposit,7768.858907
15057,715551783,02-09-24 10:28,93.25,OutgoingTransfer,Wire Transfer,7675.608907
15058,715551783,02-09-24 13:28,362.26,Payment,Mortgage Payment,7313.348907
15059,715551783,02-09-24 21:28,54.01,OutgoingTransfer,Bank Transfer,7259.338907
15060,715551783,02-10-24 21:28,1700,Payment,Credit Card Payment,5559.338907
15061,715551783,02-12-24 18:28,116.41,Deposit,Cash Deposit,5675.748907
15062,715551783,02-12-24 20:28,382.13,Purchase,Pharmacy,5293.618907
15063,715551783,2-13-24 22:28,150.03,OutgoingTransfer,Peer-to-Peer Transfer,5143.588907
15064,715551783,2-14-24 11:28,139.77,Withdrawal,ATM Withdrawal,5003.818907
15065,715551783,2-14-24 22:28,239.46,Purchase,Clothing,4764.358907
15066,715551783,2-16-24 13:28,479.5,Payment,Bill Payment,4284.858907
15067,715551783,2-16-24 16:28,173.06,OutgoingTransfer,Wire Transfer,4111.798907
15068,715551783,2-16-24 21:28,2700,Payment,Rent Payment,1411.798907
15069,715551783,2-17-24 11:28,59.03,Purchase,Restaurant,1352.768907
15070,715551783,2-17-24 20:28,488.66,Withdrawal,Mobile App Withdrawal,864.1089074
15071,715551783,2-18-24 10:28,267.01,Purchase,Pharmacy,597.0989074
15072,715551783,2-19-24 16:28,441.95,OnlineShopping,Etsy,155.1489074
15073,715551783,2-21-24 17:28,114.3,OnlineShopping,Best Buy,40.84890737
15074,715551783,2-22-24 13:28,161.84,OutgoingTransfer,Wire Transfer,-120.9910926
15075,715551783,2-22-24 15:28,212.13,Deposit,Direct Deposit,91.13890737
15076,715551783,2-23-24 9:28,396.7,Withdrawal,Branch Withdrawal,-305.5610926
15077,715551783,2-24-24 20:28,88.9,OnlineShopping,eBay,-394.4610926
15078,715551783,2-28-24 10:28,467.26,Purchase,Pharmacy,-861.7210926
15079,715551783,2-29-24 23:28,142.97,Withdrawal,ATM Withdrawal,-1004.691093
15080,715551783,03-04-24 21:28,7600,IncomingTransfer,Salary,6595.308907
15081,715551783,03-07-24 23:28,266.45,Purchase,Furniture,6328.858907
15082,715551783,03-09-24 13:28,125.64,Return,Etsy Return,6454.498907
15083,715551783,03-09-24 21:28,1300,Payment,Credit Card Payment,5154.498907
15084,715551783,03-10-24 12:28,250.67,OnlineShopping,Best Buy,4903.828907
15085,715551783,03-11-24 23:28,158.47,Payment,Mortgage Payment,4745.358907
15086,715551783,03-12-24 9:28,100.27,Return,eBay Return,4845.628907
15087,715551783,3-13-24 12:28,14.91,Withdrawal,Mobile App Withdrawal,4830.718907
15088,715551783,3-13-24 16:28,385.48,Payment,Mortgage Payment,4445.238907
15089,715551783,3-17-24 21:28,3200,Payment,Rent Payment,1245.238907
15090,715551783,3-18-24 10:28,235.28,Purchase,Travel,1009.958907
15091,715551783,3-19-24 9:28,50.28,Return,Amazon Return,1060.238907
15092,715551783,3-20-24 11:28,113.18,OnlineShopping,Best Buy,947.0589074
15093,715551783,3-22-24 13:28,472.12,OnlineShopping,AliExpress,474.9389074
15094,715551783,3-22-24 23:28,229.79,Deposit,Direct Deposit,704.7289074
15095,715551783,3-23-24 16:28,397.6,OutgoingTransfer,Wire Transfer,307.1289074
15096,715551783,3-24-24 21:28,404.76,OnlineShopping,Walmart,-97.63109263
15097,715551783,3-26-24 20:28,386.51,Purchase,Clothing,-484.1410926
15098,715551783,3-28-24 16:28,82.53,Purchase,Grocery,-566.6710926
15099,715551783,3-31-24 10:28,60.66,Payment,Loan Payment,-627.3310926
15100,715551783,3-31-24 11:28,102.56,Purchase,Grocery,-729.8910926
15101,715551783,04-01-24 21:28,7600,IncomingTransfer,Salary,6870.108907
15102,715551783,04-06-24 21:28,1600,Payment,Credit Card Payment,5270.108907
15103,715551783,04-07-24 10:28,189.36,Deposit,Check Deposit,5459.468907
15104,715551783,04-07-24 14:28,208.82,OutgoingTransfer,International Transfer,5250.648907
15105,715551783,04-08-24 11:28,75.77,OutgoingTransfer,Bank Transfer,5174.878907
15106,715551783,04-10-24 18:28,64.34,Purchase,Electronics,5110.538907
15107,715551783,04-11-24 23:28,128.38,Purchase,Home Improvement,4982.158907
15108,715551783,4-13-24 20:28,347.92,Purchase,Travel,4634.238907
15109,715551783,4-15-24 19:28,243.3,Purchase,Gas,4390.938907
15110,715551783,4-16-24 16:28,270.48,Purchase,Gas,4120.458907
15111,715551783,4-16-24 21:28,3600,Payment,Rent Payment,520.4589074
15112,715551783,4-17-24 20:28,484.21,Return,Walmart Return,1004.668907
15113,715551783,4-21-24 14:28,254.26,Withdrawal,Mobile App Withdrawal,750.4089074
15114,715551783,4-22-24 18:28,312.99,Withdrawal,ATM Withdrawal,437.4189074
15115,715551783,4-25-24 12:28,56.78,Purchase,Travel,380.6389074
15116,715551783,4-30-24 10:28,340.09,Payment,Mortgage Payment,40.54890737
15117,715551783,05-03-24 19:28,193.37,Purchase,Home Improvement,-152.8210926
15118,715551783,05-04-24 21:28,7600,IncomingTransfer,Salary,7447.178907
15119,715551783,05-07-24 15:28,321.32,Payment,Mortgage Payment,7125.858907
15120,715551783,05-09-24 17:28,166.69,Deposit,Check Deposit,7292.548907
15121,715551783,05-09-24 21:28,1600,Payment,Credit Card Payment,5692.548907
15122,715551783,05-09-24 22:28,167.77,Return,eBay Return,5860.318907
15123,715551783,05-10-24 17:28,271.14,Payment,Loan Payment,5589.178907
15124,715551783,05-12-24 18:28,227.37,OnlineShopping,AliExpress,5361.808907
15125,715551783,05-12-24 19:28,431.79,Deposit,Mobile Deposit,5793.598907
15126,715551783,5-13-24 21:28,3300,Payment,Rent Payment,2493.598907
15127,715551783,5-14-24 9:28,258.36,OutgoingTransfer,Bank Transfer,2235.238907
15128,715551783,5-15-24 9:28,98.13,Withdrawal,Branch Withdrawal,2137.108907
15129,715551783,5-17-24 15:28,278.61,Purchase,Electronics,1858.498907
15130,715551783,5-17-24 17:28,370.91,IncomingTransfer,Freelance Payment,2229.408907
15131,715551783,5-21-24 14:28,282.03,IncomingTransfer,Freelance Payment,2511.438907
15132,715551783,5-22-24 19:28,425.21,Withdrawal,ATM Withdrawal,2086.228907
15133,715551783,5-24-24 22:28,362.02,OnlineShopping,AliExpress,1724.208907
15134,715551783,5-25-24 15:28,432.48,Purchase,Grocery,1291.728907
15135,715551783,5-25-24 20:28,426.96,OnlineShopping,eBay,864.7689074
15136,715551783,5-26-24 12:28,301.52,OnlineShopping,AliExpress,563.2489074
15137,715551783,5-27-24 14:28,498.42,Payment,Bill Payment,64.82890737
15138,715551783,5-29-24 20:28,215.56,OutgoingTransfer,Wire Transfer,-150.7310926
15139,715551783,5-30-24 19:28,326.38,Withdrawal,Branch Withdrawal,-477.1110926
15140,715551783,5-30-24 20:28,170.7,Return,AliExpress Return,-306.4110926
15141,715551783,06-02-24 20:28,403.95,Purchase,Restaurant,-710.3610926
15142,715551783,06-03-24 21:28,7600,IncomingTransfer,Salary,6889.638907
15143,715551783,06-04-24 13:28,193.96,Deposit,Check Deposit,7083.598907
15144,715551783,06-06-24 9:28,200.14,OnlineShopping,Target,6883.458907
15145,715551783,06-08-24 21:28,1300,Payment,Credit Card Payment,5583.458907
15146,715551783,06-11-24 11:28,115.41,Withdrawal,Mobile App Withdrawal,5468.048907
15147,715551783,06-11-24 21:28,4100,Payment,Rent Payment,1368.048907
15148,715551783,6-17-24 15:28,343.02,OnlineShopping,Amazon,1025.028907
15149,715551783,6-18-24 21:28,187.65,OutgoingTransfer,International Transfer,837.3789074
15150,715551783,6-19-24 22:28,282.65,OnlineShopping,Best Buy,554.7289074
15151,715551783,6-21-24 21:28,349.74,OutgoingTransfer,International Transfer,204.9889074
15152,715551783,6-22-24 18:28,498.9,Return,Amazon Return,703.8889074
15153,715551783,6-23-24 11:28,355.24,Purchase,Home Improvement,348.6489074
15154,715551783,6-27-24 16:28,477.66,OnlineShopping,eBay,-129.0110926
15155,715551783,6-28-24 12:28,272.61,Purchase,Home Improvement,-401.6210926
15156,715551783,6-28-24 18:28,468.89,Purchase,Electronics,-870.5110926
15157,715551783,6-29-24 16:28,12.45,Withdrawal,Mobile App Withdrawal,-882.9610926
15158,715551783,6-29-24 17:28,58.65,Deposit,Cash Deposit,-824.3110926
15159,715551783,07-03-24 21:28,7600,IncomingTransfer,Salary,6775.688907
15160,715551783,07-05-24 18:28,160.14,OutgoingTransfer,International Transfer,6615.548907
15161,715551783,07-07-24 14:28,12.1,Payment,Bill Payment,6603.448907
15162,715551783,07-08-24 21:28,1600,Payment,Credit Card Payment,5003.448907
15163,715551783,07-10-24 12:28,491.88,OutgoingTransfer,Bank Transfer,4511.568907
15164,715551783,07-10-24 19:28,312.36,OnlineShopping,Walmart,4199.208907
15165,715551783,07-11-24 21:28,411.44,Purchase,Entertainment,3787.768907
15166,715551783,7-14-24 12:28,68.51,Purchase,Electronics,3719.258907
15167,715551783,7-14-24 16:28,292.18,OutgoingTransfer,Peer-to-Peer Transfer,3427.078907
15168,715551783,7-15-24 12:28,166.33,Return,Walmart Return,3593.408907
15169,715551783,7-15-24 16:28,372.84,Withdrawal,Mobile App Withdrawal,3220.568907
15170,715551783,7-17-24 16:28,200.87,Payment,Loan Payment,3019.698907
15171,715551783,7-17-24 19:28,316.38,Deposit,Check Deposit,3336.078907
15172,715551783,7-18-24 21:28,4500,Payment,Rent Payment,-1163.921093
15173,715640358,1-21-24 21:28,365.87,OnlineShopping,Best Buy,237.2217465
15174,715640358,1-22-24 18:28,275.78,Purchase,Travel,-38.55825351
15175,715640358,02-01-24 16:28,255.77,Purchase,Gas,-294.3282535
15176,715640358,02-02-24 21:28,3450,IncomingTransfer,Salary,3155.671746
15177,715640358,02-06-24 21:28,254.08,Return,Etsy Return,3409.751746
15178,715640358,02-07-24 21:28,1000,Payment,Credit Card Payment,2409.751746
15179,715640358,2-14-24 21:28,1400,Payment,Rent Payment,1009.751746
15180,715640358,2-20-24 10:28,91.39,OutgoingTransfer,Peer-to-Peer Transfer,918.3617465
15181,715640358,03-01-24 21:28,3450,IncomingTransfer,Salary,4368.361746
15182,715640358,03-03-24 22:28,25.71,Deposit,Cash Deposit,4394.071746
15183,715640358,03-06-24 21:28,900,Payment,Credit Card Payment,3494.071746
15184,715640358,03-08-24 20:28,151.21,Withdrawal,ATM Withdrawal,3342.861746
15185,715640358,03-12-24 15:28,273.62,Deposit,Cash Deposit,3616.481746
15186,715640358,03-12-24 23:28,33.49,Purchase,Home Improvement,3582.991746
15187,715640358,3-13-24 21:28,2100,Payment,Rent Payment,1482.991746
15188,715640358,3-21-24 13:28,184.91,Deposit,Direct Deposit,1667.901746
15189,715640358,3-27-24 21:28,279.54,Withdrawal,Branch Withdrawal,1388.361746
15190,715640358,04-02-24 17:28,190.89,OutgoingTransfer,Bank Transfer,1197.471746
15191,715640358,04-04-24 21:28,3450,IncomingTransfer,Salary,4647.471746
15192,715640358,04-04-24 21:28,363.21,Payment,Loan Payment,4284.261746
15193,715640358,04-08-24 20:28,353.63,Return,Best Buy Return,4637.891746
15194,715640358,04-09-24 18:28,179.46,OutgoingTransfer,Bank Transfer,4458.431746
15195,715640358,04-09-24 21:28,800,Payment,Credit Card Payment,3658.431746
15196,715640358,04-10-24 15:28,335.5,Purchase,Pharmacy,3322.931746
15197,715640358,04-11-24 9:28,75.39,Withdrawal,ATM Withdrawal,3247.541746
15198,715640358,04-11-24 21:28,1300,Payment,Rent Payment,1947.541746
15199,715640358,4-29-24 13:28,289.19,Payment,Bill Payment,1658.351746
15200,715640358,4-30-24 9:28,191.95,Purchase,Entertainment,1466.401746
15201,715640358,05-04-24 21:28,156.32,Payment,Loan Payment,1310.081746
15202,715640358,05-05-24 21:28,3450,IncomingTransfer,Salary,4760.081746
15203,715640358,05-06-24 17:28,257.57,Withdrawal,Branch Withdrawal,4502.511746
15204,715640358,05-08-24 21:28,81.54,Withdrawal,ATM Withdrawal,4420.971746
15205,715640358,05-10-24 21:28,1000,Payment,Credit Card Payment,3420.971746
15206,715640358,05-11-24 18:28,151.73,Withdrawal,ATM Withdrawal,3269.241746
15207,715640358,05-11-24 21:28,1300,Payment,Rent Payment,1969.241746
15208,715640358,5-18-24 10:28,224.9,Deposit,Cash Deposit,2194.141746
15209,715640358,5-18-24 16:28,165.64,Payment,Bill Payment,2028.501746
15210,715640358,5-23-24 15:28,38.4,Purchase,Home Improvement,1990.101746
15211,715640358,5-26-24 13:28,142.1,Deposit,Mobile Deposit,2132.201746
15212,715640358,5-30-24 13:28,347.15,Deposit,Cash Deposit,2479.351746
15213,715640358,5-30-24 15:28,169.59,Deposit,Cash Deposit,2648.941746
15214,715640358,5-31-24 11:28,188.19,OutgoingTransfer,Wire Transfer,2460.751746
15215,715640358,06-01-24 21:28,3450,IncomingTransfer,Salary,5910.751746
15216,715640358,06-06-24 21:28,900,Payment,Credit Card Payment,5010.751746
15217,715640358,06-08-24 22:28,331.15,Withdrawal,Branch Withdrawal,4679.601746
15218,715640358,6-13-24 14:28,116.17,Purchase,Gas,4563.431746
15219,715640358,6-15-24 18:28,249.96,Withdrawal,ATM Withdrawal,4313.471746
15220,715640358,6-16-24 15:28,321.91,Purchase,Entertainment,3991.561746
15221,715640358,6-18-24 21:28,1400,Payment,Rent Payment,2591.561746
15222,715640358,6-25-24 15:28,170.94,Payment,Mortgage Payment,2420.621746
15223,715640358,07-02-24 21:28,3450,IncomingTransfer,Salary,5870.621746
15224,715640358,07-05-24 15:28,273.2,Payment,Loan Payment,5597.421746
15225,715640358,07-07-24 21:28,800,Payment,Credit Card Payment,4797.421746
15226,715640358,07-12-24 19:28,147.17,Withdrawal,Mobile App Withdrawal,4650.251746
15227,715640358,7-14-24 22:28,49.97,Payment,Bill Payment,4600.281746
15228,715640358,7-15-24 19:28,395.33,OutgoingTransfer,Wire Transfer,4204.951746
15229,715640358,7-17-24 11:28,146.16,Return,AliExpress Return,4351.111746
15230,715640358,7-18-24 21:28,1200,Payment,Rent Payment,3151.111746
15231,715705683,1-25-24 18:28,11.41,Payment,Mortgage Payment,691.3100448
15232,715705683,1-26-24 9:28,119.1,Payment,Loan Payment,572.2100448
15233,715705683,1-27-24 11:28,243.75,OutgoingTransfer,Bank Transfer,328.4600448
15234,715705683,1-29-24 11:28,30.47,Deposit,Check Deposit,358.9300448
15235,715705683,1-29-24 21:28,48.83,Purchase,Clothing,310.1000448
15236,715705683,1-31-24 13:28,86.11,Withdrawal,Mobile App Withdrawal,223.9900448
15237,715705683,1-31-24 20:28,103.7,Withdrawal,Mobile App Withdrawal,120.2900448
15238,715705683,02-03-24 14:28,71.63,Purchase,Gas,48.66004479
15239,715705683,02-04-24 15:28,24.77,Withdrawal,ATM Withdrawal,23.89004479
15240,715705683,02-04-24 16:28,184.73,Withdrawal,Mobile App Withdrawal,-160.8399552
15241,715705683,02-04-24 21:28,2350,IncomingTransfer,Salary,2189.160045
15242,715705683,02-05-24 23:28,128.55,Payment,Bill Payment,2060.610045
15243,715705683,02-06-24 22:28,229.69,Purchase,Travel,1830.920045
15244,715705683,02-09-24 14:28,34.8,Purchase,Clothing,1796.120045
15245,715705683,02-09-24 21:28,1200,Payment,Credit Card Payment,596.1200448
15246,715705683,2-14-24 11:28,113.05,Withdrawal,Branch Withdrawal,483.0700448
15247,715705683,2-16-24 23:28,66.03,OnlineShopping,Etsy,417.0400448
15248,715705683,2-17-24 21:28,1400,Payment,Rent Payment,-982.9599552
15249,715705683,2-19-24 10:28,21.59,Deposit,Cash Deposit,-961.3699552
15250,715705683,2-20-24 16:28,109.81,Payment,Mortgage Payment,-1071.179955
15251,715705683,2-24-24 19:28,238.15,Payment,Loan Payment,-1309.329955
15252,715705683,2-25-24 14:28,10.42,Deposit,Direct Deposit,-1298.909955
15253,715705683,2-27-24 11:28,98.62,OnlineShopping,Target,-1397.529955
15254,715705683,2-27-24 19:28,99.78,Purchase,Travel,-1497.309955
15255,715705683,03-01-24 21:28,207.34,Deposit,Mobile Deposit,-1289.969955
15256,715705683,03-02-24 12:28,95.18,Purchase,Travel,-1385.149955
15257,715705683,03-02-24 12:28,140.32,Withdrawal,Mobile App Withdrawal,-1525.469955
15258,715705683,03-03-24 11:28,92.07,OutgoingTransfer,Wire Transfer,-1617.539955
15259,715705683,03-03-24 14:28,42.04,Withdrawal,Mobile App Withdrawal,-1659.579955
15260,715705683,03-04-24 21:28,2350,IncomingTransfer,Salary,690.4200448
15261,715705683,03-08-24 12:28,73.65,OnlineShopping,Walmart,616.7700448
15262,715705683,03-09-24 21:28,1500,Payment,Credit Card Payment,-883.2299552
15263,715705683,03-12-24 13:28,232.85,Purchase,Travel,-1116.079955
15264,715705683,3-16-24 22:28,166.44,Purchase,Clothing,-1282.519955
15265,715705683,3-18-24 21:28,1400,Payment,Rent Payment,-2682.519955
15266,715705683,3-22-24 18:28,52.5,Payment,Loan Payment,-2735.019955
15267,715705683,3-22-24 23:28,12.36,OutgoingTransfer,Peer-to-Peer Transfer,-2747.379955
15268,715705683,3-27-24 21:28,47.96,Deposit,Direct Deposit,-2699.419955
15269,715705683,3-27-24 21:28,21.63,Purchase,Gas,-2721.049955
15270,715705683,3-29-24 13:28,105.31,Purchase,Entertainment,-2826.359955
15271,715705683,3-30-24 18:28,111.97,Payment,Mortgage Payment,-2938.329955
15272,715705683,3-31-24 14:28,184.43,Withdrawal,Mobile App Withdrawal,-3122.759955
15273,715705683,04-02-24 12:28,223.7,Return,Store Return,-2899.059955
15274,715705683,04-04-24 21:28,240.96,Deposit,Cash Deposit,-2658.099955
15275,715705683,04-05-24 21:28,2350,IncomingTransfer,Salary,-308.0999552
15276,715705683,04-07-24 16:28,21.55,OutgoingTransfer,Bank Transfer,-329.6499552
15277,715705683,04-10-24 21:28,1300,Payment,Credit Card Payment,-1629.649955
15278,715705683,4-17-24 21:28,1200,Payment,Rent Payment,-2829.649955
15279,715705683,4-23-24 19:28,10.62,Withdrawal,ATM Withdrawal,-2840.269955
15280,715705683,4-23-24 19:28,245.74,OnlineShopping,Walmart,-3086.009955
15281,715705683,4-26-24 16:28,142.18,Purchase,Clothing,-3228.189955
15282,715705683,4-30-24 19:28,89.33,OutgoingTransfer,Bank Transfer,-3317.519955
15283,715705683,05-03-24 21:28,2350,IncomingTransfer,Salary,-967.5199552
15284,715705683,05-07-24 22:28,212.14,Purchase,Electronics,-1179.659955
15285,715705683,05-08-24 21:28,1300,Payment,Credit Card Payment,-2479.659955
15286,715705683,05-09-24 12:28,72.88,Payment,Mortgage Payment,-2552.539955
15287,715705683,05-09-24 12:28,177.47,Deposit,Direct Deposit,-2375.069955
15288,715705683,05-10-24 21:28,900,Payment,Rent Payment,-3275.069955
15289,715705683,05-12-24 10:28,94.57,Payment,Mortgage Payment,-3369.639955
15290,715705683,05-12-24 22:28,143.88,Purchase,Clothing,-3513.519955
15291,715705683,5-13-24 22:28,48.34,Deposit,Cash Deposit,-3465.179955
15292,715705683,5-15-24 11:28,96.95,Purchase,Grocery,-3562.129955
15293,715705683,5-16-24 18:28,111.75,Payment,Loan Payment,-3673.879955
15294,715705683,5-18-24 19:28,23.18,Return,Walmart Return,-3650.699955
15295,715705683,5-22-24 15:28,138.85,Withdrawal,Mobile App Withdrawal,-3789.549955
15296,715705683,5-24-24 15:28,105.78,Payment,Mortgage Payment,-3895.329955
15297,715705683,5-24-24 19:28,202.8,Purchase,Electronics,-4098.129955
15298,715705683,5-25-24 12:28,151.13,Return,AliExpress Return,-3946.999955
15299,715705683,5-30-24 10:28,139.13,Purchase,Grocery,-4086.129955
15300,715705683,06-03-24 12:28,202.32,OnlineShopping,Amazon,-4288.449955
15301,715705683,06-05-24 21:28,2350,IncomingTransfer,Salary,-1938.449955
15302,715705683,06-08-24 12:28,121.51,OutgoingTransfer,Peer-to-Peer Transfer,-2059.959955
15303,715705683,06-09-24 16:28,226.27,OnlineShopping,AliExpress,-2286.229955
15304,715705683,06-10-24 10:28,211.99,Purchase,Furniture,-2498.219955
15305,715705683,06-10-24 21:28,1300,Payment,Credit Card Payment,-3798.219955
15306,715705683,06-12-24 19:28,208.12,Purchase,Clothing,-4006.339955
15307,715705683,06-12-24 21:28,700,Payment,Rent Payment,-4706.339955
15308,715705683,6-13-24 12:28,243.02,OutgoingTransfer,International Transfer,-4949.359955
15309,715705683,6-17-24 20:28,166.11,Withdrawal,Branch Withdrawal,-5115.469955
15310,715705683,6-29-24 15:28,12.23,Deposit,Check Deposit,-5103.239955
15311,715705683,07-02-24 19:28,135.16,Withdrawal,ATM Withdrawal,-5238.399955
15312,715705683,07-05-24 21:28,2350,IncomingTransfer,Salary,-2888.399955
15313,715705683,07-06-24 16:28,124.39,Deposit,Mobile Deposit,-2764.009955
15314,715705683,07-08-24 20:28,14.33,Purchase,Clothing,-2778.339955
15315,715705683,07-09-24 19:28,40.08,OutgoingTransfer,International Transfer,-2818.419955
15316,715705683,07-10-24 21:28,1600,Payment,Credit Card Payment,-4418.419955
15317,715705683,07-12-24 9:28,155.65,Return,Target Return,-4262.769955
15318,715705683,7-14-24 21:28,1200,Payment,Rent Payment,-5462.769955
15319,715710708,1-22-24 18:28,346.84,Deposit,Mobile Deposit,731.2720364
15320,715710708,1-26-24 13:28,520.83,IncomingTransfer,Freelance Payment,1252.102036
15321,715710708,1-29-24 11:28,228.99,Purchase,Restaurant,1023.112036
15322,715710708,1-31-24 9:28,254.49,OutgoingTransfer,Wire Transfer,768.6220364
15323,715710708,02-04-24 21:28,5750,IncomingTransfer,Salary,6518.622036
15324,715710708,02-05-24 13:28,240.38,Withdrawal,ATM Withdrawal,6278.242036
15325,715710708,02-06-24 9:28,256.4,Return,Best Buy Return,6534.642036
15326,715710708,02-06-24 15:28,226.07,Purchase,Pharmacy,6308.572036
15327,715710708,02-09-24 21:28,800,Payment,Credit Card Payment,5508.572036
15328,715710708,02-12-24 22:28,231.44,Withdrawal,Mobile App Withdrawal,5277.132036
15329,715710708,02-12-24 22:28,88.33,Return,AliExpress Return,5365.462036
15330,715710708,2-14-24 21:28,2300,Payment,Rent Payment,3065.462036
15331,715710708,2-18-24 22:28,164.53,OutgoingTransfer,Bank Transfer,2900.932036
15332,715710708,2-20-24 18:28,274.12,Withdrawal,ATM Withdrawal,2626.812036
15333,715710708,2-23-24 12:28,261.92,Withdrawal,Mobile App Withdrawal,2364.892036
15334,715710708,2-23-24 18:28,358.99,Purchase,Clothing,2005.902036
15335,715710708,2-25-24 22:28,454.41,Deposit,Mobile Deposit,2460.312036
15336,715710708,2-26-24 15:28,454.63,Withdrawal,Mobile App Withdrawal,2005.682036
15337,715710708,2-27-24 10:28,466.19,IncomingTransfer,Freelance Payment,2471.872036
15338,715710708,2-28-24 12:28,232.73,Return,Store Return,2704.602036
15339,715710708,2-28-24 12:28,75.2,Payment,Bill Payment,2629.402036
15340,715710708,03-01-24 21:28,5750,IncomingTransfer,Salary,8379.402036
15341,715710708,03-02-24 10:28,479.68,Withdrawal,ATM Withdrawal,7899.722036
15342,715710708,03-02-24 16:28,537.39,Deposit,Mobile Deposit,8437.112036
15343,715710708,03-04-24 18:28,108.4,IncomingTransfer,Freelance Payment,8545.512036
15344,715710708,03-04-24 20:28,344.34,Purchase,Gas,8201.172036
15345,715710708,03-06-24 21:28,900,Payment,Credit Card Payment,7301.172036
15346,715710708,03-09-24 14:28,119.53,Withdrawal,ATM Withdrawal,7181.642036
15347,715710708,3-17-24 21:28,3400,Payment,Rent Payment,3781.642036
15348,715710708,3-18-24 19:28,102.67,OnlineShopping,eBay,3678.972036
15349,715710708,3-19-24 13:28,378.09,Withdrawal,Branch Withdrawal,3300.882036
15350,715710708,3-19-24 20:28,337.04,OnlineShopping,Amazon,2963.842036
15351,715710708,3-21-24 15:28,196.57,Purchase,Travel,2767.272036
15352,715710708,3-21-24 15:28,328.52,Withdrawal,Mobile App Withdrawal,2438.752036
15353,715710708,3-24-24 12:28,154.58,Withdrawal,ATM Withdrawal,2284.172036
15354,715710708,3-31-24 19:28,372.5,Deposit,Direct Deposit,2656.672036
15355,715710708,04-05-24 13:28,82.11,Purchase,Clothing,2574.562036
15356,715710708,04-05-24 21:28,5750,IncomingTransfer,Salary,8324.562036
15357,715710708,04-06-24 16:28,81.54,Purchase,Furniture,8243.022036
15358,715710708,04-09-24 14:28,302.71,Deposit,Direct Deposit,8545.732036
15359,715710708,04-10-24 21:28,1100,Payment,Credit Card Payment,7445.732036
15360,715710708,4-14-24 10:28,207.84,Return,Best Buy Return,7653.572036
15361,715710708,4-16-24 15:28,216.58,Purchase,Clothing,7436.992036
15362,715710708,4-16-24 18:28,298.94,OnlineShopping,AliExpress,7138.052036
15363,715710708,4-17-24 21:28,1700,Payment,Rent Payment,5438.052036
15364,715710708,4-18-24 9:28,442.75,Purchase,Grocery,4995.302036
15365,715710708,4-19-24 14:28,320.99,Payment,Loan Payment,4674.312036
15366,715710708,4-23-24 18:28,499.64,OnlineShopping,AliExpress,4174.672036
15367,715710708,4-26-24 11:28,272.42,OutgoingTransfer,Bank Transfer,3902.252036
15368,715710708,4-27-24 12:28,414.54,OnlineShopping,Walmart,3487.712036
15369,715710708,05-04-24 20:28,335.34,Return,Etsy Return,3823.052036
15370,715710708,05-04-24 21:28,5750,IncomingTransfer,Salary,9573.052036
15371,715710708,05-09-24 16:28,278.62,OutgoingTransfer,Wire Transfer,9294.432036
15372,715710708,05-09-24 21:28,1000,Payment,Credit Card Payment,8294.432036
15373,715710708,05-09-24 22:28,129.94,Payment,Bill Payment,8164.492036
15374,715710708,05-11-24 19:28,275.56,OnlineShopping,Etsy,7888.932036
15375,715710708,05-11-24 19:28,160.99,Payment,Loan Payment,7727.942036
15376,715710708,5-13-24 21:28,1600,Payment,Rent Payment,6127.942036
15377,715710708,5-14-24 11:28,428.58,Return,Walmart Return,6556.522036
15378,715710708,5-16-24 19:28,412.68,OnlineShopping,AliExpress,6143.842036
15379,715710708,5-19-24 12:28,147.94,Payment,Bill Payment,5995.902036
15380,715710708,5-22-24 13:28,229.61,Purchase,Travel,5766.292036
15381,715710708,5-25-24 10:28,449.88,IncomingTransfer,Freelance Payment,6216.172036
15382,715710708,5-31-24 14:28,525.43,Deposit,Cash Deposit,6741.602036
15383,715710708,06-01-24 15:28,501.57,Purchase,Pharmacy,6240.032036
15384,715710708,06-02-24 17:28,376.67,Deposit,Check Deposit,6616.702036
15385,715710708,06-05-24 21:28,5750,IncomingTransfer,Salary,12366.70204
15386,715710708,06-06-24 19:28,184.77,Purchase,Entertainment,12181.93204
15387,715710708,06-07-24 9:28,144.24,Withdrawal,ATM Withdrawal,12037.69204
15388,715710708,06-07-24 10:28,61.02,Deposit,Check Deposit,12098.71204
15389,715710708,06-10-24 20:28,138.29,OutgoingTransfer,Peer-to-Peer Transfer,11960.42204
15390,715710708,06-10-24 21:28,1000,Payment,Credit Card Payment,10960.42204
15391,715710708,6-13-24 21:28,3400,Payment,Rent Payment,7560.422036
15392,715710708,6-16-24 18:28,324.97,Withdrawal,Branch Withdrawal,7235.452036
15393,715710708,6-19-24 21:28,173.74,Withdrawal,ATM Withdrawal,7061.712036
15394,715710708,6-21-24 19:28,480.48,Purchase,Clothing,6581.232036
15395,715710708,6-22-24 19:28,153.99,Return,eBay Return,6735.222036
15396,715710708,6-23-24 10:28,115.83,Return,AliExpress Return,6851.052036
15397,715710708,6-25-24 9:28,124.27,OnlineShopping,Amazon,6726.782036
15398,715710708,6-25-24 22:28,388.17,Deposit,Check Deposit,7114.952036
15399,715710708,6-26-24 15:28,216.05,Deposit,Direct Deposit,7331.002036
15400,715710708,6-27-24 17:28,169.13,OutgoingTransfer,International Transfer,7161.872036
15401,715710708,6-27-24 23:28,181.22,Deposit,Check Deposit,7343.092036
15402,715710708,6-29-24 22:28,341.42,Return,Etsy Return,7684.512036
15403,715710708,07-02-24 9:28,165.24,Purchase,Electronics,7519.272036
15404,715710708,07-04-24 21:28,5750,IncomingTransfer,Salary,13269.27204
15405,715710708,07-06-24 15:28,472.35,Payment,Loan Payment,12796.92204
15406,715710708,07-06-24 15:28,245.14,Deposit,Check Deposit,13042.06204
15407,715710708,07-08-24 22:28,170.63,Payment,Mortgage Payment,12871.43204
15408,715710708,07-09-24 21:28,900,Payment,Credit Card Payment,11971.43204
15409,715710708,07-09-24 23:28,260.2,Purchase,Grocery,11711.23204
15410,715710708,07-12-24 13:28,448.79,Withdrawal,Branch Withdrawal,11262.44204
15411,715710708,7-15-24 21:28,1900,Payment,Rent Payment,9362.442036
15412,715710708,7-16-24 16:28,405.6,Purchase,Restaurant,8956.842036
15413,715745508,1-20-24 13:28,373.55,Purchase,Restaurant,647.7765441
15414,715745508,1-26-24 13:28,280.21,OutgoingTransfer,Wire Transfer,367.5665441
15415,715745508,1-28-24 12:28,383.54,Purchase,Gas,-15.97345593
15416,715745508,1-29-24 21:28,445.64,Deposit,Check Deposit,429.6665441
15417,715745508,02-03-24 16:28,219.43,Purchase,Home Improvement,210.2365441
15418,715745508,02-03-24 21:28,5400,IncomingTransfer,Salary,5610.236544
15419,715745508,02-08-24 21:28,1900,Payment,Credit Card Payment,3710.236544
15420,715745508,02-12-24 18:28,323.5,Deposit,Cash Deposit,4033.736544
15421,715745508,2-13-24 23:28,320.36,Deposit,Check Deposit,4354.096544
15422,715745508,2-15-24 21:28,2600,Payment,Rent Payment,1754.096544
15423,715745508,2-17-24 16:28,27.04,Deposit,Direct Deposit,1781.136544
15424,715745508,2-19-24 9:28,113.72,Purchase,Entertainment,1667.416544
15425,715745508,2-26-24 10:28,368.37,Return,AliExpress Return,2035.786544
15426,715745508,03-02-24 21:28,359.64,Deposit,Cash Deposit,2395.426544
15427,715745508,03-04-24 21:28,5400,IncomingTransfer,Salary,7795.426544
15428,715745508,03-05-24 12:28,53.51,Return,Etsy Return,7848.936544
15429,715745508,03-07-24 9:28,460.2,Withdrawal,Mobile App Withdrawal,7388.736544
15430,715745508,03-09-24 21:28,1600,Payment,Credit Card Payment,5788.736544
15431,715745508,3-14-24 21:28,2400,Payment,Rent Payment,3388.736544
15432,715745508,3-17-24 10:28,454.17,Payment,Bill Payment,2934.566544
15433,715745508,3-17-24 12:28,269.26,Deposit,Direct Deposit,3203.826544
15434,715745508,3-27-24 18:28,53.05,Withdrawal,ATM Withdrawal,3150.776544
15435,715745508,3-29-24 19:28,105.86,Deposit,Direct Deposit,3256.636544
15436,715745508,04-01-24 16:28,317.91,Return,Target Return,3574.546544
15437,715745508,04-03-24 22:28,374.48,Purchase,Grocery,3200.066544
15438,715745508,04-04-24 9:28,246.77,Deposit,Check Deposit,3446.836544
15439,715745508,04-04-24 17:28,22.3,Withdrawal,Mobile App Withdrawal,3424.536544
15440,715745508,04-04-24 21:28,5400,IncomingTransfer,Salary,8824.536544
15441,715745508,04-09-24 12:28,150,Return,Etsy Return,8974.536544
15442,715745508,04-09-24 21:28,1300,Payment,Credit Card Payment,7674.536544
15443,715745508,04-12-24 21:28,3200,Payment,Rent Payment,4474.536544
15444,715745508,4-13-24 21:28,458.47,Deposit,Direct Deposit,4933.006544
15445,715745508,4-14-24 14:28,169.59,Purchase,Electronics,4763.416544
15446,715745508,4-17-24 20:28,392.88,Payment,Bill Payment,4370.536544
15447,715745508,4-21-24 15:28,92.45,Purchase,Grocery,4278.086544
15448,715745508,4-24-24 23:28,270.26,Purchase,Clothing,4007.826544
15449,715745508,05-02-24 11:28,361.69,OutgoingTransfer,International Transfer,3646.136544
15450,715745508,05-03-24 14:28,80.44,Withdrawal,ATM Withdrawal,3565.696544
15451,715745508,05-05-24 21:28,5400,IncomingTransfer,Salary,8965.696544
15452,715745508,05-09-24 9:28,479,Payment,Loan Payment,8486.696544
15453,715745508,05-10-24 21:28,1500,Payment,Credit Card Payment,6986.696544
15454,715745508,5-13-24 21:28,2300,Payment,Rent Payment,4686.696544
15455,715745508,5-18-24 11:28,129.16,Payment,Loan Payment,4557.536544
15456,715745508,5-21-24 16:28,89.19,Deposit,Mobile Deposit,4646.726544
15457,715745508,5-26-24 19:28,106.27,Deposit,Mobile Deposit,4752.996544
15458,715745508,5-26-24 22:28,83.85,Withdrawal,Mobile App Withdrawal,4669.146544
15459,715745508,5-28-24 23:28,362.2,Withdrawal,Branch Withdrawal,4306.946544
15460,715745508,5-29-24 20:28,225.1,Deposit,Mobile Deposit,4532.046544
15461,715745508,5-30-24 9:28,499.76,Withdrawal,ATM Withdrawal,4032.286544
15462,715745508,5-30-24 17:28,82.67,Return,Walmart Return,4114.956544
15463,715745508,06-02-24 16:28,168.77,OutgoingTransfer,Bank Transfer,3946.186544
15464,715745508,06-02-24 21:28,5400,IncomingTransfer,Salary,9346.186544
15465,715745508,06-07-24 21:28,1800,Payment,Credit Card Payment,7546.186544
15466,715745508,06-09-24 17:28,259.09,Deposit,Cash Deposit,7805.276544
15467,715745508,06-10-24 16:28,245.68,Purchase,Furniture,7559.596544
15468,715745508,06-11-24 21:28,2100,Payment,Rent Payment,5459.596544
15469,715745508,6-15-24 10:28,379.58,Deposit,Check Deposit,5839.176544
15470,715745508,6-27-24 21:28,411.54,OnlineShopping,Best Buy,5427.636544
15471,715745508,07-04-24 21:28,5400,IncomingTransfer,Salary,10827.63654
15472,715745508,07-04-24 23:28,469.63,OutgoingTransfer,Peer-to-Peer Transfer,10358.00654
15473,715745508,07-09-24 21:28,1800,Payment,Credit Card Payment,8558.006544
15474,715745508,7-15-24 21:28,2600,Payment,Rent Payment,5958.006544
15475,715745508,7-16-24 18:28,205.66,Purchase,Restaurant,5752.346544
15476,715760733,1-26-24 10:28,23.09,Return,Target Return,1233.971679
15477,715760733,1-27-24 10:28,149.25,IncomingTransfer,Freelance Payment,1383.221679
15478,715760733,02-03-24 10:28,198.21,Return,Best Buy Return,1581.431679
15479,715760733,02-03-24 21:28,3900,IncomingTransfer,Salary,5481.431679
15480,715760733,02-08-24 21:28,2100,Payment,Credit Card Payment,3381.431679
15481,715760733,02-11-24 18:28,140.59,Deposit,Direct Deposit,3522.021679
15482,715760733,2-15-24 21:28,1400,Payment,Installment Payment,2122.021679
15483,715760733,2-15-24 21:28,283.05,IncomingTransfer,Freelance Payment,2405.071679
15484,715760733,2-24-24 19:28,379.55,Deposit,Mobile Deposit,2784.621679
15485,715760733,03-01-24 22:28,60.62,OutgoingTransfer,Wire Transfer,2724.001679
15486,715760733,03-02-24 21:28,3900,IncomingTransfer,Salary,6624.001679
15487,715760733,03-07-24 21:28,2700,Payment,Credit Card Payment,3924.001679
15488,715760733,3-13-24 21:28,1400,Payment,Installment Payment,2524.001679
15489,715760733,3-26-24 10:28,85.76,Purchase,Pharmacy,2438.241679
15490,715760733,3-27-24 11:28,284.57,OutgoingTransfer,Peer-to-Peer Transfer,2153.671679
15491,715760733,3-29-24 12:28,115.25,Deposit,Direct Deposit,2268.921679
15492,715760733,04-02-24 10:28,142.06,Payment,Mortgage Payment,2126.861679
15493,715760733,04-02-24 17:28,108.72,OutgoingTransfer,Peer-to-Peer Transfer,2018.141679
15494,715760733,04-05-24 21:28,3900,IncomingTransfer,Salary,5918.141679
15495,715760733,04-10-24 21:28,1900,Payment,Credit Card Payment,4018.141679
15496,715760733,04-11-24 10:28,161.6,Deposit,Direct Deposit,4179.741679
15497,715760733,4-18-24 21:28,1100,Payment,Insurance Payment,3079.741679
15498,715760733,4-25-24 18:28,216.24,Withdrawal,Mobile App Withdrawal,2863.501679
15499,715760733,4-28-24 18:28,146.78,OnlineShopping,Walmart,2716.721679
15500,715760733,05-01-24 21:28,3900,IncomingTransfer,Salary,6616.721679
15501,715760733,05-06-24 21:28,2400,Payment,Credit Card Payment,4216.721679
15502,715760733,5-15-24 21:28,1000,Payment,Installment Payment,3216.721679
15503,715760733,5-16-24 11:28,110.03,OutgoingTransfer,International Transfer,3106.691679
15504,715760733,5-17-24 11:28,355.92,OutgoingTransfer,Peer-to-Peer Transfer,2750.771679
15505,715760733,5-20-24 22:28,157.49,Withdrawal,Branch Withdrawal,2593.281679
15506,715760733,5-26-24 12:28,43.15,Deposit,Check Deposit,2636.431679
15507,715760733,5-26-24 19:28,292.62,Withdrawal,ATM Withdrawal,2343.811679
15508,715760733,06-01-24 21:28,3900,IncomingTransfer,Salary,6243.811679
15509,715760733,06-03-24 16:28,140.83,Purchase,Entertainment,6102.981679
15510,715760733,06-06-24 21:28,2300,Payment,Credit Card Payment,3802.981679
15511,715760733,06-12-24 21:28,1000,Payment,Insurance Payment,2802.981679
15512,715760733,6-25-24 17:28,322.14,Withdrawal,ATM Withdrawal,2480.841679
15513,715760733,6-28-24 10:28,378.81,Return,Walmart Return,2859.651679
15514,715760733,07-01-24 23:28,310.84,OnlineShopping,eBay,2548.811679
15515,715760733,07-05-24 21:28,3900,IncomingTransfer,Salary,6448.811679
15516,715760733,07-10-24 21:28,2500,Payment,Credit Card Payment,3948.811679
15517,715760733,07-11-24 16:28,290.33,OnlineShopping,AliExpress,3658.481679
15518,715760733,07-11-24 21:28,1100,Payment,Insurance Payment,2558.481679
15519,715767033,1-22-24 18:28,36.79,OnlineShopping,Etsy,-36.79
15520,715767033,1-24-24 16:28,291.27,Purchase,Grocery,-328.06
15521,715767033,1-25-24 17:28,469.28,OutgoingTransfer,Peer-to-Peer Transfer,-797.34
15522,715767033,02-01-24 21:28,1650,IncomingTransfer,Salary,852.66
15523,715767033,02-04-24 11:28,383.58,Purchase,Restaurant,469.08
15524,715767033,02-04-24 18:28,62.25,OutgoingTransfer,Wire Transfer,406.83
15525,715767033,02-12-24 19:28,354.45,Payment,Mortgage Payment,52.38
15526,715767033,02-12-24 22:28,70.63,Deposit,Direct Deposit,123.01
15527,715767033,2-14-24 21:28,400,Payment,Subscription Payment,-276.99
15528,715767033,2-16-24 13:28,329.92,Withdrawal,Branch Withdrawal,-606.91
15529,715767033,2-17-24 13:28,466.27,Return,Store Return,-140.64
15530,715767033,2-17-24 15:28,252.59,Payment,Mortgage Payment,-393.23
15531,715767033,2-18-24 14:28,153.3,Withdrawal,ATM Withdrawal,-546.53
15532,715767033,2-19-24 23:28,311.28,Withdrawal,Branch Withdrawal,-857.81
15533,715767033,2-21-24 18:28,302.85,Withdrawal,Branch Withdrawal,-1160.66
15534,715767033,2-29-24 9:28,72.53,Return,Amazon Return,-1088.13
15535,715767033,03-01-24 15:28,436.66,Withdrawal,Mobile App Withdrawal,-1524.79
15536,715767033,03-02-24 22:28,239.38,OnlineShopping,eBay,-1764.17
15537,715767033,03-05-24 21:28,1650,IncomingTransfer,Salary,-114.17
15538,715767033,03-07-24 13:28,46.58,Return,Etsy Return,-67.59
15539,715767033,3-17-24 11:28,32.42,Withdrawal,ATM Withdrawal,-100.01
15540,715767033,3-18-24 10:28,318.77,Withdrawal,Branch Withdrawal,-418.78
15541,715767033,3-18-24 11:28,31.47,Deposit,Check Deposit,-387.31
15542,715767033,3-18-24 21:28,400,Payment,Subscription Payment,-787.31
15543,715767033,3-18-24 22:28,232.04,OnlineShopping,eBay,-1019.35
15544,715767033,3-21-24 13:28,320.81,Withdrawal,Branch Withdrawal,-1340.16
15545,715767033,3-22-24 11:28,313.67,Withdrawal,ATM Withdrawal,-1653.83
15546,715767033,3-22-24 14:28,237.38,Return,Walmart Return,-1416.45
15547,715767033,3-24-24 10:28,217.04,IncomingTransfer,Freelance Payment,-1199.41
15548,715767033,3-26-24 11:28,134.64,IncomingTransfer,Freelance Payment,-1064.77
15549,715767033,3-27-24 14:28,299.97,Return,Etsy Return,-764.8
15550,715767033,04-03-24 21:28,55.23,Purchase,Grocery,-820.03
15551,715767033,04-04-24 21:28,1650,IncomingTransfer,Salary,829.97
15552,715767033,04-05-24 20:28,111.55,IncomingTransfer,Freelance Payment,941.52
15553,715767033,04-06-24 12:28,297.96,OutgoingTransfer,Bank Transfer,643.56
15554,715767033,04-06-24 19:28,241.66,Deposit,Cash Deposit,885.22
15555,715767033,04-08-24 17:28,466.61,Withdrawal,ATM Withdrawal,418.61
15556,715767033,04-08-24 18:28,272.64,Return,Walmart Return,691.25
15557,715767033,04-10-24 21:28,500,Payment,Insurance Payment,191.25
15558,715767033,4-14-24 13:28,220.86,Purchase,Clothing,-29.61
15559,715767033,4-16-24 19:28,436.94,Deposit,Direct Deposit,407.33
15560,715767033,4-16-24 21:28,451.63,OnlineShopping,Target,-44.3
15561,715767033,4-18-24 9:28,211.05,OutgoingTransfer,International Transfer,-255.35
15562,715767033,4-19-24 14:28,46.04,Withdrawal,ATM Withdrawal,-301.39
15563,715767033,4-21-24 14:28,244.27,Payment,Mortgage Payment,-545.66
15564,715767033,4-25-24 16:28,247.75,OnlineShopping,Etsy,-793.41
15565,715767033,4-27-24 10:28,53.02,Return,Store Return,-740.39
15566,715767033,4-27-24 10:28,485.64,Purchase,Furniture,-1226.03
15567,715767033,4-28-24 22:28,188.15,Purchase,Furniture,-1414.18
15568,715767033,4-29-24 17:28,281.75,Payment,Bill Payment,-1695.93
15569,715767033,05-01-24 13:28,254.59,Purchase,Clothing,-1950.52
15570,715767033,05-02-24 21:28,1650,IncomingTransfer,Salary,-300.52
15571,715767033,05-03-24 10:28,28.27,Purchase,Home Improvement,-328.79
15572,715767033,05-03-24 17:28,387.65,Withdrawal,Mobile App Withdrawal,-716.44
15573,715767033,05-05-24 13:28,24.73,Purchase,Electronics,-741.17
15574,715767033,05-05-24 22:28,132.93,Withdrawal,Mobile App Withdrawal,-874.1
15575,715767033,05-07-24 16:28,208.02,IncomingTransfer,Freelance Payment,-666.08
15576,715767033,05-08-24 22:28,166.25,Withdrawal,Mobile App Withdrawal,-832.33
15577,715767033,05-10-24 18:28,76.22,Purchase,Grocery,-908.55
15578,715767033,05-11-24 21:28,600,Payment,Insurance Payment,-1508.55
15579,715767033,5-13-24 15:28,270.27,Deposit,Cash Deposit,-1238.28
15580,715767033,5-16-24 15:28,176.14,OnlineShopping,eBay,-1414.42
15581,715767033,5-16-24 18:28,23.29,Withdrawal,Mobile App Withdrawal,-1437.71
15582,715767033,5-17-24 23:28,321.62,Purchase,Gas,-1759.33
15583,715767033,5-25-24 11:28,445.33,Withdrawal,ATM Withdrawal,-2204.66
15584,715767033,5-25-24 21:28,384.39,Purchase,Restaurant,-2589.05
15585,715767033,5-28-24 23:28,107.13,OnlineShopping,Best Buy,-2696.18
15586,715767033,06-02-24 12:28,138.64,Return,Target Return,-2557.54
15587,715767033,06-03-24 21:28,1650,IncomingTransfer,Salary,-907.54
15588,715767033,06-05-24 14:28,404.1,OnlineShopping,AliExpress,-1311.64
15589,715767033,06-06-24 21:28,109.62,Withdrawal,ATM Withdrawal,-1421.26
15590,715767033,06-07-24 14:28,88.77,Purchase,Travel,-1510.03
15591,715767033,06-08-24 22:28,317.44,Withdrawal,ATM Withdrawal,-1827.47
15592,715767033,6-14-24 11:28,128.92,Payment,Loan Payment,-1956.39
15593,715767033,6-14-24 12:28,177.56,OnlineShopping,Best Buy,-2133.95
15594,715767033,6-15-24 20:28,368.42,Withdrawal,Branch Withdrawal,-2502.37
15595,715767033,6-17-24 21:28,600,Payment,Subscription Payment,-3102.37
15596,715767033,6-17-24 21:28,109.45,OnlineShopping,Etsy,-3211.82
15597,715767033,6-20-24 20:28,383.74,IncomingTransfer,Freelance Payment,-2828.08
15598,715767033,6-21-24 12:28,132.42,Purchase,Gas,-2960.5
15599,715767033,6-24-24 9:28,81.2,Withdrawal,Mobile App Withdrawal,-3041.7
15600,715767033,6-25-24 22:28,423.65,OutgoingTransfer,Bank Transfer,-3465.35
15601,715767033,6-29-24 17:28,104.71,OnlineShopping,AliExpress,-3570.06
15602,715767033,07-03-24 12:28,13.27,Return,Amazon Return,-3556.79
15603,715767033,07-03-24 18:28,361.65,Return,Target Return,-3195.14
15604,715767033,07-04-24 21:28,80.59,Withdrawal,Mobile App Withdrawal,-3275.73
15605,715767033,07-05-24 21:28,1650,IncomingTransfer,Salary,-1625.73
15606,715767033,07-06-24 13:28,69.16,OnlineShopping,Target,-1694.89
15607,715767033,07-07-24 12:28,274.13,Deposit,Direct Deposit,-1420.76
15608,715767033,07-10-24 17:28,46.86,Purchase,Clothing,-1467.62
15609,715767033,07-11-24 14:28,137.15,Withdrawal,Branch Withdrawal,-1604.77
15610,715767033,07-12-24 18:28,339.83,Withdrawal,Mobile App Withdrawal,-1944.6
15611,715767033,07-12-24 21:28,700,Payment,Subscription Payment,-2644.6
15612,715767033,7-14-24 14:28,80.81,Purchase,Pharmacy,-2725.41
15613,715767033,7-16-24 19:28,86.7,OutgoingTransfer,Bank Transfer,-2812.11
15614,715769958,1-23-24 10:28,291.1,OutgoingTransfer,International Transfer,680.1054785
15615,715769958,1-25-24 9:28,385.89,Withdrawal,Branch Withdrawal,294.2154785
15616,715769958,1-26-24 16:28,37.5,Deposit,Mobile Deposit,331.7154785
15617,715769958,1-26-24 23:28,110.47,Deposit,Check Deposit,442.1854785
15618,715769958,1-27-24 13:28,38.96,Deposit,Direct Deposit,481.1454785
15619,715769958,1-27-24 17:28,223.57,Return,Best Buy Return,704.7154785
15620,715769958,1-28-24 15:28,381.27,OutgoingTransfer,Wire Transfer,323.4454785
15621,715769958,1-28-24 19:28,353.27,Withdrawal,Branch Withdrawal,-29.82452154
15622,715769958,1-30-24 17:28,123.34,Deposit,Cash Deposit,93.51547846
15623,715769958,02-02-24 9:28,223.79,Withdrawal,ATM Withdrawal,-130.2745215
15624,715769958,02-02-24 12:28,83.53,OnlineShopping,Target,-213.8045215
15625,715769958,02-03-24 21:28,4950,IncomingTransfer,Salary,4736.195478
15626,715769958,02-05-24 19:28,171.46,Payment,Bill Payment,4564.735478
15627,715769958,02-07-24 16:28,357.8,Purchase,Clothing,4206.935478
15628,715769958,02-08-24 15:28,394.2,Purchase,Grocery,3812.735478
15629,715769958,02-08-24 21:28,2600,Payment,Credit Card Payment,1212.735478
15630,715769958,02-09-24 15:28,357.17,Withdrawal,Mobile App Withdrawal,855.5654785
15631,715769958,02-10-24 22:28,184.85,Return,Etsy Return,1040.415478
15632,715769958,02-11-24 12:28,146.88,OutgoingTransfer,Wire Transfer,893.5354785
15633,715769958,2-15-24 21:28,1700,Payment,Rent Payment,-806.4645215
15634,715769958,2-16-24 16:28,362.65,Deposit,Cash Deposit,-443.8145215
15635,715769958,2-17-24 10:28,62.79,Purchase,Furniture,-506.6045215
15636,715769958,2-21-24 10:28,101.33,Return,Target Return,-405.2745215
15637,715769958,2-22-24 18:28,37.17,IncomingTransfer,Freelance Payment,-368.1045215
15638,715769958,2-22-24 19:28,359.2,Withdrawal,Branch Withdrawal,-727.3045215
15639,715769958,2-23-24 12:28,53.51,Deposit,Direct Deposit,-673.7945215
15640,715769958,2-26-24 14:28,157.86,Deposit,Direct Deposit,-515.9345215
15641,715769958,2-29-24 21:28,254.99,OutgoingTransfer,Wire Transfer,-770.9245215
15642,715769958,03-02-24 15:28,119.26,IncomingTransfer,Freelance Payment,-651.6645215
15643,715769958,03-02-24 19:28,112.61,Payment,Mortgage Payment,-764.2745215
15644,715769958,03-04-24 19:28,368.58,Purchase,Home Improvement,-1132.854522
15645,715769958,03-05-24 16:28,150.68,OutgoingTransfer,Wire Transfer,-1283.534522
15646,715769958,03-05-24 21:28,4950,IncomingTransfer,Salary,3666.465478
15647,715769958,03-05-24 23:28,37.42,OutgoingTransfer,Peer-to-Peer Transfer,3629.045478
15648,715769958,03-06-24 12:28,60.4,Purchase,Furniture,3568.645478
15649,715769958,03-06-24 13:28,214.02,Deposit,Cash Deposit,3782.665478
15650,715769958,03-06-24 20:28,287.94,Deposit,Check Deposit,4070.605478
15651,715769958,03-07-24 17:28,22.54,Purchase,Gas,4048.065478
15652,715769958,03-08-24 12:28,90.63,OnlineShopping,Target,3957.435478
15653,715769958,03-10-24 21:28,2600,Payment,Credit Card Payment,1357.435478
15654,715769958,3-15-24 21:28,2900,Payment,Rent Payment,-1542.564522
15655,715769958,3-16-24 14:28,366.07,Payment,Loan Payment,-1908.634522
15656,715769958,3-17-24 15:28,64.65,Return,Walmart Return,-1843.984522
15657,715769958,3-23-24 16:28,347.39,Deposit,Direct Deposit,-1496.594522
15658,715769958,3-24-24 13:28,77.62,Deposit,Direct Deposit,-1418.974522
15659,715769958,3-25-24 17:28,259.06,Payment,Bill Payment,-1678.034522
15660,715769958,3-29-24 22:28,353.29,OutgoingTransfer,International Transfer,-2031.324522
15661,715769958,04-01-24 9:28,41.01,Purchase,Entertainment,-2072.334522
15662,715769958,04-03-24 13:28,113.94,Return,Best Buy Return,-1958.394522
15663,715769958,04-04-24 11:28,390.24,Payment,Loan Payment,-2348.634522
15664,715769958,04-04-24 21:28,4950,IncomingTransfer,Salary,2601.365478
15665,715769958,04-05-24 10:28,32.69,Deposit,Cash Deposit,2634.055478
15666,715769958,04-05-24 18:28,326.66,Withdrawal,ATM Withdrawal,2307.395478
15667,715769958,04-06-24 10:28,201.78,Deposit,Mobile Deposit,2509.175478
15668,715769958,04-06-24 16:28,219.88,OutgoingTransfer,International Transfer,2289.295478
15669,715769958,04-09-24 21:28,2000,Payment,Credit Card Payment,289.2954785
15670,715769958,04-09-24 22:28,161.41,Purchase,Pharmacy,127.8854785
15671,715769958,4-13-24 21:28,380.79,OutgoingTransfer,Wire Transfer,-252.9045215
15672,715769958,4-14-24 20:28,350.71,Payment,Mortgage Payment,-603.6145215
15673,715769958,4-15-24 13:28,116.27,Deposit,Cash Deposit,-487.3445215
15674,715769958,4-16-24 19:28,147.22,Deposit,Mobile Deposit,-340.1245215
15675,715769958,4-17-24 17:28,37.75,OutgoingTransfer,International Transfer,-377.8745215
15676,715769958,4-17-24 21:28,2400,Payment,Rent Payment,-2777.874522
15677,715769958,4-18-24 21:28,232.61,Return,Walmart Return,-2545.264522
15678,715769958,4-19-24 14:28,202.26,Deposit,Direct Deposit,-2343.004522
15679,715769958,4-26-24 10:28,382.59,Deposit,Direct Deposit,-1960.414522
15680,715769958,4-28-24 18:28,173.56,Payment,Bill Payment,-2133.974522
15681,715769958,4-29-24 18:28,157.14,Withdrawal,Branch Withdrawal,-2291.114522
15682,715769958,4-30-24 13:28,251.47,Deposit,Cash Deposit,-2039.644522
15683,715769958,4-30-24 20:28,85.51,Return,Target Return,-1954.134522
15684,715769958,05-01-24 16:28,384.43,OnlineShopping,AliExpress,-2338.564522
15685,715769958,05-01-24 21:28,4950,IncomingTransfer,Salary,2611.435478
15686,715769958,05-04-24 13:28,354.04,Purchase,Travel,2257.395478
15687,715769958,05-05-24 20:28,98.08,OnlineShopping,Walmart,2159.315478
15688,715769958,05-05-24 22:28,349.25,Payment,Loan Payment,1810.065478
15689,715769958,05-06-24 21:28,2300,Payment,Credit Card Payment,-489.9345215
15690,715769958,05-07-24 12:28,26.63,Payment,Mortgage Payment,-516.5645215
15691,715769958,05-08-24 19:28,183.12,Purchase,Electronics,-699.6845215
15692,715769958,05-09-24 18:28,166.51,Purchase,Pharmacy,-866.1945215
15693,715769958,05-11-24 10:28,380.6,Deposit,Direct Deposit,-485.5945215
15694,715769958,05-11-24 12:28,346.5,Return,Amazon Return,-139.0945215
15695,715769958,05-11-24 14:28,132.35,Withdrawal,Branch Withdrawal,-271.4445215
15696,715769958,5-13-24 11:28,300.56,Purchase,Restaurant,-572.0045215
15697,715769958,5-14-24 11:28,329.74,Purchase,Gas,-901.7445215
15698,715769958,5-14-24 21:28,2100,Payment,Rent Payment,-3001.744522
15699,715769958,5-15-24 19:28,193.99,Purchase,Grocery,-3195.734522
15700,715769958,5-17-24 14:28,224.78,Withdrawal,ATM Withdrawal,-3420.514522
15701,715769958,5-26-24 14:28,237.16,OnlineShopping,Target,-3657.674522
15702,715769958,5-30-24 10:28,81.48,Purchase,Travel,-3739.154522
15703,715769958,06-02-24 16:28,308,Return,Target Return,-3431.154522
15704,715769958,06-02-24 19:28,382.92,Payment,Mortgage Payment,-3814.074522
15705,715769958,06-02-24 21:28,4950,IncomingTransfer,Salary,1135.925478
15706,715769958,06-04-24 22:28,325.49,Deposit,Check Deposit,1461.415478
15707,715769958,06-05-24 22:28,190.96,Return,Target Return,1652.375478
15708,715769958,06-07-24 21:28,2200,Payment,Credit Card Payment,-547.6245215
15709,715769958,06-08-24 22:28,396.28,Deposit,Cash Deposit,-151.3445215
15710,715769958,06-09-24 21:28,310.06,Deposit,Direct Deposit,158.7154785
15711,715769958,06-10-24 18:28,30.34,Purchase,Pharmacy,128.3754785
15712,715769958,06-11-24 10:28,350.43,Withdrawal,Mobile App Withdrawal,-222.0545215
15713,715769958,06-11-24 10:28,136.81,Return,Target Return,-85.24452154
15714,715769958,6-13-24 16:28,123.25,Withdrawal,ATM Withdrawal,-208.4945215
15715,715769958,6-13-24 20:28,74.7,IncomingTransfer,Freelance Payment,-133.7945215
15716,715769958,6-14-24 21:28,2200,Payment,Rent Payment,-2333.794522
15717,715769958,6-16-24 14:28,172.38,Purchase,Restaurant,-2506.174522
15718,715769958,6-23-24 13:28,165.91,OnlineShopping,AliExpress,-2672.084522
15719,715769958,6-29-24 20:28,56.53,OutgoingTransfer,Wire Transfer,-2728.614522
15720,715769958,6-30-24 17:28,35.59,Purchase,Clothing,-2764.204522
15721,715769958,07-01-24 16:28,132.68,Deposit,Cash Deposit,-2631.524522
15722,715769958,07-02-24 10:28,323.76,Withdrawal,Branch Withdrawal,-2955.284522
15723,715769958,07-04-24 10:28,188,Purchase,Pharmacy,-3143.284522
15724,715769958,07-04-24 21:28,4950,IncomingTransfer,Salary,1806.715478
15725,715769958,07-06-24 14:28,298.03,Deposit,Cash Deposit,2104.745478
15726,715769958,07-06-24 14:28,113.97,Withdrawal,ATM Withdrawal,1990.775478
15727,715769958,07-08-24 12:28,132.35,Deposit,Direct Deposit,2123.125478
15728,715769958,07-09-24 21:28,2200,Payment,Credit Card Payment,-76.87452154
15729,715769958,07-10-24 13:28,58.57,Purchase,Grocery,-135.4445215
15730,715769958,07-10-24 18:28,376.79,Purchase,Electronics,-512.2345215
15731,715769958,07-12-24 18:28,203.19,Payment,Loan Payment,-715.4245215
15732,715769958,7-13-24 17:28,266.91,Return,Best Buy Return,-448.5145215
15733,715769958,7-13-24 21:28,1700,Payment,Rent Payment,-2148.514522
15734,715769958,7-16-24 21:28,315.46,Purchase,Clothing,-2463.974522
15735,715769958,7-17-24 21:28,391.97,Return,Store Return,-2072.004522
15736,715812258,1-24-24 19:28,485.23,OutgoingTransfer,International Transfer,830.4851312
15737,715812258,02-02-24 9:28,545.1,OutgoingTransfer,International Transfer,285.3851312
15738,715812258,02-02-24 17:28,473.76,Withdrawal,Branch Withdrawal,-188.3748688
15739,715812258,02-03-24 18:28,528.49,Withdrawal,Mobile App Withdrawal,-716.8648688
15740,715812258,02-03-24 21:28,702.11,OnlineShopping,Target,-1418.974869
15741,715812258,02-04-24 21:28,7900,IncomingTransfer,Salary,6481.025131
15742,715812258,02-08-24 17:28,214.88,Deposit,Check Deposit,6695.905131
15743,715812258,02-09-24 21:28,2000,Payment,Credit Card Payment,4695.905131
15744,715812258,02-12-24 18:28,593.88,Purchase,Entertainment,4102.025131
15745,715812258,2-17-24 21:28,3800,Payment,Rent Payment,302.0251312
15746,715812258,2-22-24 21:28,402.58,Purchase,Travel,-100.5548688
15747,715812258,2-24-24 11:28,129.19,Purchase,Electronics,-229.7448688
15748,715812258,2-29-24 11:28,320.18,Deposit,Cash Deposit,90.43513119
15749,715812258,03-02-24 12:28,223.4,Purchase,Restaurant,-132.9648688
15750,715812258,03-02-24 21:28,7900,IncomingTransfer,Salary,7767.035131
15751,715812258,03-03-24 13:28,138.64,Withdrawal,Mobile App Withdrawal,7628.395131
15752,715812258,03-07-24 9:28,643.92,OnlineShopping,Walmart,6984.475131
15753,715812258,03-07-24 21:28,1900,Payment,Credit Card Payment,5084.475131
15754,715812258,03-08-24 12:28,388.92,IncomingTransfer,Freelance Payment,5473.395131
15755,715812258,3-15-24 14:28,711.51,Withdrawal,ATM Withdrawal,4761.885131
15756,715812258,3-15-24 21:28,3900,Payment,Rent Payment,861.8851312
15757,715812258,3-23-24 16:28,255.53,OutgoingTransfer,Peer-to-Peer Transfer,606.3551312
15758,715812258,04-01-24 22:28,259.79,Return,Etsy Return,866.1451312
15759,715812258,04-04-24 21:28,7900,IncomingTransfer,Salary,8766.145131
15760,715812258,04-05-24 17:28,697.77,Deposit,Check Deposit,9463.915131
15761,715812258,04-09-24 21:28,2200,Payment,Credit Card Payment,7263.915131
15762,715812258,04-11-24 16:28,595.12,Deposit,Direct Deposit,7859.035131
15763,715812258,04-12-24 21:28,4000,Payment,Rent Payment,3859.035131
15764,715812258,4-15-24 16:28,356.95,Payment,Mortgage Payment,3502.085131
15765,715812258,4-20-24 18:28,587.32,Withdrawal,ATM Withdrawal,2914.765131
15766,715812258,4-25-24 13:28,150.12,Purchase,Gas,2764.645131
15767,715812258,05-01-24 11:28,120.76,Return,Amazon Return,2885.405131
15768,715812258,05-05-24 21:28,7900,IncomingTransfer,Salary,10785.40513
15769,715812258,05-06-24 9:28,524.78,OnlineShopping,Amazon,10260.62513
15770,715812258,05-06-24 20:28,119.24,OutgoingTransfer,Bank Transfer,10141.38513
15771,715812258,05-08-24 12:28,747.88,Purchase,Home Improvement,9393.505131
15772,715812258,05-09-24 17:28,245.98,Withdrawal,Mobile App Withdrawal,9147.525131
15773,715812258,05-10-24 21:28,2100,Payment,Credit Card Payment,7047.525131
15774,715812258,05-10-24 23:28,463.09,Withdrawal,Branch Withdrawal,6584.435131
15775,715812258,5-13-24 21:28,3500,Payment,Rent Payment,3084.435131
15776,715812258,5-22-24 19:28,476.64,Purchase,Gas,2607.795131
15777,715812258,5-30-24 10:28,441,Purchase,Gas,2166.795131
15778,715812258,06-02-24 21:28,7900,IncomingTransfer,Salary,10066.79513
15779,715812258,06-07-24 21:28,2200,Payment,Credit Card Payment,7866.795131
15780,715812258,6-14-24 21:28,2500,Payment,Rent Payment,5366.795131
15781,715812258,6-21-24 10:28,290.47,Withdrawal,ATM Withdrawal,5076.325131
15782,715812258,07-01-24 9:28,700.86,Payment,Loan Payment,4375.465131
15783,715812258,07-01-24 21:28,7900,IncomingTransfer,Salary,12275.46513
15784,715812258,07-06-24 21:28,2200,Payment,Credit Card Payment,10075.46513
15785,715812258,07-12-24 21:28,3100,Payment,Rent Payment,6975.465131
15786,715812258,7-16-24 18:28,660.53,Withdrawal,ATM Withdrawal,6314.935131
15787,715893633,1-23-24 15:28,244.82,Payment,Mortgage Payment,697.5862991
15788,715893633,1-28-24 10:28,56.81,Purchase,Gas,640.7762991
15789,715893633,1-31-24 12:28,24.98,Deposit,Direct Deposit,665.7562991
15790,715893633,02-01-24 21:28,2750,IncomingTransfer,Salary,3415.756299
15791,715893633,02-02-24 12:28,196.66,Purchase,Grocery,3219.096299
15792,715893633,02-02-24 19:28,198.84,OnlineShopping,Walmart,3020.256299
15793,715893633,02-02-24 21:28,190.59,Deposit,Direct Deposit,3210.846299
15794,715893633,02-06-24 21:28,1300,Payment,Credit Card Payment,1910.846299
15795,715893633,02-08-24 20:28,213.96,Return,Etsy Return,2124.806299
15796,715893633,02-11-24 11:28,19.29,Withdrawal,Branch Withdrawal,2105.516299
15797,715893633,02-12-24 16:28,211.14,Withdrawal,ATM Withdrawal,1894.376299
15798,715893633,02-12-24 21:28,1200,Payment,Rent Payment,694.3762991
15799,715893633,2-14-24 21:28,223.52,Deposit,Direct Deposit,917.8962991
15800,715893633,2-20-24 14:28,68.4,OutgoingTransfer,International Transfer,849.4962991
15801,715893633,2-21-24 18:28,61.15,OnlineShopping,Target,788.3462991
15802,715893633,2-23-24 23:28,162.94,Deposit,Check Deposit,951.2862991
15803,715893633,2-25-24 10:28,190.37,Withdrawal,ATM Withdrawal,760.9162991
15804,715893633,2-27-24 20:28,184.45,Return,eBay Return,945.3662991
15805,715893633,2-28-24 10:28,80.96,IncomingTransfer,Freelance Payment,1026.326299
15806,715893633,2-28-24 22:28,222.57,OnlineShopping,Best Buy,803.7562991
15807,715893633,2-29-24 16:28,86.16,Withdrawal,ATM Withdrawal,717.5962991
15808,715893633,2-29-24 23:28,166.8,Purchase,Grocery,550.7962991
15809,715893633,03-01-24 21:28,2750,IncomingTransfer,Salary,3300.796299
15810,715893633,03-02-24 12:28,173.23,Withdrawal,Mobile App Withdrawal,3127.566299
15811,715893633,03-02-24 18:28,161.85,OnlineShopping,Amazon,2965.716299
15812,715893633,03-03-24 13:28,144.34,Payment,Mortgage Payment,2821.376299
15813,715893633,03-03-24 13:28,215.26,OutgoingTransfer,Wire Transfer,2606.116299
15814,715893633,03-06-24 21:28,1400,Payment,Credit Card Payment,1206.116299
15815,715893633,03-12-24 17:28,35.31,Deposit,Direct Deposit,1241.426299
15816,715893633,3-13-24 11:28,230.24,Withdrawal,ATM Withdrawal,1011.186299
15817,715893633,3-14-24 21:28,1000,Payment,Rent Payment,11.18629912
15818,715893633,3-15-24 10:28,21.41,Deposit,Check Deposit,32.59629912
15819,715893633,3-16-24 17:28,98.19,Deposit,Mobile Deposit,130.7862991
15820,715893633,3-16-24 18:28,173.62,Deposit,Check Deposit,304.4062991
15821,715893633,3-18-24 19:28,56.74,Deposit,Check Deposit,361.1462991
15822,715893633,3-21-24 21:28,150.1,Withdrawal,Branch Withdrawal,211.0462991
15823,715893633,3-28-24 15:28,236.31,Payment,Mortgage Payment,-25.26370088
15824,715893633,3-29-24 17:28,135.11,Return,Target Return,109.8462991
15825,715893633,3-29-24 22:28,172.81,OutgoingTransfer,Peer-to-Peer Transfer,-62.96370088
15826,715893633,3-30-24 19:28,58.72,Return,eBay Return,-4.243700884
15827,715893633,04-01-24 10:28,50.63,Purchase,Pharmacy,-54.87370088
15828,715893633,04-02-24 21:28,2750,IncomingTransfer,Salary,2695.126299
15829,715893633,04-05-24 12:28,59.15,Withdrawal,Branch Withdrawal,2635.976299
15830,715893633,04-07-24 21:28,1500,Payment,Credit Card Payment,1135.976299
15831,715893633,04-08-24 19:28,113.58,Purchase,Electronics,1022.396299
15832,715893633,04-12-24 17:28,134.97,Payment,Mortgage Payment,887.4262991
15833,715893633,4-14-24 17:28,69.43,Deposit,Mobile Deposit,956.8562991
15834,715893633,4-15-24 21:28,1000,Payment,Rent Payment,-43.14370088
15835,715893633,4-22-24 10:28,18.61,Purchase,Home Improvement,-61.75370088
15836,715893633,4-25-24 23:28,178.64,Withdrawal,Mobile App Withdrawal,-240.3937009
15837,715893633,4-27-24 22:28,76.98,Payment,Loan Payment,-317.3737009
15838,715893633,4-30-24 22:28,239.14,Purchase,Pharmacy,-556.5137009
15839,715893633,05-03-24 21:28,2750,IncomingTransfer,Salary,2193.486299
15840,715893633,05-04-24 10:28,33.99,Deposit,Cash Deposit,2227.476299
15841,715893633,05-08-24 9:28,91.59,Withdrawal,ATM Withdrawal,2135.886299
15842,715893633,05-08-24 16:28,133.75,Purchase,Travel,2002.136299
15843,715893633,05-08-24 21:28,1200,Payment,Credit Card Payment,802.1362991
15844,715893633,05-09-24 18:28,113.04,Payment,Mortgage Payment,689.0962991
15845,715893633,05-10-24 12:28,14.34,Purchase,Clothing,674.7562991
15846,715893633,05-10-24 21:28,1100,Payment,Rent Payment,-425.2437009
15847,715893633,05-11-24 17:28,134.01,OutgoingTransfer,International Transfer,-559.2537009
15848,715893633,05-11-24 22:28,180.13,Return,Amazon Return,-379.1237009
15849,715893633,05-12-24 18:28,37.02,Purchase,Electronics,-416.1437009
15850,715893633,5-13-24 17:28,244,OnlineShopping,Target,-660.1437009
15851,715893633,5-15-24 15:28,197.12,OutgoingTransfer,Peer-to-Peer Transfer,-857.2637009
15852,715893633,5-16-24 22:28,242.91,Withdrawal,Mobile App Withdrawal,-1100.173701
15853,715893633,5-23-24 10:28,117.12,Payment,Bill Payment,-1217.293701
15854,715893633,5-25-24 15:28,27.86,Purchase,Grocery,-1245.153701
15855,715893633,5-25-24 21:28,174.48,IncomingTransfer,Freelance Payment,-1070.673701
15856,715893633,5-28-24 13:28,49.23,Withdrawal,Mobile App Withdrawal,-1119.903701
15857,715893633,5-28-24 23:28,36.98,OnlineShopping,Walmart,-1156.883701
15858,715893633,5-31-24 19:28,149.15,Purchase,Home Improvement,-1306.033701
15859,715893633,06-02-24 16:28,145.17,Withdrawal,Mobile App Withdrawal,-1451.203701
15860,715893633,06-03-24 21:28,2750,IncomingTransfer,Salary,1298.796299
15861,715893633,06-08-24 21:28,1300,Payment,Credit Card Payment,-1.203700884
15862,715893633,06-09-24 21:28,28.96,OutgoingTransfer,Wire Transfer,-30.16370088
15863,715893633,06-10-24 15:28,30.29,IncomingTransfer,Freelance Payment,0.126299116
15864,715893633,06-10-24 19:28,144.24,OutgoingTransfer,Wire Transfer,-144.1137009
15865,715893633,06-10-24 20:28,15.58,OutgoingTransfer,International Transfer,-159.6937009
15866,715893633,6-16-24 21:28,1500,Payment,Rent Payment,-1659.693701
15867,715893633,6-18-24 16:28,134.5,OnlineShopping,Etsy,-1794.193701
15868,715893633,6-19-24 20:28,167.83,Withdrawal,ATM Withdrawal,-1962.023701
15869,715893633,6-24-24 17:28,231.56,OnlineShopping,Target,-2193.583701
15870,715893633,6-25-24 18:28,93.88,OutgoingTransfer,Wire Transfer,-2287.463701
15871,715893633,6-26-24 9:28,132.82,Purchase,Grocery,-2420.283701
15872,715893633,6-29-24 21:28,244.64,Purchase,Restaurant,-2664.923701
15873,715893633,07-03-24 21:28,2750,IncomingTransfer,Salary,85.07629912
15874,715893633,07-04-24 12:28,73.29,Withdrawal,Mobile App Withdrawal,11.78629912
15875,715893633,07-04-24 17:28,218.57,Purchase,Grocery,-206.7837009
15876,715893633,07-06-24 17:28,40.78,Payment,Mortgage Payment,-247.5637009
15877,715893633,07-07-24 22:28,22.47,Purchase,Grocery,-270.0337009
15878,715893633,07-08-24 21:28,1500,Payment,Credit Card Payment,-1770.033701
15879,715893633,07-10-24 9:28,214.41,Withdrawal,Mobile App Withdrawal,-1984.443701
15880,715893633,07-10-24 12:28,246.11,IncomingTransfer,Freelance Payment,-1738.333701
15881,715893633,07-10-24 21:28,900,Payment,Rent Payment,-2638.333701
15882,715893633,07-11-24 10:28,16.27,OutgoingTransfer,International Transfer,-2654.603701
15883,715893633,7-15-24 22:28,78.97,Purchase,Home Improvement,-2733.573701
15884,715893633,7-16-24 15:28,194.93,Return,Best Buy Return,-2538.643701
15885,715893633,7-17-24 16:28,148.23,Deposit,Cash Deposit,-2390.413701
15886,715932708,1-20-24 16:28,185.11,Purchase,Home Improvement,1249.835805
15887,715932708,1-21-24 20:28,110.55,Payment,Mortgage Payment,1139.285805
15888,715932708,1-26-24 17:28,146.57,Return,Walmart Return,1285.855805
15889,715932708,1-28-24 15:28,185.32,Payment,Loan Payment,1100.535805
15890,715932708,02-01-24 10:28,236.75,OnlineShopping,Target,863.7858048
15891,715932708,02-01-24 21:28,368.95,Return,Best Buy Return,1232.735805
15892,715932708,02-04-24 21:28,5100,IncomingTransfer,Salary,6332.735805
15893,715932708,02-06-24 10:28,176.97,Purchase,Grocery,6155.765805
15894,715932708,02-08-24 19:28,300.72,Purchase,Entertainment,5855.045805
15895,715932708,02-09-24 21:28,2100,Payment,Credit Card Payment,3755.045805
15896,715932708,02-12-24 14:28,230.16,Return,Target Return,3985.205805
15897,715932708,2-14-24 21:28,1600,Payment,Rent Payment,2385.205805
15898,715932708,2-20-24 10:28,292.84,Payment,Mortgage Payment,2092.365805
15899,715932708,2-20-24 15:28,146.22,Return,Store Return,2238.585805
15900,715932708,2-22-24 23:28,358.01,Deposit,Cash Deposit,2596.595805
15901,715932708,2-24-24 14:28,233.96,Purchase,Grocery,2362.635805
15902,715932708,2-27-24 13:28,64.54,Return,Store Return,2427.175805
15903,715932708,2-28-24 14:28,504.53,Return,Target Return,2931.705805
15904,715932708,03-01-24 23:28,515.45,Purchase,Home Improvement,2416.255805
15905,715932708,03-02-24 21:28,5100,IncomingTransfer,Salary,7516.255805
15906,715932708,03-05-24 21:28,260.36,Return,Etsy Return,7776.615805
15907,715932708,03-06-24 17:28,535.21,OnlineShopping,Target,7241.405805
15908,715932708,03-07-24 21:28,2300,Payment,Credit Card Payment,4941.405805
15909,715932708,03-08-24 21:28,417.41,Purchase,Restaurant,4523.995805
15910,715932708,03-09-24 17:28,452.52,Deposit,Direct Deposit,4976.515805
15911,715932708,3-13-24 20:28,153.44,Purchase,Home Improvement,4823.075805
15912,715932708,3-16-24 10:28,184.52,Deposit,Direct Deposit,5007.595805
15913,715932708,3-17-24 21:28,2200,Payment,Rent Payment,2807.595805
15914,715932708,3-18-24 19:28,218.89,Purchase,Entertainment,2588.705805
15915,715932708,3-21-24 15:28,100.63,Deposit,Direct Deposit,2689.335805
15916,715932708,3-26-24 9:28,164.15,Withdrawal,Mobile App Withdrawal,2525.185805
15917,715932708,04-01-24 12:28,313.57,Withdrawal,Branch Withdrawal,2211.615805
15918,715932708,04-01-24 18:28,161.63,OnlineShopping,Target,2049.985805
15919,715932708,04-01-24 21:28,5100,IncomingTransfer,Salary,7149.985805
15920,715932708,04-05-24 21:28,98.86,Withdrawal,Mobile App Withdrawal,7051.125805
15921,715932708,04-06-24 21:28,1900,Payment,Credit Card Payment,5151.125805
15922,715932708,04-07-24 11:28,278.93,Purchase,Restaurant,4872.195805
15923,715932708,04-10-24 18:28,275.58,IncomingTransfer,Freelance Payment,5147.775805
15924,715932708,4-13-24 13:28,251.8,Withdrawal,Branch Withdrawal,4895.975805
15925,715932708,4-14-24 21:28,2300,Payment,Rent Payment,2595.975805
15926,715932708,4-14-24 22:28,259.66,Deposit,Direct Deposit,2855.635805
15927,715932708,4-16-24 19:28,541.98,Return,Amazon Return,3397.615805
15928,715932708,4-19-24 18:28,303.18,OnlineShopping,Best Buy,3094.435805
15929,715932708,4-22-24 11:28,478.43,Return,Amazon Return,3572.865805
15930,715932708,4-22-24 15:28,296.42,Purchase,Entertainment,3276.445805
15931,715932708,4-29-24 23:28,53.21,Deposit,Direct Deposit,3329.655805
15932,715932708,05-02-24 20:28,123.84,OnlineShopping,Amazon,3205.815805
15933,715932708,05-04-24 12:28,543.6,Deposit,Direct Deposit,3749.415805
15934,715932708,05-04-24 21:28,5100,IncomingTransfer,Salary,8849.415805
15935,715932708,05-05-24 21:28,310.9,IncomingTransfer,Freelance Payment,9160.315805
15936,715932708,05-06-24 12:28,527.74,Deposit,Mobile Deposit,9688.055805
15937,715932708,05-09-24 21:28,1700,Payment,Credit Card Payment,7988.055805
15938,715932708,05-10-24 13:28,429.58,Withdrawal,Branch Withdrawal,7558.475805
15939,715932708,5-13-24 10:28,244.05,Withdrawal,Branch Withdrawal,7314.425805
15940,715932708,5-13-24 21:28,488.43,IncomingTransfer,Freelance Payment,7802.855805
15941,715932708,5-15-24 23:28,520.38,Return,Target Return,8323.235805
15942,715932708,5-16-24 14:28,353.83,Payment,Mortgage Payment,7969.405805
15943,715932708,5-18-24 21:28,2800,Payment,Rent Payment,5169.405805
15944,715932708,5-20-24 16:28,160.04,OnlineShopping,Target,5009.365805
15945,715932708,5-23-24 19:28,186.2,Return,Walmart Return,5195.565805
15946,715932708,5-27-24 15:28,166.68,Purchase,Restaurant,5028.885805
15947,715932708,5-28-24 20:28,502.88,Purchase,Gas,4526.005805
15948,715932708,5-30-24 22:28,396.87,Purchase,Furniture,4129.135805
15949,715932708,06-01-24 21:28,5100,IncomingTransfer,Salary,9229.135805
15950,715932708,06-02-24 14:28,170.4,Deposit,Cash Deposit,9399.535805
15951,715932708,06-02-24 15:28,293.73,Withdrawal,Mobile App Withdrawal,9105.805805
15952,715932708,06-03-24 12:28,89.18,OnlineShopping,Walmart,9016.625805
15953,715932708,06-05-24 18:28,178.65,Withdrawal,Branch Withdrawal,8837.975805
15954,715932708,06-06-24 21:28,2300,Payment,Credit Card Payment,6537.975805
15955,715932708,06-07-24 20:28,93.38,Deposit,Check Deposit,6631.355805
15956,715932708,06-10-24 12:28,492.41,OnlineShopping,eBay,6138.945805
15957,715932708,06-10-24 16:28,493.07,Deposit,Direct Deposit,6632.015805
15958,715932708,06-12-24 23:28,523.93,Purchase,Furniture,6108.085805
15959,715932708,6-14-24 12:28,476.88,OnlineShopping,Amazon,5631.205805
15960,715932708,6-14-24 21:28,2100,Payment,Rent Payment,3531.205805
15961,715932708,6-15-24 14:28,521.43,Withdrawal,ATM Withdrawal,3009.775805
15962,715932708,6-17-24 13:28,470.72,Deposit,Cash Deposit,3480.495805
15963,715932708,6-20-24 9:28,170.03,Withdrawal,Mobile App Withdrawal,3310.465805
15964,715932708,6-20-24 12:28,354.4,Purchase,Home Improvement,2956.065805
15965,715932708,6-23-24 11:28,214.77,Payment,Loan Payment,2741.295805
15966,715932708,6-24-24 21:28,417.35,Deposit,Direct Deposit,3158.645805
15967,715932708,6-25-24 15:28,253.59,Deposit,Direct Deposit,3412.235805
15968,715932708,6-28-24 20:28,200.72,Return,Store Return,3612.955805
15969,715932708,6-29-24 20:28,476.02,Return,AliExpress Return,4088.975805
15970,715932708,07-02-24 9:28,201.73,Withdrawal,ATM Withdrawal,3887.245805
15971,715932708,07-02-24 23:28,200.61,Return,Amazon Return,4087.855805
15972,715932708,07-03-24 21:28,5100,IncomingTransfer,Salary,9187.855805
15973,715932708,07-05-24 11:28,392.43,Deposit,Mobile Deposit,9580.285805
15974,715932708,07-07-24 22:28,76.13,IncomingTransfer,Freelance Payment,9656.415805
15975,715932708,07-08-24 21:28,2100,Payment,Credit Card Payment,7556.415805
15976,715932708,07-11-24 15:28,118.73,Withdrawal,ATM Withdrawal,7437.685805
15977,715932708,7-13-24 21:28,478.81,Deposit,Check Deposit,7916.495805
15978,715932708,7-14-24 21:28,2200,Payment,Rent Payment,5716.495805
15979,715937133,1-21-24 11:28,303.13,Deposit,Mobile Deposit,2151.303315
15980,715937133,1-22-24 15:28,202.44,IncomingTransfer,Freelance Payment,2353.743315
15981,715937133,1-23-24 19:28,339.11,OutgoingTransfer,International Transfer,2014.633315
15982,715937133,1-24-24 17:28,39.77,Withdrawal,ATM Withdrawal,1974.863315
15983,715937133,1-27-24 18:28,329.01,OutgoingTransfer,Bank Transfer,1645.853315
15984,715937133,02-02-24 13:28,117.49,Purchase,Restaurant,1528.363315
15985,715937133,02-04-24 21:28,4900,IncomingTransfer,Salary,6428.363315
15986,715937133,02-05-24 18:28,381.98,Withdrawal,Branch Withdrawal,6046.383315
15987,715937133,02-09-24 21:28,3400,Payment,Credit Card Payment,2646.383315
15988,715937133,2-13-24 19:28,319.92,OutgoingTransfer,Wire Transfer,2326.463315
15989,715937133,2-18-24 21:28,1600,Payment,Rent Payment,726.4633154
15990,715937133,2-19-24 22:28,26.78,Payment,Bill Payment,699.6833154
15991,715937133,2-21-24 17:28,101.08,IncomingTransfer,Freelance Payment,800.7633154
15992,715937133,2-22-24 16:28,281.73,Purchase,Restaurant,519.0333154
15993,715937133,2-23-24 20:28,382.27,Payment,Bill Payment,136.7633154
15994,715937133,2-27-24 13:28,103.53,Deposit,Cash Deposit,240.2933154
15995,715937133,03-05-24 21:28,4900,IncomingTransfer,Salary,5140.293315
15996,715937133,03-10-24 21:28,2300,Payment,Credit Card Payment,2840.293315
15997,715937133,03-12-24 22:28,293.59,IncomingTransfer,Freelance Payment,3133.883315
15998,715937133,3-15-24 21:28,3000,Payment,Rent Payment,133.8833154
15999,715937133,3-16-24 13:28,324.13,Purchase,Furniture,-190.2466846
16000,715937133,3-21-24 22:28,272.36,Deposit,Check Deposit,82.11331541
16001,715937133,3-30-24 11:28,24.01,OutgoingTransfer,Peer-to-Peer Transfer,58.10331541
16002,715937133,04-01-24 20:28,116.07,Return,eBay Return,174.1733154
16003,715937133,04-03-24 21:28,4900,IncomingTransfer,Salary,5074.173315
16004,715937133,04-03-24 21:28,282.61,Withdrawal,Mobile App Withdrawal,4791.563315
16005,715937133,04-08-24 21:28,2900,Payment,Credit Card Payment,1891.563315
16006,715937133,04-09-24 10:28,214.09,Payment,Loan Payment,1677.473315
16007,715937133,4-14-24 19:28,130.81,Purchase,Entertainment,1546.663315
16008,715937133,4-15-24 12:28,206.84,Payment,Bill Payment,1339.823315
16009,715937133,4-16-24 18:28,178.81,Purchase,Clothing,1161.013315
16010,715937133,4-16-24 18:28,29.49,Deposit,Mobile Deposit,1190.503315
16011,715937133,4-16-24 22:28,368.09,OnlineShopping,eBay,822.4133154
16012,715937133,4-17-24 23:28,137.17,Purchase,Gas,685.2433154
16013,715937133,4-18-24 21:28,2800,Payment,Rent Payment,-2114.756685
16014,715937133,4-29-24 11:28,90.98,OutgoingTransfer,Bank Transfer,-2205.736685
16015,715937133,05-01-24 21:28,4900,IncomingTransfer,Salary,2694.263315
16016,715937133,05-05-24 20:28,61.31,Withdrawal,Mobile App Withdrawal,2632.953315
16017,715937133,05-06-24 21:28,2600,Payment,Credit Card Payment,32.95331541
16018,715937133,05-09-24 19:28,261.86,OnlineShopping,Etsy,-228.9066846
16019,715937133,05-09-24 20:28,32.55,Deposit,Mobile Deposit,-196.3566846
16020,715937133,05-10-24 20:28,326.82,Return,Walmart Return,130.4633154
16021,715937133,05-10-24 22:28,58.3,Purchase,Grocery,72.16331541
16022,715937133,5-13-24 21:28,3100,Payment,Rent Payment,-3027.836685
16023,715937133,5-16-24 15:28,62.67,Withdrawal,Branch Withdrawal,-3090.506685
16024,715937133,5-17-24 23:28,360.25,Deposit,Check Deposit,-2730.256685
16025,715937133,5-19-24 15:28,199.82,OutgoingTransfer,International Transfer,-2930.076685
16026,715937133,5-27-24 9:28,250.95,OutgoingTransfer,Wire Transfer,-3181.026685
16027,715937133,5-28-24 21:28,269.06,Purchase,Furniture,-3450.086685
16028,715937133,06-04-24 17:28,254.51,Purchase,Home Improvement,-3704.596685
16029,715937133,06-04-24 21:28,4900,IncomingTransfer,Salary,1195.403315
16030,715937133,06-09-24 21:28,2900,Payment,Credit Card Payment,-1704.596685
16031,715937133,6-15-24 21:28,310.6,Deposit,Mobile Deposit,-1393.996685
16032,715937133,6-16-24 17:28,211.99,Purchase,Clothing,-1605.986685
16033,715937133,6-17-24 21:28,1300,Payment,Rent Payment,-2905.986685
16034,715937133,6-17-24 23:28,367.07,Purchase,Grocery,-3273.056685
16035,715937133,6-21-24 13:28,351.74,Deposit,Direct Deposit,-2921.316685
16036,715937133,6-25-24 19:28,49.85,OutgoingTransfer,Bank Transfer,-2971.166685
16037,715937133,6-27-24 13:28,164.69,Deposit,Cash Deposit,-2806.476685
16038,715937133,6-28-24 13:28,157.44,Return,Best Buy Return,-2649.036685
16039,715937133,6-29-24 21:28,84.73,Payment,Bill Payment,-2733.766685
16040,715937133,07-03-24 18:28,306.03,OnlineShopping,Target,-3039.796685
16041,715937133,07-04-24 21:28,4900,IncomingTransfer,Salary,1860.203315
16042,715937133,07-06-24 17:28,265.88,Purchase,Restaurant,1594.323315
16043,715937133,07-09-24 21:28,3100,Payment,Credit Card Payment,-1505.676685
16044,715937133,07-12-24 21:28,2800,Payment,Rent Payment,-4305.676685
16045,715976433,1-20-24 20:28,178.46,Deposit,Check Deposit,1199.74486
16046,715976433,1-23-24 9:28,40.67,Payment,Loan Payment,1159.07486
16047,715976433,1-24-24 9:28,140.65,Withdrawal,Mobile App Withdrawal,1018.42486
16048,715976433,1-26-24 21:28,145.07,OutgoingTransfer,Peer-to-Peer Transfer,873.3548603
16049,715976433,1-28-24 16:28,137.41,Withdrawal,Mobile App Withdrawal,735.9448603
16050,715976433,02-01-24 21:28,3050,IncomingTransfer,Salary,3785.94486
16051,715976433,02-04-24 16:28,56.37,Withdrawal,Branch Withdrawal,3729.57486
16052,715976433,02-06-24 21:28,2700,Payment,Credit Card Payment,1029.57486
16053,715976433,02-11-24 11:28,129.59,Deposit,Cash Deposit,1159.16486
16054,715976433,02-11-24 13:28,88.75,Withdrawal,ATM Withdrawal,1070.41486
16055,715976433,2-13-24 17:28,102.09,OutgoingTransfer,Wire Transfer,968.3248603
16056,715976433,2-13-24 17:28,11.23,Deposit,Direct Deposit,979.5548603
16057,715976433,2-17-24 21:28,1200,Payment,Rent Payment,-220.4451397
16058,715976433,2-20-24 21:28,211.75,Purchase,Grocery,-432.1951397
16059,715976433,2-27-24 18:28,16.61,Deposit,Cash Deposit,-415.5851397
16060,715976433,03-03-24 21:28,223.12,Withdrawal,Branch Withdrawal,-638.7051397
16061,715976433,03-04-24 21:28,3050,IncomingTransfer,Salary,2411.29486
16062,715976433,03-05-24 19:28,150.26,Deposit,Cash Deposit,2561.55486
16063,715976433,03-07-24 17:28,46.21,Purchase,Travel,2515.34486
16064,715976433,03-08-24 11:28,79.36,Purchase,Grocery,2435.98486
16065,715976433,03-08-24 16:28,141.44,Purchase,Entertainment,2294.54486
16066,715976433,03-09-24 21:28,2800,Payment,Credit Card Payment,-505.4551397
16067,715976433,03-12-24 21:28,1700,Payment,Rent Payment,-2205.45514
16068,715976433,3-15-24 22:28,220.89,Purchase,Grocery,-2426.34514
16069,715976433,3-19-24 23:28,158.96,Purchase,Pharmacy,-2585.30514
16070,715976433,3-23-24 20:28,169.93,Return,Walmart Return,-2415.37514
16071,715976433,3-25-24 22:28,79.51,Purchase,Entertainment,-2494.88514
16072,715976433,3-26-24 16:28,166.21,Payment,Bill Payment,-2661.09514
16073,715976433,3-29-24 10:28,153.03,Deposit,Direct Deposit,-2508.06514
16074,715976433,3-31-24 11:28,28.24,Deposit,Cash Deposit,-2479.82514
16075,715976433,3-31-24 11:28,99.67,Withdrawal,Mobile App Withdrawal,-2579.49514
16076,715976433,04-04-24 21:28,3050,IncomingTransfer,Salary,470.5048603
16077,715976433,04-05-24 12:28,89.78,OutgoingTransfer,Wire Transfer,380.7248603
16078,715976433,04-06-24 14:28,80.39,Withdrawal,Mobile App Withdrawal,300.3348603
16079,715976433,04-07-24 15:28,112.7,Withdrawal,ATM Withdrawal,187.6348603
16080,715976433,04-09-24 21:28,1900,Payment,Credit Card Payment,-1712.36514
16081,715976433,04-10-24 11:28,149.25,Deposit,Cash Deposit,-1563.11514
16082,715976433,04-12-24 21:28,89.63,OutgoingTransfer,Bank Transfer,-1652.74514
16083,715976433,4-13-24 21:28,1900,Payment,Rent Payment,-3552.74514
16084,715976433,4-15-24 19:28,203.74,Payment,Loan Payment,-3756.48514
16085,715976433,05-01-24 20:28,195.81,Deposit,Check Deposit,-3560.67514
16086,715976433,05-02-24 21:28,3050,IncomingTransfer,Salary,-510.6751397
16087,715976433,05-05-24 11:28,129.54,Purchase,Home Improvement,-640.2151397
16088,715976433,05-07-24 12:28,184.01,OnlineShopping,Best Buy,-824.2251397
16089,715976433,05-07-24 14:28,179.31,Payment,Mortgage Payment,-1003.53514
16090,715976433,05-07-24 21:28,2100,Payment,Credit Card Payment,-3103.53514
16091,715976433,05-07-24 21:28,29.47,OnlineShopping,Amazon,-3133.00514
16092,715976433,05-08-24 14:28,238.77,Withdrawal,ATM Withdrawal,-3371.77514
16093,715976433,05-10-24 19:28,146.02,OutgoingTransfer,Bank Transfer,-3517.79514
16094,715976433,5-14-24 11:28,200.54,OutgoingTransfer,Bank Transfer,-3718.33514
16095,715976433,5-14-24 21:28,1100,Payment,Rent Payment,-4818.33514
16096,715976433,5-16-24 12:28,32.26,IncomingTransfer,Freelance Payment,-4786.07514
16097,715976433,5-17-24 17:28,81.53,Deposit,Cash Deposit,-4704.54514
16098,715976433,5-17-24 22:28,241.88,Withdrawal,Branch Withdrawal,-4946.42514
16099,715976433,5-23-24 17:28,53.82,Withdrawal,Branch Withdrawal,-5000.24514
16100,715976433,5-24-24 16:28,248.19,OutgoingTransfer,Bank Transfer,-5248.43514
16101,715976433,5-27-24 16:28,239.77,OnlineShopping,Walmart,-5488.20514
16102,715976433,5-27-24 22:28,150.55,Purchase,Furniture,-5638.75514
16103,715976433,5-30-24 11:28,236.25,Payment,Loan Payment,-5875.00514
16104,715976433,06-01-24 14:28,145.77,Deposit,Mobile Deposit,-5729.23514
16105,715976433,06-01-24 22:28,22.88,Deposit,Check Deposit,-5706.35514
16106,715976433,06-02-24 20:28,117.27,OnlineShopping,Amazon,-5823.62514
16107,715976433,06-02-24 20:28,52.6,Purchase,Gas,-5876.22514
16108,715976433,06-03-24 11:28,113.02,Withdrawal,Branch Withdrawal,-5989.24514
16109,715976433,06-05-24 21:28,3050,IncomingTransfer,Salary,-2939.24514
16110,715976433,06-06-24 12:28,244.92,Purchase,Travel,-3184.16514
16111,715976433,06-06-24 13:28,138.3,IncomingTransfer,Freelance Payment,-3045.86514
16112,715976433,06-07-24 19:28,19.87,OutgoingTransfer,International Transfer,-3065.73514
16113,715976433,06-08-24 11:28,239.04,Deposit,Direct Deposit,-2826.69514
16114,715976433,06-10-24 16:28,200.13,Purchase,Pharmacy,-3026.82514
16115,715976433,06-10-24 21:28,2100,Payment,Credit Card Payment,-5126.82514
16116,715976433,06-11-24 21:28,1000,Payment,Rent Payment,-6126.82514
16117,715976433,6-14-24 11:28,158.93,Purchase,Travel,-6285.75514
16118,715976433,6-16-24 16:28,247.14,Purchase,Grocery,-6532.89514
16119,715976433,6-16-24 19:28,83.87,Deposit,Mobile Deposit,-6449.02514
16120,715976433,6-17-24 16:28,191.19,Deposit,Mobile Deposit,-6257.83514
16121,715976433,6-20-24 18:28,231.99,OutgoingTransfer,Wire Transfer,-6489.82514
16122,715976433,6-21-24 18:28,64.71,OnlineShopping,Best Buy,-6554.53514
16123,715976433,6-22-24 11:28,54.8,Deposit,Check Deposit,-6499.73514
16124,715976433,6-22-24 12:28,62.18,Deposit,Mobile Deposit,-6437.55514
16125,715976433,6-23-24 19:28,37.2,Deposit,Check Deposit,-6400.35514
16126,715976433,6-24-24 19:28,123.86,Payment,Loan Payment,-6524.21514
16127,715976433,07-01-24 16:28,157.59,OnlineShopping,Amazon,-6681.80514
16128,715976433,07-01-24 21:28,3050,IncomingTransfer,Salary,-3631.80514
16129,715976433,07-05-24 13:28,139.37,Purchase,Clothing,-3771.17514
16130,715976433,07-06-24 21:28,1900,Payment,Credit Card Payment,-5671.17514
16131,715976433,07-09-24 14:28,92.89,Purchase,Restaurant,-5764.06514
16132,715976433,07-10-24 12:28,69.74,Purchase,Home Improvement,-5833.80514
16133,715976433,07-12-24 9:28,247.35,Purchase,Grocery,-6081.15514
16134,715976433,07-12-24 18:28,123.88,OutgoingTransfer,Bank Transfer,-6205.03514
16135,715976433,7-14-24 20:28,133.68,Purchase,Restaurant,-6338.71514
16136,715976433,7-16-24 21:28,1900,Payment,Rent Payment,-8238.71514
16137,715976433,7-17-24 22:28,167.65,Return,Target Return,-8071.06514
16138,716099958,1-25-24 17:28,234.38,Deposit,Cash Deposit,1722.119684
16139,716099958,1-29-24 17:28,157.35,Withdrawal,Branch Withdrawal,1564.769684
16140,716099958,02-05-24 21:28,4300,IncomingTransfer,Salary,5864.769684
16141,716099958,02-06-24 18:28,85.59,Deposit,Cash Deposit,5950.359684
16142,716099958,02-08-24 22:28,187.01,Purchase,Pharmacy,5763.349684
16143,716099958,02-10-24 15:28,84.06,Return,Target Return,5847.409684
16144,716099958,02-10-24 21:28,2300,Payment,Credit Card Payment,3547.409684
16145,716099958,2-14-24 21:28,2400,Payment,Rent Payment,1147.409684
16146,716099958,2-16-24 12:28,155.68,Deposit,Cash Deposit,1303.089684
16147,716099958,2-17-24 22:28,316.3,Payment,Loan Payment,986.7896844
16148,716099958,2-22-24 12:28,118.29,Deposit,Mobile Deposit,1105.079684
16149,716099958,2-24-24 10:28,359.56,OutgoingTransfer,Peer-to-Peer Transfer,745.5196844
16150,716099958,2-26-24 12:28,55.95,OnlineShopping,AliExpress,689.5696844
16151,716099958,2-28-24 17:28,373.12,Deposit,Cash Deposit,1062.689684
16152,716099958,03-04-24 21:28,4300,IncomingTransfer,Salary,5362.689684
16153,716099958,03-08-24 9:28,101.43,Purchase,Restaurant,5261.259684
16154,716099958,03-08-24 23:28,109.34,Return,eBay Return,5370.599684
16155,716099958,03-09-24 21:28,2600,Payment,Credit Card Payment,2770.599684
16156,716099958,03-09-24 21:28,370.98,Payment,Loan Payment,2399.619684
16157,716099958,3-13-24 12:28,386.19,Deposit,Cash Deposit,2785.809684
16158,716099958,3-14-24 12:28,84.95,IncomingTransfer,Freelance Payment,2870.759684
16159,716099958,3-15-24 19:28,244.22,Purchase,Clothing,2626.539684
16160,716099958,3-15-24 21:28,1900,Payment,Rent Payment,726.5396844
16161,716099958,3-21-24 23:28,244.48,Return,Etsy Return,971.0196844
16162,716099958,3-25-24 23:28,327.85,Payment,Mortgage Payment,643.1696844
16163,716099958,3-26-24 9:28,101.7,Purchase,Clothing,541.4696844
16164,716099958,3-27-24 19:28,86.76,Deposit,Check Deposit,628.2296844
16165,716099958,3-31-24 20:28,223.39,Deposit,Direct Deposit,851.6196844
16166,716099958,04-01-24 21:28,4300,IncomingTransfer,Salary,5151.619684
16167,716099958,04-06-24 21:28,2400,Payment,Credit Card Payment,2751.619684
16168,716099958,4-13-24 17:28,274.19,OnlineShopping,Best Buy,2477.429684
16169,716099958,4-14-24 19:28,264.15,OutgoingTransfer,International Transfer,2213.279684
16170,716099958,4-16-24 21:28,2300,Payment,Rent Payment,-86.72031563
16171,716099958,4-17-24 10:28,395.89,Deposit,Direct Deposit,309.1696844
16172,716099958,4-18-24 13:28,165.82,Withdrawal,Branch Withdrawal,143.3496844
16173,716099958,4-19-24 22:28,360.7,Payment,Mortgage Payment,-217.3503156
16174,716099958,05-03-24 21:28,4300,IncomingTransfer,Salary,4082.649684
16175,716099958,05-08-24 21:28,2200,Payment,Credit Card Payment,1882.649684
16176,716099958,05-10-24 11:28,313.26,Deposit,Cash Deposit,2195.909684
16177,716099958,05-11-24 10:28,116.52,Deposit,Cash Deposit,2312.429684
16178,716099958,05-11-24 19:28,133.05,Deposit,Check Deposit,2445.479684
16179,716099958,05-11-24 21:28,1600,Payment,Rent Payment,845.4796844
16180,716099958,5-13-24 13:28,195.86,Purchase,Furniture,649.6196844
16181,716099958,5-13-24 22:28,86.4,Purchase,Pharmacy,563.2196844
16182,716099958,5-17-24 20:28,348.77,Payment,Loan Payment,214.4496844
16183,716099958,5-18-24 15:28,175.83,OutgoingTransfer,Bank Transfer,38.61968437
16184,716099958,5-19-24 17:28,309.49,Return,AliExpress Return,348.1096844
16185,716099958,5-21-24 20:28,291.93,Purchase,Restaurant,56.17968437
16186,716099958,5-22-24 9:28,88.04,Return,Store Return,144.2196844
16187,716099958,5-22-24 12:28,339.95,Return,Store Return,484.1696844
16188,716099958,5-29-24 16:28,397.58,Deposit,Cash Deposit,881.7496844
16189,716099958,5-31-24 10:28,350.63,Deposit,Cash Deposit,1232.379684
16190,716099958,06-04-24 21:28,4300,IncomingTransfer,Salary,5532.379684
16191,716099958,06-07-24 20:28,122.95,Deposit,Mobile Deposit,5655.329684
16192,716099958,06-09-24 21:28,2700,Payment,Credit Card Payment,2955.329684
16193,716099958,06-12-24 21:28,2200,Payment,Rent Payment,755.3296844
16194,716099958,6-20-24 9:28,186.04,Return,Target Return,941.3696844
16195,716099958,6-20-24 11:28,347.63,Withdrawal,Mobile App Withdrawal,593.7396844
16196,716099958,6-21-24 22:28,221.99,IncomingTransfer,Freelance Payment,815.7296844
16197,716099958,6-23-24 12:28,224.05,IncomingTransfer,Freelance Payment,1039.779684
16198,716099958,6-27-24 18:28,229.41,OnlineShopping,AliExpress,810.3696844
16199,716099958,07-01-24 22:28,251.04,Payment,Bill Payment,559.3296844
16200,716099958,07-02-24 21:28,4300,IncomingTransfer,Salary,4859.329684
16201,716099958,07-03-24 17:28,200.96,Payment,Loan Payment,4658.369684
16202,716099958,07-06-24 15:28,256.32,Return,Amazon Return,4914.689684
16203,716099958,07-07-24 21:28,2600,Payment,Credit Card Payment,2314.689684
16204,716099958,07-12-24 21:28,1600,Payment,Rent Payment,714.6896844
16205,716099958,7-15-24 10:28,250.82,Payment,Bill Payment,463.8696844
16206,716194683,1-21-24 14:28,396.99,Payment,Mortgage Payment,535.9936407
16207,716194683,1-25-24 17:28,304.82,OnlineShopping,AliExpress,231.1736407
16208,716194683,1-29-24 16:28,112.72,Purchase,Pharmacy,118.4536407
16209,716194683,02-01-24 18:28,152.07,Purchase,Pharmacy,-33.61635926
16210,716194683,02-01-24 21:28,4700,IncomingTransfer,Salary,4666.383641
16211,716194683,02-05-24 10:28,195.14,OnlineShopping,Target,4471.243641
16212,716194683,02-06-24 21:28,1500,Payment,Credit Card Payment,2971.243641
16213,716194683,2-13-24 9:28,46.5,Deposit,Cash Deposit,3017.743641
16214,716194683,2-15-24 12:28,235.47,Purchase,Home Improvement,2782.273641
16215,716194683,2-18-24 21:28,2200,Payment,Rent Payment,582.2736407
16216,716194683,2-19-24 13:28,119.34,Payment,Bill Payment,462.9336407
16217,716194683,2-19-24 17:28,86.19,Purchase,Gas,376.7436407
16218,716194683,2-20-24 16:28,295.99,OnlineShopping,Best Buy,80.75364074
16219,716194683,2-23-24 11:28,271.11,Deposit,Mobile Deposit,351.8636407
16220,716194683,2-23-24 12:28,301.2,Deposit,Cash Deposit,653.0636407
16221,716194683,2-26-24 20:28,381.04,OutgoingTransfer,Bank Transfer,272.0236407
16222,716194683,2-28-24 16:28,87.44,OutgoingTransfer,Bank Transfer,184.5836407
16223,716194683,03-01-24 18:28,295.35,OutgoingTransfer,International Transfer,-110.7663593
16224,716194683,03-04-24 21:28,4700,IncomingTransfer,Salary,4589.233641
16225,716194683,03-09-24 21:28,1300,Payment,Credit Card Payment,3289.233641
16226,716194683,03-12-24 18:28,72.49,OnlineShopping,Amazon,3216.743641
16227,716194683,03-12-24 18:28,212.08,Deposit,Check Deposit,3428.823641
16228,716194683,03-12-24 20:28,271.11,Deposit,Mobile Deposit,3699.933641
16229,716194683,03-12-24 21:28,1300,Payment,Rent Payment,2399.933641
16230,716194683,3-21-24 19:28,62.1,Payment,Mortgage Payment,2337.833641
16231,716194683,3-22-24 14:28,235.79,Withdrawal,Mobile App Withdrawal,2102.043641
16232,716194683,3-24-24 13:28,228.79,Withdrawal,ATM Withdrawal,1873.253641
16233,716194683,3-31-24 17:28,24.68,Deposit,Check Deposit,1897.933641
16234,716194683,04-03-24 21:28,4700,IncomingTransfer,Salary,6597.933641
16235,716194683,04-06-24 19:28,227.25,OnlineShopping,Amazon,6370.683641
16236,716194683,04-06-24 21:28,52.32,OnlineShopping,Etsy,6318.363641
16237,716194683,04-08-24 21:28,1200,Payment,Credit Card Payment,5118.363641
16238,716194683,4-13-24 10:28,135.81,Withdrawal,ATM Withdrawal,4982.553641
16239,716194683,4-14-24 11:28,229.17,Purchase,Electronics,4753.383641
16240,716194683,4-15-24 18:28,262.44,Withdrawal,ATM Withdrawal,4490.943641
16241,716194683,4-16-24 21:28,2000,Payment,Rent Payment,2490.943641
16242,716194683,4-22-24 20:28,155.62,Purchase,Entertainment,2335.323641
16243,716194683,4-24-24 9:28,222.01,Deposit,Cash Deposit,2557.333641
16244,716194683,4-26-24 18:28,57.15,Payment,Mortgage Payment,2500.183641
16245,716194683,05-01-24 21:28,4700,IncomingTransfer,Salary,7200.183641
16246,716194683,05-03-24 9:28,39.94,OnlineShopping,Walmart,7160.243641
16247,716194683,05-03-24 14:28,329.62,OutgoingTransfer,Peer-to-Peer Transfer,6830.623641
16248,716194683,05-06-24 21:28,1200,Payment,Credit Card Payment,5630.623641
16249,716194683,05-10-24 10:28,211.35,Payment,Bill Payment,5419.273641
16250,716194683,05-11-24 21:28,123.12,Payment,Bill Payment,5296.153641
16251,716194683,5-16-24 21:28,1700,Payment,Rent Payment,3596.153641
16252,716194683,5-18-24 16:28,367.98,Withdrawal,ATM Withdrawal,3228.173641
16253,716194683,5-23-24 19:28,224.06,OutgoingTransfer,International Transfer,3004.113641
16254,716194683,06-03-24 10:28,40.6,Deposit,Cash Deposit,3044.713641
16255,716194683,06-03-24 21:28,4700,IncomingTransfer,Salary,7744.713641
16256,716194683,06-04-24 13:28,249.24,IncomingTransfer,Freelance Payment,7993.953641
16257,716194683,06-04-24 18:28,63.18,Purchase,Clothing,7930.773641
16258,716194683,06-08-24 17:28,216.92,OnlineShopping,eBay,7713.853641
16259,716194683,06-08-24 21:28,1300,Payment,Credit Card Payment,6413.853641
16260,716194683,06-09-24 16:28,75.1,Deposit,Mobile Deposit,6488.953641
16261,716194683,06-12-24 12:28,30.63,Deposit,Cash Deposit,6519.583641
16262,716194683,6-14-24 21:28,2000,Payment,Rent Payment,4519.583641
16263,716194683,6-14-24 23:28,332.51,IncomingTransfer,Freelance Payment,4852.093641
16264,716194683,6-15-24 13:28,126.8,Withdrawal,ATM Withdrawal,4725.293641
16265,716194683,6-16-24 18:28,307.62,Deposit,Direct Deposit,5032.913641
16266,716194683,6-21-24 10:28,215.28,OutgoingTransfer,Bank Transfer,4817.633641
16267,716194683,6-29-24 21:28,88.5,OutgoingTransfer,International Transfer,4729.133641
16268,716194683,07-01-24 21:28,4700,IncomingTransfer,Salary,9429.133641
16269,716194683,07-06-24 21:28,1400,Payment,Credit Card Payment,8029.133641
16270,716194683,7-14-24 21:28,2200,Payment,Rent Payment,5829.133641
16271,716194683,7-16-24 13:28,108.73,Withdrawal,ATM Withdrawal,5720.403641
16272,716238483,1-20-24 11:28,571.4,Deposit,Check Deposit,2283.233639
16273,716238483,1-27-24 12:28,128.45,OnlineShopping,Etsy,2154.783639
16274,716238483,1-27-24 18:28,650.69,OnlineShopping,AliExpress,1504.093639
16275,716238483,02-01-24 13:28,529.73,Return,Etsy Return,2033.823639
16276,716238483,02-02-24 21:28,9650,IncomingTransfer,Salary,11683.82364
16277,716238483,02-02-24 22:28,315.22,Return,Amazon Return,11999.04364
16278,716238483,02-04-24 12:28,164.52,Withdrawal,Mobile App Withdrawal,11834.52364
16279,716238483,02-04-24 22:28,525.14,Withdrawal,Branch Withdrawal,11309.38364
16280,716238483,02-07-24 21:28,2400,Payment,Credit Card Payment,8909.383639
16281,716238483,02-07-24 22:28,279.18,Withdrawal,Branch Withdrawal,8630.203639
16282,716238483,02-11-24 14:28,426.94,IncomingTransfer,Freelance Payment,9057.143639
16283,716238483,02-12-24 18:28,194.2,OutgoingTransfer,Wire Transfer,8862.943639
16284,716238483,2-13-24 22:28,499.51,Deposit,Mobile Deposit,9362.453639
16285,716238483,2-15-24 21:28,3700,Payment,Subscription Payment,5662.453639
16286,716238483,2-18-24 19:28,439.52,OnlineShopping,Amazon,5222.933639
16287,716238483,2-22-24 11:28,121.89,Withdrawal,Branch Withdrawal,5101.043639
16288,716238483,2-23-24 13:28,161.14,Deposit,Check Deposit,5262.183639
16289,716238483,2-24-24 12:28,509.62,OutgoingTransfer,International Transfer,4752.563639
16290,716238483,2-24-24 17:28,299.94,Deposit,Check Deposit,5052.503639
16291,716238483,2-29-24 12:28,151.33,Payment,Mortgage Payment,4901.173639
16292,716238483,03-03-24 19:28,599.26,OutgoingTransfer,International Transfer,4301.913639
16293,716238483,03-03-24 21:28,9650,IncomingTransfer,Salary,13951.91364
16294,716238483,03-06-24 13:28,536.64,Payment,Bill Payment,13415.27364
16295,716238483,03-07-24 16:28,314.94,Withdrawal,Mobile App Withdrawal,13100.33364
16296,716238483,03-08-24 21:28,3400,Payment,Credit Card Payment,9700.333639
16297,716238483,03-11-24 19:28,220.57,Deposit,Mobile Deposit,9920.903639
16298,716238483,03-12-24 21:28,2800,Payment,Subscription Payment,7120.903639
16299,716238483,3-14-24 18:28,360.07,Withdrawal,Branch Withdrawal,6760.833639
16300,716238483,3-15-24 16:28,561.77,Purchase,Entertainment,6199.063639
16301,716238483,3-17-24 14:28,668.07,OnlineShopping,Target,5530.993639
16302,716238483,3-17-24 19:28,212.86,Payment,Mortgage Payment,5318.133639
16303,716238483,3-19-24 13:28,526.74,Return,Etsy Return,5844.873639
16304,716238483,3-21-24 21:28,260.63,Payment,Mortgage Payment,5584.243639
16305,716238483,3-23-24 22:28,145.98,Deposit,Check Deposit,5730.223639
16306,716238483,3-26-24 11:28,275.47,Payment,Bill Payment,5454.753639
16307,716238483,3-26-24 17:28,529.18,Withdrawal,ATM Withdrawal,4925.573639
16308,716238483,3-27-24 14:28,734.02,IncomingTransfer,Freelance Payment,5659.593639
16309,716238483,3-29-24 23:28,227.73,Payment,Loan Payment,5431.863639
16310,716238483,3-30-24 18:28,258.57,Withdrawal,ATM Withdrawal,5173.293639
16311,716238483,04-01-24 21:28,9650,IncomingTransfer,Salary,14823.29364
16312,716238483,04-06-24 21:28,3000,Payment,Credit Card Payment,11823.29364
16313,716238483,04-09-24 16:28,129.37,Purchase,Travel,11693.92364
16314,716238483,04-10-24 21:28,3300,Payment,Insurance Payment,8393.923639
16315,716238483,04-11-24 15:28,159.31,Purchase,Electronics,8234.613639
16316,716238483,4-16-24 19:28,432.11,IncomingTransfer,Freelance Payment,8666.723639
16317,716238483,4-21-24 15:28,413.16,OutgoingTransfer,Wire Transfer,8253.563639
16318,716238483,4-26-24 22:28,544.95,IncomingTransfer,Freelance Payment,8798.513639
16319,716238483,4-27-24 19:28,746.06,Deposit,Mobile Deposit,9544.573639
16320,716238483,4-30-24 22:28,234.88,Purchase,Travel,9309.693639
16321,716238483,05-01-24 21:28,9650,IncomingTransfer,Salary,18959.69364
16322,716238483,05-03-24 18:28,104.63,Withdrawal,ATM Withdrawal,18855.06364
16323,716238483,05-04-24 10:28,461.25,Withdrawal,Mobile App Withdrawal,18393.81364
16324,716238483,05-06-24 21:28,3500,Payment,Credit Card Payment,14893.81364
16325,716238483,05-07-24 12:28,438.01,Deposit,Mobile Deposit,15331.82364
16326,716238483,05-10-24 21:28,3400,Payment,Subscription Payment,11931.82364
16327,716238483,5-13-24 19:28,726.19,Payment,Mortgage Payment,11205.63364
16328,716238483,5-16-24 11:28,681.97,Purchase,Clothing,10523.66364
16329,716238483,5-16-24 16:28,607.67,Deposit,Check Deposit,11131.33364
16330,716238483,5-16-24 16:28,489.7,Deposit,Direct Deposit,11621.03364
16331,716238483,5-16-24 17:28,164.6,OnlineShopping,Best Buy,11456.43364
16332,716238483,5-18-24 20:28,174.39,Purchase,Gas,11282.04364
16333,716238483,5-21-24 13:28,721.26,Deposit,Check Deposit,12003.30364
16334,716238483,5-21-24 19:28,179.25,OnlineShopping,Etsy,11824.05364
16335,716238483,5-25-24 17:28,565.21,Payment,Loan Payment,11258.84364
16336,716238483,5-28-24 12:28,593.37,Payment,Loan Payment,10665.47364
16337,716238483,5-28-24 21:28,495.9,IncomingTransfer,Freelance Payment,11161.37364
16338,716238483,5-31-24 22:28,226.43,Deposit,Direct Deposit,11387.80364
16339,716238483,06-01-24 11:28,736.69,OutgoingTransfer,Wire Transfer,10651.11364
16340,716238483,06-01-24 19:28,374.16,Deposit,Mobile Deposit,11025.27364
16341,716238483,06-02-24 21:28,9650,IncomingTransfer,Salary,20675.27364
16342,716238483,06-03-24 22:28,644.15,Deposit,Direct Deposit,21319.42364
16343,716238483,06-04-24 20:28,503.03,Purchase,Gas,20816.39364
16344,716238483,06-06-24 12:28,500.35,Payment,Bill Payment,20316.04364
16345,716238483,06-07-24 21:28,2400,Payment,Credit Card Payment,17916.04364
16346,716238483,06-09-24 15:28,145.61,Purchase,Grocery,17770.43364
16347,716238483,06-09-24 18:28,405.75,Withdrawal,ATM Withdrawal,17364.68364
16348,716238483,6-13-24 21:28,3800,Payment,Installment Payment,13564.68364
16349,716238483,6-13-24 23:28,612.59,OutgoingTransfer,Bank Transfer,12952.09364
16350,716238483,6-15-24 12:28,153.03,Return,Best Buy Return,13105.12364
16351,716238483,6-15-24 18:28,118.51,OutgoingTransfer,Peer-to-Peer Transfer,12986.61364
16352,716238483,6-23-24 16:28,142.71,Purchase,Entertainment,12843.90364
16353,716238483,6-24-24 12:28,235.77,Purchase,Pharmacy,12608.13364
16354,716238483,6-24-24 21:28,699.77,Withdrawal,Mobile App Withdrawal,11908.36364
16355,716238483,6-26-24 18:28,228.06,Withdrawal,ATM Withdrawal,11680.30364
16356,716238483,6-30-24 13:28,116.72,Purchase,Gas,11563.58364
16357,716238483,07-01-24 21:28,9650,IncomingTransfer,Salary,21213.58364
16358,716238483,07-05-24 13:28,201.2,Deposit,Cash Deposit,21414.78364
16359,716238483,07-06-24 11:28,317.3,Deposit,Cash Deposit,21732.08364
16360,716238483,07-06-24 21:28,2500,Payment,Credit Card Payment,19232.08364
16361,716238483,07-07-24 21:28,149.09,Withdrawal,Mobile App Withdrawal,19082.99364
16362,716238483,07-10-24 10:28,480.85,IncomingTransfer,Freelance Payment,19563.84364
16363,716238483,07-12-24 9:28,314.18,Deposit,Cash Deposit,19878.02364
16364,716238483,7-13-24 21:28,2600,Payment,Insurance Payment,17278.02364
16365,716238483,7-15-24 20:28,171.61,Purchase,Entertainment,17106.41364
16366,716322783,1-21-24 13:28,185.74,Withdrawal,Branch Withdrawal,656.0215825
16367,716322783,1-27-24 10:28,47.05,Payment,Loan Payment,608.9715825
16368,716322783,1-28-24 13:28,139.59,Deposit,Check Deposit,748.5615825
16369,716322783,1-31-24 23:28,115.29,Withdrawal,Mobile App Withdrawal,633.2715825
16370,716322783,02-01-24 21:28,2850,IncomingTransfer,Salary,3483.271582
16371,716322783,02-03-24 20:28,214.25,Deposit,Check Deposit,3697.521582
16372,716322783,02-04-24 15:28,16.92,Deposit,Direct Deposit,3714.441582
16373,716322783,02-05-24 21:28,212.58,Payment,Mortgage Payment,3501.861582
16374,716322783,02-06-24 21:28,1700,Payment,Credit Card Payment,1801.861582
16375,716322783,02-08-24 19:28,150.46,Withdrawal,Branch Withdrawal,1651.401582
16376,716322783,2-14-24 13:28,124.71,Withdrawal,Mobile App Withdrawal,1526.691582
16377,716322783,2-14-24 21:28,1000,Payment,Rent Payment,526.6915825
16378,716322783,2-17-24 21:28,51.51,Purchase,Gas,475.1815825
16379,716322783,2-18-24 17:28,212.97,Deposit,Direct Deposit,688.1515825
16380,716322783,2-19-24 18:28,127.33,Return,Amazon Return,815.4815825
16381,716322783,2-21-24 9:28,36.26,IncomingTransfer,Freelance Payment,851.7415825
16382,716322783,2-25-24 14:28,131.13,Purchase,Pharmacy,720.6115825
16383,716322783,2-27-24 12:28,207.74,OutgoingTransfer,Wire Transfer,512.8715825
16384,716322783,2-29-24 12:28,219.21,Purchase,Electronics,293.6615825
16385,716322783,03-02-24 15:28,137.91,Payment,Loan Payment,155.7515825
16386,716322783,03-02-24 20:28,39.42,Withdrawal,ATM Withdrawal,116.3315825
16387,716322783,03-03-24 19:28,243.3,Deposit,Direct Deposit,359.6315825
16388,716322783,03-03-24 21:28,2850,IncomingTransfer,Salary,3209.631582
16389,716322783,03-04-24 11:28,81.42,OnlineShopping,Target,3128.211582
16390,716322783,03-08-24 21:28,2000,Payment,Credit Card Payment,1128.211582
16391,716322783,03-09-24 19:28,81,Purchase,Entertainment,1047.211582
16392,716322783,03-11-24 20:28,129.64,Return,Walmart Return,1176.851582
16393,716322783,03-11-24 20:28,185.91,Purchase,Travel,990.9415825
16394,716322783,03-12-24 14:28,50.48,Deposit,Check Deposit,1041.421582
16395,716322783,03-12-24 22:28,27.14,Purchase,Furniture,1014.281582
16396,716322783,3-13-24 21:28,1400,Payment,Rent Payment,-385.7184175
16397,716322783,3-15-24 18:28,18.64,IncomingTransfer,Freelance Payment,-367.0784175
16398,716322783,3-16-24 13:28,28.12,Withdrawal,Branch Withdrawal,-395.1984175
16399,716322783,3-18-24 13:28,184.51,Purchase,Travel,-579.7084175
16400,716322783,3-19-24 9:28,20.5,OnlineShopping,Best Buy,-600.2084175
16401,716322783,3-27-24 11:28,200.41,OutgoingTransfer,International Transfer,-800.6184175
16402,716322783,3-29-24 22:28,101.6,OnlineShopping,AliExpress,-902.2184175
16403,716322783,3-31-24 13:28,163.92,OnlineShopping,eBay,-1066.138418
16404,716322783,04-01-24 21:28,2850,IncomingTransfer,Salary,1783.861582
16405,716322783,04-03-24 22:28,53.53,Payment,Loan Payment,1730.331582
16406,716322783,04-05-24 11:28,74.56,Deposit,Cash Deposit,1804.891582
16407,716322783,04-06-24 17:28,197.75,Payment,Bill Payment,1607.141582
16408,716322783,04-06-24 21:28,2000,Payment,Credit Card Payment,-392.8584175
16409,716322783,04-07-24 11:28,188.47,Withdrawal,Mobile App Withdrawal,-581.3284175
16410,716322783,04-11-24 9:28,136.15,Withdrawal,Mobile App Withdrawal,-717.4784175
16411,716322783,04-11-24 10:28,57.64,Return,Walmart Return,-659.8384175
16412,716322783,4-14-24 14:28,221.15,OutgoingTransfer,International Transfer,-880.9884175
16413,716322783,4-14-24 21:28,1300,Payment,Rent Payment,-2180.988418
16414,716322783,4-20-24 17:28,85.7,Purchase,Electronics,-2266.688418
16415,716322783,4-25-24 10:28,114.35,OutgoingTransfer,Wire Transfer,-2381.038418
16416,716322783,4-28-24 12:28,91.2,Purchase,Home Improvement,-2472.238418
16417,716322783,4-29-24 13:28,80.13,Withdrawal,Mobile App Withdrawal,-2552.368418
16418,716322783,05-02-24 18:28,32.25,Payment,Loan Payment,-2584.618418
16419,716322783,05-04-24 21:28,2850,IncomingTransfer,Salary,265.3815825
16420,716322783,05-05-24 18:28,166.18,Withdrawal,Branch Withdrawal,99.20158247
16421,716322783,05-09-24 21:28,1800,Payment,Credit Card Payment,-1700.798418
16422,716322783,05-11-24 13:28,194.44,Withdrawal,Branch Withdrawal,-1895.238418
16423,716322783,5-13-24 23:28,38.52,Deposit,Direct Deposit,-1856.718418
16424,716322783,5-14-24 17:28,185.6,Deposit,Check Deposit,-1671.118418
16425,716322783,5-14-24 20:28,134.41,Withdrawal,ATM Withdrawal,-1805.528418
16426,716322783,5-15-24 9:28,172.57,Deposit,Direct Deposit,-1632.958418
16427,716322783,5-16-24 21:28,1000,Payment,Rent Payment,-2632.958418
16428,716322783,5-25-24 17:28,186.54,Deposit,Cash Deposit,-2446.418418
16429,716322783,5-25-24 19:28,119.88,OnlineShopping,eBay,-2566.298418
16430,716322783,5-26-24 21:28,234.19,Withdrawal,ATM Withdrawal,-2800.488418
16431,716322783,5-27-24 9:28,231.47,Deposit,Mobile Deposit,-2569.018418
16432,716322783,5-28-24 17:28,163.28,Withdrawal,Mobile App Withdrawal,-2732.298418
16433,716322783,5-28-24 17:28,120.18,Payment,Mortgage Payment,-2852.478418
16434,716322783,06-04-24 21:28,2850,IncomingTransfer,Salary,-2.478417527
16435,716322783,06-05-24 14:28,47.6,Purchase,Travel,-50.07841753
16436,716322783,06-08-24 15:28,195.72,Withdrawal,ATM Withdrawal,-245.7984175
16437,716322783,06-09-24 21:28,1600,Payment,Credit Card Payment,-1845.798418
16438,716322783,06-10-24 21:28,18.21,IncomingTransfer,Freelance Payment,-1827.588418
16439,716322783,6-14-24 20:28,238.32,Return,Amazon Return,-1589.268418
16440,716322783,6-16-24 21:28,229.23,Return,Walmart Return,-1360.038418
16441,716322783,6-18-24 21:28,1000,Payment,Rent Payment,-2360.038418
16442,716322783,6-19-24 22:28,64.35,IncomingTransfer,Freelance Payment,-2295.688418
16443,716322783,6-20-24 10:28,20.9,Return,Etsy Return,-2274.788418
16444,716322783,6-20-24 18:28,141.89,IncomingTransfer,Freelance Payment,-2132.898418
16445,716322783,6-28-24 21:28,94.48,Deposit,Check Deposit,-2038.418418
16446,716322783,07-01-24 17:28,120.22,Withdrawal,Branch Withdrawal,-2158.638418
16447,716322783,07-02-24 21:28,2850,IncomingTransfer,Salary,691.3615825
16448,716322783,07-06-24 10:28,64.74,Return,Target Return,756.1015825
16449,716322783,07-07-24 14:28,38.38,Purchase,Clothing,717.7215825
16450,716322783,07-07-24 21:28,2400,Payment,Credit Card Payment,-1682.278418
16451,716322783,07-08-24 14:28,38.03,Payment,Bill Payment,-1720.308418
16452,716322783,07-11-24 19:28,165.82,Withdrawal,Mobile App Withdrawal,-1886.128418
16453,716322783,7-14-24 21:28,1700,Payment,Rent Payment,-3586.128418
16454,716322783,7-15-24 15:28,26.76,Withdrawal,Mobile App Withdrawal,-3612.888418
16455,716322783,7-16-24 21:28,68.71,OnlineShopping,Etsy,-3681.598418
16456,716322783,7-17-24 17:28,196.39,Purchase,Furniture,-3877.988418
16457,716322783,7-17-24 21:28,94.82,Purchase,Home Improvement,-3972.808418
16458,716430933,1-22-24 21:28,190.8,Withdrawal,ATM Withdrawal,-190.8
16459,716430933,1-24-24 15:28,174.81,Withdrawal,Mobile App Withdrawal,-365.61
16460,716430933,1-25-24 11:28,84.36,Withdrawal,ATM Withdrawal,-449.97
16461,716430933,1-25-24 12:28,15.05,Purchase,Travel,-465.02
16462,716430933,1-27-24 12:28,180.48,Deposit,Cash Deposit,-284.54
16463,716430933,1-28-24 14:28,249.99,Deposit,Mobile Deposit,-34.55
16464,716430933,1-28-24 15:28,19.3,Purchase,Furniture,-53.85
16465,716430933,1-28-24 17:28,66.93,OutgoingTransfer,Peer-to-Peer Transfer,-120.78
16466,716430933,1-31-24 22:28,122.28,Withdrawal,Branch Withdrawal,-243.06
16467,716430933,02-01-24 10:28,217.19,Return,Best Buy Return,-25.87
16468,716430933,02-01-24 19:28,37.14,IncomingTransfer,Freelance Payment,11.27
16469,716430933,02-01-24 20:28,236.3,Payment,Loan Payment,-225.03
16470,716430933,02-01-24 23:28,214.1,Withdrawal,Mobile App Withdrawal,-439.13
16471,716430933,02-02-24 21:28,2200,IncomingTransfer,Salary,1760.87
16472,716430933,02-03-24 19:28,174.9,IncomingTransfer,Freelance Payment,1935.77
16473,716430933,02-03-24 22:28,53.19,Purchase,Travel,1882.58
16474,716430933,02-04-24 15:28,191.6,OutgoingTransfer,Bank Transfer,1690.98
16475,716430933,02-04-24 19:28,235.62,IncomingTransfer,Freelance Payment,1926.6
16476,716430933,02-08-24 14:28,60.12,Purchase,Furniture,1866.48
16477,716430933,02-09-24 23:28,31.99,Return,Target Return,1898.47
16478,716430933,02-12-24 21:28,700,Payment,Subscription Payment,1198.47
16479,716430933,2-13-24 9:28,20.18,Purchase,Restaurant,1178.29
16480,716430933,2-13-24 9:28,213.86,IncomingTransfer,Freelance Payment,1392.15
16481,716430933,2-13-24 16:28,57.73,Purchase,Pharmacy,1334.42
16482,716430933,2-15-24 17:28,228.08,Purchase,Electronics,1106.34
16483,716430933,2-15-24 20:28,174.92,IncomingTransfer,Freelance Payment,1281.26
16484,716430933,2-17-24 22:28,126.66,OnlineShopping,Best Buy,1154.6
16485,716430933,2-17-24 22:28,34.67,Withdrawal,ATM Withdrawal,1119.93
16486,716430933,2-19-24 12:28,192.99,IncomingTransfer,Freelance Payment,1312.92
16487,716430933,2-20-24 16:28,36.16,Purchase,Furniture,1276.76
16488,716430933,2-21-24 10:28,131.74,Payment,Loan Payment,1145.02
16489,716430933,2-21-24 10:28,92.48,Withdrawal,Mobile App Withdrawal,1052.54
16490,716430933,2-21-24 13:28,29.49,Return,Best Buy Return,1082.03
16491,716430933,2-21-24 19:28,173.71,Deposit,Direct Deposit,1255.74
16492,716430933,2-25-24 22:28,158.9,Purchase,Restaurant,1096.84
16493,716430933,2-26-24 21:28,94.86,Deposit,Mobile Deposit,1191.7
16494,716430933,2-27-24 19:28,36.49,Deposit,Mobile Deposit,1228.19
16495,716430933,03-01-24 12:28,74.42,Deposit,Cash Deposit,1302.61
16496,716430933,03-04-24 23:28,135.12,Withdrawal,Branch Withdrawal,1167.49
16497,716430933,03-05-24 21:28,2200,IncomingTransfer,Salary,3367.49
16498,716430933,03-06-24 13:28,176.25,Deposit,Cash Deposit,3543.74
16499,716430933,03-07-24 19:28,110.67,OutgoingTransfer,Peer-to-Peer Transfer,3433.07
16500,716430933,03-11-24 17:28,162.47,OnlineShopping,eBay,3270.6
16501,716430933,03-11-24 21:28,111.66,Purchase,Grocery,3158.94
16502,716430933,03-11-24 23:28,168.33,Deposit,Cash Deposit,3327.27
16503,716430933,3-13-24 23:28,121.8,Purchase,Furniture,3205.47
16504,716430933,3-15-24 22:28,12.81,Purchase,Entertainment,3192.66
16505,716430933,3-16-24 15:28,173.61,Return,eBay Return,3366.27
16506,716430933,3-16-24 21:28,700,Payment,Subscription Payment,2666.27
16507,716430933,3-17-24 13:28,56.92,OutgoingTransfer,Wire Transfer,2609.35
16508,716430933,3-20-24 17:28,213.51,OnlineShopping,Etsy,2395.84
16509,716430933,3-21-24 9:28,208.36,Withdrawal,Mobile App Withdrawal,2187.48
16510,716430933,3-21-24 13:28,114.6,Return,Etsy Return,2302.08
16511,716430933,3-22-24 14:28,203.87,Withdrawal,Branch Withdrawal,2098.21
16512,716430933,3-23-24 15:28,194.69,Purchase,Restaurant,1903.52
16513,716430933,3-23-24 15:28,21.23,IncomingTransfer,Freelance Payment,1924.75
16514,716430933,3-25-24 19:28,62.34,OutgoingTransfer,Wire Transfer,1862.41
16515,716430933,3-26-24 13:28,19.26,Withdrawal,Branch Withdrawal,1843.15
16516,716430933,3-26-24 15:28,95.03,Purchase,Pharmacy,1748.12
16517,716430933,3-28-24 16:28,49.95,OnlineShopping,Etsy,1698.17
16518,716430933,3-28-24 21:28,56.27,Purchase,Gas,1641.9
16519,716430933,3-31-24 17:28,104.5,Withdrawal,Branch Withdrawal,1537.4
16520,716430933,3-31-24 19:28,87.95,Payment,Mortgage Payment,1449.45
16521,716430933,04-02-24 16:28,236.9,Purchase,Grocery,1212.55
16522,716430933,04-02-24 21:28,2200,IncomingTransfer,Salary,3412.55
16523,716430933,04-02-24 21:28,109.54,IncomingTransfer,Freelance Payment,3522.09
16524,716430933,04-03-24 9:28,58.68,OutgoingTransfer,International Transfer,3463.41
16525,716430933,04-04-24 13:28,136.6,Payment,Mortgage Payment,3326.81
16526,716430933,04-06-24 12:28,96.94,Return,AliExpress Return,3423.75
16527,716430933,04-06-24 17:28,72.89,Return,Walmart Return,3496.64
16528,716430933,04-09-24 10:28,145.27,OutgoingTransfer,Wire Transfer,3351.37
16529,716430933,04-11-24 19:28,242.3,Withdrawal,ATM Withdrawal,3109.07
16530,716430933,04-11-24 23:28,13.2,Deposit,Mobile Deposit,3122.27
16531,716430933,4-16-24 21:28,800,Payment,Subscription Payment,2322.27
16532,716430933,4-17-24 20:28,117.02,Purchase,Clothing,2205.25
16533,716430933,4-18-24 11:28,221.68,Payment,Loan Payment,1983.57
16534,716430933,4-19-24 16:28,32.94,Withdrawal,ATM Withdrawal,1950.63
16535,716430933,4-19-24 18:28,182.46,Purchase,Home Improvement,1768.17
16536,716430933,4-21-24 17:28,71.39,Withdrawal,Branch Withdrawal,1696.78
16537,716430933,4-21-24 21:28,12.06,OutgoingTransfer,Bank Transfer,1684.72
16538,716430933,4-22-24 21:28,140.45,Deposit,Mobile Deposit,1825.17
16539,716430933,4-24-24 12:28,164.96,Purchase,Furniture,1660.21
16540,716430933,4-28-24 19:28,171.12,Purchase,Home Improvement,1489.09
16541,716430933,05-01-24 21:28,2200,IncomingTransfer,Salary,3689.09
16542,716430933,05-02-24 21:28,175.35,Return,AliExpress Return,3864.44
16543,716430933,05-05-24 13:28,96.12,Deposit,Direct Deposit,3960.56
16544,716430933,05-06-24 14:28,232.7,Withdrawal,Branch Withdrawal,3727.86
16545,716430933,05-06-24 18:28,207.6,IncomingTransfer,Freelance Payment,3935.46
16546,716430933,05-07-24 11:28,133.97,Return,Walmart Return,4069.43
16547,716430933,05-07-24 21:28,207.17,Payment,Mortgage Payment,3862.26
16548,716430933,05-07-24 21:28,147.14,Withdrawal,Mobile App Withdrawal,3715.12
16549,716430933,05-12-24 22:28,146.31,OutgoingTransfer,International Transfer,3568.81
16550,716430933,5-13-24 21:28,900,Payment,Installment Payment,2668.81
16551,716430933,5-13-24 23:28,18.95,Deposit,Check Deposit,2687.76
16552,716430933,5-14-24 14:28,29.08,Withdrawal,Branch Withdrawal,2658.68
16553,716430933,5-15-24 22:28,194.52,Deposit,Cash Deposit,2853.2
16554,716430933,5-16-24 19:28,23.46,Deposit,Cash Deposit,2876.66
16555,716430933,5-17-24 12:28,179.4,Deposit,Mobile Deposit,3056.06
16556,716430933,5-21-24 15:28,236.67,Deposit,Direct Deposit,3292.73
16557,716430933,5-24-24 10:28,78.09,Purchase,Clothing,3214.64
16558,716430933,5-25-24 19:28,178.95,Withdrawal,Mobile App Withdrawal,3035.69
16559,716430933,5-27-24 9:28,68.06,OnlineShopping,Best Buy,2967.63
16560,716430933,5-30-24 23:28,85.58,Purchase,Pharmacy,2882.05
16561,716430933,5-31-24 17:28,222.74,Withdrawal,ATM Withdrawal,2659.31
16562,716430933,5-31-24 20:28,10.75,Return,Amazon Return,2670.06
16563,716430933,06-01-24 12:28,236.39,Payment,Bill Payment,2433.67
16564,716430933,06-01-24 14:28,94.02,OnlineShopping,eBay,2339.65
16565,716430933,06-05-24 13:28,11.36,Deposit,Direct Deposit,2351.01
16566,716430933,06-05-24 21:28,2200,IncomingTransfer,Salary,4551.01
16567,716430933,06-08-24 10:28,114.02,Purchase,Electronics,4436.99
16568,716430933,06-12-24 21:28,600,Payment,Insurance Payment,3836.99
16569,716430933,6-13-24 19:28,222.36,Purchase,Entertainment,3614.63
16570,716430933,6-14-24 18:28,235.68,OnlineShopping,Target,3378.95
16571,716430933,6-14-24 23:28,10.08,Withdrawal,ATM Withdrawal,3368.87
16572,716430933,6-17-24 22:28,212.23,Deposit,Direct Deposit,3581.1
16573,716430933,6-18-24 12:28,18.4,IncomingTransfer,Freelance Payment,3599.5
16574,716430933,6-18-24 21:28,139.43,OnlineShopping,eBay,3460.07
16575,716430933,6-19-24 11:28,209.87,Deposit,Check Deposit,3669.94
16576,716430933,6-20-24 14:28,179.21,Deposit,Mobile Deposit,3849.15
16577,716430933,6-20-24 19:28,245.16,Payment,Bill Payment,3603.99
16578,716430933,6-20-24 19:28,137.52,OnlineShopping,eBay,3466.47
16579,716430933,6-21-24 9:28,66.38,Withdrawal,Branch Withdrawal,3400.09
16580,716430933,6-21-24 18:28,102.06,Deposit,Cash Deposit,3502.15
16581,716430933,6-22-24 11:28,26.32,Payment,Mortgage Payment,3475.83
16582,716430933,6-23-24 13:28,45.76,Purchase,Gas,3430.07
16583,716430933,6-23-24 14:28,168.68,OutgoingTransfer,Peer-to-Peer Transfer,3261.39
16584,716430933,6-25-24 20:28,100.63,Deposit,Direct Deposit,3362.02
16585,716430933,6-25-24 22:28,170.87,OnlineShopping,Best Buy,3191.15
16586,716430933,6-26-24 9:28,238.16,OutgoingTransfer,Bank Transfer,2952.99
16587,716430933,6-26-24 22:28,46.55,Purchase,Electronics,2906.44
16588,716430933,6-28-24 22:28,209.3,Deposit,Direct Deposit,3115.74
16589,716430933,6-29-24 12:28,188.57,Withdrawal,ATM Withdrawal,2927.17
16590,716430933,07-01-24 16:28,157.65,Payment,Mortgage Payment,2769.52
16591,716430933,07-01-24 16:28,111.27,OutgoingTransfer,Peer-to-Peer Transfer,2658.25
16592,716430933,07-01-24 19:28,73.65,Purchase,Grocery,2584.6
16593,716430933,07-04-24 13:28,77.26,OnlineShopping,Amazon,2507.34
16594,716430933,07-04-24 21:28,2200,IncomingTransfer,Salary,4707.34
16595,716430933,07-05-24 22:28,245.03,Return,AliExpress Return,4952.37
16596,716430933,07-10-24 18:28,172.48,Return,Best Buy Return,5124.85
16597,716430933,07-11-24 15:28,40.32,Purchase,Electronics,5084.53
16598,716430933,07-12-24 21:28,700,Payment,Subscription Payment,4384.53
16599,716430933,07-12-24 22:28,46.06,Deposit,Mobile Deposit,4430.59
16600,716430933,7-13-24 13:28,56.97,Deposit,Check Deposit,4487.56
16601,716447733,1-20-24 14:28,78.32,Deposit,Check Deposit,586.5843746
16602,716447733,1-23-24 11:28,165.66,Deposit,Mobile Deposit,752.2443746
16603,716447733,1-28-24 14:28,385.77,Withdrawal,Branch Withdrawal,366.4743746
16604,716447733,1-31-24 13:28,52.01,IncomingTransfer,Freelance Payment,418.4843746
16605,716447733,02-02-24 21:28,4850,IncomingTransfer,Salary,5268.484375
16606,716447733,02-07-24 19:28,81.86,Purchase,Gas,5186.624375
16607,716447733,02-07-24 21:28,1200,Payment,Credit Card Payment,3986.624375
16608,716447733,2-15-24 21:28,1900,Payment,Insurance Payment,2086.624375
16609,716447733,2-22-24 17:28,306.82,Deposit,Check Deposit,2393.444375
16610,716447733,2-24-24 19:28,161.78,Return,eBay Return,2555.224375
16611,716447733,03-01-24 21:28,4850,IncomingTransfer,Salary,7405.224375
16612,716447733,03-05-24 13:28,245.22,Withdrawal,Branch Withdrawal,7160.004375
16613,716447733,03-06-24 21:28,1200,Payment,Credit Card Payment,5960.004375
16614,716447733,03-07-24 11:28,94.43,Payment,Bill Payment,5865.574375
16615,716447733,03-08-24 16:28,56.51,Withdrawal,ATM Withdrawal,5809.064375
16616,716447733,03-10-24 21:28,1500,Payment,Subscription Payment,4309.064375
16617,716447733,03-11-24 12:28,54.88,Withdrawal,Mobile App Withdrawal,4254.184375
16618,716447733,3-15-24 19:28,272.87,OnlineShopping,eBay,3981.314375
16619,716447733,3-17-24 16:28,293.25,Purchase,Furniture,3688.064375
16620,716447733,3-26-24 15:28,248.85,OnlineShopping,AliExpress,3439.214375
16621,716447733,3-29-24 23:28,377.68,Deposit,Mobile Deposit,3816.894375
16622,716447733,3-30-24 18:28,247.2,Purchase,Gas,3569.694375
16623,716447733,04-03-24 10:28,177.23,OutgoingTransfer,International Transfer,3392.464375
16624,716447733,04-03-24 21:28,4850,IncomingTransfer,Salary,8242.464375
16625,716447733,04-08-24 21:28,1000,Payment,Credit Card Payment,7242.464375
16626,716447733,04-12-24 18:28,330.32,Purchase,Electronics,6912.144375
16627,716447733,4-17-24 10:28,194.67,Deposit,Cash Deposit,7106.814375
16628,716447733,4-17-24 21:28,1300,Payment,Subscription Payment,5806.814375
16629,716447733,4-22-24 17:28,394.67,Payment,Loan Payment,5412.144375
16630,716447733,4-25-24 23:28,72.94,Payment,Bill Payment,5339.204375
16631,716447733,4-27-24 16:28,323.76,Withdrawal,Branch Withdrawal,5015.444375
16632,716447733,05-01-24 21:28,4850,IncomingTransfer,Salary,9865.444375
16633,716447733,05-04-24 22:28,121.15,Purchase,Pharmacy,9744.294375
16634,716447733,05-06-24 21:28,1300,Payment,Credit Card Payment,8444.294375
16635,716447733,05-08-24 12:28,321.13,Withdrawal,Mobile App Withdrawal,8123.164375
16636,716447733,5-16-24 21:28,1300,Payment,Subscription Payment,6823.164375
16637,716447733,5-16-24 23:28,369.26,Withdrawal,ATM Withdrawal,6453.904375
16638,716447733,5-18-24 16:28,43.22,Withdrawal,Branch Withdrawal,6410.684375
16639,716447733,5-22-24 13:28,229.43,Deposit,Cash Deposit,6640.114375
16640,716447733,5-27-24 9:28,385.98,Purchase,Pharmacy,6254.134375
16641,716447733,5-27-24 10:28,364.89,OnlineShopping,Best Buy,5889.244375
16642,716447733,5-29-24 9:28,366.8,OnlineShopping,AliExpress,5522.444375
16643,716447733,5-29-24 10:28,299.41,Purchase,Clothing,5223.034375
16644,716447733,06-01-24 15:28,368.85,Payment,Mortgage Payment,4854.184375
16645,716447733,06-04-24 20:28,68.32,OutgoingTransfer,Bank Transfer,4785.864375
16646,716447733,06-04-24 21:28,4850,IncomingTransfer,Salary,9635.864375
16647,716447733,06-09-24 21:28,1100,Payment,Credit Card Payment,8535.864375
16648,716447733,6-15-24 14:28,25.06,Payment,Mortgage Payment,8510.804375
16649,716447733,6-17-24 21:28,2100,Payment,Subscription Payment,6410.804375
16650,716447733,6-21-24 20:28,78.52,Payment,Bill Payment,6332.284375
16651,716447733,6-22-24 15:28,76.16,Withdrawal,Mobile App Withdrawal,6256.124375
16652,716447733,07-01-24 20:28,67.68,Purchase,Travel,6188.444375
16653,716447733,07-01-24 23:28,381.35,Withdrawal,ATM Withdrawal,5807.094375
16654,716447733,07-02-24 19:28,105.46,Purchase,Restaurant,5701.634375
16655,716447733,07-04-24 15:28,338.61,Withdrawal,Mobile App Withdrawal,5363.024375
16656,716447733,07-04-24 15:28,135.9,Withdrawal,Mobile App Withdrawal,5227.124375
16657,716447733,07-04-24 21:28,4850,IncomingTransfer,Salary,10077.12437
16658,716447733,07-06-24 20:28,127.52,Return,AliExpress Return,10204.64437
16659,716447733,07-09-24 21:28,1300,Payment,Credit Card Payment,8904.644375
16660,716447733,07-11-24 18:28,97.51,Deposit,Mobile Deposit,9002.154375
16661,716447733,07-12-24 21:28,2000,Payment,Insurance Payment,7002.154375
16662,716474358,1-20-24 19:28,102.81,Deposit,Check Deposit,659.6408616
16663,716474358,1-25-24 13:28,156.8,OutgoingTransfer,Wire Transfer,502.8408616
16664,716474358,1-26-24 16:28,140.71,Withdrawal,ATM Withdrawal,362.1308616
16665,716474358,1-28-24 14:28,17.54,Payment,Loan Payment,344.5908616
16666,716474358,1-28-24 18:28,186.88,OutgoingTransfer,International Transfer,157.7108616
16667,716474358,1-28-24 22:28,44.8,Deposit,Check Deposit,202.5108616
16668,716474358,1-29-24 15:28,216.43,OnlineShopping,Target,-13.91913835
16669,716474358,02-01-24 21:28,165.97,Purchase,Pharmacy,-179.8891384
16670,716474358,02-03-24 12:28,105.28,Deposit,Direct Deposit,-74.60913835
16671,716474358,02-03-24 21:28,1700,IncomingTransfer,Salary,1625.390862
16672,716474358,02-05-24 9:28,239.11,Payment,Bill Payment,1386.280862
16673,716474358,02-06-24 13:28,211.58,Purchase,Gas,1174.700862
16674,716474358,02-08-24 21:28,900,Payment,Credit Card Payment,274.7008616
16675,716474358,02-08-24 23:28,82.46,Deposit,Check Deposit,357.1608616
16676,716474358,02-10-24 14:28,16.3,Purchase,Entertainment,340.8608616
16677,716474358,02-10-24 22:28,55.25,Withdrawal,Branch Withdrawal,285.6108616
16678,716474358,2-14-24 21:28,700,Payment,Subscription Payment,-414.3891384
16679,716474358,2-15-24 9:28,86.28,Return,Walmart Return,-328.1091384
16680,716474358,2-17-24 13:28,221.79,Deposit,Check Deposit,-106.3191384
16681,716474358,2-17-24 14:28,38.13,Deposit,Direct Deposit,-68.18913835
16682,716474358,2-19-24 17:28,234.79,Withdrawal,ATM Withdrawal,-302.9791384
16683,716474358,2-19-24 18:28,32.29,Payment,Loan Payment,-335.2691384
16684,716474358,2-21-24 21:28,77.81,Payment,Mortgage Payment,-413.0791384
16685,716474358,2-22-24 9:28,213.42,Payment,Loan Payment,-626.4991384
16686,716474358,2-23-24 23:28,228.51,Deposit,Cash Deposit,-397.9891384
16687,716474358,2-25-24 11:28,13.87,Purchase,Restaurant,-411.8591384
16688,716474358,2-26-24 20:28,124.47,Return,Store Return,-287.3891384
16689,716474358,2-28-24 16:28,233.84,OutgoingTransfer,Bank Transfer,-521.2291384
16690,716474358,03-01-24 14:28,109.89,Purchase,Grocery,-631.1191384
16691,716474358,03-01-24 23:28,184.67,Deposit,Check Deposit,-446.4491384
16692,716474358,03-04-24 21:28,1700,IncomingTransfer,Salary,1253.550862
16693,716474358,03-05-24 13:28,40.5,Deposit,Cash Deposit,1294.050862
16694,716474358,03-05-24 17:28,74.75,Purchase,Restaurant,1219.300862
16695,716474358,03-07-24 21:28,236.26,Payment,Bill Payment,983.0408616
16696,716474358,03-08-24 15:28,222.55,Deposit,Direct Deposit,1205.590862
16697,716474358,03-09-24 21:28,900,Payment,Credit Card Payment,305.5908616
16698,716474358,03-09-24 21:28,141.26,Deposit,Mobile Deposit,446.8508616
16699,716474358,3-13-24 21:28,600,Payment,Installment Payment,-153.1491384
16700,716474358,3-15-24 19:28,199.67,Purchase,Entertainment,-352.8191384
16701,716474358,3-19-24 17:28,145.82,Withdrawal,Branch Withdrawal,-498.6391384
16702,716474358,3-19-24 19:28,100.7,Deposit,Direct Deposit,-397.9391384
16703,716474358,3-21-24 19:28,193.79,OutgoingTransfer,Wire Transfer,-591.7291384
16704,716474358,3-25-24 16:28,115.41,OnlineShopping,Amazon,-707.1391384
16705,716474358,3-26-24 13:28,210.22,Deposit,Direct Deposit,-496.9191384
16706,716474358,3-27-24 10:28,113.34,IncomingTransfer,Freelance Payment,-383.5791384
16707,716474358,3-27-24 21:28,212.28,Purchase,Entertainment,-595.8591384
16708,716474358,04-02-24 21:28,1700,IncomingTransfer,Salary,1104.140862
16709,716474358,04-03-24 13:28,133,Return,AliExpress Return,1237.140862
16710,716474358,04-05-24 10:28,59.11,Withdrawal,Branch Withdrawal,1178.030862
16711,716474358,04-07-24 14:28,222.14,Return,Amazon Return,1400.170862
16712,716474358,04-07-24 21:28,900,Payment,Credit Card Payment,500.1708616
16713,716474358,04-07-24 21:28,64.94,OutgoingTransfer,Peer-to-Peer Transfer,435.2308616
16714,716474358,04-08-24 19:28,56.22,OnlineShopping,Amazon,379.0108616
16715,716474358,04-11-24 9:28,96.85,Payment,Bill Payment,282.1608616
16716,716474358,4-15-24 21:28,500,Payment,Insurance Payment,-217.8391384
16717,716474358,4-18-24 14:28,249.6,Purchase,Gas,-467.4391384
16718,716474358,4-23-24 23:28,20.13,Deposit,Direct Deposit,-447.3091384
16719,716474358,4-24-24 10:28,196.15,Payment,Mortgage Payment,-643.4591384
16720,716474358,4-24-24 19:28,137.3,Purchase,Gas,-780.7591384
16721,716474358,4-25-24 14:28,68.35,OutgoingTransfer,Bank Transfer,-849.1091384
16722,716474358,4-27-24 12:28,69.45,IncomingTransfer,Freelance Payment,-779.6591384
16723,716474358,4-29-24 17:28,63.92,Deposit,Mobile Deposit,-715.7391384
16724,716474358,05-01-24 21:28,1700,IncomingTransfer,Salary,984.2608616
16725,716474358,05-06-24 15:28,246.09,Return,eBay Return,1230.350862
16726,716474358,05-06-24 21:28,900,Payment,Credit Card Payment,330.3508616
16727,716474358,05-11-24 21:28,500,Payment,Installment Payment,-169.6491384
16728,716474358,5-15-24 23:28,205.38,Payment,Loan Payment,-375.0291384
16729,716474358,5-18-24 17:28,50.81,Payment,Mortgage Payment,-425.8391384
16730,716474358,5-19-24 18:28,36.44,IncomingTransfer,Freelance Payment,-389.3991384
16731,716474358,5-22-24 23:28,148.74,Purchase,Clothing,-538.1391384
16732,716474358,5-25-24 13:28,137.88,Deposit,Direct Deposit,-400.2591384
16733,716474358,5-25-24 19:28,183.65,Withdrawal,Branch Withdrawal,-583.9091384
16734,716474358,5-25-24 21:28,12.88,Purchase,Electronics,-596.7891384
16735,716474358,5-26-24 16:28,146.04,OnlineShopping,Amazon,-742.8291384
16736,716474358,06-01-24 10:28,116.92,Payment,Mortgage Payment,-859.7491384
16737,716474358,06-01-24 11:28,212.28,Deposit,Mobile Deposit,-647.4691384
16738,716474358,06-02-24 21:28,1700,IncomingTransfer,Salary,1052.530862
16739,716474358,06-05-24 19:28,29.52,Deposit,Mobile Deposit,1082.050862
16740,716474358,06-07-24 21:28,900,Payment,Credit Card Payment,182.0508616
16741,716474358,06-12-24 9:28,108.13,Deposit,Cash Deposit,290.1808616
16742,716474358,6-15-24 19:28,110.36,Purchase,Home Improvement,179.8208616
16743,716474358,6-15-24 21:28,600,Payment,Insurance Payment,-420.1791384
16744,716474358,6-23-24 17:28,158.67,Withdrawal,Mobile App Withdrawal,-578.8491384
16745,716474358,6-24-24 11:28,64.42,Deposit,Mobile Deposit,-514.4291384
16746,716474358,6-24-24 16:28,188.22,IncomingTransfer,Freelance Payment,-326.2091384
16747,716474358,6-27-24 19:28,209.84,Payment,Bill Payment,-536.0491384
16748,716474358,07-02-24 13:28,54.03,Purchase,Restaurant,-590.0791384
16749,716474358,07-02-24 17:28,53.91,Withdrawal,ATM Withdrawal,-643.9891384
16750,716474358,07-02-24 19:28,31.34,Deposit,Direct Deposit,-612.6491384
16751,716474358,07-03-24 21:28,1700,IncomingTransfer,Salary,1087.350862
16752,716474358,07-08-24 21:28,900,Payment,Credit Card Payment,187.3508616
16753,716474358,7-16-24 21:28,700,Payment,Insurance Payment,-512.6491384
16754,716486508,1-21-24 13:28,49.35,Purchase,Gas,-49.35
16755,716486508,1-24-24 18:28,30.38,Purchase,Clothing,-79.73
16756,716486508,1-25-24 17:28,20.69,OnlineShopping,Target,-100.42
16757,716486508,1-30-24 15:28,272.45,Withdrawal,Branch Withdrawal,-372.87
16758,716486508,1-31-24 11:28,30.73,Purchase,Furniture,-403.6
16759,716486508,02-02-24 11:28,366.87,Return,Walmart Return,-36.73
16760,716486508,02-04-24 21:28,3700,IncomingTransfer,Salary,3663.27
16761,716486508,02-06-24 21:28,21.58,Payment,Bill Payment,3641.69
16762,716486508,02-11-24 19:28,211.01,Deposit,Direct Deposit,3852.7
16763,716486508,02-12-24 21:28,1300,Payment,Subscription Payment,2552.7
16764,716486508,2-15-24 21:28,86.36,OutgoingTransfer,Wire Transfer,2466.34
16765,716486508,2-16-24 19:28,289.44,Return,Etsy Return,2755.78
16766,716486508,2-18-24 19:28,60.59,Purchase,Clothing,2695.19
16767,716486508,2-19-24 12:28,52.28,OnlineShopping,eBay,2642.91
16768,716486508,2-24-24 11:28,272.84,OutgoingTransfer,Peer-to-Peer Transfer,2370.07
16769,716486508,2-24-24 16:28,270.3,OnlineShopping,eBay,2099.77
16770,716486508,2-28-24 22:28,123.95,Payment,Mortgage Payment,1975.82
16771,716486508,03-02-24 10:28,87.53,Deposit,Mobile Deposit,2063.35
16772,716486508,03-02-24 21:28,3700,IncomingTransfer,Salary,5763.35
16773,716486508,03-05-24 12:28,220.36,OutgoingTransfer,Peer-to-Peer Transfer,5542.99
16774,716486508,03-05-24 21:28,288.89,Deposit,Direct Deposit,5831.88
16775,716486508,03-06-24 19:28,33.52,Purchase,Restaurant,5798.36
16776,716486508,03-08-24 9:28,117.96,IncomingTransfer,Freelance Payment,5916.32
16777,716486508,03-11-24 22:28,169.44,Return,Store Return,6085.76
16778,716486508,3-13-24 22:28,97.03,Return,Etsy Return,6182.79
16779,716486508,3-13-24 23:28,305.32,Return,Walmart Return,6488.11
16780,716486508,3-17-24 18:28,155.43,Deposit,Cash Deposit,6643.54
16781,716486508,3-17-24 21:28,1400,Payment,Installment Payment,5243.54
16782,716486508,3-20-24 21:28,353.39,Return,Amazon Return,5596.93
16783,716486508,3-23-24 21:28,173.94,Deposit,Mobile Deposit,5770.87
16784,716486508,3-24-24 15:28,368.77,Purchase,Pharmacy,5402.1
16785,716486508,3-25-24 10:28,210.87,IncomingTransfer,Freelance Payment,5612.97
16786,716486508,3-26-24 16:28,244.6,Return,Best Buy Return,5857.57
16787,716486508,3-29-24 10:28,60.66,Return,Target Return,5918.23
16788,716486508,3-29-24 17:28,162.15,Deposit,Check Deposit,6080.38
16789,716486508,3-30-24 13:28,363.03,Withdrawal,ATM Withdrawal,5717.35
16790,716486508,3-30-24 19:28,393.06,OnlineShopping,Best Buy,5324.29
16791,716486508,04-01-24 21:28,3700,IncomingTransfer,Salary,9024.29
16792,716486508,04-05-24 17:28,220.75,OutgoingTransfer,Bank Transfer,8803.54
16793,716486508,04-11-24 12:28,176.42,Deposit,Direct Deposit,8979.96
16794,716486508,04-11-24 22:28,398.21,Deposit,Cash Deposit,9378.17
16795,716486508,04-12-24 12:28,162.12,IncomingTransfer,Freelance Payment,9540.29
16796,716486508,4-13-24 21:28,1000,Payment,Installment Payment,8540.29
16797,716486508,4-16-24 17:28,45.34,Deposit,Mobile Deposit,8585.63
16798,716486508,4-16-24 20:28,119.8,Purchase,Furniture,8465.83
16799,716486508,4-17-24 18:28,109.12,Deposit,Mobile Deposit,8574.95
16800,716486508,4-19-24 13:28,42.25,Deposit,Direct Deposit,8617.2
16801,716486508,4-21-24 12:28,210.56,Purchase,Clothing,8406.64
16802,716486508,4-22-24 21:28,288.5,Withdrawal,Mobile App Withdrawal,8118.14
16803,716486508,4-25-24 12:28,127.5,Return,eBay Return,8245.64
16804,716486508,4-26-24 18:28,374.48,Return,Target Return,8620.12
16805,716486508,4-26-24 23:28,22.64,OutgoingTransfer,International Transfer,8597.48
16806,716486508,05-01-24 11:28,191.02,Payment,Mortgage Payment,8406.46
16807,716486508,05-02-24 22:28,84.96,Purchase,Travel,8321.5
16808,716486508,05-03-24 20:28,380.85,Payment,Bill Payment,7940.65
16809,716486508,05-03-24 21:28,3700,IncomingTransfer,Salary,11640.65
16810,716486508,05-04-24 12:28,72.77,Withdrawal,Branch Withdrawal,11567.88
16811,716486508,05-05-24 14:28,381.72,Deposit,Direct Deposit,11949.6
16812,716486508,05-05-24 17:28,370.16,Return,Best Buy Return,12319.76
16813,716486508,05-06-24 11:28,197.51,Return,Amazon Return,12517.27
16814,716486508,05-10-24 22:28,362.19,OnlineShopping,Walmart,12155.08
16815,716486508,05-12-24 21:28,1300,Payment,Subscription Payment,10855.08
16816,716486508,5-15-24 13:28,63.7,Withdrawal,ATM Withdrawal,10791.38
16817,716486508,5-16-24 15:28,174.71,Payment,Mortgage Payment,10616.67
16818,716486508,5-17-24 22:28,311.95,Withdrawal,Branch Withdrawal,10304.72
16819,716486508,5-18-24 16:28,351.49,Purchase,Electronics,9953.23
16820,716486508,5-18-24 22:28,130.12,OutgoingTransfer,International Transfer,9823.11
16821,716486508,5-29-24 15:28,195.7,Deposit,Cash Deposit,10018.81
16822,716486508,5-30-24 11:28,376.4,Deposit,Check Deposit,10395.21
16823,716486508,06-02-24 21:28,3700,IncomingTransfer,Salary,14095.21
16824,716486508,06-03-24 11:28,238.91,OutgoingTransfer,Wire Transfer,13856.3
16825,716486508,06-03-24 22:28,61.57,Withdrawal,ATM Withdrawal,13794.73
16826,716486508,06-06-24 13:28,34.71,Purchase,Gas,13760.02
16827,716486508,06-06-24 18:28,386.87,Withdrawal,Branch Withdrawal,13373.15
16828,716486508,6-13-24 21:28,1700,Payment,Subscription Payment,11673.15
16829,716486508,6-13-24 22:28,392.85,Deposit,Check Deposit,12066
16830,716486508,6-18-24 16:28,224.7,IncomingTransfer,Freelance Payment,12290.7
16831,716486508,6-27-24 14:28,287.55,Payment,Mortgage Payment,12003.15
16832,716486508,07-01-24 22:28,314.27,OnlineShopping,Target,11688.88
16833,716486508,07-03-24 18:28,114.17,OnlineShopping,Amazon,11574.71
16834,716486508,07-03-24 21:28,234.12,Purchase,Travel,11340.59
16835,716486508,07-05-24 21:28,3700,IncomingTransfer,Salary,15040.59
16836,716486508,07-07-24 10:28,26.36,OnlineShopping,Amazon,15014.23
16837,716486508,07-07-24 18:28,49.86,Return,Target Return,15064.09
16838,716486508,07-07-24 21:28,307.73,Deposit,Mobile Deposit,15371.82
16839,716486508,07-10-24 21:28,1600,Payment,Subscription Payment,13771.82
16840,716486508,07-12-24 22:28,100.43,Purchase,Clothing,13671.39
16841,716486508,7-14-24 11:28,41.7,Purchase,Restaurant,13629.69
16842,716486508,7-16-24 9:28,141.7,Return,Walmart Return,13771.39
16843,716486508,7-17-24 15:28,315.46,Purchase,Entertainment,13455.93
16844,716602683,1-20-24 14:28,54.72,Withdrawal,Branch Withdrawal,1489.036344
16845,716602683,1-20-24 21:28,180.09,Deposit,Check Deposit,1669.126344
16846,716602683,1-31-24 9:28,86.47,Deposit,Check Deposit,1755.596344
16847,716602683,02-01-24 21:28,3900,IncomingTransfer,Salary,5655.596344
16848,716602683,02-06-24 9:28,187.58,Purchase,Home Improvement,5468.016344
16849,716602683,02-06-24 21:28,2700,Payment,Credit Card Payment,2768.016344
16850,716602683,2-15-24 21:28,1200,Payment,Subscription Payment,1568.016344
16851,716602683,2-15-24 23:28,294.4,OutgoingTransfer,Wire Transfer,1273.616344
16852,716602683,2-16-24 12:28,48.22,OutgoingTransfer,Wire Transfer,1225.396344
16853,716602683,2-16-24 15:28,266.65,Purchase,Gas,958.7463435
16854,716602683,2-19-24 9:28,305.56,Withdrawal,Branch Withdrawal,653.1863435
16855,716602683,2-20-24 14:28,191.58,Purchase,Electronics,461.6063435
16856,716602683,2-24-24 21:28,200.73,Withdrawal,Branch Withdrawal,260.8763435
16857,716602683,03-01-24 11:28,48.57,OutgoingTransfer,International Transfer,212.3063435
16858,716602683,03-01-24 21:28,3900,IncomingTransfer,Salary,4112.306344
16859,716602683,03-02-24 14:28,153.93,Deposit,Mobile Deposit,4266.236344
16860,716602683,03-06-24 14:28,157.88,Purchase,Furniture,4108.356344
16861,716602683,03-06-24 21:28,2100,Payment,Credit Card Payment,2008.356344
16862,716602683,03-08-24 17:28,317.58,Purchase,Clothing,1690.776344
16863,716602683,03-08-24 19:28,291.23,Return,Target Return,1982.006344
16864,716602683,03-09-24 17:28,168.95,Purchase,Restaurant,1813.056344
16865,716602683,03-10-24 19:28,183.13,Payment,Bill Payment,1629.926344
16866,716602683,3-13-24 12:28,325.31,Purchase,Restaurant,1304.616344
16867,716602683,3-15-24 11:28,336.87,Purchase,Clothing,967.7463435
16868,716602683,3-18-24 21:28,1200,Payment,Subscription Payment,-232.2536565
16869,716602683,3-19-24 19:28,101.3,Payment,Bill Payment,-333.5536565
16870,716602683,3-24-24 11:28,79.49,Purchase,Travel,-413.0436565
16871,716602683,3-26-24 21:28,61.24,Withdrawal,Branch Withdrawal,-474.2836565
16872,716602683,3-27-24 20:28,126.31,Deposit,Mobile Deposit,-347.9736565
16873,716602683,3-29-24 22:28,347.28,Deposit,Mobile Deposit,-0.693656468
16874,716602683,3-30-24 10:28,255.36,OnlineShopping,Etsy,-256.0536565
16875,716602683,3-30-24 17:28,91.73,Withdrawal,Mobile App Withdrawal,-347.7836565
16876,716602683,04-03-24 18:28,153.44,Purchase,Pharmacy,-501.2236565
16877,716602683,04-03-24 21:28,3900,IncomingTransfer,Salary,3398.776344
16878,716602683,04-03-24 21:28,363.09,Purchase,Pharmacy,3035.686344
16879,716602683,04-04-24 12:28,329.77,OnlineShopping,eBay,2705.916344
16880,716602683,04-04-24 15:28,340.23,Purchase,Furniture,2365.686344
16881,716602683,04-06-24 10:28,379.07,Payment,Bill Payment,1986.616344
16882,716602683,04-08-24 21:28,2100,Payment,Credit Card Payment,-113.3836565
16883,716602683,4-14-24 14:28,250.42,Deposit,Check Deposit,137.0363435
16884,716602683,4-15-24 18:28,52.87,OutgoingTransfer,Wire Transfer,84.16634353
16885,716602683,4-16-24 9:28,113.86,Deposit,Check Deposit,198.0263435
16886,716602683,4-16-24 21:28,1600,Payment,Subscription Payment,-1401.973656
16887,716602683,4-20-24 16:28,201.19,Purchase,Entertainment,-1603.163656
16888,716602683,4-21-24 16:28,179.58,Purchase,Home Improvement,-1782.743656
16889,716602683,4-21-24 16:28,118.41,Payment,Mortgage Payment,-1901.153656
16890,716602683,4-23-24 9:28,55.67,Deposit,Check Deposit,-1845.483656
16891,716602683,4-25-24 13:28,113.88,Payment,Loan Payment,-1959.363656
16892,716602683,4-25-24 17:28,368.99,Payment,Mortgage Payment,-2328.353656
16893,716602683,4-26-24 11:28,134.49,Purchase,Pharmacy,-2462.843656
16894,716602683,4-29-24 21:28,150.03,Purchase,Home Improvement,-2612.873656
16895,716602683,05-02-24 21:28,3900,IncomingTransfer,Salary,1287.126344
16896,716602683,05-04-24 21:28,270.79,Purchase,Electronics,1016.336344
16897,716602683,05-05-24 17:28,398.99,Withdrawal,ATM Withdrawal,617.3463435
16898,716602683,05-05-24 20:28,55.77,Deposit,Cash Deposit,673.1163435
16899,716602683,05-06-24 21:28,144.04,Payment,Mortgage Payment,529.0763435
16900,716602683,05-07-24 9:28,42.93,Return,Best Buy Return,572.0063435
16901,716602683,05-07-24 21:28,2700,Payment,Credit Card Payment,-2127.993656
16902,716602683,05-09-24 22:28,350.51,Withdrawal,ATM Withdrawal,-2478.503656
16903,716602683,05-11-24 10:28,125.3,OutgoingTransfer,Peer-to-Peer Transfer,-2603.803656
16904,716602683,05-12-24 16:28,226.05,Withdrawal,ATM Withdrawal,-2829.853656
16905,716602683,5-18-24 21:28,1100,Payment,Insurance Payment,-3929.853656
16906,716602683,5-27-24 16:28,230.18,Deposit,Cash Deposit,-3699.673656
16907,716602683,5-31-24 23:28,21.72,Purchase,Electronics,-3721.393656
16908,716602683,06-01-24 10:28,266.11,OnlineShopping,Walmart,-3987.503656
16909,716602683,06-03-24 21:28,3900,IncomingTransfer,Salary,-87.50365647
16910,716602683,06-04-24 23:28,159.07,OnlineShopping,Amazon,-246.5736565
16911,716602683,06-07-24 17:28,310.52,Purchase,Restaurant,-557.0936565
16912,716602683,06-08-24 21:28,2200,Payment,Credit Card Payment,-2757.093656
16913,716602683,6-13-24 19:28,365.86,OnlineShopping,Target,-3122.953656
16914,716602683,6-14-24 14:28,61.73,Withdrawal,Mobile App Withdrawal,-3184.683656
16915,716602683,6-15-24 16:28,357.85,IncomingTransfer,Freelance Payment,-2826.833656
16916,716602683,6-16-24 21:28,117.38,Purchase,Clothing,-2944.213656
16917,716602683,6-17-24 21:28,1700,Payment,Insurance Payment,-4644.213656
16918,716602683,6-23-24 13:28,92.12,OutgoingTransfer,Bank Transfer,-4736.333656
16919,716602683,6-24-24 18:28,268.35,Deposit,Mobile Deposit,-4467.983656
16920,716602683,6-25-24 22:28,213.96,Withdrawal,Mobile App Withdrawal,-4681.943656
16921,716602683,6-28-24 23:28,209.4,Return,Amazon Return,-4472.543656
16922,716602683,07-03-24 10:28,51.59,Purchase,Gas,-4524.133656
16923,716602683,07-03-24 21:28,3900,IncomingTransfer,Salary,-624.1336565
16924,716602683,07-06-24 17:28,218.26,OutgoingTransfer,Bank Transfer,-842.3936565
16925,716602683,07-08-24 21:28,2100,Payment,Credit Card Payment,-2942.393656
16926,716602683,07-09-24 9:28,38.1,Purchase,Pharmacy,-2980.493656
16927,716602683,07-12-24 12:28,76.03,IncomingTransfer,Freelance Payment,-2904.463656
16928,716602683,07-12-24 17:28,378.45,Purchase,Travel,-3282.913656
16929,716602683,7-13-24 20:28,48.18,Purchase,Pharmacy,-3331.093656
16930,716602683,7-13-24 21:28,1100,Payment,Subscription Payment,-4431.093656
16931,716602683,7-14-24 17:28,233.69,Deposit,Direct Deposit,-4197.403656
16932,716660583,1-21-24 20:28,290.85,Deposit,Direct Deposit,1746.081281
16933,716660583,1-26-24 21:28,214.7,Payment,Loan Payment,1531.381281
16934,716660583,1-27-24 20:28,302.65,Payment,Loan Payment,1228.731281
16935,716660583,1-28-24 16:28,299.02,Withdrawal,ATM Withdrawal,929.711281
16936,716660583,1-31-24 16:28,230.88,IncomingTransfer,Freelance Payment,1160.591281
16937,716660583,02-01-24 23:28,104.37,Purchase,Gas,1056.221281
16938,716660583,02-03-24 21:28,394.66,Withdrawal,Branch Withdrawal,661.561281
16939,716660583,02-03-24 22:28,124.24,Payment,Mortgage Payment,537.321281
16940,716660583,02-04-24 21:28,4900,IncomingTransfer,Salary,5437.321281
16941,716660583,02-08-24 11:28,296.02,Withdrawal,Mobile App Withdrawal,5141.301281
16942,716660583,02-09-24 21:28,2000,Payment,Credit Card Payment,3141.301281
16943,716660583,02-09-24 23:28,328.37,Purchase,Pharmacy,2812.931281
16944,716660583,02-11-24 16:28,180.32,Return,Amazon Return,2993.251281
16945,716660583,2-14-24 13:28,194.6,Payment,Mortgage Payment,2798.651281
16946,716660583,2-15-24 13:28,307.67,OutgoingTransfer,Peer-to-Peer Transfer,2490.981281
16947,716660583,2-16-24 21:28,1700,Payment,Insurance Payment,790.981281
16948,716660583,2-17-24 12:28,166.56,Deposit,Cash Deposit,957.541281
16949,716660583,2-19-24 23:28,106.85,Deposit,Direct Deposit,1064.391281
16950,716660583,2-22-24 14:28,264.98,OnlineShopping,Walmart,799.411281
16951,716660583,2-23-24 16:28,92.04,OutgoingTransfer,Peer-to-Peer Transfer,707.371281
16952,716660583,2-23-24 18:28,149.8,Withdrawal,ATM Withdrawal,557.571281
16953,716660583,2-24-24 21:28,193.38,OutgoingTransfer,Bank Transfer,364.191281
16954,716660583,2-24-24 22:28,320.31,OutgoingTransfer,Bank Transfer,43.881281
16955,716660583,2-29-24 12:28,228.67,Withdrawal,Branch Withdrawal,-184.788719
16956,716660583,03-05-24 21:28,4900,IncomingTransfer,Salary,4715.211281
16957,716660583,03-09-24 22:28,334.91,Purchase,Furniture,4380.301281
16958,716660583,03-10-24 21:28,2000,Payment,Credit Card Payment,2380.301281
16959,716660583,03-11-24 16:28,390.77,Deposit,Direct Deposit,2771.071281
16960,716660583,03-12-24 10:28,164.01,Withdrawal,Branch Withdrawal,2607.061281
16961,716660583,3-15-24 10:28,45.52,OutgoingTransfer,International Transfer,2561.541281
16962,716660583,3-15-24 12:28,158.85,OnlineShopping,Walmart,2402.691281
16963,716660583,3-18-24 21:28,1400,Payment,Insurance Payment,1002.691281
16964,716660583,3-19-24 17:28,379.65,Payment,Bill Payment,623.041281
16965,716660583,3-20-24 19:28,346.95,Withdrawal,ATM Withdrawal,276.091281
16966,716660583,3-21-24 11:28,71.78,Withdrawal,Branch Withdrawal,204.311281
16967,716660583,3-21-24 14:28,28.76,Purchase,Gas,175.551281
16968,716660583,3-21-24 14:28,246.65,OutgoingTransfer,International Transfer,-71.098719
16969,716660583,3-22-24 15:28,97.84,Withdrawal,Branch Withdrawal,-168.938719
16970,716660583,3-23-24 11:28,226.67,Payment,Bill Payment,-395.608719
16971,716660583,3-24-24 11:28,258.61,Purchase,Restaurant,-654.218719
16972,716660583,3-24-24 14:28,110.84,Deposit,Check Deposit,-543.378719
16973,716660583,3-26-24 18:28,317.48,Payment,Bill Payment,-860.858719
16974,716660583,3-30-24 21:28,389.74,Withdrawal,Mobile App Withdrawal,-1250.598719
16975,716660583,3-31-24 12:28,246.67,Payment,Bill Payment,-1497.268719
16976,716660583,04-03-24 11:28,67.42,OutgoingTransfer,International Transfer,-1564.688719
16977,716660583,04-04-24 21:28,4900,IncomingTransfer,Salary,3335.311281
16978,716660583,04-05-24 16:28,290.82,Payment,Loan Payment,3044.491281
16979,716660583,04-08-24 14:28,200.36,Purchase,Restaurant,2844.131281
16980,716660583,04-08-24 18:28,362.85,OutgoingTransfer,International Transfer,2481.281281
16981,716660583,04-09-24 21:28,2200,Payment,Credit Card Payment,281.281281
16982,716660583,04-10-24 23:28,133.49,Withdrawal,ATM Withdrawal,147.791281
16983,716660583,04-12-24 21:28,2100,Payment,Installment Payment,-1952.208719
16984,716660583,4-14-24 11:28,259.61,Purchase,Restaurant,-2211.818719
16985,716660583,4-16-24 12:28,201.46,OutgoingTransfer,Peer-to-Peer Transfer,-2413.278719
16986,716660583,4-18-24 21:28,94.83,OutgoingTransfer,Bank Transfer,-2508.108719
16987,716660583,4-23-24 19:28,307.7,Deposit,Mobile Deposit,-2200.408719
16988,716660583,4-24-24 14:28,47.55,Return,eBay Return,-2152.858719
16989,716660583,4-27-24 18:28,215.94,Withdrawal,Mobile App Withdrawal,-2368.798719
16990,716660583,05-02-24 21:28,4900,IncomingTransfer,Salary,2531.201281
16991,716660583,05-03-24 11:28,277.33,OutgoingTransfer,Wire Transfer,2253.871281
16992,716660583,05-06-24 15:28,287.92,Return,Store Return,2541.791281
16993,716660583,05-07-24 21:28,2000,Payment,Credit Card Payment,541.791281
16994,716660583,05-10-24 23:28,331.41,IncomingTransfer,Freelance Payment,873.201281
16995,716660583,05-11-24 11:28,98.82,Deposit,Cash Deposit,972.021281
16996,716660583,5-13-24 12:28,245.92,Purchase,Travel,726.101281
16997,716660583,5-15-24 21:28,1400,Payment,Subscription Payment,-673.898719
16998,716660583,5-16-24 9:28,143.92,Purchase,Furniture,-817.818719
16999,716660583,5-19-24 22:28,174.5,Deposit,Check Deposit,-643.318719
17000,716660583,5-25-24 12:28,230.18,Withdrawal,Branch Withdrawal,-873.498719
17001,716660583,5-25-24 17:28,102.81,Deposit,Check Deposit,-770.688719
17002,716660583,5-28-24 22:28,117.61,Purchase,Restaurant,-888.298719
17003,716660583,06-01-24 21:28,4900,IncomingTransfer,Salary,4011.701281
17004,716660583,06-04-24 17:28,22.25,IncomingTransfer,Freelance Payment,4033.951281
17005,716660583,06-06-24 19:28,60.48,Return,Etsy Return,4094.431281
17006,716660583,06-06-24 21:28,2000,Payment,Credit Card Payment,2094.431281
17007,716660583,06-08-24 13:28,162.6,Payment,Loan Payment,1931.831281
17008,716660583,06-10-24 16:28,58.83,Withdrawal,ATM Withdrawal,1873.001281
17009,716660583,6-17-24 11:28,371.63,Deposit,Cash Deposit,2244.631281
17010,716660583,6-18-24 21:28,2100,Payment,Installment Payment,144.631281
17011,716660583,6-22-24 12:28,176.72,Deposit,Mobile Deposit,321.351281
17012,716660583,6-28-24 22:28,243.28,IncomingTransfer,Freelance Payment,564.631281
17013,716660583,07-02-24 21:28,4900,IncomingTransfer,Salary,5464.631281
17014,716660583,07-06-24 17:28,355.2,Payment,Mortgage Payment,5109.431281
17015,716660583,07-07-24 17:28,46.48,OnlineShopping,Best Buy,5062.951281
17016,716660583,07-07-24 21:28,1900,Payment,Credit Card Payment,3162.951281
17017,716660583,07-08-24 11:28,182.9,OutgoingTransfer,Peer-to-Peer Transfer,2980.051281
17018,716660583,07-08-24 15:28,317.21,IncomingTransfer,Freelance Payment,3297.261281
17019,716660583,07-08-24 17:28,301.19,Purchase,Furniture,2996.071281
17020,716660583,07-12-24 21:28,29.63,OutgoingTransfer,Wire Transfer,2966.441281
17021,716660583,7-13-24 21:28,1800,Payment,Installment Payment,1166.441281
17022,716689383,1-21-24 10:28,278.53,Withdrawal,Branch Withdrawal,235.3181958
17023,716689383,1-23-24 9:28,46.94,Purchase,Electronics,188.3781958
17024,716689383,1-23-24 10:28,146.16,OutgoingTransfer,International Transfer,42.21819582
17025,716689383,1-24-24 13:28,108.56,Purchase,Electronics,-66.34180418
17026,716689383,1-25-24 22:28,160.39,Return,Store Return,94.04819582
17027,716689383,1-28-24 15:28,350.5,Withdrawal,Mobile App Withdrawal,-256.4518042
17028,716689383,02-01-24 20:28,177.33,Return,Target Return,-79.12180418
17029,716689383,02-03-24 12:28,159.15,Withdrawal,ATM Withdrawal,-238.2718042
17030,716689383,02-03-24 21:28,4400,IncomingTransfer,Salary,4161.728196
17031,716689383,02-04-24 10:28,262.12,Deposit,Direct Deposit,4423.848196
17032,716689383,02-05-24 9:28,267.93,Deposit,Cash Deposit,4691.778196
17033,716689383,02-06-24 15:28,290.7,OutgoingTransfer,Bank Transfer,4401.078196
17034,716689383,02-08-24 21:28,1200,Payment,Credit Card Payment,3201.078196
17035,716689383,02-11-24 21:28,1300,Payment,Rent Payment,1901.078196
17036,716689383,02-11-24 22:28,118.86,Deposit,Cash Deposit,2019.938196
17037,716689383,02-12-24 16:28,350.2,Purchase,Restaurant,1669.738196
17038,716689383,2-16-24 10:28,311.28,Payment,Loan Payment,1358.458196
17039,716689383,2-16-24 10:28,37.72,OnlineShopping,Walmart,1320.738196
17040,716689383,2-17-24 22:28,116.38,IncomingTransfer,Freelance Payment,1437.118196
17041,716689383,2-23-24 21:28,319.61,Purchase,Electronics,1117.508196
17042,716689383,2-25-24 12:28,250.46,Deposit,Check Deposit,1367.968196
17043,716689383,2-27-24 17:28,258.71,Deposit,Mobile Deposit,1626.678196
17044,716689383,03-01-24 9:28,315.68,Deposit,Check Deposit,1942.358196
17045,716689383,03-02-24 21:28,4400,IncomingTransfer,Salary,6342.358196
17046,716689383,03-04-24 17:28,190.33,Withdrawal,Branch Withdrawal,6152.028196
17047,716689383,03-04-24 18:28,236.06,Deposit,Cash Deposit,6388.088196
17048,716689383,03-05-24 15:28,130.49,Deposit,Direct Deposit,6518.578196
17049,716689383,03-07-24 13:28,258.46,Deposit,Check Deposit,6777.038196
17050,716689383,03-07-24 21:28,1100,Payment,Credit Card Payment,5677.038196
17051,716689383,03-09-24 16:28,396.56,Deposit,Mobile Deposit,6073.598196
17052,716689383,03-12-24 14:28,30.7,Return,Target Return,6104.298196
17053,716689383,03-12-24 21:28,2100,Payment,Rent Payment,4004.298196
17054,716689383,03-12-24 23:28,258.99,Payment,Bill Payment,3745.308196
17055,716689383,3-13-24 16:28,196.76,Purchase,Electronics,3548.548196
17056,716689383,3-15-24 14:28,304.49,Payment,Mortgage Payment,3244.058196
17057,716689383,3-18-24 22:28,267.57,Withdrawal,ATM Withdrawal,2976.488196
17058,716689383,3-19-24 21:28,27.14,Deposit,Direct Deposit,3003.628196
17059,716689383,3-26-24 15:28,351.28,OnlineShopping,Walmart,2652.348196
17060,716689383,3-29-24 16:28,35.38,OutgoingTransfer,Wire Transfer,2616.968196
17061,716689383,3-29-24 17:28,238.43,Return,AliExpress Return,2855.398196
17062,716689383,04-03-24 16:28,292.14,Deposit,Mobile Deposit,3147.538196
17063,716689383,04-05-24 15:28,246.28,OnlineShopping,Walmart,2901.258196
17064,716689383,04-05-24 21:28,4400,IncomingTransfer,Salary,7301.258196
17065,716689383,04-07-24 10:28,114.19,IncomingTransfer,Freelance Payment,7415.448196
17066,716689383,04-08-24 23:28,135.92,Return,Etsy Return,7551.368196
17067,716689383,04-10-24 10:28,214.86,Deposit,Mobile Deposit,7766.228196
17068,716689383,04-10-24 21:28,1200,Payment,Credit Card Payment,6566.228196
17069,716689383,04-12-24 15:28,297.19,Deposit,Mobile Deposit,6863.418196
17070,716689383,04-12-24 22:28,195.15,OnlineShopping,Walmart,6668.268196
17071,716689383,4-15-24 21:28,67.53,OnlineShopping,Amazon,6600.738196
17072,716689383,4-16-24 10:28,331.37,Withdrawal,ATM Withdrawal,6269.368196
17073,716689383,4-16-24 12:28,291.38,OnlineShopping,Target,5977.988196
17074,716689383,4-17-24 21:28,1200,Payment,Rent Payment,4777.988196
17075,716689383,4-18-24 10:28,20.08,Withdrawal,Mobile App Withdrawal,4757.908196
17076,716689383,4-21-24 22:28,245.39,Payment,Mortgage Payment,4512.518196
17077,716689383,4-23-24 21:28,298.96,Purchase,Gas,4213.558196
17078,716689383,4-25-24 17:28,376.11,OutgoingTransfer,International Transfer,3837.448196
17079,716689383,4-27-24 17:28,329.7,Purchase,Clothing,3507.748196
17080,716689383,4-27-24 20:28,242.57,Purchase,Grocery,3265.178196
17081,716689383,05-01-24 21:28,4400,IncomingTransfer,Salary,7665.178196
17082,716689383,05-04-24 19:28,131.81,Deposit,Cash Deposit,7796.988196
17083,716689383,05-06-24 21:28,1400,Payment,Credit Card Payment,6396.988196
17084,716689383,05-11-24 10:28,110.42,OutgoingTransfer,International Transfer,6286.568196
17085,716689383,05-11-24 13:28,342.08,Withdrawal,ATM Withdrawal,5944.488196
17086,716689383,05-11-24 21:28,2500,Payment,Rent Payment,3444.488196
17087,716689383,05-12-24 10:28,237.16,OnlineShopping,AliExpress,3207.328196
17088,716689383,5-13-24 12:28,179.94,OutgoingTransfer,International Transfer,3027.388196
17089,716689383,5-20-24 10:28,63.73,Return,Etsy Return,3091.118196
17090,716689383,5-24-24 19:28,54.73,Purchase,Gas,3036.388196
17091,716689383,5-28-24 21:28,55.99,Deposit,Direct Deposit,3092.378196
17092,716689383,5-29-24 17:28,241.41,Deposit,Cash Deposit,3333.788196
17093,716689383,5-30-24 17:28,311.95,Purchase,Restaurant,3021.838196
17094,716689383,5-31-24 20:28,257.14,Payment,Mortgage Payment,2764.698196
17095,716689383,06-02-24 21:28,4400,IncomingTransfer,Salary,7164.698196
17096,716689383,06-07-24 14:28,352.85,Deposit,Direct Deposit,7517.548196
17097,716689383,06-07-24 21:28,1000,Payment,Credit Card Payment,6517.548196
17098,716689383,06-09-24 19:28,98.93,Deposit,Direct Deposit,6616.478196
17099,716689383,6-13-24 9:28,384.7,OnlineShopping,eBay,6231.778196
17100,716689383,6-14-24 13:28,25.95,Deposit,Mobile Deposit,6257.728196
17101,716689383,6-16-24 12:28,137.39,Deposit,Cash Deposit,6395.118196
17102,716689383,6-16-24 21:28,2800,Payment,Rent Payment,3595.118196
17103,716689383,6-22-24 11:28,267.91,Deposit,Check Deposit,3863.028196
17104,716689383,6-24-24 22:28,367.47,Deposit,Direct Deposit,4230.498196
17105,716689383,6-25-24 21:28,270.86,Withdrawal,Mobile App Withdrawal,3959.638196
17106,716689383,6-26-24 23:28,120,OnlineShopping,Etsy,3839.638196
17107,716689383,6-27-24 11:28,254.16,OnlineShopping,Etsy,3585.478196
17108,716689383,6-28-24 17:28,75.69,Return,AliExpress Return,3661.168196
17109,716689383,07-02-24 21:28,4400,IncomingTransfer,Salary,8061.168196
17110,716689383,07-02-24 21:28,195.81,Deposit,Check Deposit,8256.978196
17111,716689383,07-05-24 11:28,266.56,OnlineShopping,AliExpress,7990.418196
17112,716689383,07-07-24 21:28,1400,Payment,Credit Card Payment,6590.418196
17113,716689383,07-12-24 12:28,62.3,Purchase,Pharmacy,6528.118196
17114,716689383,7-13-24 10:28,112.56,Purchase,Gas,6415.558196
17115,716689383,7-14-24 20:28,25.8,Return,Store Return,6441.358196
17116,716689383,7-18-24 21:28,2100,Payment,Rent Payment,4341.358196
17117,716708583,02-02-24 17:28,679.37,OnlineShopping,Etsy,-679.37
17118,716708583,02-03-24 17:28,889.73,Return,Amazon Return,210.36
17119,716708583,02-03-24 21:28,15200,IncomingTransfer,Salary,15410.36
17120,716708583,02-03-24 22:28,210.8,Withdrawal,Mobile App Withdrawal,15199.56
17121,716708583,02-06-24 9:28,478.28,Purchase,Restaurant,14721.28
17122,716708583,02-06-24 14:28,267.09,OutgoingTransfer,Bank Transfer,14454.19
17123,716708583,02-11-24 20:28,874.43,Purchase,Furniture,13579.76
17124,716708583,2-14-24 16:28,898.98,Purchase,Clothing,12680.78
17125,716708583,2-14-24 20:28,417.91,Deposit,Check Deposit,13098.69
17126,716708583,2-17-24 11:28,570.26,Purchase,Electronics,12528.43
17127,716708583,2-18-24 21:28,6100,Payment,Rent Payment,6428.43
17128,716708583,2-21-24 11:28,890.55,OnlineShopping,Target,5537.88
17129,716708583,2-21-24 13:28,593.26,Purchase,Pharmacy,4944.62
17130,716708583,2-21-24 15:28,298.44,Payment,Loan Payment,4646.18
17131,716708583,2-24-24 22:28,946.03,Payment,Loan Payment,3700.15
17132,716708583,2-26-24 9:28,337.77,Withdrawal,Branch Withdrawal,3362.38
17133,716708583,2-29-24 15:28,370.74,OutgoingTransfer,Bank Transfer,2991.64
17134,716708583,03-03-24 21:28,15200,IncomingTransfer,Salary,18191.64
17135,716708583,03-04-24 17:28,709.86,Return,Store Return,18901.5
17136,716708583,03-12-24 15:28,862.93,Purchase,Restaurant,18038.57
17137,716708583,3-16-24 12:28,940.62,OutgoingTransfer,Bank Transfer,17097.95
17138,716708583,3-18-24 21:28,4300,Payment,Rent Payment,12797.95
17139,716708583,3-20-24 19:28,706.2,Withdrawal,ATM Withdrawal,12091.75
17140,716708583,3-21-24 10:28,304.23,Purchase,Travel,11787.52
17141,716708583,3-21-24 12:28,848.01,Purchase,Grocery,10939.51
17142,716708583,3-22-24 22:28,680.54,Deposit,Check Deposit,11620.05
17143,716708583,3-25-24 11:28,933.6,Purchase,Gas,10686.45
17144,716708583,3-25-24 17:28,382.61,Purchase,Restaurant,10303.84
17145,716708583,3-26-24 10:28,372.47,IncomingTransfer,Freelance Payment,10676.31
17146,716708583,3-29-24 11:28,516.64,OnlineShopping,Target,10159.67
17147,716708583,3-30-24 11:28,549.15,Payment,Loan Payment,9610.52
17148,716708583,3-30-24 17:28,322.99,Return,eBay Return,9933.51
17149,716708583,3-31-24 15:28,571.13,Deposit,Check Deposit,10504.64
17150,716708583,3-31-24 19:28,786.22,Deposit,Check Deposit,11290.86
17151,716708583,04-01-24 9:28,226.89,Purchase,Restaurant,11063.97
17152,716708583,04-02-24 10:28,381.6,Deposit,Cash Deposit,11445.57
17153,716708583,04-02-24 11:28,775.76,Payment,Mortgage Payment,10669.81
17154,716708583,04-03-24 16:28,566.99,Return,AliExpress Return,11236.8
17155,716708583,04-04-24 21:28,15200,IncomingTransfer,Salary,26436.8
17156,716708583,04-10-24 18:28,921.7,Return,Amazon Return,27358.5
17157,716708583,04-11-24 21:28,424.85,Purchase,Travel,26933.65
17158,716708583,4-13-24 16:28,649.37,Purchase,Travel,26284.28
17159,716708583,4-14-24 21:28,6700,Payment,Rent Payment,19584.28
17160,716708583,4-16-24 21:28,739.13,OutgoingTransfer,International Transfer,18845.15
17161,716708583,4-16-24 22:28,239.06,Return,Store Return,19084.21
17162,716708583,4-19-24 20:28,233.9,Purchase,Gas,18850.31
17163,716708583,4-19-24 20:28,498.33,Withdrawal,ATM Withdrawal,18351.98
17164,716708583,4-25-24 17:28,203.01,OnlineShopping,eBay,18148.97
17165,716708583,4-26-24 18:28,445.73,OnlineShopping,Walmart,17703.24
17166,716708583,4-29-24 18:28,877.37,OutgoingTransfer,International Transfer,16825.87
17167,716708583,05-02-24 12:28,452.7,Withdrawal,ATM Withdrawal,16373.17
17168,716708583,05-02-24 16:28,543.38,Purchase,Restaurant,15829.79
17169,716708583,05-02-24 18:28,791.13,OutgoingTransfer,International Transfer,15038.66
17170,716708583,05-02-24 21:28,15200,IncomingTransfer,Salary,30238.66
17171,716708583,05-11-24 11:28,680.08,Payment,Mortgage Payment,29558.58
17172,716708583,5-13-24 22:28,831.18,IncomingTransfer,Freelance Payment,30389.76
17173,716708583,5-16-24 21:28,9200,Payment,Rent Payment,21189.76
17174,716708583,5-17-24 14:28,573.79,OnlineShopping,Amazon,20615.97
17175,716708583,5-19-24 12:28,824.75,Withdrawal,ATM Withdrawal,19791.22
17176,716708583,5-21-24 9:28,738.39,Payment,Loan Payment,19052.83
17177,716708583,5-31-24 9:28,818.39,Purchase,Pharmacy,18234.44
17178,716708583,06-02-24 17:28,432.56,Deposit,Direct Deposit,18667
17179,716708583,06-03-24 21:28,15200,IncomingTransfer,Salary,33867
17180,716708583,06-06-24 19:28,479.88,OutgoingTransfer,Peer-to-Peer Transfer,33387.12
17181,716708583,06-07-24 10:28,712.09,Payment,Mortgage Payment,32675.03
17182,716708583,06-10-24 16:28,793.8,Purchase,Grocery,31881.23
17183,716708583,6-13-24 17:28,791.87,IncomingTransfer,Freelance Payment,32673.1
17184,716708583,6-17-24 21:28,7500,Payment,Rent Payment,25173.1
17185,716708583,6-23-24 10:28,511.18,Withdrawal,ATM Withdrawal,24661.92
17186,716708583,6-27-24 9:28,854.94,Payment,Mortgage Payment,23806.98
17187,716708583,6-28-24 10:28,843.81,Purchase,Electronics,22963.17
17188,716708583,6-29-24 12:28,801.29,Purchase,Electronics,22161.88
17189,716708583,6-30-24 17:28,761.56,Purchase,Clothing,21400.32
17190,716708583,07-01-24 9:28,328.17,OutgoingTransfer,International Transfer,21072.15
17191,716708583,07-05-24 21:28,15200,IncomingTransfer,Salary,36272.15
17192,716708583,07-12-24 14:28,392.04,Return,Best Buy Return,36664.19
17193,716708583,7-14-24 11:28,832.13,OutgoingTransfer,International Transfer,35832.06
17194,716708583,7-14-24 21:28,6300,Payment,Rent Payment,29532.06
17195,716708583,7-17-24 11:28,367.78,Withdrawal,Mobile App Withdrawal,29164.28
17196,716708583,7-17-24 14:28,556.74,OnlineShopping,Etsy,28607.54
17197,716709858,1-21-24 14:28,11.11,Payment,Mortgage Payment,-11.11
17198,716709858,1-23-24 11:28,74.31,Withdrawal,Mobile App Withdrawal,-85.42
17199,716709858,1-25-24 10:28,40.93,OnlineShopping,Walmart,-126.35
17200,716709858,1-25-24 15:28,158,Deposit,Direct Deposit,31.65
17201,716709858,1-25-24 16:28,33.06,OutgoingTransfer,Bank Transfer,-1.41
17202,716709858,1-25-24 22:28,103.94,Purchase,Entertainment,-105.35
17203,716709858,02-01-24 21:28,1900,IncomingTransfer,Salary,1794.65
17204,716709858,02-02-24 16:28,186.74,Withdrawal,ATM Withdrawal,1607.91
17205,716709858,02-04-24 18:28,212.11,Purchase,Travel,1395.8
17206,716709858,02-06-24 13:28,139.75,OutgoingTransfer,International Transfer,1256.05
17207,716709858,2-17-24 21:28,1000,Payment,Rent Payment,256.05
17208,716709858,2-18-24 14:28,62.84,Deposit,Cash Deposit,318.89
17209,716709858,2-21-24 16:28,120.89,Purchase,Restaurant,198
17210,716709858,2-28-24 11:28,164.06,Purchase,Electronics,33.94
17211,716709858,2-28-24 19:28,105.78,Purchase,Travel,-71.84
17212,716709858,03-01-24 21:28,1900,IncomingTransfer,Salary,1828.16
17213,716709858,03-05-24 15:28,99.47,Return,Walmart Return,1927.63
17214,716709858,03-07-24 11:28,160.94,Purchase,Home Improvement,1766.69
17215,716709858,03-11-24 20:28,238.21,Purchase,Gas,1528.48
17216,716709858,3-14-24 14:28,16.24,OnlineShopping,eBay,1512.24
17217,716709858,3-15-24 16:28,153.18,OutgoingTransfer,Bank Transfer,1359.06
17218,716709858,3-18-24 21:28,900,Payment,Rent Payment,459.06
17219,716709858,3-19-24 15:28,221.81,Withdrawal,Branch Withdrawal,237.25
17220,716709858,3-19-24 23:28,211,Withdrawal,Mobile App Withdrawal,26.25
17221,716709858,3-20-24 15:28,166.7,Deposit,Direct Deposit,192.95
17222,716709858,04-03-24 13:28,179.95,OutgoingTransfer,Bank Transfer,13
17223,716709858,04-04-24 21:28,1900,IncomingTransfer,Salary,1913
17224,716709858,04-11-24 20:28,106.86,OnlineShopping,Best Buy,1806.14
17225,716709858,04-11-24 21:28,177.03,OnlineShopping,Etsy,1629.11
17226,716709858,04-11-24 23:28,195.41,Withdrawal,Mobile App Withdrawal,1433.7
17227,716709858,4-14-24 14:28,190.53,Return,Store Return,1624.23
17228,716709858,4-14-24 16:28,217.57,Payment,Loan Payment,1406.66
17229,716709858,4-15-24 21:28,800,Payment,Rent Payment,606.66
17230,716709858,4-17-24 10:28,43.47,Deposit,Direct Deposit,650.13
17231,716709858,4-19-24 13:28,216.96,Return,Target Return,867.09
17232,716709858,4-19-24 15:28,57.54,Payment,Loan Payment,809.55
17233,716709858,4-22-24 17:28,233.45,OutgoingTransfer,Peer-to-Peer Transfer,576.1
17234,716709858,4-23-24 9:28,186.72,Deposit,Mobile Deposit,762.82
17235,716709858,4-24-24 18:28,91.76,IncomingTransfer,Freelance Payment,854.58
17236,716709858,4-29-24 21:28,182.51,Purchase,Electronics,672.07
17237,716709858,05-04-24 21:28,1900,IncomingTransfer,Salary,2572.07
17238,716709858,05-06-24 19:28,39.22,Purchase,Pharmacy,2532.85
17239,716709858,05-09-24 11:28,233.49,Purchase,Restaurant,2299.36
17240,716709858,05-10-24 15:28,46.47,Deposit,Mobile Deposit,2345.83
17241,716709858,5-14-24 21:28,1200,Payment,Rent Payment,1145.83
17242,716709858,5-15-24 18:28,41.05,Deposit,Mobile Deposit,1186.88
17243,716709858,5-16-24 23:28,93.21,Withdrawal,Branch Withdrawal,1093.67
17244,716709858,5-21-24 22:28,216.91,Purchase,Travel,876.76
17245,716709858,5-29-24 15:28,222.7,OnlineShopping,AliExpress,654.06
17246,716709858,5-29-24 21:28,197.43,Purchase,Travel,456.63
17247,716709858,5-29-24 21:28,139.54,Purchase,Entertainment,317.09
17248,716709858,06-04-24 21:28,1900,IncomingTransfer,Salary,2217.09
17249,716709858,06-11-24 11:28,122.68,Deposit,Cash Deposit,2339.77
17250,716709858,06-11-24 13:28,108.91,Purchase,Clothing,2230.86
17251,716709858,6-13-24 10:28,207.46,Deposit,Mobile Deposit,2438.32
17252,716709858,6-15-24 19:28,218.82,IncomingTransfer,Freelance Payment,2657.14
17253,716709858,6-17-24 10:28,129.8,Deposit,Cash Deposit,2786.94
17254,716709858,6-18-24 21:28,1200,Payment,Rent Payment,1586.94
17255,716709858,6-21-24 21:28,76.39,Payment,Bill Payment,1510.55
17256,716709858,6-27-24 23:28,60.55,Withdrawal,ATM Withdrawal,1450
17257,716709858,07-04-24 17:28,106.66,OutgoingTransfer,International Transfer,1343.34
17258,716709858,07-04-24 21:28,1900,IncomingTransfer,Salary,3243.34
17259,716709858,07-09-24 23:28,79.74,OutgoingTransfer,International Transfer,3163.6
17260,716709858,7-13-24 11:28,30.93,Return,Best Buy Return,3194.53
17261,716709858,7-17-24 10:28,160.14,IncomingTransfer,Freelance Payment,3354.67
17262,716709858,7-18-24 21:28,900,Payment,Rent Payment,2454.67
17263,716725008,1-20-24 20:28,541.19,Purchase,Entertainment,1288.786323
17264,716725008,1-21-24 10:28,325.22,Withdrawal,Branch Withdrawal,963.5663227
17265,716725008,1-27-24 15:28,560.6,Return,Best Buy Return,1524.166323
17266,716725008,1-29-24 15:28,250.04,OnlineShopping,Etsy,1274.126323
17267,716725008,1-29-24 19:28,528.91,Return,eBay Return,1803.036323
17268,716725008,1-30-24 18:28,479.74,IncomingTransfer,Freelance Payment,2282.776323
17269,716725008,02-02-24 9:28,645.62,Payment,Mortgage Payment,1637.156323
17270,716725008,02-02-24 9:28,150.48,Return,Best Buy Return,1787.636323
17271,716725008,02-03-24 12:28,464.97,Purchase,Clothing,1322.666323
17272,716725008,02-03-24 16:28,464.23,Withdrawal,Mobile App Withdrawal,858.4363227
17273,716725008,02-04-24 21:28,7550,IncomingTransfer,Salary,8408.436323
17274,716725008,02-05-24 20:28,363.19,Purchase,Pharmacy,8045.246323
17275,716725008,02-07-24 23:28,346.67,OnlineShopping,Etsy,7698.576323
17276,716725008,02-09-24 21:28,2200,Payment,Credit Card Payment,5498.576323
17277,716725008,2-14-24 16:28,145.29,OnlineShopping,Amazon,5353.286323
17278,716725008,2-16-24 23:28,301.8,OnlineShopping,Walmart,5051.486323
17279,716725008,2-17-24 21:28,2900,Payment,Rent Payment,2151.486323
17280,716725008,2-26-24 20:28,262.15,Purchase,Entertainment,1889.336323
17281,716725008,03-03-24 21:28,7550,IncomingTransfer,Salary,9439.336323
17282,716725008,03-05-24 11:28,501.23,Withdrawal,Branch Withdrawal,8938.106323
17283,716725008,03-05-24 16:28,717.64,Deposit,Check Deposit,9655.746323
17284,716725008,03-07-24 10:28,155.05,Payment,Loan Payment,9500.696323
17285,716725008,03-07-24 14:28,196.69,Return,Store Return,9697.386323
17286,716725008,03-08-24 21:28,2900,Payment,Credit Card Payment,6797.386323
17287,716725008,03-09-24 15:28,224.39,OutgoingTransfer,Bank Transfer,6572.996323
17288,716725008,03-10-24 12:28,200.33,Payment,Mortgage Payment,6372.666323
17289,716725008,03-11-24 19:28,185.29,Return,Etsy Return,6557.956323
17290,716725008,03-11-24 21:28,3100,Payment,Rent Payment,3457.956323
17291,716725008,3-16-24 19:28,559.08,Purchase,Entertainment,2898.876323
17292,716725008,3-18-24 17:28,422.4,Purchase,Home Improvement,2476.476323
17293,716725008,3-18-24 18:28,297.63,Withdrawal,Mobile App Withdrawal,2178.846323
17294,716725008,3-19-24 21:28,104.29,Withdrawal,Branch Withdrawal,2074.556323
17295,716725008,3-20-24 12:28,432.36,IncomingTransfer,Freelance Payment,2506.916323
17296,716725008,3-21-24 16:28,210.96,Return,AliExpress Return,2717.876323
17297,716725008,3-23-24 12:28,211.8,Purchase,Furniture,2506.076323
17298,716725008,3-24-24 13:28,353.61,OutgoingTransfer,Wire Transfer,2152.466323
17299,716725008,3-26-24 12:28,735.33,Purchase,Furniture,1417.136323
17300,716725008,3-27-24 23:28,256.46,Deposit,Direct Deposit,1673.596323
17301,716725008,3-28-24 22:28,600.05,Return,Etsy Return,2273.646323
17302,716725008,3-29-24 9:28,176.5,Withdrawal,Branch Withdrawal,2097.146323
17303,716725008,3-29-24 17:28,127.65,Withdrawal,ATM Withdrawal,1969.496323
17304,716725008,04-01-24 12:28,597.34,Withdrawal,ATM Withdrawal,1372.156323
17305,716725008,04-01-24 18:28,640.06,OutgoingTransfer,Peer-to-Peer Transfer,732.0963227
17306,716725008,04-03-24 21:28,7550,IncomingTransfer,Salary,8282.096323
17307,716725008,04-03-24 23:28,223.87,Purchase,Entertainment,8058.226323
17308,716725008,04-05-24 11:28,366.43,OnlineShopping,Etsy,7691.796323
17309,716725008,04-06-24 11:28,138.59,Return,Target Return,7830.386323
17310,716725008,04-06-24 15:28,581.52,Purchase,Pharmacy,7248.866323
17311,716725008,04-08-24 21:28,2600,Payment,Credit Card Payment,4648.866323
17312,716725008,04-09-24 13:28,426.6,Deposit,Check Deposit,5075.466323
17313,716725008,04-11-24 17:28,685.32,Purchase,Grocery,4390.146323
17314,716725008,04-12-24 18:28,726.34,OutgoingTransfer,Peer-to-Peer Transfer,3663.806323
17315,716725008,4-13-24 21:28,4200,Payment,Rent Payment,-536.1936773
17316,716725008,4-17-24 19:28,210.22,Purchase,Pharmacy,-746.4136773
17317,716725008,4-20-24 21:28,524.63,Withdrawal,Branch Withdrawal,-1271.043677
17318,716725008,4-23-24 16:28,560.43,Payment,Loan Payment,-1831.473677
17319,716725008,4-25-24 21:28,291.52,Deposit,Mobile Deposit,-1539.953677
17320,716725008,4-27-24 15:28,123.08,Deposit,Cash Deposit,-1416.873677
17321,716725008,4-27-24 21:28,680.97,Return,Target Return,-735.9036773
17322,716725008,4-28-24 14:28,230.39,OnlineShopping,eBay,-966.2936773
17323,716725008,4-30-24 15:28,552.5,Return,AliExpress Return,-413.7936773
17324,716725008,05-01-24 18:28,205.81,Return,Walmart Return,-207.9836773
17325,716725008,05-01-24 21:28,7550,IncomingTransfer,Salary,7342.016323
17326,716725008,05-05-24 14:28,435.92,Purchase,Pharmacy,6906.096323
17327,716725008,05-05-24 22:28,672.47,Purchase,Pharmacy,6233.626323
17328,716725008,05-06-24 21:28,3200,Payment,Credit Card Payment,3033.626323
17329,716725008,05-07-24 21:28,129.15,Deposit,Mobile Deposit,3162.776323
17330,716725008,05-08-24 11:28,578.82,Withdrawal,Mobile App Withdrawal,2583.956323
17331,716725008,05-10-24 19:28,393.45,Purchase,Clothing,2190.506323
17332,716725008,05-11-24 19:28,173.3,OnlineShopping,Walmart,2017.206323
17333,716725008,05-11-24 21:28,2000,Payment,Rent Payment,17.20632271
17334,716725008,05-12-24 18:28,432.86,OutgoingTransfer,Peer-to-Peer Transfer,-415.6536773
17335,716725008,5-13-24 17:28,300.03,OutgoingTransfer,Peer-to-Peer Transfer,-715.6836773
17336,716725008,5-13-24 18:28,569.7,Withdrawal,ATM Withdrawal,-1285.383677
17337,716725008,5-13-24 19:28,616.41,Withdrawal,ATM Withdrawal,-1901.793677
17338,716725008,5-13-24 23:28,442.61,Purchase,Grocery,-2344.403677
17339,716725008,5-15-24 20:28,118.95,Deposit,Check Deposit,-2225.453677
17340,716725008,5-17-24 12:28,338.57,OutgoingTransfer,International Transfer,-2564.023677
17341,716725008,5-18-24 14:28,512.14,Return,Walmart Return,-2051.883677
17342,716725008,5-22-24 16:28,439.17,Deposit,Mobile Deposit,-1612.713677
17343,716725008,5-25-24 19:28,547.03,Deposit,Direct Deposit,-1065.683677
17344,716725008,5-27-24 10:28,433.65,Payment,Mortgage Payment,-1499.333677
17345,716725008,5-27-24 20:28,250.1,Return,eBay Return,-1249.233677
17346,716725008,5-31-24 21:28,455.86,Purchase,Grocery,-1705.093677
17347,716725008,06-04-24 9:28,279.38,Deposit,Direct Deposit,-1425.713677
17348,716725008,06-05-24 21:28,7550,IncomingTransfer,Salary,6124.286323
17349,716725008,06-06-24 9:28,350.97,Return,Best Buy Return,6475.256323
17350,716725008,06-06-24 22:28,724.7,Withdrawal,Mobile App Withdrawal,5750.556323
17351,716725008,06-07-24 11:28,526.56,OnlineShopping,Etsy,5223.996323
17352,716725008,06-10-24 18:28,697.08,Payment,Loan Payment,4526.916323
17353,716725008,06-10-24 21:28,3200,Payment,Credit Card Payment,1326.916323
17354,716725008,06-12-24 21:28,4800,Payment,Rent Payment,-3473.083677
17355,716725008,6-15-24 12:28,241.69,OutgoingTransfer,International Transfer,-3714.773677
17356,716725008,6-20-24 9:28,246.15,Withdrawal,Branch Withdrawal,-3960.923677
17357,716725008,6-21-24 9:28,158.87,Purchase,Pharmacy,-4119.793677
17358,716725008,6-22-24 19:28,241,Purchase,Grocery,-4360.793677
17359,716725008,6-25-24 13:28,505.66,OnlineShopping,Best Buy,-4866.453677
17360,716725008,6-30-24 13:28,571.92,Deposit,Check Deposit,-4294.533677
17361,716725008,6-30-24 13:28,281.61,Withdrawal,ATM Withdrawal,-4576.143677
17362,716725008,07-01-24 11:28,738.11,Purchase,Clothing,-5314.253677
17363,716725008,07-02-24 9:28,728.44,Withdrawal,ATM Withdrawal,-6042.693677
17364,716725008,07-02-24 21:28,7550,IncomingTransfer,Salary,1507.306323
17365,716725008,07-03-24 15:28,535.43,Deposit,Mobile Deposit,2042.736323
17366,716725008,07-05-24 9:28,502.01,Deposit,Direct Deposit,2544.746323
17367,716725008,07-05-24 15:28,151.43,Return,Etsy Return,2696.176323
17368,716725008,07-07-24 13:28,486.28,IncomingTransfer,Freelance Payment,3182.456323
17369,716725008,07-07-24 21:28,2600,Payment,Credit Card Payment,582.4563227
17370,716725008,07-10-24 12:28,183.99,Deposit,Mobile Deposit,766.4463227
17371,716725008,07-10-24 21:28,4400,Payment,Rent Payment,-3633.553677
17372,716725008,07-11-24 14:28,262.18,Deposit,Check Deposit,-3371.373677
17373,716725008,7-16-24 18:28,490.25,Withdrawal,Branch Withdrawal,-3861.623677
17374,716725008,7-17-24 18:28,311.58,OutgoingTransfer,Peer-to-Peer Transfer,-4173.203677
17375,716742483,1-21-24 13:28,162.76,OutgoingTransfer,Bank Transfer,563.3142751
17376,716742483,1-21-24 14:28,248.77,OutgoingTransfer,Peer-to-Peer Transfer,314.5442751
17377,716742483,1-23-24 18:28,83.12,Purchase,Home Improvement,231.4242751
17378,716742483,1-25-24 17:28,26.02,Deposit,Cash Deposit,257.4442751
17379,716742483,1-26-24 15:28,11.68,OnlineShopping,AliExpress,245.7642751
17380,716742483,1-27-24 22:28,24.8,Withdrawal,Mobile App Withdrawal,220.9642751
17381,716742483,1-31-24 10:28,195.17,Payment,Loan Payment,25.79427512
17382,716742483,02-03-24 17:28,103.4,Withdrawal,Mobile App Withdrawal,-77.60572488
17383,716742483,02-05-24 11:28,197.4,Deposit,Direct Deposit,119.7942751
17384,716742483,02-05-24 21:28,3300,IncomingTransfer,Salary,3419.794275
17385,716742483,02-08-24 12:28,177.59,Payment,Loan Payment,3242.204275
17386,716742483,02-08-24 23:28,132.64,Return,AliExpress Return,3374.844275
17387,716742483,02-09-24 16:28,200.82,Withdrawal,ATM Withdrawal,3174.024275
17388,716742483,02-10-24 19:28,93.35,Purchase,Furniture,3080.674275
17389,716742483,02-10-24 21:28,1400,Payment,Credit Card Payment,1680.674275
17390,716742483,02-10-24 21:28,30.91,Deposit,Mobile Deposit,1711.584275
17391,716742483,02-12-24 17:28,74.12,OnlineShopping,eBay,1637.464275
17392,716742483,02-12-24 19:28,207.26,Deposit,Mobile Deposit,1844.724275
17393,716742483,2-14-24 19:28,247.94,Deposit,Check Deposit,2092.664275
17394,716742483,2-15-24 21:28,1100,Payment,Installment Payment,992.6642751
17395,716742483,2-16-24 9:28,213.21,Payment,Mortgage Payment,779.4542751
17396,716742483,2-20-24 14:28,145.95,OutgoingTransfer,Wire Transfer,633.5042751
17397,716742483,2-21-24 12:28,79.97,IncomingTransfer,Freelance Payment,713.4742751
17398,716742483,2-21-24 18:28,215.23,Withdrawal,ATM Withdrawal,498.2442751
17399,716742483,2-22-24 9:28,127.76,Deposit,Cash Deposit,626.0042751
17400,716742483,2-23-24 10:28,15.6,Purchase,Restaurant,610.4042751
17401,716742483,2-23-24 14:28,129.81,Payment,Mortgage Payment,480.5942751
17402,716742483,2-24-24 17:28,194.76,Purchase,Clothing,285.8342751
17403,716742483,2-25-24 14:28,100.53,Withdrawal,Mobile App Withdrawal,185.3042751
17404,716742483,2-26-24 16:28,197.01,Purchase,Grocery,-11.70572488
17405,716742483,2-27-24 23:28,211.71,Withdrawal,Mobile App Withdrawal,-223.4157249
17406,716742483,2-28-24 10:28,155.77,Purchase,Pharmacy,-379.1857249
17407,716742483,2-28-24 16:28,78.05,Deposit,Check Deposit,-301.1357249
17408,716742483,2-29-24 19:28,90.61,Deposit,Mobile Deposit,-210.5257249
17409,716742483,03-01-24 21:28,3300,IncomingTransfer,Salary,3089.474275
17410,716742483,03-03-24 13:28,110.32,IncomingTransfer,Freelance Payment,3199.794275
17411,716742483,03-04-24 14:28,133.04,Payment,Mortgage Payment,3066.754275
17412,716742483,03-05-24 11:28,142.89,Withdrawal,ATM Withdrawal,2923.864275
17413,716742483,03-06-24 19:28,162.82,Purchase,Grocery,2761.044275
17414,716742483,03-06-24 21:28,1400,Payment,Credit Card Payment,1361.044275
17415,716742483,03-08-24 10:28,247.34,Deposit,Check Deposit,1608.384275
17416,716742483,03-08-24 11:28,32.85,Withdrawal,Branch Withdrawal,1575.534275
17417,716742483,03-08-24 23:28,174.88,Deposit,Cash Deposit,1750.414275
17418,716742483,03-10-24 12:28,85.48,Purchase,Travel,1664.934275
17419,716742483,03-10-24 22:28,159.03,Purchase,Grocery,1505.904275
17420,716742483,03-11-24 20:28,26.99,Payment,Bill Payment,1478.914275
17421,716742483,03-11-24 21:28,156.27,Withdrawal,ATM Withdrawal,1322.644275
17422,716742483,3-15-24 17:28,154.92,Purchase,Home Improvement,1167.724275
17423,716742483,3-15-24 18:28,108.8,Deposit,Check Deposit,1276.524275
17424,716742483,3-15-24 21:28,1100,Payment,Installment Payment,176.5242751
17425,716742483,3-24-24 11:28,46.88,IncomingTransfer,Freelance Payment,223.4042751
17426,716742483,3-24-24 15:28,114.84,Deposit,Direct Deposit,338.2442751
17427,716742483,3-24-24 22:28,127.89,Withdrawal,Branch Withdrawal,210.3542751
17428,716742483,3-25-24 13:28,84.85,Payment,Bill Payment,125.5042751
17429,716742483,3-26-24 23:28,240.8,Return,Store Return,366.3042751
17430,716742483,3-27-24 14:28,101.81,Purchase,Entertainment,264.4942751
17431,716742483,04-04-24 12:28,235.75,Purchase,Pharmacy,28.74427512
17432,716742483,04-05-24 12:28,30.08,Withdrawal,Branch Withdrawal,-1.335724883
17433,716742483,04-05-24 16:28,118.63,Return,Amazon Return,117.2942751
17434,716742483,04-05-24 21:28,3300,IncomingTransfer,Salary,3417.294275
17435,716742483,04-07-24 12:28,71.22,OutgoingTransfer,Wire Transfer,3346.074275
17436,716742483,04-07-24 22:28,237.41,Return,Store Return,3583.484275
17437,716742483,04-09-24 20:28,38.06,OnlineShopping,Best Buy,3545.424275
17438,716742483,04-10-24 13:28,240.18,Payment,Bill Payment,3305.244275
17439,716742483,04-10-24 21:28,1300,Payment,Credit Card Payment,2005.244275
17440,716742483,04-12-24 10:28,140.01,Return,AliExpress Return,2145.254275
17441,716742483,4-13-24 21:28,1200,Payment,Subscription Payment,945.2542751
17442,716742483,4-16-24 13:28,206.08,Payment,Bill Payment,739.1742751
17443,716742483,4-17-24 17:28,156.4,Withdrawal,Branch Withdrawal,582.7742751
17444,716742483,4-18-24 19:28,182.42,IncomingTransfer,Freelance Payment,765.1942751
17445,716742483,4-25-24 15:28,101.2,OutgoingTransfer,Bank Transfer,663.9942751
17446,716742483,4-26-24 23:28,231.26,Withdrawal,Branch Withdrawal,432.7342751
17447,716742483,4-27-24 13:28,62.93,Withdrawal,Branch Withdrawal,369.8042751
17448,716742483,4-28-24 18:28,36.04,OutgoingTransfer,Peer-to-Peer Transfer,333.7642751
17449,716742483,4-29-24 13:28,98.78,Purchase,Travel,234.9842751
17450,716742483,4-30-24 15:28,189.44,IncomingTransfer,Freelance Payment,424.4242751
17451,716742483,4-30-24 20:28,188.15,Purchase,Gas,236.2742751
17452,716742483,05-04-24 21:28,3300,IncomingTransfer,Salary,3536.274275
17453,716742483,05-05-24 13:28,182.4,Deposit,Check Deposit,3718.674275
17454,716742483,05-05-24 15:28,78.82,Purchase,Clothing,3639.854275
17455,716742483,05-08-24 9:28,137.47,OnlineShopping,Amazon,3502.384275
17456,716742483,05-08-24 20:28,89.25,Deposit,Mobile Deposit,3591.634275
17457,716742483,05-09-24 21:28,1300,Payment,Credit Card Payment,2291.634275
17458,716742483,5-14-24 17:28,16.5,IncomingTransfer,Freelance Payment,2308.134275
17459,716742483,5-15-24 13:28,68.36,Deposit,Mobile Deposit,2376.494275
17460,716742483,5-15-24 20:28,74.04,Withdrawal,Mobile App Withdrawal,2302.454275
17461,716742483,5-15-24 21:28,1200,Payment,Subscription Payment,1102.454275
17462,716742483,5-15-24 22:28,201.36,Deposit,Check Deposit,1303.814275
17463,716742483,5-18-24 21:28,199.39,Return,eBay Return,1503.204275
17464,716742483,5-20-24 23:28,135.18,OnlineShopping,Amazon,1368.024275
17465,716742483,5-23-24 13:28,47.03,Withdrawal,ATM Withdrawal,1320.994275
17466,716742483,5-25-24 11:28,239.27,Deposit,Mobile Deposit,1560.264275
17467,716742483,5-26-24 14:28,108.59,Deposit,Mobile Deposit,1668.854275
17468,716742483,5-27-24 9:28,143.86,Deposit,Direct Deposit,1812.714275
17469,716742483,5-28-24 11:28,184.65,Purchase,Electronics,1628.064275
17470,716742483,06-04-24 9:28,192.24,Deposit,Mobile Deposit,1820.304275
17471,716742483,06-04-24 17:28,44.95,IncomingTransfer,Freelance Payment,1865.254275
17472,716742483,06-05-24 21:28,3300,IncomingTransfer,Salary,5165.254275
17473,716742483,06-06-24 21:28,203.05,Purchase,Home Improvement,4962.204275
17474,716742483,06-07-24 16:28,157.97,Purchase,Gas,4804.234275
17475,716742483,06-10-24 20:28,200.45,Purchase,Travel,4603.784275
17476,716742483,06-10-24 21:28,1400,Payment,Credit Card Payment,3203.784275
17477,716742483,06-11-24 22:28,78.14,Purchase,Clothing,3125.644275
17478,716742483,6-14-24 21:28,1200,Payment,Insurance Payment,1925.644275
17479,716742483,6-17-24 16:28,31.25,Purchase,Clothing,1894.394275
17480,716742483,6-18-24 18:28,85.36,Purchase,Gas,1809.034275
17481,716742483,6-20-24 16:28,215.9,Purchase,Restaurant,1593.134275
17482,716742483,6-22-24 14:28,11.11,Purchase,Travel,1582.024275
17483,716742483,6-24-24 14:28,198.06,OutgoingTransfer,Peer-to-Peer Transfer,1383.964275
17484,716742483,6-27-24 17:28,230.56,OutgoingTransfer,Bank Transfer,1153.404275
17485,716742483,6-27-24 19:28,163.79,Return,Target Return,1317.194275
17486,716742483,07-02-24 16:28,200.76,Return,Etsy Return,1517.954275
17487,716742483,07-04-24 21:28,3300,IncomingTransfer,Salary,4817.954275
17488,716742483,07-09-24 12:28,186.45,Deposit,Mobile Deposit,5004.404275
17489,716742483,07-09-24 21:28,1300,Payment,Credit Card Payment,3704.404275
17490,716742483,07-10-24 22:28,74.26,Purchase,Home Improvement,3630.144275
17491,716742483,7-14-24 18:28,23.96,Deposit,Check Deposit,3654.104275
17492,716742483,7-18-24 21:28,800,Payment,Insurance Payment,2854.104275
17493,716754783,1-22-24 18:28,858.15,Return,Amazon Return,1963.32407
17494,716754783,1-24-24 9:28,204.78,Deposit,Cash Deposit,2168.10407
17495,716754783,1-28-24 22:28,506.61,IncomingTransfer,Freelance Payment,2674.71407
17496,716754783,02-05-24 21:28,12100,IncomingTransfer,Salary,14774.71407
17497,716754783,02-10-24 20:28,914.21,OnlineShopping,Amazon,13860.50407
17498,716754783,02-10-24 21:28,1800,Payment,Credit Card Payment,12060.50407
17499,716754783,02-11-24 21:28,4400,Payment,Installment Payment,7660.50407
17500,716754783,2-13-24 17:28,303.05,Deposit,Cash Deposit,7963.55407
17501,716754783,2-18-24 20:28,612.08,Withdrawal,Branch Withdrawal,7351.47407
17502,716754783,2-22-24 11:28,605.08,Payment,Bill Payment,6746.39407
17503,716754783,03-02-24 21:28,12100,IncomingTransfer,Salary,18846.39407
17504,716754783,03-07-24 21:28,1500,Payment,Credit Card Payment,17346.39407
17505,716754783,03-09-24 10:28,947.06,IncomingTransfer,Freelance Payment,18293.45407
17506,716754783,3-13-24 9:28,271.37,OutgoingTransfer,Wire Transfer,18022.08407
17507,716754783,3-13-24 21:28,3600,Payment,Installment Payment,14422.08407
17508,716754783,3-14-24 18:28,788.49,Return,Walmart Return,15210.57407
17509,716754783,3-19-24 12:28,502.11,Deposit,Check Deposit,15712.68407
17510,716754783,3-23-24 11:28,616.4,OutgoingTransfer,Bank Transfer,15096.28407
17511,716754783,3-24-24 17:28,786.79,OnlineShopping,Amazon,14309.49407
17512,716754783,3-26-24 10:28,536.44,Withdrawal,Branch Withdrawal,13773.05407
17513,716754783,3-29-24 13:28,674.72,Withdrawal,Mobile App Withdrawal,13098.33407
17514,716754783,04-02-24 21:28,12100,IncomingTransfer,Salary,25198.33407
17515,716754783,04-05-24 10:28,709.23,OutgoingTransfer,Bank Transfer,24489.10407
17516,716754783,04-07-24 21:28,1500,Payment,Credit Card Payment,22989.10407
17517,716754783,04-09-24 20:28,874.19,OutgoingTransfer,Bank Transfer,22114.91407
17518,716754783,4-13-24 21:28,3300,Payment,Insurance Payment,18814.91407
17519,716754783,4-14-24 11:28,324.29,Return,Amazon Return,19139.20407
17520,716754783,4-14-24 19:28,501.88,Withdrawal,ATM Withdrawal,18637.32407
17521,716754783,4-19-24 14:28,935.48,Deposit,Check Deposit,19572.80407
17522,716754783,4-23-24 17:28,241.51,IncomingTransfer,Freelance Payment,19814.31407
17523,716754783,4-27-24 12:28,349.75,Withdrawal,ATM Withdrawal,19464.56407
17524,716754783,05-01-24 21:28,684.93,Deposit,Check Deposit,20149.49407
17525,716754783,05-04-24 10:28,375.21,Deposit,Cash Deposit,20524.70407
17526,716754783,05-04-24 12:28,621.27,Deposit,Mobile Deposit,21145.97407
17527,716754783,05-04-24 21:28,12100,IncomingTransfer,Salary,33245.97407
17528,716754783,05-09-24 9:28,440.06,Deposit,Check Deposit,33686.03407
17529,716754783,05-09-24 21:28,1900,Payment,Credit Card Payment,31786.03407
17530,716754783,05-10-24 21:28,4600,Payment,Subscription Payment,27186.03407
17531,716754783,5-13-24 17:28,336.02,Payment,Mortgage Payment,26850.01407
17532,716754783,5-20-24 10:28,526.95,Deposit,Check Deposit,27376.96407
17533,716754783,5-23-24 10:28,266.04,Purchase,Gas,27110.92407
17534,716754783,5-24-24 12:28,608.11,Payment,Loan Payment,26502.81407
17535,716754783,06-01-24 22:28,240.56,Payment,Bill Payment,26262.25407
17536,716754783,06-02-24 11:28,602.52,Deposit,Cash Deposit,26864.77407
17537,716754783,06-02-24 21:28,12100,IncomingTransfer,Salary,38964.77407
17538,716754783,06-05-24 11:28,342.91,Withdrawal,Branch Withdrawal,38621.86407
17539,716754783,06-06-24 15:28,541.24,Deposit,Mobile Deposit,39163.10407
17540,716754783,06-07-24 21:28,1800,Payment,Credit Card Payment,37363.10407
17541,716754783,06-07-24 22:28,477.07,Return,Target Return,37840.17407
17542,716754783,06-08-24 11:28,728.12,Purchase,Grocery,37112.05407
17543,716754783,6-13-24 21:28,5000,Payment,Insurance Payment,32112.05407
17544,716754783,6-17-24 9:28,618.8,Withdrawal,Branch Withdrawal,31493.25407
17545,716754783,6-19-24 13:28,319.19,Deposit,Check Deposit,31812.44407
17546,716754783,6-23-24 15:28,222.65,Deposit,Cash Deposit,32035.09407
17547,716754783,6-24-24 20:28,824.33,Purchase,Gas,31210.76407
17548,716754783,6-24-24 23:28,827.49,Purchase,Travel,30383.27407
17549,716754783,6-29-24 13:28,662.76,Deposit,Check Deposit,31046.03407
17550,716754783,07-02-24 21:28,12100,IncomingTransfer,Salary,43146.03407
17551,716754783,07-06-24 12:28,380.46,Deposit,Cash Deposit,43526.49407
17552,716754783,07-07-24 21:28,1800,Payment,Credit Card Payment,41726.49407
17553,716754783,07-10-24 21:28,698.87,Return,Etsy Return,42425.36407
17554,716754783,07-12-24 21:28,4500,Payment,Installment Payment,37925.36407
17555,716768808,1-24-24 23:28,911.16,Return,AliExpress Return,2144.767692
17556,716768808,02-01-24 21:28,16250,IncomingTransfer,Salary,18394.76769
17557,716768808,02-03-24 15:28,446.94,Deposit,Direct Deposit,18841.70769
17558,716768808,02-05-24 17:28,718.05,Return,Best Buy Return,19559.75769
17559,716768808,02-06-24 21:28,2200,Payment,Credit Card Payment,17359.75769
17560,716768808,02-09-24 23:28,429.43,Return,Best Buy Return,17789.18769
17561,716768808,2-13-24 11:28,660.31,OnlineShopping,AliExpress,17128.87769
17562,716768808,2-14-24 18:28,542.33,Purchase,Electronics,16586.54769
17563,716768808,2-18-24 21:28,5800,Payment,Insurance Payment,10786.54769
17564,716768808,2-21-24 23:28,618.08,Purchase,Furniture,10168.46769
17565,716768808,2-26-24 13:28,517.08,Payment,Bill Payment,9651.387692
17566,716768808,2-29-24 19:28,363.02,Withdrawal,ATM Withdrawal,9288.367692
17567,716768808,03-03-24 21:28,16250,IncomingTransfer,Salary,25538.36769
17568,716768808,03-08-24 21:28,2600,Payment,Credit Card Payment,22938.36769
17569,716768808,03-09-24 20:28,633.98,Payment,Mortgage Payment,22304.38769
17570,716768808,03-11-24 21:28,6900,Payment,Insurance Payment,15404.38769
17571,716768808,3-17-24 15:28,566.74,Return,Target Return,15971.12769
17572,716768808,3-18-24 20:28,269.26,Withdrawal,Mobile App Withdrawal,15701.86769
17573,716768808,3-26-24 20:28,617.6,Deposit,Cash Deposit,16319.46769
17574,716768808,3-28-24 23:28,487.74,Withdrawal,ATM Withdrawal,15831.72769
17575,716768808,3-31-24 21:28,480.81,OnlineShopping,AliExpress,15350.91769
17576,716768808,04-04-24 12:28,888.72,Deposit,Direct Deposit,16239.63769
17577,716768808,04-05-24 21:28,16250,IncomingTransfer,Salary,32489.63769
17578,716768808,04-06-24 21:28,822.28,Purchase,Restaurant,31667.35769
17579,716768808,04-10-24 21:28,2700,Payment,Credit Card Payment,28967.35769
17580,716768808,04-12-24 11:28,400.55,Purchase,Restaurant,28566.80769
17581,716768808,04-12-24 21:28,5700,Payment,Installment Payment,22866.80769
17582,716768808,4-15-24 12:28,819.81,Purchase,Electronics,22046.99769
17583,716768808,4-18-24 22:28,578.7,OutgoingTransfer,Peer-to-Peer Transfer,21468.29769
17584,716768808,4-24-24 11:28,451.5,Return,Best Buy Return,21919.79769
17585,716768808,4-25-24 15:28,740.57,Return,Walmart Return,22660.36769
17586,716768808,4-25-24 20:28,937.28,Return,eBay Return,23597.64769
17587,716768808,4-28-24 19:28,503.46,Purchase,Entertainment,23094.18769
17588,716768808,4-28-24 22:28,300.26,Payment,Mortgage Payment,22793.92769
17589,716768808,05-05-24 21:28,16250,IncomingTransfer,Salary,39043.92769
17590,716768808,05-07-24 22:28,230.19,Purchase,Gas,38813.73769
17591,716768808,05-09-24 10:28,697.72,OnlineShopping,Best Buy,38116.01769
17592,716768808,05-10-24 21:28,2000,Payment,Credit Card Payment,36116.01769
17593,716768808,05-12-24 21:28,226.08,Purchase,Grocery,35889.93769
17594,716768808,5-13-24 17:28,883.01,Payment,Bill Payment,35006.92769
17595,716768808,5-13-24 21:28,4800,Payment,Subscription Payment,30206.92769
17596,716768808,5-14-24 14:28,282.18,Deposit,Check Deposit,30489.10769
17597,716768808,5-18-24 19:28,599.18,OnlineShopping,eBay,29889.92769
17598,716768808,5-25-24 11:28,825.51,Withdrawal,Mobile App Withdrawal,29064.41769
17599,716768808,5-31-24 17:28,561.41,Purchase,Pharmacy,28503.00769
17600,716768808,06-02-24 22:28,455.16,Purchase,Clothing,28047.84769
17601,716768808,06-03-24 21:28,225.05,Purchase,Gas,27822.79769
17602,716768808,06-04-24 21:28,16250,IncomingTransfer,Salary,44072.79769
17603,716768808,06-09-24 21:28,2400,Payment,Credit Card Payment,41672.79769
17604,716768808,06-11-24 21:28,7100,Payment,Subscription Payment,34572.79769
17605,716768808,6-19-24 13:28,217.73,OutgoingTransfer,Peer-to-Peer Transfer,34355.06769
17606,716768808,6-20-24 19:28,508.98,Purchase,Pharmacy,33846.08769
17607,716768808,6-24-24 16:28,702.52,Deposit,Mobile Deposit,34548.60769
17608,716768808,6-25-24 16:28,683.01,Withdrawal,Branch Withdrawal,33865.59769
17609,716768808,6-27-24 16:28,273.72,Deposit,Direct Deposit,34139.31769
17610,716768808,07-05-24 21:28,16250,IncomingTransfer,Salary,50389.31769
17611,716768808,07-07-24 11:28,420.92,Return,AliExpress Return,50810.23769
17612,716768808,07-10-24 21:28,2400,Payment,Credit Card Payment,48410.23769
17613,716768808,07-12-24 14:28,760.63,Return,Etsy Return,49170.86769
17614,716768808,7-14-24 21:28,6700,Payment,Installment Payment,42470.86769
17615,716768808,7-14-24 22:28,821.94,OutgoingTransfer,Peer-to-Peer Transfer,41648.92769
17616,716782758,1-28-24 16:28,299.78,Purchase,Furniture,-299.78
17617,716782758,1-29-24 15:28,321.51,OnlineShopping,AliExpress,-621.29
17618,716782758,1-29-24 22:28,109.12,Purchase,Home Improvement,-730.41
17619,716782758,02-05-24 21:28,5300,IncomingTransfer,Salary,4569.59
17620,716782758,02-07-24 15:28,125.35,Withdrawal,Mobile App Withdrawal,4444.24
17621,716782758,02-10-24 16:28,419.18,IncomingTransfer,Freelance Payment,4863.42
17622,716782758,2-16-24 21:28,2900,Payment,Rent Payment,1963.42
17623,716782758,2-27-24 11:28,286.69,Purchase,Entertainment,1676.73
17624,716782758,03-01-24 15:28,318.5,Deposit,Mobile Deposit,1995.23
17625,716782758,03-04-24 15:28,325.39,OnlineShopping,Best Buy,1669.84
17626,716782758,03-04-24 21:28,325.05,Payment,Bill Payment,1344.79
17627,716782758,03-05-24 21:28,5300,IncomingTransfer,Salary,6644.79
17628,716782758,03-07-24 23:28,407.19,Withdrawal,Branch Withdrawal,6237.6
17629,716782758,3-14-24 21:28,1700,Payment,Rent Payment,4537.6
17630,716782758,3-14-24 21:28,135.07,Return,Store Return,4672.67
17631,716782758,3-16-24 19:28,518.98,Payment,Mortgage Payment,4153.69
17632,716782758,3-26-24 16:28,118.29,Payment,Loan Payment,4035.4
17633,716782758,04-01-24 21:28,5300,IncomingTransfer,Salary,9335.4
17634,716782758,04-05-24 18:28,195.93,OnlineShopping,eBay,9139.47
17635,716782758,4-13-24 22:28,202.48,Payment,Bill Payment,8936.99
17636,716782758,4-18-24 21:28,3000,Payment,Rent Payment,5936.99
17637,716782758,4-30-24 17:28,427.41,OutgoingTransfer,Peer-to-Peer Transfer,5509.58
17638,716782758,05-01-24 20:28,418.04,OnlineShopping,Amazon,5091.54
17639,716782758,05-03-24 19:28,496.47,OnlineShopping,Target,4595.07
17640,716782758,05-04-24 21:28,5300,IncomingTransfer,Salary,9895.07
17641,716782758,05-05-24 15:28,342.66,Return,Best Buy Return,10237.73
17642,716782758,05-09-24 11:28,125.82,OnlineShopping,Best Buy,10111.91
17643,716782758,5-15-24 21:28,1900,Payment,Rent Payment,8211.91
17644,716782758,5-19-24 14:28,283.46,Purchase,Pharmacy,7928.45
17645,716782758,5-21-24 17:28,449.28,Deposit,Cash Deposit,8377.73
17646,716782758,5-21-24 19:28,456.98,Purchase,Travel,7920.75
17647,716782758,5-26-24 16:28,367.3,Purchase,Clothing,7553.45
17648,716782758,5-28-24 21:28,228.91,Purchase,Pharmacy,7324.54
17649,716782758,06-02-24 21:28,298.66,OnlineShopping,AliExpress,7025.88
17650,716782758,06-05-24 21:28,5300,IncomingTransfer,Salary,12325.88
17651,716782758,06-09-24 20:28,152.98,Purchase,Electronics,12172.9
17652,716782758,6-14-24 21:28,3000,Payment,Rent Payment,9172.9
17653,716782758,6-15-24 13:28,312.38,Purchase,Gas,8860.52
17654,716782758,6-15-24 14:28,175.51,Purchase,Gas,8685.01
17655,716782758,6-25-24 23:28,513.76,Withdrawal,Mobile App Withdrawal,8171.25
17656,716782758,07-02-24 13:28,200.84,Return,Walmart Return,8372.09
17657,716782758,07-03-24 21:28,5300,IncomingTransfer,Salary,13672.09
17658,716782758,07-07-24 22:28,77.01,OutgoingTransfer,Peer-to-Peer Transfer,13595.08
17659,716782758,07-11-24 21:28,1900,Payment,Rent Payment,11695.08
17660,716790633,1-25-24 10:28,372,OnlineShopping,Best Buy,-372
17661,716790633,02-02-24 15:28,300.64,OutgoingTransfer,Bank Transfer,-672.64
17662,716790633,02-03-24 21:28,5300,IncomingTransfer,Salary,4627.36
17663,716790633,02-08-24 14:28,514.96,Purchase,Home Improvement,4112.4
17664,716790633,02-10-24 18:28,476.58,Deposit,Direct Deposit,4588.98
17665,716790633,02-11-24 14:28,110.97,Payment,Bill Payment,4478.01
17666,716790633,02-12-24 19:28,121.64,Deposit,Cash Deposit,4599.65
17667,716790633,2-16-24 21:28,2100,Payment,Rent Payment,2499.65
17668,716790633,2-21-24 19:28,478.4,OnlineShopping,Best Buy,2021.25
17669,716790633,2-23-24 19:28,112.5,Return,Best Buy Return,2133.75
17670,716790633,2-24-24 20:28,85.73,Purchase,Home Improvement,2048.02
17671,716790633,2-25-24 22:28,244.13,Return,Best Buy Return,2292.15
17672,716790633,2-27-24 20:28,511.43,Withdrawal,Branch Withdrawal,1780.72
17673,716790633,2-29-24 20:28,521.56,OnlineShopping,Target,1259.16
17674,716790633,03-03-24 21:28,5300,IncomingTransfer,Salary,6559.16
17675,716790633,3-13-24 21:28,3100,Payment,Rent Payment,3459.16
17676,716790633,3-16-24 19:28,154.1,IncomingTransfer,Freelance Payment,3613.26
17677,716790633,3-18-24 17:28,329.63,IncomingTransfer,Freelance Payment,3942.89
17678,716790633,3-26-24 13:28,72.36,Purchase,Grocery,3870.53
17679,716790633,3-31-24 10:28,482.06,OnlineShopping,eBay,3388.47
17680,716790633,04-01-24 21:28,5300,IncomingTransfer,Salary,8688.47
17681,716790633,04-02-24 14:28,523.97,Return,AliExpress Return,9212.44
17682,716790633,04-05-24 22:28,494.07,Payment,Loan Payment,8718.37
17683,716790633,04-10-24 11:28,548.36,Withdrawal,ATM Withdrawal,8170.01
17684,716790633,04-11-24 23:28,168.5,Purchase,Restaurant,8001.51
17685,716790633,4-17-24 21:28,1600,Payment,Rent Payment,6401.51
17686,716790633,4-28-24 22:28,158.88,Purchase,Grocery,6242.63
17687,716790633,05-05-24 21:28,5300,IncomingTransfer,Salary,11542.63
17688,716790633,05-10-24 12:28,199.57,OutgoingTransfer,International Transfer,11343.06
17689,716790633,05-11-24 21:28,1400,Payment,Rent Payment,9943.06
17690,716790633,5-13-24 17:28,152.32,Deposit,Cash Deposit,10095.38
17691,716790633,5-15-24 10:28,516.7,OutgoingTransfer,Wire Transfer,9578.68
17692,716790633,5-19-24 11:28,212.27,IncomingTransfer,Freelance Payment,9790.95
17693,716790633,5-20-24 11:28,504.59,Purchase,Home Improvement,9286.36
17694,716790633,5-21-24 16:28,410.49,Payment,Bill Payment,8875.87
17695,716790633,5-22-24 16:28,329.43,IncomingTransfer,Freelance Payment,9205.3
17696,716790633,5-26-24 18:28,198.57,Purchase,Clothing,9006.73
17697,716790633,5-27-24 22:28,122.7,Deposit,Mobile Deposit,9129.43
17698,716790633,5-29-24 18:28,240.25,OutgoingTransfer,International Transfer,8889.18
17699,716790633,06-02-24 21:28,5300,IncomingTransfer,Salary,14189.18
17700,716790633,6-15-24 18:28,547.8,OutgoingTransfer,Wire Transfer,13641.38
17701,716790633,6-16-24 21:28,381.19,IncomingTransfer,Freelance Payment,14022.57
17702,716790633,6-17-24 21:28,3200,Payment,Rent Payment,10822.57
17703,716790633,6-17-24 22:28,311.75,Purchase,Restaurant,10510.82
17704,716790633,6-25-24 9:28,242.22,Deposit,Check Deposit,10753.04
17705,716790633,6-28-24 14:28,73.94,Withdrawal,Mobile App Withdrawal,10679.1
17706,716790633,6-28-24 22:28,528.08,OutgoingTransfer,Peer-to-Peer Transfer,10151.02
17707,716790633,07-04-24 21:28,5300,IncomingTransfer,Salary,15451.02
17708,716790633,07-12-24 15:28,520.46,Withdrawal,ATM Withdrawal,14930.56
17709,716790633,7-15-24 21:28,2500,Payment,Rent Payment,12430.56
17710,716815308,1-20-24 11:28,104.64,Payment,Mortgage Payment,889.5011997
17711,716815308,1-21-24 18:28,191.06,OnlineShopping,Amazon,698.4411997
17712,716815308,1-22-24 16:28,231.5,Withdrawal,Mobile App Withdrawal,466.9411997
17713,716815308,1-23-24 13:28,139.31,Deposit,Check Deposit,606.2511997
17714,716815308,1-23-24 20:28,249.13,Deposit,Direct Deposit,855.3811997
17715,716815308,1-23-24 23:28,210.52,OutgoingTransfer,International Transfer,644.8611997
17716,716815308,1-26-24 21:28,201.74,Deposit,Cash Deposit,846.6011997
17717,716815308,1-27-24 19:28,99.42,Deposit,Mobile Deposit,946.0211997
17718,716815308,1-27-24 21:28,212.21,Return,Etsy Return,1158.2312
17719,716815308,02-01-24 21:28,3000,IncomingTransfer,Salary,4158.2312
17720,716815308,02-06-24 9:28,31.74,Purchase,Gas,4126.4912
17721,716815308,02-06-24 21:28,1700,Payment,Credit Card Payment,2426.4912
17722,716815308,02-12-24 14:28,156.2,IncomingTransfer,Freelance Payment,2582.6912
17723,716815308,2-13-24 12:28,50.14,IncomingTransfer,Freelance Payment,2632.8312
17724,716815308,2-18-24 21:28,1100,Payment,Installment Payment,1532.8312
17725,716815308,2-20-24 13:28,215.24,OnlineShopping,Walmart,1317.5912
17726,716815308,2-25-24 17:28,58.7,Deposit,Mobile Deposit,1376.2912
17727,716815308,2-27-24 21:28,219.06,OnlineShopping,Best Buy,1157.2312
17728,716815308,03-02-24 21:28,3000,IncomingTransfer,Salary,4157.2312
17729,716815308,03-07-24 21:28,2200,Payment,Credit Card Payment,1957.2312
17730,716815308,03-07-24 21:28,32.39,Purchase,Electronics,1924.8412
17731,716815308,03-11-24 15:28,71.56,OnlineShopping,Etsy,1853.2812
17732,716815308,03-11-24 16:28,179.36,Withdrawal,Mobile App Withdrawal,1673.9212
17733,716815308,03-12-24 12:28,11.41,OutgoingTransfer,Bank Transfer,1662.5112
17734,716815308,3-14-24 23:28,31.65,IncomingTransfer,Freelance Payment,1694.1612
17735,716815308,3-15-24 21:28,1200,Payment,Subscription Payment,494.1611997
17736,716815308,3-17-24 10:28,128.06,Deposit,Direct Deposit,622.2211997
17737,716815308,3-17-24 21:28,187.72,Deposit,Mobile Deposit,809.9411997
17738,716815308,3-19-24 17:28,61.4,Purchase,Furniture,748.5411997
17739,716815308,3-20-24 14:28,38.56,Payment,Mortgage Payment,709.9811997
17740,716815308,3-21-24 17:28,102.05,Purchase,Pharmacy,607.9311997
17741,716815308,3-22-24 10:28,56.15,Purchase,Clothing,551.7811997
17742,716815308,3-23-24 20:28,241.16,OnlineShopping,AliExpress,310.6211997
17743,716815308,3-23-24 22:28,51.16,Deposit,Mobile Deposit,361.7811997
17744,716815308,3-27-24 17:28,175.22,Deposit,Direct Deposit,537.0011997
17745,716815308,3-27-24 18:28,236.23,Deposit,Direct Deposit,773.2311997
17746,716815308,3-28-24 9:28,147.99,Deposit,Check Deposit,921.2211997
17747,716815308,3-29-24 22:28,225.37,Purchase,Grocery,695.8511997
17748,716815308,04-01-24 9:28,36.28,Purchase,Grocery,659.5711997
17749,716815308,04-03-24 20:28,54.03,Purchase,Entertainment,605.5411997
17750,716815308,04-03-24 21:28,3000,IncomingTransfer,Salary,3605.5412
17751,716815308,04-08-24 21:28,2200,Payment,Credit Card Payment,1405.5412
17752,716815308,04-10-24 14:28,244.24,Withdrawal,Mobile App Withdrawal,1161.3012
17753,716815308,04-11-24 9:28,80.77,Deposit,Mobile Deposit,1242.0712
17754,716815308,4-15-24 21:28,900,Payment,Subscription Payment,342.0711997
17755,716815308,4-16-24 10:28,209.86,OnlineShopping,Amazon,132.2111997
17756,716815308,4-17-24 11:28,100.58,Purchase,Pharmacy,31.63119972
17757,716815308,4-19-24 15:28,75.93,Deposit,Direct Deposit,107.5611997
17758,716815308,4-23-24 17:28,136.09,OnlineShopping,Best Buy,-28.52880028
17759,716815308,4-28-24 18:28,93.47,Purchase,Gas,-121.9988003
17760,716815308,05-02-24 15:28,44.35,OnlineShopping,Target,-166.3488003
17761,716815308,05-04-24 13:28,10.91,Withdrawal,ATM Withdrawal,-177.2588003
17762,716815308,05-04-24 21:28,3000,IncomingTransfer,Salary,2822.7412
17763,716815308,05-05-24 22:28,42.21,Withdrawal,ATM Withdrawal,2780.5312
17764,716815308,05-09-24 21:28,1700,Payment,Credit Card Payment,1080.5312
17765,716815308,05-12-24 21:28,1200,Payment,Insurance Payment,-119.4688003
17766,716815308,5-13-24 13:28,246.3,Deposit,Cash Deposit,126.8311997
17767,716815308,5-18-24 13:28,115.86,Purchase,Clothing,10.97119972
17768,716815308,5-24-24 9:28,165.05,Withdrawal,ATM Withdrawal,-154.0788003
17769,716815308,5-27-24 16:28,147.15,Purchase,Entertainment,-301.2288003
17770,716815308,5-27-24 23:28,30.61,Purchase,Pharmacy,-331.8388003
17771,716815308,5-31-24 17:28,59.59,Return,Etsy Return,-272.2488003
17772,716815308,06-01-24 11:28,102.89,Payment,Mortgage Payment,-375.1388003
17773,716815308,06-02-24 21:28,142.76,Purchase,Electronics,-517.8988003
17774,716815308,06-03-24 21:28,3000,IncomingTransfer,Salary,2482.1012
17775,716815308,06-05-24 10:28,185.07,IncomingTransfer,Freelance Payment,2667.1712
17776,716815308,06-08-24 21:28,1800,Payment,Credit Card Payment,867.1711997
17777,716815308,06-08-24 22:28,106.87,Withdrawal,Branch Withdrawal,760.3011997
17778,716815308,06-09-24 14:28,130.4,IncomingTransfer,Freelance Payment,890.7011997
17779,716815308,06-09-24 16:28,136.42,Withdrawal,Branch Withdrawal,754.2811997
17780,716815308,6-15-24 21:28,1200,Payment,Installment Payment,-445.7188003
17781,716815308,6-16-24 15:28,167.74,Purchase,Restaurant,-613.4588003
17782,716815308,6-22-24 19:28,246.04,Purchase,Home Improvement,-859.4988003
17783,716815308,6-22-24 20:28,194.45,Deposit,Direct Deposit,-665.0488003
17784,716815308,6-24-24 19:28,60.25,Purchase,Travel,-725.2988003
17785,716815308,6-25-24 11:28,86.41,Withdrawal,ATM Withdrawal,-811.7088003
17786,716815308,6-28-24 16:28,15.19,Deposit,Mobile Deposit,-796.5188003
17787,716815308,07-01-24 17:28,158.04,OnlineShopping,eBay,-954.5588003
17788,716815308,07-04-24 21:28,3000,IncomingTransfer,Salary,2045.4412
17789,716815308,07-05-24 11:28,116.94,Payment,Bill Payment,1928.5012
17790,716815308,07-08-24 18:28,152.73,OutgoingTransfer,Peer-to-Peer Transfer,1775.7712
17791,716815308,07-09-24 21:28,1700,Payment,Credit Card Payment,75.77119972
17792,716815308,07-09-24 21:28,200.4,OutgoingTransfer,Bank Transfer,-124.6288003
17793,716815308,07-10-24 14:28,80.44,Deposit,Direct Deposit,-44.18880028
17794,716815308,07-12-24 21:28,1200,Payment,Insurance Payment,-1244.1888
17795,716815308,7-13-24 22:28,161.75,Withdrawal,Branch Withdrawal,-1405.9388
17796,716815308,7-15-24 20:28,165.13,Deposit,Check Deposit,-1240.8088
17797,716966808,1-27-24 19:28,698.69,Withdrawal,Branch Withdrawal,269.3571936
17798,716966808,1-29-24 16:28,463.78,OutgoingTransfer,Bank Transfer,-194.4228064
17799,716966808,1-30-24 16:28,189.52,OutgoingTransfer,Peer-to-Peer Transfer,-383.9428064
17800,716966808,02-05-24 19:28,343.54,Withdrawal,Branch Withdrawal,-727.4828064
17801,716966808,02-05-24 21:28,7750,IncomingTransfer,Salary,7022.517194
17802,716966808,02-10-24 10:28,588.21,Payment,Mortgage Payment,6434.307194
17803,716966808,02-10-24 21:28,1900,Payment,Credit Card Payment,4534.307194
17804,716966808,2-18-24 21:28,3500,Payment,Rent Payment,1034.307194
17805,716966808,2-19-24 18:28,390.4,Payment,Loan Payment,643.9071936
17806,716966808,2-20-24 9:28,153.81,OutgoingTransfer,Bank Transfer,490.0971936
17807,716966808,2-24-24 19:28,146.09,Payment,Bill Payment,344.0071936
17808,716966808,2-28-24 14:28,413.49,Purchase,Restaurant,-69.48280645
17809,716966808,03-04-24 21:28,7750,IncomingTransfer,Salary,7680.517194
17810,716966808,03-08-24 14:28,616.85,Deposit,Mobile Deposit,8297.367194
17811,716966808,03-09-24 21:28,1700,Payment,Credit Card Payment,6597.367194
17812,716966808,03-12-24 21:28,2100,Payment,Rent Payment,4497.367194
17813,716966808,3-24-24 10:28,378.5,Deposit,Check Deposit,4875.867194
17814,716966808,3-24-24 11:28,670.05,OutgoingTransfer,Wire Transfer,4205.817194
17815,716966808,3-29-24 18:28,364.14,OnlineShopping,eBay,3841.677194
17816,716966808,3-31-24 20:28,321.77,Withdrawal,Branch Withdrawal,3519.907194
17817,716966808,04-04-24 21:28,7750,IncomingTransfer,Salary,11269.90719
17818,716966808,04-09-24 21:28,2400,Payment,Credit Card Payment,8869.907194
17819,716966808,04-11-24 13:28,261.96,Deposit,Direct Deposit,9131.867194
17820,716966808,04-12-24 22:28,291.09,Payment,Loan Payment,8840.777194
17821,716966808,4-14-24 22:28,493.96,Purchase,Pharmacy,8346.817194
17822,716966808,4-16-24 12:28,681.01,Deposit,Check Deposit,9027.827194
17823,716966808,4-17-24 21:28,2000,Payment,Rent Payment,7027.827194
17824,716966808,4-23-24 22:28,586.7,Return,Amazon Return,7614.527194
17825,716966808,05-05-24 19:28,610.54,Withdrawal,Mobile App Withdrawal,7003.987194
17826,716966808,05-05-24 21:28,7750,IncomingTransfer,Salary,14753.98719
17827,716966808,05-10-24 21:28,1800,Payment,Credit Card Payment,12953.98719
17828,716966808,5-18-24 21:28,3400,Payment,Rent Payment,9553.987194
17829,716966808,5-22-24 10:28,189.91,Purchase,Travel,9364.077194
17830,716966808,06-04-24 12:28,213.29,Purchase,Home Improvement,9150.787194
17831,716966808,06-05-24 9:28,560.44,Purchase,Travel,8590.347194
17832,716966808,06-05-24 21:28,7750,IncomingTransfer,Salary,16340.34719
17833,716966808,06-05-24 22:28,489.63,OnlineShopping,Target,15850.71719
17834,716966808,06-10-24 21:28,2500,Payment,Credit Card Payment,13350.71719
17835,716966808,06-10-24 22:28,419.56,Purchase,Home Improvement,12931.15719
17836,716966808,6-15-24 21:28,5000,Payment,Rent Payment,7931.157194
17837,716966808,6-18-24 13:28,367.86,OnlineShopping,Etsy,7563.297194
17838,716966808,6-20-24 22:28,535.01,Deposit,Mobile Deposit,8098.307194
17839,716966808,6-24-24 11:28,263.51,OnlineShopping,AliExpress,7834.797194
17840,716966808,07-02-24 13:28,522.08,Deposit,Mobile Deposit,8356.877194
17841,716966808,07-04-24 21:28,7750,IncomingTransfer,Salary,16106.87719
17842,716966808,07-08-24 18:28,618.28,Purchase,Home Improvement,15488.59719
17843,716966808,07-08-24 20:28,686.22,OutgoingTransfer,Wire Transfer,14802.37719
17844,716966808,07-09-24 21:28,2000,Payment,Credit Card Payment,12802.37719
17845,716966808,07-11-24 13:28,740.85,OutgoingTransfer,International Transfer,12061.52719
17846,716966808,07-11-24 14:28,253.68,Deposit,Direct Deposit,12315.20719
17847,716966808,7-13-24 12:28,240.42,Purchase,Gas,12074.78719
17848,716966808,7-16-24 21:28,2700,Payment,Rent Payment,9374.787194
17849,716966808,7-17-24 9:28,467.62,Deposit,Direct Deposit,9842.407194
17850,717008358,1-22-24 19:28,53.8,Deposit,Check Deposit,53.8
17851,717008358,1-23-24 9:28,243.84,Purchase,Grocery,-190.04
17852,717008358,1-25-24 18:28,98.86,Purchase,Furniture,-288.9
17853,717008358,1-28-24 11:28,100.38,Purchase,Pharmacy,-389.28
17854,717008358,1-28-24 17:28,68.21,Deposit,Mobile Deposit,-321.07
17855,717008358,1-28-24 22:28,197.27,Withdrawal,Mobile App Withdrawal,-518.34
17856,717008358,1-30-24 20:28,216.46,Deposit,Direct Deposit,-301.88
17857,717008358,02-01-24 9:28,130.58,OnlineShopping,eBay,-432.46
17858,717008358,02-01-24 21:28,66.09,OnlineShopping,Target,-498.55
17859,717008358,02-02-24 20:28,95.27,Payment,Mortgage Payment,-593.82
17860,717008358,02-05-24 19:28,39.88,Withdrawal,ATM Withdrawal,-633.7
17861,717008358,02-05-24 21:28,2500,IncomingTransfer,Salary,1866.3
17862,717008358,02-09-24 22:28,54.38,IncomingTransfer,Freelance Payment,1920.68
17863,717008358,02-11-24 21:28,900,Payment,Rent Payment,1020.68
17864,717008358,02-12-24 9:28,46.66,IncomingTransfer,Freelance Payment,1067.34
17865,717008358,2-13-24 15:28,242.36,OnlineShopping,Target,824.98
17866,717008358,2-14-24 12:28,40.25,Purchase,Entertainment,784.73
17867,717008358,2-14-24 22:28,206.97,OutgoingTransfer,Peer-to-Peer Transfer,577.76
17868,717008358,2-19-24 17:28,102.48,Purchase,Gas,475.28
17869,717008358,2-21-24 11:28,121.35,Return,Amazon Return,596.63
17870,717008358,2-21-24 14:28,103.49,Return,eBay Return,700.12
17871,717008358,2-21-24 16:28,104.34,Withdrawal,Mobile App Withdrawal,595.78
17872,717008358,2-22-24 22:28,54.35,OnlineShopping,Etsy,541.43
17873,717008358,2-24-24 14:28,202.35,Return,eBay Return,743.78
17874,717008358,2-24-24 18:28,133.73,Withdrawal,Mobile App Withdrawal,610.05
17875,717008358,2-27-24 11:28,177.95,OnlineShopping,Best Buy,432.1
17876,717008358,2-28-24 22:28,230.7,IncomingTransfer,Freelance Payment,662.8
17877,717008358,2-29-24 13:28,170.04,Payment,Loan Payment,492.76
17878,717008358,2-29-24 21:28,233.39,Deposit,Cash Deposit,726.15
17879,717008358,03-02-24 12:28,40.1,OutgoingTransfer,International Transfer,686.05
17880,717008358,03-02-24 20:28,28.58,Deposit,Direct Deposit,714.63
17881,717008358,03-03-24 22:28,126.64,OnlineShopping,Etsy,587.99
17882,717008358,03-05-24 12:28,182.52,Purchase,Electronics,405.47
17883,717008358,03-05-24 21:28,2500,IncomingTransfer,Salary,2905.47
17884,717008358,03-06-24 21:28,112.73,OutgoingTransfer,Bank Transfer,2792.74
17885,717008358,03-11-24 15:28,23.36,OutgoingTransfer,Wire Transfer,2769.38
17886,717008358,3-14-24 14:28,112.13,Deposit,Check Deposit,2881.51
17887,717008358,3-18-24 12:28,10.06,Payment,Mortgage Payment,2871.45
17888,717008358,3-18-24 21:28,1400,Payment,Rent Payment,1471.45
17889,717008358,3-22-24 23:28,193.46,OutgoingTransfer,International Transfer,1277.99
17890,717008358,3-23-24 17:28,214.51,Deposit,Mobile Deposit,1492.5
17891,717008358,3-25-24 9:28,51.93,Withdrawal,Mobile App Withdrawal,1440.57
17892,717008358,3-26-24 16:28,92.26,Purchase,Travel,1348.31
17893,717008358,3-28-24 19:28,16.36,OnlineShopping,Amazon,1331.95
17894,717008358,04-02-24 11:28,117.71,Deposit,Direct Deposit,1449.66
17895,717008358,04-03-24 23:28,236.28,Purchase,Gas,1213.38
17896,717008358,04-05-24 21:28,2500,IncomingTransfer,Salary,3713.38
17897,717008358,04-06-24 20:28,45.51,Deposit,Cash Deposit,3758.89
17898,717008358,04-07-24 16:28,62.47,Purchase,Travel,3696.42
17899,717008358,4-13-24 20:28,110.73,Withdrawal,Mobile App Withdrawal,3585.69
17900,717008358,4-17-24 21:28,900,Payment,Rent Payment,2685.69
17901,717008358,4-18-24 12:28,85.58,Deposit,Mobile Deposit,2771.27
17902,717008358,4-21-24 20:28,62.67,Purchase,Gas,2708.6
17903,717008358,4-26-24 17:28,151.4,Return,Walmart Return,2860
17904,717008358,4-27-24 15:28,86.6,Purchase,Clothing,2773.4
17905,717008358,4-28-24 10:28,119.19,OutgoingTransfer,Bank Transfer,2654.21
17906,717008358,4-30-24 15:28,170.64,Return,Walmart Return,2824.85
17907,717008358,4-30-24 23:28,120.59,Withdrawal,Branch Withdrawal,2704.26
17908,717008358,05-02-24 11:28,225.18,Withdrawal,Mobile App Withdrawal,2479.08
17909,717008358,05-03-24 11:28,178.15,Payment,Bill Payment,2300.93
17910,717008358,05-05-24 20:28,235.63,Withdrawal,Mobile App Withdrawal,2065.3
17911,717008358,05-05-24 21:28,2500,IncomingTransfer,Salary,4565.3
17912,717008358,05-06-24 9:28,165.09,Purchase,Home Improvement,4400.21
17913,717008358,05-07-24 16:28,153.32,Purchase,Electronics,4246.89
17914,717008358,05-07-24 23:28,25.93,Return,AliExpress Return,4272.82
17915,717008358,05-08-24 13:28,34.97,Return,Target Return,4307.79
17916,717008358,05-08-24 18:28,169.98,IncomingTransfer,Freelance Payment,4477.77
17917,717008358,5-13-24 17:28,244.99,Deposit,Check Deposit,4722.76
17918,717008358,5-14-24 9:28,216.67,IncomingTransfer,Freelance Payment,4939.43
17919,717008358,5-15-24 21:28,1000,Payment,Rent Payment,3939.43
17920,717008358,5-16-24 10:28,118.41,Payment,Mortgage Payment,3821.02
17921,717008358,5-16-24 11:28,120.26,OnlineShopping,Amazon,3700.76
17922,717008358,5-16-24 18:28,152.9,OnlineShopping,Target,3547.86
17923,717008358,5-21-24 17:28,41.34,OutgoingTransfer,Peer-to-Peer Transfer,3506.52
17924,717008358,5-25-24 14:28,155.9,Purchase,Entertainment,3350.62
17925,717008358,5-26-24 12:28,210.02,Return,Walmart Return,3560.64
17926,717008358,5-26-24 18:28,52.91,OnlineShopping,Best Buy,3507.73
17927,717008358,06-02-24 14:28,160.73,Withdrawal,Mobile App Withdrawal,3347
17928,717008358,06-02-24 21:28,2500,IncomingTransfer,Salary,5847
17929,717008358,06-06-24 19:28,219.02,IncomingTransfer,Freelance Payment,6066.02
17930,717008358,06-07-24 17:28,99.87,OutgoingTransfer,Wire Transfer,5966.15
17931,717008358,06-08-24 12:28,177.14,Deposit,Check Deposit,6143.29
17932,717008358,06-08-24 13:28,104.82,Payment,Mortgage Payment,6038.47
17933,717008358,06-08-24 19:28,12.49,Withdrawal,Mobile App Withdrawal,6025.98
17934,717008358,06-09-24 10:28,92.9,Deposit,Cash Deposit,6118.88
17935,717008358,06-12-24 21:28,1200,Payment,Rent Payment,4918.88
17936,717008358,6-15-24 22:28,153.26,Purchase,Gas,4765.62
17937,717008358,6-16-24 21:28,239.09,Withdrawal,Mobile App Withdrawal,4526.53
17938,717008358,6-18-24 21:28,135.81,Return,Target Return,4662.34
17939,717008358,6-23-24 14:28,154.31,Withdrawal,ATM Withdrawal,4508.03
17940,717008358,6-25-24 11:28,178.89,Withdrawal,Branch Withdrawal,4329.14
17941,717008358,6-28-24 11:28,197.53,Purchase,Travel,4131.61
17942,717008358,07-01-24 21:28,2500,IncomingTransfer,Salary,6631.61
17943,717008358,07-04-24 20:28,125.3,OutgoingTransfer,Wire Transfer,6506.31
17944,717008358,07-10-24 12:28,244.46,OutgoingTransfer,International Transfer,6261.85
17945,717008358,7-14-24 13:28,56.64,IncomingTransfer,Freelance Payment,6318.49
17946,717008358,7-16-24 23:28,117.58,Deposit,Direct Deposit,6436.07
17947,717008358,7-17-24 9:28,230.32,Withdrawal,Mobile App Withdrawal,6205.75
17948,717008358,7-17-24 11:28,70.31,Deposit,Direct Deposit,6276.06
17949,717008358,7-18-24 21:28,1000,Payment,Rent Payment,5276.06
17950,717189183,1-20-24 10:28,349.51,OnlineShopping,Target,1248.775308
17951,717189183,1-24-24 10:28,134.52,Withdrawal,ATM Withdrawal,1114.255308
17952,717189183,1-29-24 22:28,274.93,Payment,Loan Payment,839.3253081
17953,717189183,1-30-24 11:28,345.78,Purchase,Furniture,493.5453081
17954,717189183,02-02-24 21:28,4800,IncomingTransfer,Salary,5293.545308
17955,717189183,02-03-24 13:28,265.59,Return,Walmart Return,5559.135308
17956,717189183,02-03-24 19:28,358.56,Purchase,Grocery,5200.575308
17957,717189183,02-07-24 21:28,2300,Payment,Credit Card Payment,2900.575308
17958,717189183,2-14-24 9:28,316.33,OutgoingTransfer,Bank Transfer,2584.245308
17959,717189183,2-14-24 21:28,2300,Payment,Rent Payment,284.2453081
17960,717189183,2-19-24 12:28,161.39,Purchase,Furniture,122.8553081
17961,717189183,2-23-24 20:28,195.05,OnlineShopping,Etsy,-72.19469193
17962,717189183,2-24-24 18:28,197.31,Withdrawal,Mobile App Withdrawal,-269.5046919
17963,717189183,2-25-24 14:28,369.64,Withdrawal,ATM Withdrawal,-639.1446919
17964,717189183,2-27-24 10:28,47.44,Purchase,Entertainment,-686.5846919
17965,717189183,03-02-24 13:28,131.14,Withdrawal,Mobile App Withdrawal,-817.7246919
17966,717189183,03-03-24 13:28,86.64,Withdrawal,ATM Withdrawal,-904.3646919
17967,717189183,03-04-24 10:28,70.23,Purchase,Travel,-974.5946919
17968,717189183,03-05-24 21:28,4800,IncomingTransfer,Salary,3825.405308
17969,717189183,03-07-24 10:28,124.42,Purchase,Furniture,3700.985308
17970,717189183,03-09-24 10:28,304.65,Deposit,Direct Deposit,4005.635308
17971,717189183,03-09-24 13:28,319.33,OnlineShopping,Amazon,3686.305308
17972,717189183,03-09-24 15:28,327.3,Return,eBay Return,4013.605308
17973,717189183,03-10-24 21:28,2900,Payment,Credit Card Payment,1113.605308
17974,717189183,03-10-24 21:28,2600,Payment,Rent Payment,-1486.394692
17975,717189183,03-11-24 10:28,52.27,OnlineShopping,Walmart,-1538.664692
17976,717189183,3-17-24 17:28,282.42,Purchase,Travel,-1821.084692
17977,717189183,3-23-24 14:28,36.66,Purchase,Travel,-1857.744692
17978,717189183,3-29-24 11:28,88.83,OnlineShopping,Etsy,-1946.574692
17979,717189183,3-29-24 17:28,353.67,Deposit,Check Deposit,-1592.904692
17980,717189183,3-31-24 13:28,389.56,Deposit,Check Deposit,-1203.344692
17981,717189183,3-31-24 15:28,230.98,OnlineShopping,Best Buy,-1434.324692
17982,717189183,3-31-24 15:28,133.52,Return,Walmart Return,-1300.804692
17983,717189183,04-02-24 21:28,4800,IncomingTransfer,Salary,3499.195308
17984,717189183,04-04-24 21:28,118.01,Withdrawal,ATM Withdrawal,3381.185308
17985,717189183,04-07-24 18:28,352.35,Purchase,Grocery,3028.835308
17986,717189183,04-07-24 21:28,2500,Payment,Credit Card Payment,528.8353081
17987,717189183,04-10-24 9:28,83.37,Deposit,Cash Deposit,612.2053081
17988,717189183,04-11-24 21:28,2000,Payment,Rent Payment,-1387.794692
17989,717189183,04-12-24 20:28,296.52,Deposit,Mobile Deposit,-1091.274692
17990,717189183,4-13-24 17:28,377.21,OutgoingTransfer,International Transfer,-1468.484692
17991,717189183,4-16-24 13:28,382.74,Withdrawal,ATM Withdrawal,-1851.224692
17992,717189183,4-18-24 22:28,106.85,Purchase,Restaurant,-1958.074692
17993,717189183,4-30-24 10:28,349.1,Deposit,Direct Deposit,-1608.974692
17994,717189183,05-04-24 21:28,4800,IncomingTransfer,Salary,3191.025308
17995,717189183,05-05-24 13:28,316.12,Withdrawal,Branch Withdrawal,2874.905308
17996,717189183,05-05-24 16:28,165.7,Deposit,Direct Deposit,3040.605308
17997,717189183,05-05-24 20:28,261.98,Deposit,Check Deposit,3302.585308
17998,717189183,05-09-24 21:28,2200,Payment,Credit Card Payment,1102.585308
17999,717189183,05-12-24 17:28,300.25,Withdrawal,Mobile App Withdrawal,802.3353081
18000,717189183,5-13-24 20:28,228.2,Purchase,Travel,574.1353081
18001,717189183,5-15-24 11:28,106.43,IncomingTransfer,Freelance Payment,680.5653081
18002,717189183,5-15-24 21:28,1400,Payment,Rent Payment,-719.4346919
18003,717189183,5-15-24 21:28,347.53,IncomingTransfer,Freelance Payment,-371.9046919
18004,717189183,5-16-24 12:28,325.6,Return,eBay Return,-46.30469193
18005,717189183,5-20-24 23:28,63.92,Payment,Bill Payment,-110.2246919
18006,717189183,5-21-24 10:28,230.21,Deposit,Direct Deposit,119.9853081
18007,717189183,5-22-24 21:28,351.3,Withdrawal,Branch Withdrawal,-231.3146919
18008,717189183,5-24-24 21:28,32.58,Purchase,Entertainment,-263.8946919
18009,717189183,5-25-24 15:28,221.36,OnlineShopping,Etsy,-485.2546919
18010,717189183,5-31-24 10:28,321.46,Payment,Bill Payment,-806.7146919
18011,717189183,06-01-24 22:28,379.81,OutgoingTransfer,International Transfer,-1186.524692
18012,717189183,06-02-24 12:28,155.73,Deposit,Direct Deposit,-1030.794692
18013,717189183,06-04-24 21:28,4800,IncomingTransfer,Salary,3769.205308
18014,717189183,06-09-24 21:28,2500,Payment,Credit Card Payment,1269.205308
18015,717189183,06-11-24 21:28,2000,Payment,Rent Payment,-730.7946919
18016,717189183,6-14-24 14:28,136.9,Purchase,Furniture,-867.6946919
18017,717189183,6-19-24 16:28,190.42,Return,Store Return,-677.2746919
18018,717189183,6-20-24 16:28,364.84,Deposit,Cash Deposit,-312.4346919
18019,717189183,6-25-24 14:28,381.53,Return,eBay Return,69.09530807
18020,717189183,6-27-24 11:28,99.14,Withdrawal,ATM Withdrawal,-30.04469193
18021,717189183,6-29-24 20:28,76.65,OnlineShopping,Target,-106.6946919
18022,717189183,07-02-24 16:28,387.42,Withdrawal,Mobile App Withdrawal,-494.1146919
18023,717189183,07-02-24 21:28,398.71,Return,Store Return,-95.40469193
18024,717189183,07-03-24 13:28,380.76,Deposit,Direct Deposit,285.3553081
18025,717189183,07-04-24 21:28,4800,IncomingTransfer,Salary,5085.355308
18026,717189183,07-09-24 11:28,321.99,Payment,Bill Payment,4763.365308
18027,717189183,07-09-24 21:28,2800,Payment,Credit Card Payment,1963.365308
18028,717189183,07-09-24 23:28,120.37,Payment,Mortgage Payment,1842.995308
18029,717189183,7-13-24 21:28,2300,Payment,Rent Payment,-457.0046919
18030,717189183,7-15-24 11:28,99.83,Purchase,Home Improvement,-556.8346919
18031,717189183,7-15-24 17:28,159.82,Withdrawal,Mobile App Withdrawal,-716.6546919
18032,717189183,7-16-24 23:28,356.06,Withdrawal,ATM Withdrawal,-1072.714692
18033,717219933,1-20-24 20:28,150.57,Purchase,Restaurant,348.5080116
18034,717219933,1-23-24 10:28,60.05,Purchase,Home Improvement,288.4580116
18035,717219933,1-27-24 14:28,191.78,Return,Store Return,480.2380116
18036,717219933,1-28-24 15:28,195.82,Deposit,Cash Deposit,676.0580116
18037,717219933,02-02-24 21:28,2450,IncomingTransfer,Salary,3126.058012
18038,717219933,02-04-24 11:28,215.78,Withdrawal,Mobile App Withdrawal,2910.278012
18039,717219933,02-07-24 21:28,900,Payment,Credit Card Payment,2010.278012
18040,717219933,02-09-24 16:28,59,Purchase,Furniture,1951.278012
18041,717219933,02-09-24 16:28,187.45,Return,Etsy Return,2138.728012
18042,717219933,02-11-24 13:28,118.73,Withdrawal,ATM Withdrawal,2019.998012
18043,717219933,02-12-24 18:28,59.95,Return,Target Return,2079.948012
18044,717219933,02-12-24 21:28,1500,Payment,Rent Payment,579.9480116
18045,717219933,2-14-24 19:28,245.06,OutgoingTransfer,Wire Transfer,334.8880116
18046,717219933,2-16-24 23:28,198.99,OutgoingTransfer,Bank Transfer,135.8980116
18047,717219933,2-18-24 10:28,11.83,Payment,Bill Payment,124.0680116
18048,717219933,2-21-24 14:28,118.76,OutgoingTransfer,Wire Transfer,5.308011641
18049,717219933,2-23-24 10:28,131.9,Withdrawal,Branch Withdrawal,-126.5919884
18050,717219933,2-25-24 12:28,91.6,Purchase,Travel,-218.1919884
18051,717219933,2-26-24 16:28,122.2,Deposit,Check Deposit,-95.99198836
18052,717219933,03-02-24 10:28,229.74,OnlineShopping,AliExpress,-325.7319884
18053,717219933,03-02-24 21:28,2450,IncomingTransfer,Salary,2124.268012
18054,717219933,03-07-24 21:28,800,Payment,Credit Card Payment,1324.268012
18055,717219933,03-12-24 21:28,143.89,Payment,Loan Payment,1180.378012
18056,717219933,3-17-24 11:28,19.77,Payment,Mortgage Payment,1160.608012
18057,717219933,3-18-24 12:28,140.01,Deposit,Cash Deposit,1300.618012
18058,717219933,3-18-24 21:28,600,Payment,Rent Payment,700.6180116
18059,717219933,3-19-24 10:28,10.95,Purchase,Entertainment,689.6680116
18060,717219933,3-30-24 17:28,125.28,Purchase,Gas,564.3880116
18061,717219933,04-01-24 21:28,2450,IncomingTransfer,Salary,3014.388012
18062,717219933,04-02-24 21:28,190.08,Return,Amazon Return,3204.468012
18063,717219933,04-06-24 21:28,900,Payment,Credit Card Payment,2304.468012
18064,717219933,04-11-24 23:28,168.44,Withdrawal,ATM Withdrawal,2136.028012
18065,717219933,4-14-24 12:28,36.46,Return,Store Return,2172.488012
18066,717219933,4-17-24 21:28,600,Payment,Rent Payment,1572.488012
18067,717219933,4-18-24 21:28,113.21,Payment,Loan Payment,1459.278012
18068,717219933,4-20-24 13:28,75.11,Deposit,Cash Deposit,1534.388012
18069,717219933,4-28-24 15:28,110.93,Deposit,Direct Deposit,1645.318012
18070,717219933,05-02-24 21:28,2450,IncomingTransfer,Salary,4095.318012
18071,717219933,05-03-24 16:28,71.18,Payment,Bill Payment,4024.138012
18072,717219933,05-06-24 14:28,163.28,Purchase,Restaurant,3860.858012
18073,717219933,05-07-24 13:28,206.62,Deposit,Cash Deposit,4067.478012
18074,717219933,05-07-24 21:28,600,Payment,Credit Card Payment,3467.478012
18075,717219933,05-11-24 18:28,235.04,Purchase,Gas,3232.438012
18076,717219933,5-13-24 13:28,132.35,Deposit,Check Deposit,3364.788012
18077,717219933,5-13-24 21:28,1400,Payment,Rent Payment,1964.788012
18078,717219933,5-21-24 18:28,141.26,Withdrawal,Mobile App Withdrawal,1823.528012
18079,717219933,5-23-24 18:28,56.58,IncomingTransfer,Freelance Payment,1880.108012
18080,717219933,5-27-24 13:28,232.72,Purchase,Restaurant,1647.388012
18081,717219933,06-02-24 16:28,144.07,Deposit,Cash Deposit,1791.458012
18082,717219933,06-02-24 21:28,2450,IncomingTransfer,Salary,4241.458012
18083,717219933,06-05-24 11:28,236.4,OutgoingTransfer,Bank Transfer,4005.058012
18084,717219933,06-07-24 12:28,144.38,Return,Best Buy Return,4149.438012
18085,717219933,06-07-24 21:28,900,Payment,Credit Card Payment,3249.438012
18086,717219933,6-15-24 21:28,800,Payment,Rent Payment,2449.438012
18087,717219933,6-25-24 16:28,92.76,OnlineShopping,eBay,2356.678012
18088,717219933,6-29-24 22:28,54.85,Deposit,Cash Deposit,2411.528012
18089,717219933,07-02-24 17:28,108.07,Deposit,Direct Deposit,2519.598012
18090,717219933,07-04-24 21:28,2450,IncomingTransfer,Salary,4969.598012
18091,717219933,07-06-24 19:28,245.2,Purchase,Pharmacy,4724.398012
18092,717219933,07-07-24 14:28,91.52,Withdrawal,ATM Withdrawal,4632.878012
18093,717219933,07-09-24 21:28,800,Payment,Credit Card Payment,3832.878012
18094,717219933,07-11-24 21:28,1600,Payment,Rent Payment,2232.878012
18095,717219933,07-12-24 12:28,230.24,Withdrawal,ATM Withdrawal,2002.638012
18096,717219933,7-16-24 22:28,57.58,Withdrawal,Branch Withdrawal,1945.058012
18097,717219933,7-17-24 13:28,118.36,Withdrawal,ATM Withdrawal,1826.698012
18098,717219933,7-17-24 18:28,213.4,Purchase,Home Improvement,1613.298012
18099,717247383,1-24-24 20:28,322.57,Deposit,Cash Deposit,322.57
18100,717247383,1-26-24 21:28,268.09,IncomingTransfer,Freelance Payment,590.66
18101,717247383,02-03-24 20:28,379.44,IncomingTransfer,Freelance Payment,970.1
18102,717247383,02-03-24 21:28,4500,IncomingTransfer,Salary,5470.1
18103,717247383,02-04-24 10:28,311.28,OutgoingTransfer,Wire Transfer,5158.82
18104,717247383,02-07-24 15:28,282.23,Withdrawal,Branch Withdrawal,4876.59
18105,717247383,02-10-24 17:28,69.73,Withdrawal,ATM Withdrawal,4806.86
18106,717247383,2-13-24 23:28,228.03,OutgoingTransfer,Wire Transfer,4578.83
18107,717247383,2-14-24 19:28,218.49,Deposit,Mobile Deposit,4797.32
18108,717247383,2-15-24 21:28,1400,Payment,Subscription Payment,3397.32
18109,717247383,2-19-24 13:28,286.57,Deposit,Direct Deposit,3683.89
18110,717247383,2-19-24 22:28,152.19,OutgoingTransfer,Wire Transfer,3531.7
18111,717247383,2-21-24 14:28,256.53,OutgoingTransfer,Peer-to-Peer Transfer,3275.17
18112,717247383,2-22-24 13:28,237.04,OutgoingTransfer,Bank Transfer,3038.13
18113,717247383,2-28-24 22:28,391.86,IncomingTransfer,Freelance Payment,3429.99
18114,717247383,2-29-24 22:28,181.69,Withdrawal,Mobile App Withdrawal,3248.3
18115,717247383,03-03-24 14:28,285.43,Withdrawal,Branch Withdrawal,2962.87
18116,717247383,03-05-24 18:28,225.29,Purchase,Electronics,2737.58
18117,717247383,03-05-24 21:28,4500,IncomingTransfer,Salary,7237.58
18118,717247383,03-05-24 23:28,232.42,Return,AliExpress Return,7470
18119,717247383,03-11-24 13:28,92.78,OnlineShopping,Amazon,7377.22
18120,717247383,03-11-24 15:28,378.32,OutgoingTransfer,Peer-to-Peer Transfer,6998.9
18121,717247383,03-11-24 23:28,268.44,Withdrawal,Mobile App Withdrawal,6730.46
18122,717247383,03-12-24 17:28,347.57,IncomingTransfer,Freelance Payment,7078.03
18123,717247383,3-13-24 21:28,193.95,Purchase,Travel,6884.08
18124,717247383,3-16-24 15:28,368.18,Return,eBay Return,7252.26
18125,717247383,3-16-24 15:28,52.01,Withdrawal,ATM Withdrawal,7200.25
18126,717247383,3-17-24 21:28,1600,Payment,Subscription Payment,5600.25
18127,717247383,3-18-24 14:28,105.78,Deposit,Mobile Deposit,5706.03
18128,717247383,3-19-24 10:28,239.67,Payment,Mortgage Payment,5466.36
18129,717247383,3-21-24 16:28,184.77,Purchase,Entertainment,5281.59
18130,717247383,3-22-24 10:28,42.72,Purchase,Gas,5238.87
18131,717247383,3-24-24 20:28,110.6,Purchase,Gas,5128.27
18132,717247383,3-31-24 17:28,216.81,OutgoingTransfer,International Transfer,4911.46
18133,717247383,04-03-24 9:28,284.95,Return,Amazon Return,5196.41
18134,717247383,04-03-24 21:28,4500,IncomingTransfer,Salary,9696.41
18135,717247383,04-06-24 16:28,297.71,Purchase,Pharmacy,9398.7
18136,717247383,04-09-24 9:28,282.36,Purchase,Gas,9116.34
18137,717247383,04-11-24 18:28,93.16,Purchase,Electronics,9023.18
18138,717247383,04-12-24 21:28,1800,Payment,Installment Payment,7223.18
18139,717247383,4-25-24 18:28,362.14,Return,Walmart Return,7585.32
18140,717247383,4-29-24 23:28,279.56,Purchase,Grocery,7305.76
18141,717247383,05-02-24 9:28,74.92,Return,Best Buy Return,7380.68
18142,717247383,05-03-24 13:28,158.8,Return,Amazon Return,7539.48
18143,717247383,05-03-24 21:28,4500,IncomingTransfer,Salary,12039.48
18144,717247383,05-03-24 22:28,124.12,IncomingTransfer,Freelance Payment,12163.6
18145,717247383,05-04-24 11:28,312.14,Withdrawal,Mobile App Withdrawal,11851.46
18146,717247383,05-04-24 14:28,87.32,Purchase,Electronics,11764.14
18147,717247383,05-07-24 12:28,280.06,Deposit,Direct Deposit,12044.2
18148,717247383,05-07-24 15:28,365.59,IncomingTransfer,Freelance Payment,12409.79
18149,717247383,05-11-24 21:28,1600,Payment,Insurance Payment,10809.79
18150,717247383,5-16-24 16:28,322.23,Deposit,Cash Deposit,11132.02
18151,717247383,5-16-24 17:28,352.04,Return,Walmart Return,11484.06
18152,717247383,5-24-24 9:28,307.22,OnlineShopping,Amazon,11176.84
18153,717247383,5-27-24 10:28,378.45,OutgoingTransfer,International Transfer,10798.39
18154,717247383,5-28-24 10:28,159.19,Deposit,Direct Deposit,10957.58
18155,717247383,5-29-24 19:28,249.03,Withdrawal,Branch Withdrawal,10708.55
18156,717247383,06-02-24 12:28,365.3,OnlineShopping,eBay,10343.25
18157,717247383,06-02-24 21:28,4500,IncomingTransfer,Salary,14843.25
18158,717247383,06-04-24 11:28,127.61,Withdrawal,Branch Withdrawal,14715.64
18159,717247383,06-06-24 19:28,21.14,Purchase,Clothing,14694.5
18160,717247383,06-12-24 21:28,1900,Payment,Insurance Payment,12794.5
18161,717247383,6-13-24 9:28,301.2,Purchase,Restaurant,12493.3
18162,717247383,6-13-24 18:28,327.22,OnlineShopping,Amazon,12166.08
18163,717247383,6-16-24 20:28,145.89,Deposit,Direct Deposit,12311.97
18164,717247383,6-21-24 17:28,112.92,IncomingTransfer,Freelance Payment,12424.89
18165,717247383,6-22-24 18:28,71.96,Purchase,Home Improvement,12352.93
18166,717247383,6-24-24 17:28,235.54,Payment,Loan Payment,12117.39
18167,717247383,6-24-24 20:28,385.78,Purchase,Gas,11731.61
18168,717247383,6-25-24 15:28,134.96,Purchase,Home Improvement,11596.65
18169,717247383,07-01-24 16:28,282.19,Deposit,Check Deposit,11878.84
18170,717247383,07-01-24 21:28,4500,IncomingTransfer,Salary,16378.84
18171,717247383,07-03-24 22:28,213.71,Deposit,Direct Deposit,16592.55
18172,717247383,07-07-24 10:28,355.36,Purchase,Home Improvement,16237.19
18173,717247383,07-07-24 12:28,61.56,Payment,Mortgage Payment,16175.63
18174,717247383,07-09-24 18:28,238.19,Payment,Mortgage Payment,15937.44
18175,717247383,07-10-24 21:28,1700,Payment,Insurance Payment,14237.44
18176,717247383,07-11-24 19:28,305.28,OutgoingTransfer,Bank Transfer,13932.16
18177,717247383,07-11-24 20:28,138.21,Purchase,Gas,13793.95
18178,717247383,07-12-24 16:28,331.08,Deposit,Check Deposit,14125.03
18179,717247383,7-13-24 14:28,27.1,Purchase,Restaurant,14097.93
18180,717260058,1-31-24 11:28,21.19,Withdrawal,ATM Withdrawal,944.2886824
18181,717260058,02-01-24 21:28,2750,IncomingTransfer,Salary,3694.288682
18182,717260058,02-06-24 21:28,1400,Payment,Credit Card Payment,2294.288682
18183,717260058,02-07-24 10:28,48.65,Payment,Bill Payment,2245.638682
18184,717260058,02-09-24 14:28,217.68,Deposit,Check Deposit,2463.318682
18185,717260058,02-12-24 21:28,1100,Payment,Rent Payment,1363.318682
18186,717260058,03-04-24 21:28,2750,IncomingTransfer,Salary,4113.318682
18187,717260058,03-09-24 21:28,1900,Payment,Credit Card Payment,2213.318682
18188,717260058,03-12-24 23:28,187.12,IncomingTransfer,Freelance Payment,2400.438682
18189,717260058,3-13-24 21:28,900,Payment,Rent Payment,1500.438682
18190,717260058,3-14-24 14:28,39.43,IncomingTransfer,Freelance Payment,1539.868682
18191,717260058,3-24-24 20:28,201.83,Return,AliExpress Return,1741.698682
18192,717260058,3-25-24 23:28,36.14,Deposit,Cash Deposit,1777.838682
18193,717260058,3-26-24 14:28,155.82,Return,Amazon Return,1933.658682
18194,717260058,3-29-24 17:28,113.32,OutgoingTransfer,Peer-to-Peer Transfer,1820.338682
18195,717260058,3-31-24 17:28,230.27,Deposit,Direct Deposit,2050.608682
18196,717260058,04-01-24 21:28,2750,IncomingTransfer,Salary,4800.608682
18197,717260058,04-02-24 14:28,180.44,Return,Etsy Return,4981.048682
18198,717260058,04-03-24 9:28,171.13,Return,Best Buy Return,5152.178682
18199,717260058,04-06-24 21:28,1400,Payment,Credit Card Payment,3752.178682
18200,717260058,04-09-24 20:28,198.45,Deposit,Direct Deposit,3950.628682
18201,717260058,4-14-24 21:28,1200,Payment,Rent Payment,2750.628682
18202,717260058,4-18-24 9:28,138.18,Deposit,Direct Deposit,2888.808682
18203,717260058,4-20-24 18:28,104.14,Deposit,Mobile Deposit,2992.948682
18204,717260058,4-28-24 14:28,224.88,OnlineShopping,Amazon,2768.068682
18205,717260058,05-02-24 14:28,241.22,Withdrawal,ATM Withdrawal,2526.848682
18206,717260058,05-03-24 13:28,74.64,OnlineShopping,Etsy,2452.208682
18207,717260058,05-05-24 21:28,2750,IncomingTransfer,Salary,5202.208682
18208,717260058,05-10-24 21:28,1400,Payment,Credit Card Payment,3802.208682
18209,717260058,05-11-24 14:28,75.26,IncomingTransfer,Freelance Payment,3877.468682
18210,717260058,05-11-24 21:28,1400,Payment,Rent Payment,2477.468682
18211,717260058,5-16-24 11:28,142.65,Purchase,Entertainment,2334.818682
18212,717260058,5-19-24 11:28,96.5,OnlineShopping,Best Buy,2238.318682
18213,717260058,5-28-24 12:28,52.6,Purchase,Clothing,2185.718682
18214,717260058,06-01-24 21:28,2750,IncomingTransfer,Salary,4935.718682
18215,717260058,06-06-24 21:28,1700,Payment,Credit Card Payment,3235.718682
18216,717260058,06-10-24 16:28,33.36,OutgoingTransfer,International Transfer,3202.358682
18217,717260058,6-14-24 21:28,900,Payment,Rent Payment,2302.358682
18218,717260058,6-27-24 15:28,247.94,OutgoingTransfer,Bank Transfer,2054.418682
18219,717260058,6-28-24 19:28,168.4,Deposit,Cash Deposit,2222.818682
18220,717260058,07-02-24 21:28,2750,IncomingTransfer,Salary,4972.818682
18221,717260058,07-07-24 10:28,156.34,Return,AliExpress Return,5129.158682
18222,717260058,07-07-24 21:28,1900,Payment,Credit Card Payment,3229.158682
18223,717260058,7-15-24 21:28,1000,Payment,Rent Payment,2229.158682
18224,717260058,7-16-24 17:28,168.19,Withdrawal,Mobile App Withdrawal,2060.968682
18225,717308433,1-29-24 19:28,335.88,Withdrawal,Mobile App Withdrawal,-335.88
18226,717308433,1-30-24 23:28,343.45,Payment,Bill Payment,-679.33
18227,717308433,02-01-24 21:28,90.2,IncomingTransfer,Freelance Payment,-589.13
18228,717308433,02-02-24 11:28,190.73,Deposit,Cash Deposit,-398.4
18229,717308433,02-04-24 18:28,358.8,Payment,Mortgage Payment,-757.2
18230,717308433,02-04-24 18:28,184.69,Purchase,Electronics,-941.89
18231,717308433,02-04-24 21:28,6000,IncomingTransfer,Salary,5058.11
18232,717308433,02-10-24 21:28,2400,Payment,Installment Payment,2658.11
18233,717308433,02-11-24 21:28,313.73,Deposit,Mobile Deposit,2971.84
18234,717308433,02-12-24 16:28,457.78,Purchase,Electronics,2514.06
18235,717308433,2-19-24 12:28,487.16,OutgoingTransfer,Peer-to-Peer Transfer,2026.9
18236,717308433,2-19-24 23:28,167.71,Deposit,Mobile Deposit,2194.61
18237,717308433,2-20-24 11:28,370.1,Withdrawal,ATM Withdrawal,1824.51
18238,717308433,2-23-24 14:28,57.61,OutgoingTransfer,Bank Transfer,1766.9
18239,717308433,03-02-24 21:28,6000,IncomingTransfer,Salary,7766.9
18240,717308433,03-12-24 21:28,1800,Payment,Subscription Payment,5966.9
18241,717308433,3-13-24 9:28,448.33,OnlineShopping,Walmart,5518.57
18242,717308433,3-13-24 15:28,173.88,Purchase,Entertainment,5344.69
18243,717308433,3-23-24 20:28,178.82,Payment,Mortgage Payment,5165.87
18244,717308433,3-23-24 22:28,339.5,Deposit,Direct Deposit,5505.37
18245,717308433,3-24-24 12:28,124.76,Deposit,Mobile Deposit,5630.13
18246,717308433,3-29-24 11:28,510.39,Deposit,Mobile Deposit,6140.52
18247,717308433,04-01-24 22:28,86.72,Return,Amazon Return,6227.24
18248,717308433,04-02-24 21:28,6000,IncomingTransfer,Salary,12227.24
18249,717308433,04-02-24 21:28,120.97,Return,Etsy Return,12348.21
18250,717308433,04-07-24 17:28,57.9,Return,Amazon Return,12406.11
18251,717308433,04-08-24 11:28,352.26,Return,Target Return,12758.37
18252,717308433,04-10-24 16:28,494.02,OutgoingTransfer,Bank Transfer,12264.35
18253,717308433,4-15-24 18:28,200.93,Deposit,Direct Deposit,12465.28
18254,717308433,4-15-24 22:28,512.32,Deposit,Direct Deposit,12977.6
18255,717308433,4-17-24 21:28,2000,Payment,Subscription Payment,10977.6
18256,717308433,4-25-24 16:28,502.46,Return,Etsy Return,11480.06
18257,717308433,4-25-24 20:28,239.71,Payment,Mortgage Payment,11240.35
18258,717308433,05-04-24 21:28,6000,IncomingTransfer,Salary,17240.35
18259,717308433,05-06-24 12:28,347.85,IncomingTransfer,Freelance Payment,17588.2
18260,717308433,05-06-24 17:28,101.32,OnlineShopping,Walmart,17486.88
18261,717308433,05-08-24 10:28,254.66,OutgoingTransfer,Bank Transfer,17232.22
18262,717308433,05-11-24 21:28,2500,Payment,Subscription Payment,14732.22
18263,717308433,5-13-24 17:28,496.73,Payment,Loan Payment,14235.49
18264,717308433,5-14-24 21:28,302.93,Deposit,Direct Deposit,14538.42
18265,717308433,5-14-24 22:28,205.66,OutgoingTransfer,Peer-to-Peer Transfer,14332.76
18266,717308433,5-19-24 18:28,534.78,Withdrawal,ATM Withdrawal,13797.98
18267,717308433,06-01-24 11:28,212.62,OutgoingTransfer,Bank Transfer,13585.36
18268,717308433,06-05-24 21:28,6000,IncomingTransfer,Salary,19585.36
18269,717308433,06-08-24 14:28,499.19,Deposit,Direct Deposit,20084.55
18270,717308433,06-10-24 21:28,2200,Payment,Insurance Payment,17884.55
18271,717308433,6-25-24 14:28,502.37,Payment,Bill Payment,17382.18
18272,717308433,6-30-24 16:28,203.6,OutgoingTransfer,International Transfer,17178.58
18273,717308433,07-02-24 21:28,6000,IncomingTransfer,Salary,23178.58
18274,717308433,07-07-24 17:28,327.12,Purchase,Electronics,22851.46
18275,717308433,7-16-24 21:28,1800,Payment,Insurance Payment,21051.46
18276,717395733,1-28-24 21:28,200.2,Deposit,Direct Deposit,796.3074132
18277,717395733,1-31-24 18:28,387.4,Withdrawal,Mobile App Withdrawal,408.9074132
18278,717395733,02-02-24 13:28,250.46,Deposit,Check Deposit,659.3674132
18279,717395733,02-03-24 21:28,4200,IncomingTransfer,Salary,4859.367413
18280,717395733,02-05-24 18:28,239.6,Return,Store Return,5098.967413
18281,717395733,02-07-24 14:28,301.94,OutgoingTransfer,International Transfer,4797.027413
18282,717395733,02-08-24 11:28,306.29,Return,AliExpress Return,5103.317413
18283,717395733,02-08-24 20:28,372.65,Purchase,Grocery,4730.667413
18284,717395733,02-08-24 21:28,1000,Payment,Credit Card Payment,3730.667413
18285,717395733,02-10-24 21:28,1100,Payment,Rent Payment,2630.667413
18286,717395733,02-11-24 10:28,176.15,IncomingTransfer,Freelance Payment,2806.817413
18287,717395733,02-12-24 17:28,235.65,OutgoingTransfer,Peer-to-Peer Transfer,2571.167413
18288,717395733,2-14-24 13:28,170.45,OnlineShopping,Etsy,2400.717413
18289,717395733,2-14-24 16:28,80.42,Purchase,Pharmacy,2320.297413
18290,717395733,2-14-24 23:28,269.2,IncomingTransfer,Freelance Payment,2589.497413
18291,717395733,2-15-24 16:28,304.04,OnlineShopping,Walmart,2285.457413
18292,717395733,2-16-24 22:28,209.26,Return,Etsy Return,2494.717413
18293,717395733,2-25-24 14:28,335.12,Deposit,Check Deposit,2829.837413
18294,717395733,2-29-24 11:28,354.62,Purchase,Entertainment,2475.217413
18295,717395733,2-29-24 19:28,242.67,Purchase,Gas,2232.547413
18296,717395733,03-03-24 10:28,370.79,IncomingTransfer,Freelance Payment,2603.337413
18297,717395733,03-04-24 21:28,4200,IncomingTransfer,Salary,6803.337413
18298,717395733,03-05-24 22:28,238.22,Deposit,Mobile Deposit,7041.557413
18299,717395733,03-08-24 11:28,399.52,Purchase,Grocery,6642.037413
18300,717395733,03-08-24 14:28,357.48,OutgoingTransfer,International Transfer,6284.557413
18301,717395733,03-09-24 21:28,900,Payment,Credit Card Payment,5384.557413
18302,717395733,03-12-24 21:28,1700,Payment,Rent Payment,3684.557413
18303,717395733,3-18-24 20:28,232.13,Deposit,Mobile Deposit,3916.687413
18304,717395733,3-22-24 10:28,49.21,Purchase,Travel,3867.477413
18305,717395733,3-23-24 18:28,224.6,Return,Etsy Return,4092.077413
18306,717395733,3-25-24 17:28,296.54,Withdrawal,Mobile App Withdrawal,3795.537413
18307,717395733,3-25-24 23:28,361.38,Deposit,Direct Deposit,4156.917413
18308,717395733,3-26-24 17:28,220.56,Deposit,Mobile Deposit,4377.477413
18309,717395733,3-26-24 21:28,349.99,Purchase,Restaurant,4027.487413
18310,717395733,3-26-24 21:28,94.13,Purchase,Electronics,3933.357413
18311,717395733,04-01-24 10:28,43.67,Payment,Bill Payment,3889.687413
18312,717395733,04-01-24 12:28,367.78,OnlineShopping,AliExpress,3521.907413
18313,717395733,04-03-24 16:28,47.25,Return,eBay Return,3569.157413
18314,717395733,04-04-24 14:28,249.74,Return,Amazon Return,3818.897413
18315,717395733,04-05-24 14:28,101.87,Purchase,Clothing,3717.027413
18316,717395733,04-05-24 21:28,4200,IncomingTransfer,Salary,7917.027413
18317,717395733,04-07-24 12:28,175.94,Purchase,Pharmacy,7741.087413
18318,717395733,04-09-24 16:28,81.9,Deposit,Cash Deposit,7822.987413
18319,717395733,04-09-24 21:28,394.98,Deposit,Check Deposit,8217.967413
18320,717395733,04-10-24 18:28,55.5,Purchase,Restaurant,8162.467413
18321,717395733,04-10-24 21:28,900,Payment,Credit Card Payment,7262.467413
18322,717395733,04-12-24 10:28,230.61,Purchase,Restaurant,7031.857413
18323,717395733,4-17-24 19:28,306.86,Purchase,Entertainment,6724.997413
18324,717395733,4-18-24 21:28,2400,Payment,Rent Payment,4324.997413
18325,717395733,4-18-24 21:28,333.47,OnlineShopping,Target,3991.527413
18326,717395733,4-20-24 19:28,254.48,IncomingTransfer,Freelance Payment,4246.007413
18327,717395733,4-20-24 20:28,201.7,Withdrawal,Mobile App Withdrawal,4044.307413
18328,717395733,4-28-24 19:28,171.34,Deposit,Check Deposit,4215.647413
18329,717395733,4-30-24 12:28,356.39,Withdrawal,Mobile App Withdrawal,3859.257413
18330,717395733,05-01-24 20:28,75.8,Payment,Loan Payment,3783.457413
18331,717395733,05-04-24 21:28,4200,IncomingTransfer,Salary,7983.457413
18332,717395733,05-08-24 9:28,297.89,Deposit,Check Deposit,8281.347413
18333,717395733,05-09-24 10:28,335.26,Deposit,Check Deposit,8616.607413
18334,717395733,05-09-24 20:28,325.36,OutgoingTransfer,Peer-to-Peer Transfer,8291.247413
18335,717395733,05-09-24 21:28,700,Payment,Credit Card Payment,7591.247413
18336,717395733,05-10-24 11:28,238.04,Withdrawal,Mobile App Withdrawal,7353.207413
18337,717395733,5-14-24 14:28,67.1,OnlineShopping,Walmart,7286.107413
18338,717395733,5-15-24 11:28,378.21,OutgoingTransfer,Peer-to-Peer Transfer,6907.897413
18339,717395733,5-15-24 17:28,214.24,Return,AliExpress Return,7122.137413
18340,717395733,5-17-24 21:28,1600,Payment,Rent Payment,5522.137413
18341,717395733,5-20-24 11:28,208.46,Deposit,Cash Deposit,5730.597413
18342,717395733,5-20-24 20:28,222.96,Return,eBay Return,5953.557413
18343,717395733,5-21-24 19:28,337.48,Return,Target Return,6291.037413
18344,717395733,06-01-24 10:28,364.83,Deposit,Direct Deposit,6655.867413
18345,717395733,06-01-24 16:28,52.07,Payment,Bill Payment,6603.797413
18346,717395733,06-02-24 10:28,169.92,Deposit,Check Deposit,6773.717413
18347,717395733,06-05-24 21:28,4200,IncomingTransfer,Salary,10973.71741
18348,717395733,06-08-24 22:28,385.11,OnlineShopping,Walmart,10588.60741
18349,717395733,06-09-24 15:28,92,Deposit,Direct Deposit,10680.60741
18350,717395733,06-10-24 21:28,800,Payment,Credit Card Payment,9880.607413
18351,717395733,06-11-24 17:28,348,Purchase,Travel,9532.607413
18352,717395733,6-14-24 17:28,335.67,Payment,Mortgage Payment,9196.937413
18353,717395733,6-14-24 23:28,215.03,OnlineShopping,AliExpress,8981.907413
18354,717395733,6-17-24 21:28,2600,Payment,Rent Payment,6381.907413
18355,717395733,6-17-24 23:28,274.05,OnlineShopping,Best Buy,6107.857413
18356,717395733,6-19-24 10:28,97.34,Deposit,Cash Deposit,6205.197413
18357,717395733,6-19-24 15:28,240.69,Return,eBay Return,6445.887413
18358,717395733,6-20-24 14:28,160.22,OutgoingTransfer,International Transfer,6285.667413
18359,717395733,6-21-24 9:28,162.04,OutgoingTransfer,Peer-to-Peer Transfer,6123.627413
18360,717395733,6-23-24 15:28,282.69,Purchase,Pharmacy,5840.937413
18361,717395733,6-24-24 12:28,196.66,OnlineShopping,Target,5644.277413
18362,717395733,6-26-24 17:28,60.57,Return,eBay Return,5704.847413
18363,717395733,6-26-24 19:28,215.31,OutgoingTransfer,International Transfer,5489.537413
18364,717395733,6-30-24 22:28,43.58,Withdrawal,Branch Withdrawal,5445.957413
18365,717395733,07-01-24 16:28,349.54,Payment,Mortgage Payment,5096.417413
18366,717395733,07-01-24 17:28,268.83,Deposit,Direct Deposit,5365.247413
18367,717395733,07-02-24 11:28,52.56,Return,Target Return,5417.807413
18368,717395733,07-05-24 21:28,4200,IncomingTransfer,Salary,9617.807413
18369,717395733,07-09-24 9:28,287.46,Purchase,Pharmacy,9330.347413
18370,717395733,07-10-24 21:28,900,Payment,Credit Card Payment,8430.347413
18371,717395733,7-16-24 11:28,334.9,Withdrawal,ATM Withdrawal,8095.447413
18372,717395733,7-16-24 20:28,307.07,Purchase,Entertainment,7788.377413
18373,717395733,7-16-24 21:28,1300,Payment,Rent Payment,6488.377413
18374,717395733,7-17-24 11:28,292.57,Deposit,Direct Deposit,6780.947413
18375,717444558,1-21-24 19:28,236.41,Purchase,Clothing,1225.752097
18376,717444558,1-23-24 22:28,106.98,OutgoingTransfer,International Transfer,1118.772097
18377,717444558,1-26-24 20:28,44.62,Purchase,Clothing,1074.152097
18378,717444558,1-27-24 16:28,117.15,Withdrawal,Branch Withdrawal,957.0020972
18379,717444558,1-29-24 9:28,161.01,Payment,Mortgage Payment,795.9920972
18380,717444558,1-31-24 12:28,212.21,Withdrawal,Branch Withdrawal,583.7820972
18381,717444558,1-31-24 20:28,239.93,Purchase,Grocery,343.8520972
18382,717444558,02-02-24 13:28,142.98,Purchase,Gas,200.8720972
18383,717444558,02-02-24 14:28,156.83,OnlineShopping,Amazon,44.04209719
18384,717444558,02-02-24 15:28,145.45,Payment,Bill Payment,-101.4079028
18385,717444558,02-03-24 13:28,23.13,Purchase,Travel,-124.5379028
18386,717444558,02-03-24 21:28,3250,IncomingTransfer,Salary,3125.462097
18387,717444558,02-04-24 22:28,168.56,Deposit,Check Deposit,3294.022097
18388,717444558,02-06-24 22:28,113.85,Purchase,Grocery,3180.172097
18389,717444558,02-07-24 14:28,36.65,Withdrawal,ATM Withdrawal,3143.522097
18390,717444558,02-08-24 13:28,110.43,OnlineShopping,Target,3033.092097
18391,717444558,02-08-24 21:28,2400,Payment,Credit Card Payment,633.0920972
18392,717444558,02-10-24 15:28,42.74,Purchase,Pharmacy,590.3520972
18393,717444558,02-12-24 18:28,210.88,Deposit,Cash Deposit,801.2320972
18394,717444558,2-14-24 9:28,142.79,OutgoingTransfer,Wire Transfer,658.4420972
18395,717444558,2-14-24 21:28,1700,Payment,Rent Payment,-1041.557903
18396,717444558,2-17-24 14:28,65.73,OutgoingTransfer,Bank Transfer,-1107.287903
18397,717444558,2-20-24 15:28,59.81,Deposit,Cash Deposit,-1047.477903
18398,717444558,2-21-24 10:28,233.54,Purchase,Home Improvement,-1281.017903
18399,717444558,2-21-24 19:28,154.63,Payment,Bill Payment,-1435.647903
18400,717444558,2-29-24 23:28,219.15,OnlineShopping,Target,-1654.797903
18401,717444558,03-01-24 21:28,3250,IncomingTransfer,Salary,1595.202097
18402,717444558,03-03-24 13:28,217.32,Purchase,Home Improvement,1377.882097
18403,717444558,03-04-24 11:28,19.99,Purchase,Furniture,1357.892097
18404,717444558,03-05-24 21:28,36.53,Withdrawal,Mobile App Withdrawal,1321.362097
18405,717444558,03-06-24 21:28,2300,Payment,Credit Card Payment,-978.6379028
18406,717444558,03-11-24 21:28,1500,Payment,Rent Payment,-2478.637903
18407,717444558,3-16-24 16:28,80.25,Withdrawal,ATM Withdrawal,-2558.887903
18408,717444558,3-16-24 19:28,225.84,Withdrawal,Branch Withdrawal,-2784.727903
18409,717444558,3-18-24 9:28,14.03,Purchase,Entertainment,-2798.757903
18410,717444558,3-18-24 12:28,27.1,Payment,Loan Payment,-2825.857903
18411,717444558,3-18-24 23:28,10.15,OutgoingTransfer,Peer-to-Peer Transfer,-2836.007903
18412,717444558,3-22-24 22:28,13.15,OutgoingTransfer,Bank Transfer,-2849.157903
18413,717444558,3-26-24 9:28,112.92,Deposit,Cash Deposit,-2736.237903
18414,717444558,3-29-24 9:28,83.34,Purchase,Restaurant,-2819.577903
18415,717444558,3-31-24 13:28,67.68,Deposit,Direct Deposit,-2751.897903
18416,717444558,04-01-24 21:28,3250,IncomingTransfer,Salary,498.1020972
18417,717444558,04-02-24 18:28,90.54,Payment,Mortgage Payment,407.5620972
18418,717444558,04-05-24 17:28,39.45,OnlineShopping,Target,368.1120972
18419,717444558,04-06-24 13:28,60.11,Withdrawal,Branch Withdrawal,308.0020972
18420,717444558,04-06-24 21:28,2300,Payment,Credit Card Payment,-1991.997903
18421,717444558,04-06-24 21:28,211.75,OutgoingTransfer,International Transfer,-2203.747903
18422,717444558,04-10-24 21:28,1700,Payment,Rent Payment,-3903.747903
18423,717444558,04-12-24 14:28,216.92,Purchase,Gas,-4120.667903
18424,717444558,4-14-24 16:28,246.86,Payment,Mortgage Payment,-4367.527903
18425,717444558,4-15-24 23:28,232.52,Return,Target Return,-4135.007903
18426,717444558,4-19-24 15:28,167.83,Purchase,Furniture,-4302.837903
18427,717444558,4-24-24 23:28,48.66,OnlineShopping,Best Buy,-4351.497903
18428,717444558,4-26-24 12:28,35.53,Deposit,Cash Deposit,-4315.967903
18429,717444558,4-27-24 10:28,56.51,Withdrawal,Branch Withdrawal,-4372.477903
18430,717444558,05-01-24 19:28,185.65,Withdrawal,Mobile App Withdrawal,-4558.127903
18431,717444558,05-05-24 21:28,3250,IncomingTransfer,Salary,-1308.127903
18432,717444558,05-10-24 20:28,18.17,Withdrawal,Mobile App Withdrawal,-1326.297903
18433,717444558,05-10-24 21:28,2200,Payment,Credit Card Payment,-3526.297903
18434,717444558,05-12-24 18:28,20.56,Purchase,Home Improvement,-3546.857903
18435,717444558,05-12-24 20:28,170.4,OutgoingTransfer,Wire Transfer,-3717.257903
18436,717444558,05-12-24 20:28,145.71,Purchase,Grocery,-3862.967903
18437,717444558,05-12-24 21:28,75.97,Purchase,Travel,-3938.937903
18438,717444558,5-14-24 9:28,60.07,Withdrawal,ATM Withdrawal,-3999.007903
18439,717444558,5-14-24 19:28,89.93,Purchase,Entertainment,-4088.937903
18440,717444558,5-17-24 21:28,1400,Payment,Rent Payment,-5488.937903
18441,717444558,5-23-24 17:28,21.84,OnlineShopping,Best Buy,-5510.777903
18442,717444558,5-24-24 10:28,125.81,Purchase,Electronics,-5636.587903
18443,717444558,5-29-24 21:28,97.81,Withdrawal,ATM Withdrawal,-5734.397903
18444,717444558,5-31-24 14:28,221.41,IncomingTransfer,Freelance Payment,-5512.987903
18445,717444558,06-01-24 14:28,39.1,Return,Target Return,-5473.887903
18446,717444558,06-03-24 19:28,86.81,Payment,Mortgage Payment,-5560.697903
18447,717444558,06-05-24 21:28,3250,IncomingTransfer,Salary,-2310.697903
18448,717444558,06-08-24 16:28,48.34,Deposit,Direct Deposit,-2262.357903
18449,717444558,06-10-24 21:28,2200,Payment,Credit Card Payment,-4462.357903
18450,717444558,06-10-24 21:28,1900,Payment,Rent Payment,-6362.357903
18451,717444558,06-11-24 18:28,87.95,Purchase,Furniture,-6450.307903
18452,717444558,6-15-24 17:28,126.3,Return,Target Return,-6324.007903
18453,717444558,6-16-24 11:28,224.87,Purchase,Restaurant,-6548.877903
18454,717444558,6-21-24 11:28,185.31,Payment,Loan Payment,-6734.187903
18455,717444558,6-23-24 19:28,218.09,Purchase,Grocery,-6952.277903
18456,717444558,6-27-24 17:28,157.72,Payment,Loan Payment,-7109.997903
18457,717444558,6-27-24 22:28,10.16,Purchase,Pharmacy,-7120.157903
18458,717444558,6-28-24 19:28,218.76,Return,Etsy Return,-6901.397903
18459,717444558,07-02-24 21:28,3250,IncomingTransfer,Salary,-3651.397903
18460,717444558,07-06-24 12:28,136.69,OnlineShopping,AliExpress,-3788.087903
18461,717444558,07-07-24 21:28,2400,Payment,Credit Card Payment,-6188.087903
18462,717444558,07-08-24 9:28,141.15,Payment,Loan Payment,-6329.237903
18463,717444558,07-10-24 20:28,245.13,IncomingTransfer,Freelance Payment,-6084.107903
18464,717444558,07-12-24 17:28,207.86,OutgoingTransfer,Peer-to-Peer Transfer,-6291.967903
18465,717444558,07-12-24 21:28,900,Payment,Rent Payment,-7191.967903
18466,717444558,07-12-24 22:28,156.29,OutgoingTransfer,Bank Transfer,-7348.257903
18467,717444558,7-13-24 13:28,214.72,Return,Walmart Return,-7133.537903
18468,717444558,7-16-24 11:28,147.47,IncomingTransfer,Freelance Payment,-6986.067903
18469,717535083,1-22-24 19:28,194.06,Return,Store Return,1057.759618
18470,717535083,1-22-24 21:28,166.68,Deposit,Check Deposit,1224.439618
18471,717535083,1-23-24 14:28,136.66,OutgoingTransfer,International Transfer,1087.779618
18472,717535083,1-24-24 13:28,141.15,Payment,Bill Payment,946.6296184
18473,717535083,1-31-24 20:28,68.57,Purchase,Clothing,878.0596184
18474,717535083,02-01-24 15:28,55.19,IncomingTransfer,Freelance Payment,933.2496184
18475,717535083,02-01-24 15:28,49.41,OnlineShopping,Best Buy,883.8396184
18476,717535083,02-03-24 19:28,241.96,OutgoingTransfer,International Transfer,641.8796184
18477,717535083,02-04-24 21:28,2650,IncomingTransfer,Salary,3291.879618
18478,717535083,02-05-24 22:28,68.47,Payment,Loan Payment,3223.409618
18479,717535083,02-05-24 23:28,35.93,IncomingTransfer,Freelance Payment,3259.339618
18480,717535083,02-08-24 14:28,70.61,OnlineShopping,eBay,3188.729618
18481,717535083,02-09-24 20:28,66.07,OnlineShopping,AliExpress,3122.659618
18482,717535083,02-09-24 21:28,1300,Payment,Credit Card Payment,1822.659618
18483,717535083,2-13-24 23:28,179.85,OutgoingTransfer,International Transfer,1642.809618
18484,717535083,2-15-24 21:28,800,Payment,Rent Payment,842.8096184
18485,717535083,2-17-24 21:28,151.04,Withdrawal,Branch Withdrawal,691.7696184
18486,717535083,2-19-24 22:28,61.31,Withdrawal,ATM Withdrawal,630.4596184
18487,717535083,2-22-24 20:28,25.23,Deposit,Direct Deposit,655.6896184
18488,717535083,2-23-24 14:28,239.4,Payment,Bill Payment,416.2896184
18489,717535083,2-24-24 12:28,195.97,OnlineShopping,Target,220.3196184
18490,717535083,2-26-24 12:28,162.89,Purchase,Electronics,57.42961838
18491,717535083,2-26-24 13:28,53.39,OutgoingTransfer,Wire Transfer,4.03961838
18492,717535083,2-28-24 11:28,211.45,Purchase,Entertainment,-207.4103816
18493,717535083,2-28-24 23:28,121.15,IncomingTransfer,Freelance Payment,-86.26038162
18494,717535083,03-01-24 21:28,2650,IncomingTransfer,Salary,2563.739618
18495,717535083,03-06-24 21:28,1200,Payment,Credit Card Payment,1363.739618
18496,717535083,03-08-24 16:28,91.22,Payment,Loan Payment,1272.519618
18497,717535083,03-11-24 13:28,243.47,Payment,Mortgage Payment,1029.049618
18498,717535083,3-13-24 12:28,188.62,Payment,Loan Payment,840.4296184
18499,717535083,3-16-24 19:28,32.5,Deposit,Mobile Deposit,872.9296184
18500,717535083,3-17-24 21:28,1000,Payment,Rent Payment,-127.0703816
18501,717535083,3-18-24 16:28,21.13,Deposit,Mobile Deposit,-105.9403816
18502,717535083,3-18-24 18:28,141.3,Payment,Loan Payment,-247.2403816
18503,717535083,3-18-24 21:28,242.77,Withdrawal,Branch Withdrawal,-490.0103816
18504,717535083,3-24-24 10:28,56.32,Withdrawal,ATM Withdrawal,-546.3303816
18505,717535083,3-24-24 20:28,116.18,OutgoingTransfer,International Transfer,-662.5103816
18506,717535083,3-25-24 10:28,225.69,Payment,Mortgage Payment,-888.2003816
18507,717535083,04-05-24 21:28,2650,IncomingTransfer,Salary,1761.799618
18508,717535083,04-05-24 23:28,247.93,Payment,Loan Payment,1513.869618
18509,717535083,04-06-24 17:28,137.14,Deposit,Cash Deposit,1651.009618
18510,717535083,04-07-24 18:28,186.22,OnlineShopping,Target,1464.789618
18511,717535083,04-07-24 21:28,119.08,Payment,Bill Payment,1345.709618
18512,717535083,04-08-24 20:28,178.47,OnlineShopping,Amazon,1167.239618
18513,717535083,04-10-24 21:28,1600,Payment,Credit Card Payment,-432.7603816
18514,717535083,04-11-24 14:28,51.6,Purchase,Electronics,-484.3603816
18515,717535083,04-12-24 16:28,135.06,Return,eBay Return,-349.3003816
18516,717535083,4-13-24 12:28,176.01,Withdrawal,Branch Withdrawal,-525.3103816
18517,717535083,4-14-24 21:28,1300,Payment,Rent Payment,-1825.310382
18518,717535083,4-15-24 23:28,21.13,IncomingTransfer,Freelance Payment,-1804.180382
18519,717535083,4-21-24 12:28,119.03,IncomingTransfer,Freelance Payment,-1685.150382
18520,717535083,4-21-24 13:28,214.87,Purchase,Electronics,-1900.020382
18521,717535083,4-24-24 10:28,233.28,Withdrawal,Mobile App Withdrawal,-2133.300382
18522,717535083,4-24-24 21:28,32.72,Withdrawal,Mobile App Withdrawal,-2166.020382
18523,717535083,4-26-24 14:28,223.43,Withdrawal,Mobile App Withdrawal,-2389.450382
18524,717535083,4-27-24 22:28,45.49,Return,Etsy Return,-2343.960382
18525,717535083,4-29-24 14:28,18.46,Deposit,Direct Deposit,-2325.500382
18526,717535083,05-01-24 21:28,2650,IncomingTransfer,Salary,324.4996184
18527,717535083,05-03-24 22:28,113.09,Return,Best Buy Return,437.5896184
18528,717535083,05-05-24 18:28,85.3,OnlineShopping,eBay,352.2896184
18529,717535083,05-05-24 19:28,43.11,Deposit,Direct Deposit,395.3996184
18530,717535083,05-06-24 15:28,31.43,Withdrawal,Mobile App Withdrawal,363.9696184
18531,717535083,05-06-24 21:28,1600,Payment,Credit Card Payment,-1236.030382
18532,717535083,05-07-24 13:28,161.1,Deposit,Mobile Deposit,-1074.930382
18533,717535083,05-07-24 13:28,53.35,Purchase,Entertainment,-1128.280382
18534,717535083,05-10-24 18:28,177.65,Withdrawal,Mobile App Withdrawal,-1305.930382
18535,717535083,05-11-24 22:28,171.65,Deposit,Cash Deposit,-1134.280382
18536,717535083,05-12-24 16:28,119.34,Deposit,Mobile Deposit,-1014.940382
18537,717535083,05-12-24 20:28,187.9,Return,Store Return,-827.0403816
18538,717535083,5-13-24 21:28,1700,Payment,Rent Payment,-2527.040382
18539,717535083,5-14-24 9:28,19.46,Withdrawal,Mobile App Withdrawal,-2546.500382
18540,717535083,5-15-24 11:28,38.95,Deposit,Direct Deposit,-2507.550382
18541,717535083,5-19-24 13:28,244.28,Payment,Mortgage Payment,-2751.830382
18542,717535083,5-20-24 12:28,154.02,OutgoingTransfer,Peer-to-Peer Transfer,-2905.850382
18543,717535083,5-22-24 23:28,70.04,Purchase,Clothing,-2975.890382
18544,717535083,5-26-24 15:28,186.21,Purchase,Travel,-3162.100382
18545,717535083,5-28-24 23:28,44.81,Return,Best Buy Return,-3117.290382
18546,717535083,06-04-24 21:28,2650,IncomingTransfer,Salary,-467.2903816
18547,717535083,06-09-24 21:28,1100,Payment,Credit Card Payment,-1567.290382
18548,717535083,06-12-24 11:28,134.7,OnlineShopping,Target,-1701.990382
18549,717535083,6-13-24 9:28,187.01,Payment,Bill Payment,-1889.000382
18550,717535083,6-13-24 23:28,34.61,Deposit,Mobile Deposit,-1854.390382
18551,717535083,6-14-24 23:28,60.34,Purchase,Home Improvement,-1914.730382
18552,717535083,6-17-24 21:28,1000,Payment,Rent Payment,-2914.730382
18553,717535083,6-18-24 19:28,192.4,Purchase,Travel,-3107.130382
18554,717535083,6-19-24 17:28,51.6,IncomingTransfer,Freelance Payment,-3055.530382
18555,717535083,6-22-24 13:28,91.49,IncomingTransfer,Freelance Payment,-2964.040382
18556,717535083,6-22-24 13:28,73.14,Purchase,Gas,-3037.180382
18557,717535083,6-23-24 19:28,21.95,Purchase,Restaurant,-3059.130382
18558,717535083,6-23-24 22:28,119.35,IncomingTransfer,Freelance Payment,-2939.780382
18559,717535083,6-28-24 20:28,196.44,Withdrawal,ATM Withdrawal,-3136.220382
18560,717535083,6-29-24 11:28,51.28,Deposit,Direct Deposit,-3084.940382
18561,717535083,6-29-24 14:28,189.45,Deposit,Check Deposit,-2895.490382
18562,717535083,6-30-24 14:28,11.51,Deposit,Check Deposit,-2883.980382
18563,717535083,07-02-24 23:28,125.46,OnlineShopping,Walmart,-3009.440382
18564,717535083,07-03-24 21:28,2650,IncomingTransfer,Salary,-359.4403816
18565,717535083,07-08-24 21:28,1100,Payment,Credit Card Payment,-1459.440382
18566,717535083,07-10-24 19:28,192.99,Deposit,Cash Deposit,-1266.450382
18567,717535083,07-12-24 10:28,121.6,OnlineShopping,AliExpress,-1388.050382
18568,717535083,7-14-24 21:28,1400,Payment,Rent Payment,-2788.050382
18569,717535083,7-16-24 10:28,80.46,IncomingTransfer,Freelance Payment,-2707.590382
18570,717535083,7-16-24 17:28,193.05,Payment,Mortgage Payment,-2900.640382
18571,717578358,1-22-24 18:28,340.86,Purchase,Gas,874.2401193
18572,717578358,1-22-24 19:28,45.18,Deposit,Direct Deposit,919.4201193
18573,717578358,1-26-24 17:28,28.54,OnlineShopping,Etsy,890.8801193
18574,717578358,1-29-24 10:28,350.48,Withdrawal,Mobile App Withdrawal,540.4001193
18575,717578358,02-03-24 14:28,428.86,OnlineShopping,AliExpress,111.5401193
18576,717578358,02-04-24 21:28,4100,IncomingTransfer,Salary,4211.540119
18577,717578358,02-09-24 21:28,1700,Payment,Credit Card Payment,2511.540119
18578,717578358,02-10-24 14:28,447.55,OnlineShopping,eBay,2063.990119
18579,717578358,02-12-24 14:28,231.37,Return,eBay Return,2295.360119
18580,717578358,2-15-24 16:28,309.57,OutgoingTransfer,Bank Transfer,1985.790119
18581,717578358,2-15-24 17:28,255.43,Payment,Mortgage Payment,1730.360119
18582,717578358,2-16-24 14:28,183.98,Payment,Bill Payment,1546.380119
18583,717578358,2-17-24 16:28,21.79,Payment,Loan Payment,1524.590119
18584,717578358,2-17-24 21:28,2300,Payment,Rent Payment,-775.4098807
18585,717578358,2-20-24 9:28,448.83,Payment,Loan Payment,-1224.239881
18586,717578358,2-20-24 23:28,265.79,IncomingTransfer,Freelance Payment,-958.4498807
18587,717578358,2-22-24 23:28,43.42,IncomingTransfer,Freelance Payment,-915.0298807
18588,717578358,2-24-24 12:28,22.32,Purchase,Clothing,-937.3498807
18589,717578358,2-25-24 10:28,123.09,Purchase,Furniture,-1060.439881
18590,717578358,2-26-24 14:28,433.06,IncomingTransfer,Freelance Payment,-627.3798807
18591,717578358,2-26-24 21:28,20.51,Withdrawal,Branch Withdrawal,-647.8898807
18592,717578358,03-02-24 21:28,4100,IncomingTransfer,Salary,3452.110119
18593,717578358,03-02-24 22:28,259.48,Return,eBay Return,3711.590119
18594,717578358,03-06-24 16:28,176.11,IncomingTransfer,Freelance Payment,3887.700119
18595,717578358,03-07-24 21:28,2400,Payment,Credit Card Payment,1487.700119
18596,717578358,03-08-24 14:28,402.8,Withdrawal,Branch Withdrawal,1084.900119
18597,717578358,3-15-24 23:28,324.98,OnlineShopping,Etsy,759.9201193
18598,717578358,3-18-24 21:28,2300,Payment,Rent Payment,-1540.079881
18599,717578358,3-22-24 21:28,82.32,Deposit,Mobile Deposit,-1457.759881
18600,717578358,3-22-24 23:28,130.97,Deposit,Mobile Deposit,-1326.789881
18601,717578358,3-24-24 10:28,56.76,Purchase,Entertainment,-1383.549881
18602,717578358,3-24-24 22:28,218.59,Purchase,Entertainment,-1602.139881
18603,717578358,3-30-24 20:28,389.74,Return,AliExpress Return,-1212.399881
18604,717578358,3-31-24 15:28,439.8,Withdrawal,Mobile App Withdrawal,-1652.199881
18605,717578358,04-03-24 9:28,208.58,Deposit,Cash Deposit,-1443.619881
18606,717578358,04-03-24 10:28,284.06,Deposit,Mobile Deposit,-1159.559881
18607,717578358,04-05-24 10:28,32.87,Payment,Bill Payment,-1192.429881
18608,717578358,04-05-24 14:28,314.24,Purchase,Restaurant,-1506.669881
18609,717578358,04-05-24 21:28,4100,IncomingTransfer,Salary,2593.330119
18610,717578358,04-07-24 10:28,11.19,Deposit,Check Deposit,2604.520119
18611,717578358,04-10-24 21:28,2300,Payment,Credit Card Payment,304.5201193
18612,717578358,04-11-24 20:28,436.67,Withdrawal,Mobile App Withdrawal,-132.1498807
18613,717578358,4-13-24 21:28,33.41,Return,Etsy Return,-98.73988067
18614,717578358,4-14-24 14:28,13.46,OutgoingTransfer,Wire Transfer,-112.1998807
18615,717578358,4-14-24 21:28,262.69,Return,Best Buy Return,150.4901193
18616,717578358,4-14-24 22:28,417.03,Deposit,Direct Deposit,567.5201193
18617,717578358,4-15-24 21:28,1200,Payment,Rent Payment,-632.4798807
18618,717578358,4-18-24 22:28,10.84,IncomingTransfer,Freelance Payment,-621.6398807
18619,717578358,4-21-24 22:28,459.29,Deposit,Check Deposit,-162.3498807
18620,717578358,4-24-24 21:28,112.91,IncomingTransfer,Freelance Payment,-49.43988067
18621,717578358,4-25-24 16:28,16.07,Return,Walmart Return,-33.36988067
18622,717578358,05-01-24 21:28,4100,IncomingTransfer,Salary,4066.630119
18623,717578358,05-01-24 21:28,80.8,Return,Best Buy Return,4147.430119
18624,717578358,05-01-24 23:28,47.82,Withdrawal,Branch Withdrawal,4099.610119
18625,717578358,05-03-24 21:28,121.72,Deposit,Cash Deposit,4221.330119
18626,717578358,05-06-24 12:28,210.57,OnlineShopping,AliExpress,4010.760119
18627,717578358,05-06-24 21:28,2200,Payment,Credit Card Payment,1810.760119
18628,717578358,05-10-24 13:28,259.35,Withdrawal,ATM Withdrawal,1551.410119
18629,717578358,05-11-24 21:28,1200,Payment,Rent Payment,351.4101193
18630,717578358,05-12-24 19:28,64.49,Payment,Bill Payment,286.9201193
18631,717578358,5-16-24 17:28,477.54,Withdrawal,Mobile App Withdrawal,-190.6198807
18632,717578358,5-18-24 16:28,153.89,Deposit,Direct Deposit,-36.72988067
18633,717578358,5-19-24 13:28,60.19,OutgoingTransfer,Wire Transfer,-96.91988067
18634,717578358,5-23-24 20:28,85.86,Purchase,Furniture,-182.7798807
18635,717578358,5-28-24 21:28,154.08,OutgoingTransfer,International Transfer,-336.8598807
18636,717578358,5-29-24 10:28,203.22,Payment,Bill Payment,-540.0798807
18637,717578358,06-02-24 21:28,4100,IncomingTransfer,Salary,3559.920119
18638,717578358,06-03-24 23:28,451.83,OnlineShopping,Best Buy,3108.090119
18639,717578358,06-04-24 13:28,478.03,Return,Target Return,3586.120119
18640,717578358,06-06-24 15:28,35.17,Deposit,Check Deposit,3621.290119
18641,717578358,06-07-24 21:28,1700,Payment,Credit Card Payment,1921.290119
18642,717578358,06-10-24 13:28,278.06,Return,AliExpress Return,2199.350119
18643,717578358,06-10-24 23:28,448.64,Purchase,Travel,1750.710119
18644,717578358,06-11-24 13:28,28.72,Purchase,Clothing,1721.990119
18645,717578358,06-12-24 21:28,2000,Payment,Rent Payment,-278.0098807
18646,717578358,6-13-24 12:28,173.67,Withdrawal,ATM Withdrawal,-451.6798807
18647,717578358,6-13-24 23:28,202.67,Deposit,Cash Deposit,-249.0098807
18648,717578358,6-15-24 12:28,166.62,Payment,Bill Payment,-415.6298807
18649,717578358,6-19-24 19:28,55.49,Purchase,Electronics,-471.1198807
18650,717578358,6-19-24 20:28,386.02,Payment,Mortgage Payment,-857.1398807
18651,717578358,6-20-24 23:28,376.41,OnlineShopping,Amazon,-1233.549881
18652,717578358,6-25-24 17:28,26.02,Withdrawal,Branch Withdrawal,-1259.569881
18653,717578358,6-30-24 14:28,159.08,Withdrawal,ATM Withdrawal,-1418.649881
18654,717578358,6-30-24 19:28,296.77,Return,Best Buy Return,-1121.879881
18655,717578358,6-30-24 20:28,380.67,Payment,Bill Payment,-1502.549881
18656,717578358,07-01-24 18:28,186.93,Deposit,Mobile Deposit,-1315.619881
18657,717578358,07-01-24 21:28,4100,IncomingTransfer,Salary,2784.380119
18658,717578358,07-02-24 19:28,273.95,Withdrawal,Branch Withdrawal,2510.430119
18659,717578358,07-03-24 11:28,286.4,Payment,Loan Payment,2224.030119
18660,717578358,07-03-24 15:28,62.59,Deposit,Direct Deposit,2286.620119
18661,717578358,07-05-24 18:28,140.9,Payment,Bill Payment,2145.720119
18662,717578358,07-06-24 21:28,2100,Payment,Credit Card Payment,45.72011933
18663,717578358,07-11-24 13:28,193.15,Purchase,Home Improvement,-147.4298807
18664,717578358,07-11-24 15:28,152.5,Deposit,Mobile Deposit,5.070119329
18665,717578358,7-13-24 15:28,118.98,Purchase,Gas,-113.9098807
18666,717578358,7-13-24 19:28,23.81,IncomingTransfer,Freelance Payment,-90.09988067
18667,717578358,7-15-24 21:28,1700,Payment,Rent Payment,-1790.099881
18668,717578358,7-17-24 14:28,141.6,Payment,Bill Payment,-1931.699881
18669,717595908,02-02-24 19:28,483.72,Deposit,Direct Deposit,2082.862798
18670,717595908,02-05-24 19:28,527.1,Withdrawal,Mobile App Withdrawal,1555.762798
18671,717595908,02-05-24 21:28,5850,IncomingTransfer,Salary,7405.762798
18672,717595908,02-06-24 21:28,299.11,Return,Store Return,7704.872798
18673,717595908,02-07-24 20:28,296.87,Deposit,Mobile Deposit,8001.742798
18674,717595908,02-10-24 21:28,3000,Payment,Credit Card Payment,5001.742798
18675,717595908,2-14-24 21:28,2200,Payment,Rent Payment,2801.742798
18676,717595908,2-15-24 19:28,228.25,Deposit,Check Deposit,3029.992798
18677,717595908,2-16-24 15:28,388.71,Deposit,Check Deposit,3418.702798
18678,717595908,2-17-24 17:28,278.28,IncomingTransfer,Freelance Payment,3696.982798
18679,717595908,2-20-24 11:28,425.35,Purchase,Travel,3271.632798
18680,717595908,2-21-24 20:28,224.63,Deposit,Check Deposit,3496.262798
18681,717595908,2-24-24 13:28,350.04,Purchase,Gas,3146.222798
18682,717595908,03-01-24 21:28,5850,IncomingTransfer,Salary,8996.222798
18683,717595908,03-02-24 21:28,142.98,Payment,Bill Payment,8853.242798
18684,717595908,03-06-24 21:28,3000,Payment,Credit Card Payment,5853.242798
18685,717595908,03-10-24 18:28,534.88,Withdrawal,ATM Withdrawal,5318.362798
18686,717595908,03-11-24 15:28,160.66,Deposit,Check Deposit,5479.022798
18687,717595908,03-11-24 18:28,323.87,Withdrawal,Mobile App Withdrawal,5155.152798
18688,717595908,03-11-24 21:28,3300,Payment,Rent Payment,1855.152798
18689,717595908,3-16-24 13:28,432.69,Deposit,Direct Deposit,2287.842798
18690,717595908,3-17-24 12:28,398.18,Return,Amazon Return,2686.022798
18691,717595908,3-23-24 20:28,507.04,Purchase,Travel,2178.982798
18692,717595908,3-24-24 10:28,526,Withdrawal,ATM Withdrawal,1652.982798
18693,717595908,3-30-24 18:28,172.88,Return,Etsy Return,1825.862798
18694,717595908,04-01-24 21:28,5850,IncomingTransfer,Salary,7675.862798
18695,717595908,04-06-24 21:28,2600,Payment,Credit Card Payment,5075.862798
18696,717595908,04-10-24 9:28,84.84,Return,Target Return,5160.702798
18697,717595908,04-10-24 12:28,399.49,Deposit,Mobile Deposit,5560.192798
18698,717595908,04-10-24 14:28,105.54,Payment,Mortgage Payment,5454.652798
18699,717595908,4-18-24 21:28,2600,Payment,Rent Payment,2854.652798
18700,717595908,4-20-24 17:28,382.12,Withdrawal,Branch Withdrawal,2472.532798
18701,717595908,4-28-24 20:28,206.31,Deposit,Mobile Deposit,2678.842798
18702,717595908,4-30-24 23:28,532.42,IncomingTransfer,Freelance Payment,3211.262798
18703,717595908,05-03-24 22:28,496.01,Return,Amazon Return,3707.272798
18704,717595908,05-04-24 21:28,5850,IncomingTransfer,Salary,9557.272798
18705,717595908,05-09-24 21:28,3200,Payment,Credit Card Payment,6357.272798
18706,717595908,05-11-24 21:28,3700,Payment,Rent Payment,2657.272798
18707,717595908,5-13-24 16:28,159.46,Purchase,Restaurant,2497.812798
18708,717595908,5-14-24 9:28,112.31,Deposit,Check Deposit,2610.122798
18709,717595908,5-22-24 21:28,128.93,Purchase,Home Improvement,2481.192798
18710,717595908,5-24-24 16:28,135.84,IncomingTransfer,Freelance Payment,2617.032798
18711,717595908,5-24-24 22:28,408.08,Deposit,Direct Deposit,3025.112798
18712,717595908,5-25-24 16:28,83.54,OutgoingTransfer,International Transfer,2941.572798
18713,717595908,5-27-24 16:28,244.92,Payment,Bill Payment,2696.652798
18714,717595908,06-02-24 21:28,5850,IncomingTransfer,Salary,8546.652798
18715,717595908,06-07-24 21:28,2600,Payment,Credit Card Payment,5946.652798
18716,717595908,6-13-24 16:28,406.73,Purchase,Home Improvement,5539.922798
18717,717595908,6-16-24 21:28,3300,Payment,Rent Payment,2239.922798
18718,717595908,6-25-24 10:28,378.83,IncomingTransfer,Freelance Payment,2618.752798
18719,717595908,6-28-24 14:28,195.52,Purchase,Gas,2423.232798
18720,717595908,07-01-24 22:28,345.09,Purchase,Restaurant,2078.142798
18721,717595908,07-02-24 15:28,350.67,OnlineShopping,Amazon,1727.472798
18722,717595908,07-04-24 21:28,5850,IncomingTransfer,Salary,7577.472798
18723,717595908,07-05-24 19:28,371.55,Withdrawal,Mobile App Withdrawal,7205.922798
18724,717595908,07-05-24 23:28,354.86,Payment,Loan Payment,6851.062798
18725,717595908,07-06-24 22:28,396.72,Deposit,Direct Deposit,7247.782798
18726,717595908,07-09-24 21:28,2400,Payment,Credit Card Payment,4847.782798
18727,717595908,07-11-24 9:28,242.84,OutgoingTransfer,International Transfer,4604.942798
18728,717595908,7-13-24 13:28,449.92,Purchase,Grocery,4155.022798
18729,717595908,7-13-24 18:28,364.9,Return,Etsy Return,4519.922798
18730,717595908,7-13-24 21:28,3000,Payment,Rent Payment,1519.922798
18731,717595908,7-16-24 22:28,115.85,Deposit,Check Deposit,1635.772798
18732,717621333,1-20-24 22:28,148.53,Deposit,Cash Deposit,1401.677179
18733,717621333,1-24-24 19:28,112.99,Deposit,Direct Deposit,1514.667179
18734,717621333,1-26-24 10:28,80.36,IncomingTransfer,Freelance Payment,1595.027179
18735,717621333,1-26-24 17:28,79.33,Purchase,Gas,1515.697179
18736,717621333,1-31-24 20:28,225.39,Withdrawal,Mobile App Withdrawal,1290.307179
18737,717621333,02-01-24 16:28,79.07,OutgoingTransfer,Peer-to-Peer Transfer,1211.237179
18738,717621333,02-02-24 21:28,2900,IncomingTransfer,Salary,4111.237179
18739,717621333,02-03-24 12:28,142.02,OnlineShopping,Amazon,3969.217179
18740,717621333,02-03-24 14:28,177.67,Payment,Loan Payment,3791.547179
18741,717621333,02-04-24 14:28,33.02,Purchase,Entertainment,3758.527179
18742,717621333,02-07-24 21:28,2200,Payment,Credit Card Payment,1558.527179
18743,717621333,02-11-24 16:28,110.71,Deposit,Check Deposit,1669.237179
18744,717621333,02-12-24 14:28,169.56,Withdrawal,Mobile App Withdrawal,1499.677179
18745,717621333,02-12-24 19:28,99.29,OnlineShopping,Best Buy,1400.387179
18746,717621333,02-12-24 21:28,1200,Payment,Installment Payment,200.3871794
18747,717621333,2-16-24 9:28,189.52,OutgoingTransfer,Peer-to-Peer Transfer,10.86717943
18748,717621333,2-18-24 12:28,206.91,Purchase,Pharmacy,-196.0428206
18749,717621333,2-20-24 19:28,229.53,Purchase,Grocery,-425.5728206
18750,717621333,2-21-24 15:28,108.63,Withdrawal,Branch Withdrawal,-534.2028206
18751,717621333,2-23-24 11:28,137.05,Purchase,Entertainment,-671.2528206
18752,717621333,2-24-24 21:28,106.02,Purchase,Gas,-777.2728206
18753,717621333,03-02-24 18:28,31.8,Return,Target Return,-745.4728206
18754,717621333,03-02-24 19:28,233.02,OnlineShopping,AliExpress,-978.4928206
18755,717621333,03-03-24 13:28,193.5,Payment,Loan Payment,-1171.992821
18756,717621333,03-03-24 17:28,210.24,Purchase,Furniture,-1382.232821
18757,717621333,03-04-24 21:28,2900,IncomingTransfer,Salary,1517.767179
18758,717621333,03-07-24 14:28,176.81,IncomingTransfer,Freelance Payment,1694.577179
18759,717621333,03-09-24 12:28,90.11,Deposit,Check Deposit,1784.687179
18760,717621333,03-09-24 14:28,29.59,Purchase,Electronics,1755.097179
18761,717621333,03-09-24 21:28,2600,Payment,Credit Card Payment,-844.9028206
18762,717621333,03-10-24 10:28,70.12,Withdrawal,ATM Withdrawal,-915.0228206
18763,717621333,03-11-24 18:28,208.31,Payment,Loan Payment,-1123.332821
18764,717621333,03-11-24 22:28,157.88,Withdrawal,ATM Withdrawal,-1281.212821
18765,717621333,3-13-24 21:28,800,Payment,Subscription Payment,-2081.212821
18766,717621333,3-17-24 15:28,139.34,Deposit,Check Deposit,-1941.872821
18767,717621333,3-18-24 11:28,211.06,Deposit,Cash Deposit,-1730.812821
18768,717621333,3-22-24 17:28,209.34,Return,Walmart Return,-1521.472821
18769,717621333,3-28-24 11:28,50.45,OutgoingTransfer,Bank Transfer,-1571.922821
18770,717621333,3-28-24 17:28,49.38,Withdrawal,Branch Withdrawal,-1621.302821
18771,717621333,3-28-24 19:28,103.02,Withdrawal,Mobile App Withdrawal,-1724.322821
18772,717621333,3-31-24 13:28,195.77,OnlineShopping,Walmart,-1920.092821
18773,717621333,04-02-24 20:28,220.56,Deposit,Cash Deposit,-1699.532821
18774,717621333,04-05-24 18:28,15.09,Purchase,Home Improvement,-1714.622821
18775,717621333,04-05-24 21:28,2900,IncomingTransfer,Salary,1185.377179
18776,717621333,04-05-24 23:28,136.77,Deposit,Mobile Deposit,1322.147179
18777,717621333,04-07-24 10:28,37.08,OutgoingTransfer,Peer-to-Peer Transfer,1285.067179
18778,717621333,04-08-24 10:28,135.37,Deposit,Direct Deposit,1420.437179
18779,717621333,04-08-24 19:28,137.59,Deposit,Cash Deposit,1558.027179
18780,717621333,04-08-24 22:28,117.29,OnlineShopping,Amazon,1440.737179
18781,717621333,04-09-24 15:28,195.47,IncomingTransfer,Freelance Payment,1636.207179
18782,717621333,04-10-24 21:28,2700,Payment,Credit Card Payment,-1063.792821
18783,717621333,04-11-24 21:28,1000,Payment,Insurance Payment,-2063.792821
18784,717621333,4-17-24 12:28,101.01,IncomingTransfer,Freelance Payment,-1962.782821
18785,717621333,4-18-24 13:28,242.44,Purchase,Pharmacy,-2205.222821
18786,717621333,4-20-24 22:28,243.63,Deposit,Direct Deposit,-1961.592821
18787,717621333,4-26-24 15:28,192.58,Return,Store Return,-1769.012821
18788,717621333,4-27-24 16:28,218.64,OnlineShopping,Best Buy,-1987.652821
18789,717621333,05-01-24 15:28,192.31,Purchase,Entertainment,-2179.962821
18790,717621333,05-01-24 19:28,54.03,Payment,Mortgage Payment,-2233.992821
18791,717621333,05-02-24 21:28,2900,IncomingTransfer,Salary,666.0071794
18792,717621333,05-03-24 18:28,158.6,Withdrawal,ATM Withdrawal,507.4071794
18793,717621333,05-06-24 16:28,117.86,Withdrawal,Branch Withdrawal,389.5471794
18794,717621333,05-07-24 11:28,21.47,OutgoingTransfer,Peer-to-Peer Transfer,368.0771794
18795,717621333,05-07-24 21:28,1900,Payment,Credit Card Payment,-1531.922821
18796,717621333,05-10-24 20:28,155.63,OutgoingTransfer,International Transfer,-1687.552821
18797,717621333,05-10-24 21:28,1300,Payment,Subscription Payment,-2987.552821
18798,717621333,05-11-24 10:28,48.6,Return,Etsy Return,-2938.952821
18799,717621333,05-11-24 11:28,30.9,Withdrawal,Branch Withdrawal,-2969.852821
18800,717621333,5-14-24 10:28,109.27,Deposit,Check Deposit,-2860.582821
18801,717621333,5-19-24 13:28,162.96,Purchase,Furniture,-3023.542821
18802,717621333,5-19-24 19:28,68.03,Withdrawal,Mobile App Withdrawal,-3091.572821
18803,717621333,5-20-24 17:28,154.44,IncomingTransfer,Freelance Payment,-2937.132821
18804,717621333,5-21-24 23:28,207.41,OutgoingTransfer,Wire Transfer,-3144.542821
18805,717621333,06-04-24 15:28,105.78,Payment,Bill Payment,-3250.322821
18806,717621333,06-04-24 18:28,193.22,Deposit,Cash Deposit,-3057.102821
18807,717621333,06-05-24 21:28,2900,IncomingTransfer,Salary,-157.1028206
18808,717621333,06-06-24 21:28,115.93,Deposit,Mobile Deposit,-41.17282057
18809,717621333,06-08-24 11:28,12.22,Purchase,Travel,-53.39282057
18810,717621333,06-10-24 21:28,2800,Payment,Credit Card Payment,-2853.392821
18811,717621333,06-10-24 21:28,1100,Payment,Subscription Payment,-3953.392821
18812,717621333,6-19-24 11:28,103.79,OnlineShopping,Target,-4057.182821
18813,717621333,6-19-24 11:28,61.72,Withdrawal,ATM Withdrawal,-4118.902821
18814,717621333,6-21-24 11:28,22.35,Withdrawal,Branch Withdrawal,-4141.252821
18815,717621333,6-21-24 17:28,155.09,Withdrawal,Branch Withdrawal,-4296.342821
18816,717621333,6-28-24 22:28,38.16,Deposit,Mobile Deposit,-4258.182821
18817,717621333,6-30-24 13:28,148.28,Payment,Bill Payment,-4406.462821
18818,717621333,07-03-24 20:28,62.36,OutgoingTransfer,International Transfer,-4468.822821
18819,717621333,07-03-24 21:28,2900,IncomingTransfer,Salary,-1568.822821
18820,717621333,07-04-24 9:28,70.37,Withdrawal,Mobile App Withdrawal,-1639.192821
18821,717621333,07-07-24 16:28,41.82,Withdrawal,Mobile App Withdrawal,-1681.012821
18822,717621333,07-07-24 17:28,73.75,OutgoingTransfer,Bank Transfer,-1754.762821
18823,717621333,07-08-24 21:28,2400,Payment,Credit Card Payment,-4154.762821
18824,717621333,07-09-24 13:28,114.97,Deposit,Direct Deposit,-4039.792821
18825,717621333,07-10-24 17:28,218.51,Purchase,Clothing,-4258.302821
18826,717621333,7-13-24 21:28,1000,Payment,Insurance Payment,-5258.302821
18827,717621333,7-16-24 10:28,29.73,Withdrawal,Branch Withdrawal,-5288.032821
18828,717628608,1-20-24 12:28,399.78,Purchase,Clothing,544.3823193
18829,717628608,1-24-24 11:28,407.87,Payment,Bill Payment,136.5123193
18830,717628608,1-26-24 13:28,312.14,OnlineShopping,Walmart,-175.6276807
18831,717628608,02-01-24 20:28,121.05,Deposit,Mobile Deposit,-54.57768066
18832,717628608,02-02-24 21:28,6550,IncomingTransfer,Salary,6495.422319
18833,717628608,02-07-24 21:28,2300,Payment,Credit Card Payment,4195.422319
18834,717628608,02-09-24 16:28,100.89,Payment,Bill Payment,4094.532319
18835,717628608,2-13-24 21:28,4300,Payment,Rent Payment,-205.4676807
18836,717628608,2-19-24 9:28,365.38,Payment,Mortgage Payment,-570.8476807
18837,717628608,2-26-24 13:28,495.77,IncomingTransfer,Freelance Payment,-75.07768066
18838,717628608,2-27-24 11:28,237.45,Deposit,Mobile Deposit,162.3723193
18839,717628608,2-27-24 20:28,120.78,Purchase,Restaurant,41.59231934
18840,717628608,2-28-24 16:28,411.56,OnlineShopping,eBay,-369.9676807
18841,717628608,03-02-24 13:28,456.71,Withdrawal,Branch Withdrawal,-826.6776807
18842,717628608,03-02-24 13:28,264.06,Deposit,Cash Deposit,-562.6176807
18843,717628608,03-02-24 21:28,6550,IncomingTransfer,Salary,5987.382319
18844,717628608,03-06-24 18:28,276.74,Purchase,Electronics,5710.642319
18845,717628608,03-07-24 21:28,1800,Payment,Credit Card Payment,3910.642319
18846,717628608,03-12-24 21:28,3300,Payment,Rent Payment,610.6423193
18847,717628608,04-01-24 21:28,6550,IncomingTransfer,Salary,7160.642319
18848,717628608,04-05-24 10:28,344,Withdrawal,Branch Withdrawal,6816.642319
18849,717628608,04-06-24 21:28,2100,Payment,Credit Card Payment,4716.642319
18850,717628608,04-11-24 17:28,284.84,Payment,Mortgage Payment,4431.802319
18851,717628608,4-16-24 18:28,378.64,OnlineShopping,Target,4053.162319
18852,717628608,4-16-24 19:28,158.96,Deposit,Direct Deposit,4212.122319
18853,717628608,4-16-24 21:28,3300,Payment,Rent Payment,912.1223193
18854,717628608,4-20-24 12:28,266.57,OnlineShopping,eBay,645.5523193
18855,717628608,4-21-24 18:28,54.72,Purchase,Clothing,590.8323193
18856,717628608,05-04-24 21:28,6550,IncomingTransfer,Salary,7140.832319
18857,717628608,05-09-24 21:28,2300,Payment,Credit Card Payment,4840.832319
18858,717628608,05-11-24 12:28,537.16,Withdrawal,Mobile App Withdrawal,4303.672319
18859,717628608,05-12-24 21:28,3600,Payment,Rent Payment,703.6723193
18860,717628608,5-13-24 10:28,539.04,Return,eBay Return,1242.712319
18861,717628608,5-16-24 21:28,278.86,Return,Best Buy Return,1521.572319
18862,717628608,5-19-24 13:28,456.37,OnlineShopping,Amazon,1065.202319
18863,717628608,5-20-24 19:28,198.05,OutgoingTransfer,Wire Transfer,867.1523193
18864,717628608,5-24-24 22:28,263.43,IncomingTransfer,Freelance Payment,1130.582319
18865,717628608,5-27-24 12:28,518.22,Withdrawal,ATM Withdrawal,612.3623193
18866,717628608,06-03-24 21:28,6550,IncomingTransfer,Salary,7162.362319
18867,717628608,06-08-24 21:28,2200,Payment,Credit Card Payment,4962.362319
18868,717628608,6-15-24 21:28,3000,Payment,Rent Payment,1962.362319
18869,717628608,6-16-24 19:28,260.45,Deposit,Direct Deposit,2222.812319
18870,717628608,6-25-24 15:28,517.41,Purchase,Pharmacy,1705.402319
18871,717628608,6-26-24 10:28,386.02,OutgoingTransfer,Wire Transfer,1319.382319
18872,717628608,6-28-24 16:28,104.93,Deposit,Direct Deposit,1424.312319
18873,717628608,07-03-24 19:28,132.25,Withdrawal,Branch Withdrawal,1292.062319
18874,717628608,07-03-24 21:28,6550,IncomingTransfer,Salary,7842.062319
18875,717628608,07-07-24 17:28,147.66,Return,Best Buy Return,7989.722319
18876,717628608,07-08-24 21:28,2100,Payment,Credit Card Payment,5889.722319
18877,717628608,07-12-24 21:28,2800,Payment,Rent Payment,3089.722319
18878,717628608,7-14-24 19:28,270.83,Withdrawal,Branch Withdrawal,2818.892319
18879,717628608,7-14-24 21:28,293.25,OnlineShopping,Best Buy,2525.642319
18880,717813558,1-20-24 14:28,108.44,OutgoingTransfer,Peer-to-Peer Transfer,1313.139592
18881,717813558,1-31-24 9:28,148.26,Purchase,Electronics,1164.879592
18882,717813558,02-04-24 21:28,3500,IncomingTransfer,Salary,4664.879592
18883,717813558,02-04-24 21:28,89.42,Purchase,Electronics,4575.459592
18884,717813558,02-05-24 20:28,123.54,IncomingTransfer,Freelance Payment,4698.999592
18885,717813558,02-09-24 21:28,2500,Payment,Credit Card Payment,2198.999592
18886,717813558,02-12-24 11:28,118.78,OnlineShopping,Amazon,2080.219592
18887,717813558,02-12-24 19:28,396.46,Withdrawal,Branch Withdrawal,1683.759592
18888,717813558,02-12-24 21:28,1600,Payment,Rent Payment,83.75959219
18889,717813558,2-15-24 14:28,73.2,OnlineShopping,eBay,10.55959219
18890,717813558,2-15-24 20:28,424.88,OnlineShopping,eBay,-414.3204078
18891,717813558,2-28-24 18:28,27.12,IncomingTransfer,Freelance Payment,-387.2004078
18892,717813558,03-03-24 21:28,3500,IncomingTransfer,Salary,3112.799592
18893,717813558,03-04-24 10:28,201.85,Payment,Mortgage Payment,2910.949592
18894,717813558,03-08-24 21:28,2500,Payment,Credit Card Payment,410.9495922
18895,717813558,03-09-24 15:28,152.78,Deposit,Check Deposit,563.7295922
18896,717813558,3-16-24 21:28,1400,Payment,Rent Payment,-836.2704078
18897,717813558,3-21-24 21:28,382.03,Purchase,Travel,-1218.300408
18898,717813558,3-30-24 13:28,213.08,Purchase,Clothing,-1431.380408
18899,717813558,04-05-24 21:28,3500,IncomingTransfer,Salary,2068.619592
18900,717813558,04-08-24 21:28,173.19,Withdrawal,Mobile App Withdrawal,1895.429592
18901,717813558,04-10-24 21:28,2900,Payment,Credit Card Payment,-1004.570408
18902,717813558,04-11-24 18:28,98.9,Withdrawal,Branch Withdrawal,-1103.470408
18903,717813558,04-12-24 9:28,124.66,Deposit,Cash Deposit,-978.8104078
18904,717813558,4-14-24 11:28,328.37,Return,AliExpress Return,-650.4404078
18905,717813558,4-16-24 21:28,1500,Payment,Rent Payment,-2150.440408
18906,717813558,4-23-24 16:28,421.39,Withdrawal,Branch Withdrawal,-2571.830408
18907,717813558,4-27-24 14:28,23.1,Deposit,Cash Deposit,-2548.730408
18908,717813558,4-29-24 20:28,130.31,Payment,Loan Payment,-2679.040408
18909,717813558,05-02-24 21:28,3500,IncomingTransfer,Salary,820.9595922
18910,717813558,05-02-24 22:28,328.32,IncomingTransfer,Freelance Payment,1149.279592
18911,717813558,05-03-24 15:28,210.81,IncomingTransfer,Freelance Payment,1360.089592
18912,717813558,05-07-24 13:28,399.77,Payment,Mortgage Payment,960.3195922
18913,717813558,05-07-24 21:28,2200,Payment,Credit Card Payment,-1239.680408
18914,717813558,5-13-24 9:28,487.76,Payment,Mortgage Payment,-1727.440408
18915,717813558,5-17-24 12:28,129.81,OutgoingTransfer,Peer-to-Peer Transfer,-1857.250408
18916,717813558,5-18-24 21:28,1900,Payment,Rent Payment,-3757.250408
18917,717813558,5-25-24 20:28,250.91,Purchase,Entertainment,-4008.160408
18918,717813558,5-28-24 23:28,76.36,Purchase,Furniture,-4084.520408
18919,717813558,06-02-24 21:28,3500,IncomingTransfer,Salary,-584.5204078
18920,717813558,06-03-24 17:28,179.93,Purchase,Restaurant,-764.4504078
18921,717813558,06-07-24 21:28,2500,Payment,Credit Card Payment,-3264.450408
18922,717813558,06-12-24 21:28,1900,Payment,Rent Payment,-5164.450408
18923,717813558,6-17-24 15:28,80.09,Return,AliExpress Return,-5084.360408
18924,717813558,6-25-24 17:28,390.27,Deposit,Mobile Deposit,-4694.090408
18925,717813558,6-25-24 17:28,286.17,Return,Etsy Return,-4407.920408
18926,717813558,6-29-24 19:28,118.7,IncomingTransfer,Freelance Payment,-4289.220408
18927,717813558,07-02-24 18:28,334.86,Deposit,Mobile Deposit,-3954.360408
18928,717813558,07-03-24 18:28,188.1,Deposit,Check Deposit,-3766.260408
18929,717813558,07-04-24 20:28,362.68,OnlineShopping,AliExpress,-4128.940408
18930,717813558,07-05-24 10:28,374.23,Return,Walmart Return,-3754.710408
18931,717813558,07-05-24 21:28,3500,IncomingTransfer,Salary,-254.7104078
18932,717813558,07-10-24 16:28,285.73,Purchase,Gas,-540.4404078
18933,717813558,07-10-24 21:28,2700,Payment,Credit Card Payment,-3240.440408
18934,717813558,07-12-24 21:28,2000,Payment,Rent Payment,-5240.440408
18935,717813558,7-15-24 23:28,28.5,Withdrawal,Branch Withdrawal,-5268.940408
18936,717819633,1-25-24 18:28,31.57,Withdrawal,Branch Withdrawal,1211.906634
18937,717819633,02-01-24 9:28,139.74,Withdrawal,ATM Withdrawal,1072.166634
18938,717819633,02-01-24 21:28,3100,IncomingTransfer,Salary,4172.166634
18939,717819633,02-03-24 21:28,138.83,Deposit,Direct Deposit,4310.996634
18940,717819633,02-04-24 11:28,140.8,Deposit,Mobile Deposit,4451.796634
18941,717819633,02-06-24 21:28,1600,Payment,Credit Card Payment,2851.796634
18942,717819633,02-07-24 20:28,147.79,Withdrawal,Branch Withdrawal,2704.006634
18943,717819633,2-13-24 21:28,1400,Payment,Rent Payment,1304.006634
18944,717819633,2-16-24 15:28,169.81,OutgoingTransfer,Peer-to-Peer Transfer,1134.196634
18945,717819633,2-19-24 14:28,162.17,Payment,Loan Payment,972.0266337
18946,717819633,2-22-24 22:28,120.77,Deposit,Check Deposit,1092.796634
18947,717819633,2-26-24 18:28,157.91,OutgoingTransfer,Wire Transfer,934.8866337
18948,717819633,2-27-24 19:28,157.48,Purchase,Electronics,777.4066337
18949,717819633,03-04-24 11:28,169.49,OutgoingTransfer,Bank Transfer,607.9166337
18950,717819633,03-05-24 21:28,3100,IncomingTransfer,Salary,3707.916634
18951,717819633,03-07-24 9:28,33.87,OnlineShopping,Etsy,3674.046634
18952,717819633,03-08-24 17:28,31.5,Deposit,Cash Deposit,3705.546634
18953,717819633,03-09-24 18:28,81.73,Payment,Loan Payment,3623.816634
18954,717819633,03-10-24 21:28,1900,Payment,Credit Card Payment,1723.816634
18955,717819633,3-14-24 21:28,1500,Payment,Rent Payment,223.8166337
18956,717819633,3-15-24 17:28,43.73,Deposit,Mobile Deposit,267.5466337
18957,717819633,3-16-24 16:28,47.57,Deposit,Mobile Deposit,315.1166337
18958,717819633,3-17-24 10:28,70.99,Deposit,Mobile Deposit,386.1066337
18959,717819633,3-17-24 15:28,14.27,Return,Store Return,400.3766337
18960,717819633,3-19-24 21:28,22.01,Payment,Bill Payment,378.3666337
18961,717819633,3-22-24 22:28,180.44,Withdrawal,ATM Withdrawal,197.9266337
18962,717819633,3-28-24 20:28,66.71,Deposit,Direct Deposit,264.6366337
18963,717819633,3-29-24 20:28,170.01,OutgoingTransfer,Peer-to-Peer Transfer,94.62663374
18964,717819633,04-01-24 21:28,3100,IncomingTransfer,Salary,3194.626634
18965,717819633,04-06-24 21:28,1800,Payment,Credit Card Payment,1394.626634
18966,717819633,04-07-24 15:28,197.92,Deposit,Direct Deposit,1592.546634
18967,717819633,04-08-24 18:28,93.76,Purchase,Home Improvement,1498.786634
18968,717819633,04-12-24 21:28,1900,Payment,Rent Payment,-401.2133663
18969,717819633,4-13-24 12:28,94.99,Withdrawal,Branch Withdrawal,-496.2033663
18970,717819633,4-14-24 15:28,211.64,Purchase,Clothing,-707.8433663
18971,717819633,4-15-24 14:28,233.79,Return,AliExpress Return,-474.0533663
18972,717819633,4-17-24 16:28,38.18,Deposit,Cash Deposit,-435.8733663
18973,717819633,4-18-24 15:28,238.44,Deposit,Mobile Deposit,-197.4333663
18974,717819633,4-18-24 23:28,218.63,Withdrawal,Branch Withdrawal,-416.0633663
18975,717819633,4-19-24 11:28,172.93,Return,eBay Return,-243.1333663
18976,717819633,4-21-24 13:28,233.66,Withdrawal,ATM Withdrawal,-476.7933663
18977,717819633,4-21-24 15:28,52.26,OutgoingTransfer,Bank Transfer,-529.0533663
18978,717819633,4-28-24 19:28,104.85,Payment,Bill Payment,-633.9033663
18979,717819633,05-03-24 22:28,51.44,Payment,Loan Payment,-685.3433663
18980,717819633,05-03-24 23:28,242.18,Purchase,Gas,-927.5233663
18981,717819633,05-05-24 21:28,3100,IncomingTransfer,Salary,2172.476634
18982,717819633,05-06-24 11:28,108.78,Withdrawal,Mobile App Withdrawal,2063.696634
18983,717819633,05-10-24 19:28,128.28,Withdrawal,ATM Withdrawal,1935.416634
18984,717819633,05-10-24 21:28,2000,Payment,Credit Card Payment,-64.58336626
18985,717819633,05-11-24 21:28,1300,Payment,Rent Payment,-1364.583366
18986,717819633,5-24-24 23:28,128.42,Purchase,Pharmacy,-1493.003366
18987,717819633,5-25-24 20:28,189.35,OnlineShopping,Best Buy,-1682.353366
18988,717819633,5-29-24 22:28,41.32,Purchase,Travel,-1723.673366
18989,717819633,5-30-24 12:28,167.63,Withdrawal,Branch Withdrawal,-1891.303366
18990,717819633,5-31-24 16:28,40.81,OnlineShopping,Etsy,-1932.113366
18991,717819633,06-02-24 20:28,130.67,IncomingTransfer,Freelance Payment,-1801.443366
18992,717819633,06-04-24 11:28,235.22,OnlineShopping,eBay,-2036.663366
18993,717819633,06-05-24 21:28,3100,IncomingTransfer,Salary,1063.336634
18994,717819633,06-07-24 18:28,17.68,Deposit,Cash Deposit,1081.016634
18995,717819633,06-08-24 17:28,180,OutgoingTransfer,Wire Transfer,901.0166337
18996,717819633,06-09-24 16:28,151.3,Deposit,Check Deposit,1052.316634
18997,717819633,06-10-24 21:28,1900,Payment,Credit Card Payment,-847.6833663
18998,717819633,06-10-24 21:28,2000,Payment,Rent Payment,-2847.683366
18999,717819633,6-15-24 21:28,143.09,Deposit,Mobile Deposit,-2704.593366
19000,717819633,6-20-24 11:28,201.53,Purchase,Entertainment,-2906.123366
19001,717819633,6-25-24 12:28,89.49,Payment,Loan Payment,-2995.613366
19002,717819633,07-01-24 21:28,3100,IncomingTransfer,Salary,104.3866337
19003,717819633,07-04-24 20:28,221.97,Return,Walmart Return,326.3566337
19004,717819633,07-05-24 18:28,121.36,Purchase,Entertainment,204.9966337
19005,717819633,07-06-24 21:28,2100,Payment,Credit Card Payment,-1895.003366
19006,717819633,7-13-24 10:28,159.64,Purchase,Restaurant,-2054.643366
19007,717819633,7-13-24 18:28,102.06,Return,Amazon Return,-1952.583366
19008,717819633,7-13-24 19:28,102.39,OnlineShopping,Walmart,-2054.973366
19009,717819633,7-13-24 21:28,180.4,Purchase,Gas,-2235.373366
19010,717819633,7-18-24 21:28,1200,Payment,Rent Payment,-3435.373366
19011,717849708,1-28-24 22:28,139.28,Purchase,Travel,390.3196614
19012,717849708,1-31-24 10:28,235.13,IncomingTransfer,Freelance Payment,625.4496614
19013,717849708,02-03-24 10:28,342.47,Purchase,Electronics,282.9796614
19014,717849708,02-05-24 21:28,6600,IncomingTransfer,Salary,6882.979661
19015,717849708,02-06-24 9:28,366.7,Withdrawal,Branch Withdrawal,6516.279661
19016,717849708,02-06-24 13:28,149.19,Deposit,Direct Deposit,6665.469661
19017,717849708,02-06-24 22:28,429.38,OutgoingTransfer,Bank Transfer,6236.089661
19018,717849708,02-07-24 21:28,241.66,Payment,Bill Payment,5994.429661
19019,717849708,02-08-24 18:28,456.04,OutgoingTransfer,International Transfer,5538.389661
19020,717849708,02-09-24 11:28,168.85,Withdrawal,Branch Withdrawal,5369.539661
19021,717849708,02-10-24 21:28,1000,Payment,Credit Card Payment,4369.539661
19022,717849708,02-11-24 20:28,435.46,Purchase,Travel,3934.079661
19023,717849708,02-12-24 23:28,53.85,Deposit,Direct Deposit,3987.929661
19024,717849708,2-13-24 23:28,393.72,OutgoingTransfer,Wire Transfer,3594.209661
19025,717849708,2-14-24 21:28,3300,Payment,Rent Payment,294.2096614
19026,717849708,2-16-24 18:28,157.97,OutgoingTransfer,Wire Transfer,136.2396614
19027,717849708,2-17-24 16:28,451.31,Withdrawal,Mobile App Withdrawal,-315.0703386
19028,717849708,2-20-24 14:28,131.55,OutgoingTransfer,Peer-to-Peer Transfer,-446.6203386
19029,717849708,2-23-24 10:28,100.63,Deposit,Cash Deposit,-345.9903386
19030,717849708,2-23-24 22:28,544.68,Purchase,Entertainment,-890.6703386
19031,717849708,2-29-24 19:28,177.03,Deposit,Check Deposit,-713.6403386
19032,717849708,03-03-24 17:28,431.44,Purchase,Entertainment,-1145.080339
19033,717849708,03-04-24 17:28,221.81,OutgoingTransfer,Peer-to-Peer Transfer,-1366.890339
19034,717849708,03-04-24 21:28,6600,IncomingTransfer,Salary,5233.109661
19035,717849708,03-06-24 16:28,229.3,OutgoingTransfer,Bank Transfer,5003.809661
19036,717849708,03-08-24 14:28,457.54,Return,Best Buy Return,5461.349661
19037,717849708,03-09-24 13:28,360.79,Deposit,Direct Deposit,5822.139661
19038,717849708,03-09-24 21:28,1000,Payment,Credit Card Payment,4822.139661
19039,717849708,03-11-24 14:28,204.53,Deposit,Cash Deposit,5026.669661
19040,717849708,03-11-24 21:28,237.01,OutgoingTransfer,Bank Transfer,4789.659661
19041,717849708,03-12-24 15:28,234.5,Withdrawal,Branch Withdrawal,4555.159661
19042,717849708,3-13-24 12:28,211.92,OutgoingTransfer,International Transfer,4343.239661
19043,717849708,3-13-24 22:28,88.73,OutgoingTransfer,Bank Transfer,4254.509661
19044,717849708,3-14-24 21:28,3800,Payment,Rent Payment,454.5096614
19045,717849708,3-17-24 22:28,57.62,IncomingTransfer,Freelance Payment,512.1296614
19046,717849708,3-18-24 10:28,279.12,Return,Etsy Return,791.2496614
19047,717849708,3-19-24 14:28,141.06,Deposit,Direct Deposit,932.3096614
19048,717849708,3-22-24 13:28,337.23,Purchase,Restaurant,595.0796614
19049,717849708,3-24-24 22:28,518.12,Deposit,Direct Deposit,1113.199661
19050,717849708,3-28-24 13:28,251.26,Deposit,Check Deposit,1364.459661
19051,717849708,3-31-24 13:28,55.55,Purchase,Electronics,1308.909661
19052,717849708,04-01-24 9:28,57.86,Purchase,Gas,1251.049661
19053,717849708,04-02-24 10:28,289.75,IncomingTransfer,Freelance Payment,1540.799661
19054,717849708,04-03-24 15:28,437.88,OutgoingTransfer,International Transfer,1102.919661
19055,717849708,04-03-24 21:28,6600,IncomingTransfer,Salary,7702.919661
19056,717849708,04-03-24 23:28,497.04,Payment,Bill Payment,7205.879661
19057,717849708,04-04-24 11:28,425.6,Purchase,Pharmacy,6780.279661
19058,717849708,04-07-24 13:28,464.09,Payment,Mortgage Payment,6316.189661
19059,717849708,04-07-24 15:28,119.16,Withdrawal,ATM Withdrawal,6197.029661
19060,717849708,04-08-24 21:28,1000,Payment,Credit Card Payment,5197.029661
19061,717849708,4-13-24 22:28,245.41,Purchase,Restaurant,4951.619661
19062,717849708,4-15-24 19:28,399.99,OutgoingTransfer,Bank Transfer,4551.629661
19063,717849708,4-16-24 22:28,454.67,Deposit,Check Deposit,5006.299661
19064,717849708,4-17-24 21:28,2300,Payment,Rent Payment,2706.299661
19065,717849708,4-17-24 22:28,326.36,Withdrawal,Branch Withdrawal,2379.939661
19066,717849708,4-18-24 20:28,128.74,Withdrawal,ATM Withdrawal,2251.199661
19067,717849708,4-19-24 9:28,60.55,Withdrawal,ATM Withdrawal,2190.649661
19068,717849708,4-22-24 11:28,522.42,OnlineShopping,AliExpress,1668.229661
19069,717849708,4-23-24 15:28,499.52,Withdrawal,Mobile App Withdrawal,1168.709661
19070,717849708,4-23-24 23:28,357.49,Purchase,Clothing,811.2196614
19071,717849708,4-26-24 9:28,496.38,Deposit,Mobile Deposit,1307.599661
19072,717849708,4-27-24 21:28,284.97,Withdrawal,Mobile App Withdrawal,1022.629661
19073,717849708,4-29-24 15:28,316.22,Purchase,Clothing,706.4096614
19074,717849708,05-04-24 21:28,6600,IncomingTransfer,Salary,7306.409661
19075,717849708,05-05-24 22:28,152.94,Withdrawal,Mobile App Withdrawal,7153.469661
19076,717849708,05-06-24 15:28,88.37,OnlineShopping,eBay,7065.099661
19077,717849708,05-06-24 20:28,458.87,Withdrawal,ATM Withdrawal,6606.229661
19078,717849708,05-09-24 21:28,800,Payment,Credit Card Payment,5806.229661
19079,717849708,05-12-24 19:28,143.53,OnlineShopping,eBay,5662.699661
19080,717849708,05-12-24 21:28,3300,Payment,Rent Payment,2362.699661
19081,717849708,5-14-24 18:28,155.57,Return,AliExpress Return,2518.269661
19082,717849708,5-18-24 21:28,539.84,Deposit,Cash Deposit,3058.109661
19083,717849708,5-22-24 13:28,183.14,OutgoingTransfer,Wire Transfer,2874.969661
19084,717849708,5-24-24 18:28,294.22,Purchase,Electronics,2580.749661
19085,717849708,5-27-24 17:28,468.3,OutgoingTransfer,International Transfer,2112.449661
19086,717849708,5-27-24 19:28,427.64,Deposit,Check Deposit,2540.089661
19087,717849708,5-28-24 11:28,443.77,OutgoingTransfer,Wire Transfer,2096.319661
19088,717849708,5-31-24 16:28,509.07,Purchase,Grocery,1587.249661
19089,717849708,06-02-24 18:28,185.56,IncomingTransfer,Freelance Payment,1772.809661
19090,717849708,06-02-24 19:28,82.37,Payment,Loan Payment,1690.439661
19091,717849708,06-05-24 21:28,6600,IncomingTransfer,Salary,8290.439661
19092,717849708,06-06-24 12:28,64.22,Withdrawal,Mobile App Withdrawal,8226.219661
19093,717849708,06-09-24 12:28,215.8,Purchase,Home Improvement,8010.419661
19094,717849708,06-10-24 21:28,1000,Payment,Credit Card Payment,7010.419661
19095,717849708,6-14-24 21:28,3100,Payment,Rent Payment,3910.419661
19096,717849708,6-18-24 9:28,194.06,Withdrawal,ATM Withdrawal,3716.359661
19097,717849708,6-18-24 15:28,408.86,Purchase,Home Improvement,3307.499661
19098,717849708,6-23-24 13:28,346.98,IncomingTransfer,Freelance Payment,3654.479661
19099,717849708,6-28-24 16:28,130.11,OutgoingTransfer,Peer-to-Peer Transfer,3524.369661
19100,717849708,6-30-24 13:28,364.38,Withdrawal,ATM Withdrawal,3159.989661
19101,717849708,07-01-24 23:28,160.07,Payment,Mortgage Payment,2999.919661
19102,717849708,07-02-24 21:28,6600,IncomingTransfer,Salary,9599.919661
19103,717849708,07-05-24 15:28,51.14,OutgoingTransfer,Wire Transfer,9548.779661
19104,717849708,07-05-24 15:28,475.64,Deposit,Direct Deposit,10024.41966
19105,717849708,07-07-24 21:28,900,Payment,Credit Card Payment,9124.419661
19106,717849708,07-09-24 13:28,83.31,Deposit,Cash Deposit,9207.729661
19107,717849708,07-09-24 13:28,226.24,Payment,Bill Payment,8981.489661
19108,717849708,07-11-24 14:28,133.78,Purchase,Pharmacy,8847.709661
19109,717849708,7-13-24 21:28,4100,Payment,Rent Payment,4747.709661
19110,717849708,7-14-24 17:28,211.4,Purchase,Grocery,4536.309661
19111,717849708,7-14-24 19:28,381.64,Purchase,Furniture,4154.669661
19112,717849708,7-14-24 19:28,456.5,Withdrawal,ATM Withdrawal,3698.169661
19113,717849708,7-16-24 14:28,476.79,Deposit,Check Deposit,4174.959661
19114,717849708,7-16-24 21:28,348.73,Purchase,Electronics,3826.229661
19115,717849708,7-17-24 10:28,428.79,Deposit,Direct Deposit,4255.019661
19116,717870108,1-25-24 21:28,54.43,Deposit,Cash Deposit,777.5155932
19117,717870108,1-27-24 22:28,389.46,Deposit,Direct Deposit,1166.975593
19118,717870108,1-31-24 16:28,261.4,Payment,Loan Payment,905.5755932
19119,717870108,02-01-24 15:28,190.5,OutgoingTransfer,Peer-to-Peer Transfer,715.0755932
19120,717870108,02-05-24 21:28,3650,IncomingTransfer,Salary,4365.075593
19121,717870108,02-09-24 9:28,42.54,Purchase,Home Improvement,4322.535593
19122,717870108,02-09-24 19:28,174.15,OutgoingTransfer,International Transfer,4148.385593
19123,717870108,02-10-24 21:28,1600,Payment,Credit Card Payment,2548.385593
19124,717870108,02-11-24 15:28,198.63,Deposit,Direct Deposit,2747.015593
19125,717870108,02-12-24 20:28,41.81,Purchase,Restaurant,2705.205593
19126,717870108,02-12-24 21:28,205.85,Return,Target Return,2911.055593
19127,717870108,2-13-24 21:28,1200,Payment,Rent Payment,1711.055593
19128,717870108,2-14-24 9:28,317.84,Payment,Bill Payment,1393.215593
19129,717870108,2-19-24 11:28,35.84,Withdrawal,Mobile App Withdrawal,1357.375593
19130,717870108,2-23-24 20:28,57.68,OnlineShopping,Amazon,1299.695593
19131,717870108,2-24-24 17:28,52.3,Deposit,Mobile Deposit,1351.995593
19132,717870108,2-24-24 20:28,129.7,Withdrawal,Mobile App Withdrawal,1222.295593
19133,717870108,2-26-24 20:28,278.56,OutgoingTransfer,Wire Transfer,943.7355932
19134,717870108,2-29-24 15:28,276.78,IncomingTransfer,Freelance Payment,1220.515593
19135,717870108,03-01-24 10:28,105.18,Purchase,Pharmacy,1115.335593
19136,717870108,03-01-24 21:28,3650,IncomingTransfer,Salary,4765.335593
19137,717870108,03-02-24 15:28,72.62,Deposit,Check Deposit,4837.955593
19138,717870108,03-04-24 16:28,203.03,Withdrawal,Branch Withdrawal,4634.925593
19139,717870108,03-05-24 15:28,241.13,Payment,Mortgage Payment,4393.795593
19140,717870108,03-05-24 17:28,197.48,OutgoingTransfer,Peer-to-Peer Transfer,4196.315593
19141,717870108,03-06-24 21:28,1700,Payment,Credit Card Payment,2496.315593
19142,717870108,03-08-24 20:28,39.02,IncomingTransfer,Freelance Payment,2535.335593
19143,717870108,03-11-24 12:28,24.59,IncomingTransfer,Freelance Payment,2559.925593
19144,717870108,03-11-24 16:28,211.08,Purchase,Furniture,2348.845593
19145,717870108,03-11-24 20:28,309.14,OnlineShopping,Best Buy,2039.705593
19146,717870108,3-15-24 14:28,133.63,Deposit,Direct Deposit,2173.335593
19147,717870108,3-17-24 21:28,1600,Payment,Rent Payment,573.3355932
19148,717870108,3-18-24 15:28,234.92,OnlineShopping,Etsy,338.4155932
19149,717870108,3-19-24 12:28,371.66,Purchase,Grocery,-33.24440683
19150,717870108,3-19-24 17:28,170.55,Purchase,Furniture,-203.7944068
19151,717870108,3-25-24 17:28,267.96,Purchase,Restaurant,-471.7544068
19152,717870108,3-29-24 18:28,67.03,Deposit,Check Deposit,-404.7244068
19153,717870108,04-01-24 21:28,3650,IncomingTransfer,Salary,3245.275593
19154,717870108,04-06-24 21:28,1600,Payment,Credit Card Payment,1645.275593
19155,717870108,04-08-24 22:28,351.67,Purchase,Electronics,1293.605593
19156,717870108,04-10-24 10:28,29.99,Purchase,Entertainment,1263.615593
19157,717870108,04-11-24 11:28,355.56,Return,Target Return,1619.175593
19158,717870108,04-11-24 18:28,264.74,Deposit,Check Deposit,1883.915593
19159,717870108,4-14-24 11:28,363.6,Purchase,Gas,1520.315593
19160,717870108,4-14-24 21:28,1200,Payment,Rent Payment,320.3155932
19161,717870108,4-18-24 10:28,132.44,Withdrawal,ATM Withdrawal,187.8755932
19162,717870108,4-18-24 19:28,81.85,Payment,Bill Payment,106.0255932
19163,717870108,4-25-24 10:28,51.71,Return,Target Return,157.7355932
19164,717870108,4-25-24 21:28,97.88,Deposit,Direct Deposit,255.6155932
19165,717870108,4-29-24 15:28,156.92,Payment,Mortgage Payment,98.69559317
19166,717870108,4-30-24 18:28,120.57,OnlineShopping,Amazon,-21.87440683
19167,717870108,05-01-24 21:28,3650,IncomingTransfer,Salary,3628.125593
19168,717870108,05-02-24 10:28,238.99,Withdrawal,Branch Withdrawal,3389.135593
19169,717870108,05-02-24 17:28,243.21,Return,Store Return,3632.345593
19170,717870108,05-04-24 14:28,67.89,OutgoingTransfer,International Transfer,3564.455593
19171,717870108,05-05-24 22:28,69.08,OnlineShopping,eBay,3495.375593
19172,717870108,05-06-24 21:28,1400,Payment,Credit Card Payment,2095.375593
19173,717870108,05-07-24 10:28,269.09,Deposit,Direct Deposit,2364.465593
19174,717870108,05-07-24 11:28,202.56,OnlineShopping,AliExpress,2161.905593
19175,717870108,5-15-24 16:28,32.19,OutgoingTransfer,International Transfer,2129.715593
19176,717870108,5-15-24 16:28,323.05,OutgoingTransfer,Wire Transfer,1806.665593
19177,717870108,5-16-24 9:28,21.97,Payment,Mortgage Payment,1784.695593
19178,717870108,5-17-24 21:28,1900,Payment,Rent Payment,-115.3044068
19179,717870108,5-20-24 22:28,295.73,Return,Amazon Return,180.4255932
19180,717870108,5-21-24 20:28,23.28,Deposit,Cash Deposit,203.7055932
19181,717870108,5-24-24 10:28,167.68,Deposit,Mobile Deposit,371.3855932
19182,717870108,5-24-24 18:28,75.76,Purchase,Entertainment,295.6255932
19183,717870108,5-29-24 18:28,128.81,Deposit,Direct Deposit,424.4355932
19184,717870108,5-31-24 15:28,326.33,Deposit,Mobile Deposit,750.7655932
19185,717870108,06-01-24 14:28,193.96,Return,eBay Return,944.7255932
19186,717870108,06-02-24 17:28,69.82,Return,Target Return,1014.545593
19187,717870108,06-02-24 21:28,3650,IncomingTransfer,Salary,4664.545593
19188,717870108,06-07-24 21:28,1400,Payment,Credit Card Payment,3264.545593
19189,717870108,06-07-24 22:28,303.1,OutgoingTransfer,Peer-to-Peer Transfer,2961.445593
19190,717870108,06-08-24 14:28,57.9,Deposit,Mobile Deposit,3019.345593
19191,717870108,06-10-24 14:28,351.79,OnlineShopping,Target,2667.555593
19192,717870108,06-10-24 18:28,136.27,Purchase,Furniture,2531.285593
19193,717870108,06-11-24 9:28,370.96,Purchase,Pharmacy,2160.325593
19194,717870108,06-12-24 13:28,47.36,Purchase,Furniture,2112.965593
19195,717870108,06-12-24 19:28,42.24,Return,Amazon Return,2155.205593
19196,717870108,6-13-24 21:28,1600,Payment,Rent Payment,555.2055932
19197,717870108,6-14-24 14:28,340.74,OutgoingTransfer,International Transfer,214.4655932
19198,717870108,6-14-24 21:28,377.54,Deposit,Cash Deposit,592.0055932
19199,717870108,6-15-24 16:28,255.48,Purchase,Clothing,336.5255932
19200,717870108,6-21-24 15:28,373.75,Return,Walmart Return,710.2755932
19201,717870108,6-26-24 21:28,228.07,Purchase,Electronics,482.2055932
19202,717870108,6-27-24 17:28,295.67,Withdrawal,ATM Withdrawal,186.5355932
19203,717870108,6-27-24 19:28,240.11,Deposit,Direct Deposit,426.6455932
19204,717870108,6-28-24 19:28,100.04,OnlineShopping,AliExpress,326.6055932
19205,717870108,6-29-24 18:28,371.43,Withdrawal,Branch Withdrawal,-44.82440683
19206,717870108,07-03-24 21:28,3650,IncomingTransfer,Salary,3605.175593
19207,717870108,07-04-24 23:28,122.2,Purchase,Pharmacy,3482.975593
19208,717870108,07-07-24 12:28,373.93,IncomingTransfer,Freelance Payment,3856.905593
19209,717870108,07-07-24 22:28,305.35,Return,Store Return,4162.255593
19210,717870108,07-08-24 21:28,1600,Payment,Credit Card Payment,2562.255593
19211,717870108,07-10-24 19:28,70.92,Deposit,Direct Deposit,2633.175593
19212,717870108,07-11-24 14:28,238.81,Payment,Loan Payment,2394.365593
19213,717870108,07-12-24 21:28,2100,Payment,Rent Payment,294.3655932
19214,717870108,7-13-24 16:28,319.85,Withdrawal,ATM Withdrawal,-25.48440683
19215,717890583,1-20-24 10:28,67.44,OutgoingTransfer,Bank Transfer,1099.55102
19216,717890583,1-21-24 15:28,288.05,Return,eBay Return,1387.60102
19217,717890583,1-22-24 23:28,142.08,Return,Walmart Return,1529.68102
19218,717890583,1-24-24 23:28,133.23,OnlineShopping,Best Buy,1396.45102
19219,717890583,1-26-24 17:28,213.38,Deposit,Check Deposit,1609.83102
19220,717890583,1-29-24 16:28,395.82,OutgoingTransfer,International Transfer,1214.01102
19221,717890583,02-01-24 18:28,173.45,Purchase,Gas,1040.56102
19222,717890583,02-02-24 19:28,196.8,Purchase,Entertainment,843.7610196
19223,717890583,02-03-24 21:28,3700,IncomingTransfer,Salary,4543.76102
19224,717890583,02-05-24 21:28,286.76,OutgoingTransfer,International Transfer,4257.00102
19225,717890583,02-08-24 21:28,1800,Payment,Credit Card Payment,2457.00102
19226,717890583,02-09-24 23:28,187.16,Purchase,Clothing,2269.84102
19227,717890583,02-10-24 21:28,54.39,Purchase,Home Improvement,2215.45102
19228,717890583,02-11-24 11:28,61.39,Purchase,Electronics,2154.06102
19229,717890583,2-14-24 16:28,357.88,Deposit,Mobile Deposit,2511.94102
19230,717890583,2-14-24 21:28,2100,Payment,Rent Payment,411.9410196
19231,717890583,2-18-24 12:28,76.31,Deposit,Check Deposit,488.2510196
19232,717890583,2-20-24 10:28,399.67,Purchase,Restaurant,88.58101963
19233,717890583,2-24-24 21:28,279.79,Withdrawal,Mobile App Withdrawal,-191.2089804
19234,717890583,2-25-24 17:28,312.92,OutgoingTransfer,Peer-to-Peer Transfer,-504.1289804
19235,717890583,2-26-24 15:28,167.41,Return,Target Return,-336.7189804
19236,717890583,2-27-24 12:28,223.06,Deposit,Cash Deposit,-113.6589804
19237,717890583,2-27-24 13:28,284.61,Withdrawal,Branch Withdrawal,-398.2689804
19238,717890583,2-28-24 21:28,333.46,Withdrawal,Branch Withdrawal,-731.7289804
19239,717890583,2-29-24 12:28,303.74,IncomingTransfer,Freelance Payment,-427.9889804
19240,717890583,03-04-24 17:28,245.22,OutgoingTransfer,Wire Transfer,-673.2089804
19241,717890583,03-05-24 21:28,3700,IncomingTransfer,Salary,3026.79102
19242,717890583,03-09-24 12:28,223.33,OutgoingTransfer,International Transfer,2803.46102
19243,717890583,03-10-24 21:28,1700,Payment,Credit Card Payment,1103.46102
19244,717890583,3-13-24 20:28,261.26,Deposit,Cash Deposit,1364.72102
19245,717890583,3-13-24 23:28,394.28,Return,Amazon Return,1759.00102
19246,717890583,3-14-24 20:28,45.23,Purchase,Grocery,1713.77102
19247,717890583,3-15-24 17:28,340.98,OnlineShopping,Walmart,1372.79102
19248,717890583,3-17-24 21:28,1500,Payment,Rent Payment,-127.2089804
19249,717890583,3-23-24 19:28,172.03,Withdrawal,Mobile App Withdrawal,-299.2389804
19250,717890583,3-26-24 9:28,111.83,OutgoingTransfer,Peer-to-Peer Transfer,-411.0689804
19251,717890583,3-28-24 14:28,206.08,Purchase,Clothing,-617.1489804
19252,717890583,3-28-24 21:28,269.84,Withdrawal,Mobile App Withdrawal,-886.9889804
19253,717890583,3-30-24 12:28,139.3,Purchase,Travel,-1026.28898
19254,717890583,3-30-24 17:28,178.96,Withdrawal,Branch Withdrawal,-1205.24898
19255,717890583,04-02-24 11:28,344.72,IncomingTransfer,Freelance Payment,-860.5289804
19256,717890583,04-02-24 12:28,122.42,Purchase,Grocery,-982.9489804
19257,717890583,04-02-24 18:28,72.89,OnlineShopping,AliExpress,-1055.83898
19258,717890583,04-03-24 18:28,59.11,Purchase,Electronics,-1114.94898
19259,717890583,04-04-24 21:28,3700,IncomingTransfer,Salary,2585.05102
19260,717890583,04-05-24 22:28,106.62,Purchase,Restaurant,2478.43102
19261,717890583,04-06-24 17:28,353.78,Payment,Mortgage Payment,2124.65102
19262,717890583,04-06-24 18:28,85.03,Deposit,Direct Deposit,2209.68102
19263,717890583,04-08-24 11:28,180.96,OutgoingTransfer,International Transfer,2028.72102
19264,717890583,04-09-24 21:28,2200,Payment,Credit Card Payment,-171.2789804
19265,717890583,4-17-24 10:28,354.2,Purchase,Home Improvement,-525.4789804
19266,717890583,4-17-24 11:28,313.16,OutgoingTransfer,Peer-to-Peer Transfer,-838.6389804
19267,717890583,4-18-24 21:28,2300,Payment,Rent Payment,-3138.63898
19268,717890583,4-19-24 16:28,48.5,Return,Store Return,-3090.13898
19269,717890583,4-21-24 19:28,80.62,Return,Walmart Return,-3009.51898
19270,717890583,4-23-24 21:28,188.92,Deposit,Direct Deposit,-2820.59898
19271,717890583,4-25-24 22:28,391.88,OutgoingTransfer,Bank Transfer,-3212.47898
19272,717890583,4-26-24 11:28,184.98,Return,AliExpress Return,-3027.49898
19273,717890583,4-28-24 20:28,291.33,Withdrawal,Mobile App Withdrawal,-3318.82898
19274,717890583,4-30-24 18:28,246.11,Deposit,Mobile Deposit,-3072.71898
19275,717890583,05-01-24 21:28,3700,IncomingTransfer,Salary,627.2810196
19276,717890583,05-05-24 22:28,38.73,Deposit,Cash Deposit,666.0110196
19277,717890583,05-06-24 18:28,261.14,Deposit,Check Deposit,927.1510196
19278,717890583,05-06-24 21:28,1600,Payment,Credit Card Payment,-672.8489804
19279,717890583,05-08-24 20:28,239.44,Withdrawal,Branch Withdrawal,-912.2889804
19280,717890583,05-09-24 23:28,326.97,IncomingTransfer,Freelance Payment,-585.3189804
19281,717890583,05-11-24 10:28,100.19,OnlineShopping,Walmart,-685.5089804
19282,717890583,05-11-24 21:28,1100,Payment,Rent Payment,-1785.50898
19283,717890583,5-19-24 12:28,132.39,Payment,Bill Payment,-1917.89898
19284,717890583,5-20-24 20:28,164.13,Purchase,Furniture,-2082.02898
19285,717890583,5-21-24 14:28,79.43,Purchase,Travel,-2161.45898
19286,717890583,5-22-24 13:28,355.01,OnlineShopping,eBay,-2516.46898
19287,717890583,5-23-24 11:28,153.92,Deposit,Direct Deposit,-2362.54898
19288,717890583,5-23-24 11:28,299.68,Purchase,Pharmacy,-2662.22898
19289,717890583,5-23-24 22:28,157.75,Return,eBay Return,-2504.47898
19290,717890583,5-24-24 19:28,272.97,OnlineShopping,eBay,-2777.44898
19291,717890583,5-25-24 10:28,36.02,OnlineShopping,eBay,-2813.46898
19292,717890583,5-25-24 20:28,287.56,OnlineShopping,Etsy,-3101.02898
19293,717890583,5-26-24 16:28,256.74,Withdrawal,Mobile App Withdrawal,-3357.76898
19294,717890583,5-27-24 23:28,61.49,OutgoingTransfer,Peer-to-Peer Transfer,-3419.25898
19295,717890583,5-28-24 11:28,179.5,Purchase,Clothing,-3598.75898
19296,717890583,5-28-24 19:28,137.44,OnlineShopping,Walmart,-3736.19898
19297,717890583,5-29-24 14:28,214.97,Deposit,Cash Deposit,-3521.22898
19298,717890583,5-31-24 23:28,179.02,IncomingTransfer,Freelance Payment,-3342.20898
19299,717890583,06-01-24 21:28,367.11,OutgoingTransfer,Wire Transfer,-3709.31898
19300,717890583,06-02-24 14:28,74.52,OutgoingTransfer,Bank Transfer,-3783.83898
19301,717890583,06-03-24 15:28,149.09,Purchase,Travel,-3932.92898
19302,717890583,06-03-24 22:28,243.95,Withdrawal,ATM Withdrawal,-4176.87898
19303,717890583,06-04-24 21:28,3700,IncomingTransfer,Salary,-476.8789804
19304,717890583,06-05-24 12:28,357.78,Deposit,Cash Deposit,-119.0989804
19305,717890583,06-07-24 18:28,245.4,Withdrawal,Mobile App Withdrawal,-364.4989804
19306,717890583,06-09-24 21:28,2300,Payment,Credit Card Payment,-2664.49898
19307,717890583,6-15-24 21:28,1100,Payment,Rent Payment,-3764.49898
19308,717890583,6-16-24 19:28,161.41,Withdrawal,Mobile App Withdrawal,-3925.90898
19309,717890583,6-17-24 12:28,265.41,Purchase,Entertainment,-4191.31898
19310,717890583,6-17-24 12:28,289.05,Deposit,Direct Deposit,-3902.26898
19311,717890583,6-21-24 11:28,172.31,Deposit,Check Deposit,-3729.95898
19312,717890583,6-21-24 14:28,310.49,Withdrawal,Branch Withdrawal,-4040.44898
19313,717890583,6-23-24 15:28,159.03,OutgoingTransfer,Bank Transfer,-4199.47898
19314,717890583,6-23-24 20:28,126.27,OutgoingTransfer,Wire Transfer,-4325.74898
19315,717890583,6-28-24 19:28,113.18,Purchase,Grocery,-4438.92898
19316,717890583,07-02-24 14:28,147.23,Withdrawal,Branch Withdrawal,-4586.15898
19317,717890583,07-03-24 14:28,104.21,Return,Etsy Return,-4481.94898
19318,717890583,07-04-24 21:28,3700,IncomingTransfer,Salary,-781.9489804
19319,717890583,07-05-24 9:28,89.65,Withdrawal,Mobile App Withdrawal,-871.5989804
19320,717890583,07-09-24 21:28,2100,Payment,Credit Card Payment,-2971.59898
19321,717890583,07-12-24 13:28,251,Payment,Loan Payment,-3222.59898
19322,717890583,07-12-24 20:28,63.41,Payment,Bill Payment,-3286.00898
19323,717890583,07-12-24 21:28,1500,Payment,Rent Payment,-4786.00898
19324,717890583,7-16-24 18:28,320.18,Deposit,Cash Deposit,-4465.82898
19325,717890583,7-16-24 21:28,306.98,OutgoingTransfer,International Transfer,-4772.80898
19326,717966933,1-21-24 13:28,281.08,Withdrawal,ATM Withdrawal,711.6016425
19327,717966933,1-21-24 15:28,214.28,Payment,Bill Payment,497.3216425
19328,717966933,1-23-24 14:28,464.82,Purchase,Electronics,32.50164254
19329,717966933,1-24-24 16:28,434.8,Deposit,Direct Deposit,467.3016425
19330,717966933,1-27-24 19:28,380.97,OutgoingTransfer,Bank Transfer,86.33164254
19331,717966933,1-28-24 16:28,200.91,Deposit,Direct Deposit,287.2416425
19332,717966933,1-31-24 19:28,310.37,IncomingTransfer,Freelance Payment,597.6116425
19333,717966933,02-02-24 9:28,454.78,Purchase,Entertainment,142.8316425
19334,717966933,02-02-24 14:28,103.6,Deposit,Direct Deposit,246.4316425
19335,717966933,02-02-24 22:28,30.91,Deposit,Cash Deposit,277.3416425
19336,717966933,02-03-24 21:28,1700,IncomingTransfer,Salary,1977.341643
19337,717966933,02-04-24 13:28,262.44,OutgoingTransfer,Wire Transfer,1714.901643
19338,717966933,02-04-24 19:28,23.95,Purchase,Clothing,1690.951643
19339,717966933,02-06-24 21:28,308.31,IncomingTransfer,Freelance Payment,1999.261643
19340,717966933,02-08-24 21:28,1600,Payment,Credit Card Payment,399.2616425
19341,717966933,2-15-24 21:28,600,Payment,Rent Payment,-200.7383575
19342,717966933,2-16-24 15:28,168.41,Withdrawal,Mobile App Withdrawal,-369.1483575
19343,717966933,2-16-24 20:28,267.49,OutgoingTransfer,Bank Transfer,-636.6383575
19344,717966933,2-18-24 16:28,449.81,Withdrawal,ATM Withdrawal,-1086.448357
19345,717966933,2-22-24 15:28,349.86,Purchase,Home Improvement,-1436.308357
19346,717966933,2-28-24 11:28,239.23,Payment,Mortgage Payment,-1675.538357
19347,717966933,2-29-24 16:28,23.1,Withdrawal,Mobile App Withdrawal,-1698.638357
19348,717966933,03-02-24 11:28,124.8,Purchase,Grocery,-1823.438357
19349,717966933,03-03-24 21:28,1700,IncomingTransfer,Salary,-123.4383575
19350,717966933,03-08-24 21:28,1700,Payment,Credit Card Payment,-1823.438357
19351,717966933,03-09-24 16:28,301.64,Deposit,Mobile Deposit,-1521.798357
19352,717966933,03-11-24 19:28,216.96,Payment,Bill Payment,-1738.758357
19353,717966933,3-13-24 20:28,365.78,Withdrawal,ATM Withdrawal,-2104.538357
19354,717966933,3-13-24 22:28,427.09,OutgoingTransfer,International Transfer,-2531.628357
19355,717966933,3-15-24 18:28,262.73,Deposit,Mobile Deposit,-2268.898357
19356,717966933,3-15-24 21:28,1000,Payment,Rent Payment,-3268.898357
19357,717966933,3-16-24 14:28,449.58,OutgoingTransfer,Peer-to-Peer Transfer,-3718.478357
19358,717966933,3-17-24 14:28,362.92,Payment,Loan Payment,-4081.398357
19359,717966933,3-18-24 21:28,235.77,Deposit,Cash Deposit,-3845.628357
19360,717966933,3-20-24 21:28,30.86,Payment,Mortgage Payment,-3876.488357
19361,717966933,3-24-24 14:28,477.45,Return,Walmart Return,-3399.038357
19362,717966933,3-30-24 19:28,240.63,OnlineShopping,AliExpress,-3639.668357
19363,717966933,3-30-24 20:28,328.1,Return,Target Return,-3311.568357
19364,717966933,04-03-24 11:28,411.93,OnlineShopping,Etsy,-3723.498357
19365,717966933,04-04-24 13:28,444.52,Withdrawal,ATM Withdrawal,-4168.018357
19366,717966933,04-04-24 13:28,114.86,OutgoingTransfer,Bank Transfer,-4282.878357
19367,717966933,04-05-24 15:28,376.71,Purchase,Home Improvement,-4659.588357
19368,717966933,04-05-24 21:28,1700,IncomingTransfer,Salary,-2959.588357
19369,717966933,04-10-24 21:28,2100,Payment,Credit Card Payment,-5059.588357
19370,717966933,04-10-24 22:28,77.43,Purchase,Entertainment,-5137.018357
19371,717966933,4-13-24 18:28,128.85,OnlineShopping,eBay,-5265.868357
19372,717966933,4-15-24 22:28,149.51,OutgoingTransfer,Bank Transfer,-5415.378357
19373,717966933,4-18-24 21:28,800,Payment,Rent Payment,-6215.378357
19374,717966933,4-19-24 14:28,388.41,Withdrawal,Branch Withdrawal,-6603.788357
19375,717966933,4-19-24 15:28,451.1,Purchase,Restaurant,-7054.888357
19376,717966933,4-20-24 20:28,319.35,Deposit,Check Deposit,-6735.538357
19377,717966933,4-21-24 20:28,112.81,Deposit,Cash Deposit,-6622.728357
19378,717966933,4-24-24 17:28,331.16,Return,Store Return,-6291.568357
19379,717966933,4-25-24 11:28,335.48,Withdrawal,Mobile App Withdrawal,-6627.048357
19380,717966933,4-26-24 21:28,23.82,IncomingTransfer,Freelance Payment,-6603.228357
19381,717966933,4-26-24 21:28,91.22,Payment,Mortgage Payment,-6694.448357
19382,717966933,05-02-24 14:28,76.23,Purchase,Home Improvement,-6770.678357
19383,717966933,05-03-24 10:28,62.61,IncomingTransfer,Freelance Payment,-6708.068357
19384,717966933,05-03-24 21:28,1700,IncomingTransfer,Salary,-5008.068357
19385,717966933,05-08-24 21:28,1600,Payment,Credit Card Payment,-6608.068357
19386,717966933,05-09-24 23:28,11.08,Deposit,Mobile Deposit,-6596.988357
19387,717966933,05-10-24 15:28,122.08,Payment,Mortgage Payment,-6719.068357
19388,717966933,5-15-24 21:28,700,Payment,Rent Payment,-7419.068357
19389,717966933,5-15-24 23:28,405.98,Purchase,Travel,-7825.048357
19390,717966933,5-16-24 19:28,408.45,Return,Walmart Return,-7416.598357
19391,717966933,5-17-24 10:28,32.6,Payment,Mortgage Payment,-7449.198357
19392,717966933,5-21-24 9:28,291.66,Purchase,Electronics,-7740.858357
19393,717966933,5-21-24 14:28,364.89,IncomingTransfer,Freelance Payment,-7375.968357
19394,717966933,5-24-24 14:28,372.9,Purchase,Gas,-7748.868357
19395,717966933,5-26-24 13:28,333.84,Deposit,Mobile Deposit,-7415.028357
19396,717966933,5-27-24 23:28,142.22,OutgoingTransfer,Peer-to-Peer Transfer,-7557.248357
19397,717966933,5-30-24 23:28,52.25,Purchase,Pharmacy,-7609.498357
19398,717966933,5-31-24 17:28,202.59,Payment,Bill Payment,-7812.088357
19399,717966933,06-01-24 21:28,1700,IncomingTransfer,Salary,-6112.088357
19400,717966933,06-03-24 16:28,132.47,OnlineShopping,Walmart,-6244.558357
19401,717966933,06-04-24 16:28,190.46,Payment,Loan Payment,-6435.018357
19402,717966933,06-05-24 10:28,86.91,Return,Amazon Return,-6348.108357
19403,717966933,06-06-24 12:28,391.62,OnlineShopping,Walmart,-6739.728357
19404,717966933,06-06-24 21:28,2000,Payment,Credit Card Payment,-8739.728357
19405,717966933,06-08-24 19:28,207,Deposit,Mobile Deposit,-8532.728357
19406,717966933,6-16-24 21:28,700,Payment,Rent Payment,-9232.728357
19407,717966933,6-17-24 12:28,241.81,OutgoingTransfer,Peer-to-Peer Transfer,-9474.538357
19408,717966933,6-19-24 17:28,464.92,Deposit,Mobile Deposit,-9009.618357
19409,717966933,6-21-24 13:28,65.39,IncomingTransfer,Freelance Payment,-8944.228357
19410,717966933,6-21-24 22:28,373.93,IncomingTransfer,Freelance Payment,-8570.298357
19411,717966933,6-26-24 13:28,433.92,Deposit,Check Deposit,-8136.378357
19412,717966933,6-26-24 13:28,403.43,Payment,Loan Payment,-8539.808357
19413,717966933,6-29-24 17:28,402.44,Purchase,Furniture,-8942.248357
19414,717966933,07-01-24 22:28,217.02,IncomingTransfer,Freelance Payment,-8725.228357
19415,717966933,07-03-24 21:28,1700,IncomingTransfer,Salary,-7025.228357
19416,717966933,07-04-24 21:28,93.74,IncomingTransfer,Freelance Payment,-6931.488357
19417,717966933,07-06-24 16:28,466.9,Deposit,Direct Deposit,-6464.588357
19418,717966933,07-08-24 17:28,249.85,Purchase,Home Improvement,-6714.438357
19419,717966933,07-08-24 21:28,1500,Payment,Credit Card Payment,-8214.438357
19420,717966933,07-11-24 10:28,369.46,Deposit,Direct Deposit,-7844.978357
19421,717966933,07-12-24 21:28,500,Payment,Rent Payment,-8344.978357
19422,717966933,07-12-24 22:28,42.18,Return,Walmart Return,-8302.798357
19423,717966933,7-14-24 13:28,68.31,Payment,Bill Payment,-8371.108357
19424,717966933,7-17-24 23:28,28.92,Withdrawal,ATM Withdrawal,-8400.028357
19425,718043583,1-20-24 15:28,259.65,Withdrawal,Mobile App Withdrawal,648.8292184
19426,718043583,1-20-24 18:28,259.25,OutgoingTransfer,Bank Transfer,389.5792184
19427,718043583,1-22-24 12:28,870.51,OutgoingTransfer,Peer-to-Peer Transfer,-480.9307816
19428,718043583,1-23-24 19:28,649.22,OnlineShopping,Best Buy,-1130.150782
19429,718043583,1-24-24 19:28,808.34,OnlineShopping,Etsy,-1938.490782
19430,718043583,1-26-24 16:28,326.82,IncomingTransfer,Freelance Payment,-1611.670782
19431,718043583,1-30-24 9:28,411.59,OnlineShopping,Etsy,-2023.260782
19432,718043583,1-30-24 11:28,815.1,Withdrawal,Mobile App Withdrawal,-2838.360782
19433,718043583,1-30-24 13:28,784.4,Payment,Bill Payment,-3622.760782
19434,718043583,02-01-24 13:28,313.12,Deposit,Direct Deposit,-3309.640782
19435,718043583,02-01-24 21:28,10800,IncomingTransfer,Salary,7490.359218
19436,718043583,02-03-24 21:28,460.2,OutgoingTransfer,International Transfer,7030.159218
19437,718043583,02-04-24 12:28,414.59,Return,eBay Return,7444.749218
19438,718043583,02-04-24 17:28,831.39,Deposit,Cash Deposit,8276.139218
19439,718043583,02-06-24 21:28,2000,Payment,Credit Card Payment,6276.139218
19440,718043583,02-10-24 14:28,789.64,OnlineShopping,Best Buy,5486.499218
19441,718043583,02-10-24 19:28,818.44,Return,Amazon Return,6304.939218
19442,718043583,02-11-24 13:28,267.37,Withdrawal,Mobile App Withdrawal,6037.569218
19443,718043583,02-11-24 22:28,745.42,Return,Walmart Return,6782.989218
19444,718043583,2-13-24 22:28,515.27,OutgoingTransfer,International Transfer,6267.719218
19445,718043583,2-14-24 21:28,3500,Payment,Rent Payment,2767.719218
19446,718043583,2-16-24 17:28,316.98,Deposit,Direct Deposit,3084.699218
19447,718043583,2-17-24 18:28,838.69,Return,Store Return,3923.389218
19448,718043583,2-17-24 18:28,400.18,OutgoingTransfer,Bank Transfer,3523.209218
19449,718043583,2-22-24 18:28,600.88,Deposit,Direct Deposit,4124.089218
19450,718043583,2-24-24 21:28,384.48,OnlineShopping,Best Buy,3739.609218
19451,718043583,2-27-24 23:28,426.17,Return,AliExpress Return,4165.779218
19452,718043583,03-04-24 9:28,262.59,Return,Amazon Return,4428.369218
19453,718043583,03-04-24 14:28,270.12,Return,Walmart Return,4698.489218
19454,718043583,03-04-24 21:28,10800,IncomingTransfer,Salary,15498.48922
19455,718043583,03-06-24 18:28,316.35,Deposit,Check Deposit,15814.83922
19456,718043583,03-06-24 20:28,657.64,OnlineShopping,Best Buy,15157.19922
19457,718043583,03-09-24 21:28,1700,Payment,Credit Card Payment,13457.19922
19458,718043583,03-09-24 21:28,863.01,Deposit,Cash Deposit,14320.20922
19459,718043583,03-12-24 13:28,650.68,Payment,Loan Payment,13669.52922
19460,718043583,03-12-24 21:28,5800,Payment,Rent Payment,7869.529218
19461,718043583,3-16-24 15:28,808.39,Withdrawal,Mobile App Withdrawal,7061.139218
19462,718043583,3-24-24 13:28,371.75,Payment,Mortgage Payment,6689.389218
19463,718043583,3-24-24 20:28,484.98,Deposit,Check Deposit,7174.369218
19464,718043583,3-24-24 21:28,207.56,Withdrawal,Mobile App Withdrawal,6966.809218
19465,718043583,3-25-24 22:28,273.1,Deposit,Cash Deposit,7239.909218
19466,718043583,3-27-24 20:28,277.64,IncomingTransfer,Freelance Payment,7517.549218
19467,718043583,04-02-24 10:28,816.87,Payment,Bill Payment,6700.679218
19468,718043583,04-02-24 21:28,481.34,OnlineShopping,eBay,6219.339218
19469,718043583,04-03-24 10:28,899.68,Return,Best Buy Return,7119.019218
19470,718043583,04-04-24 21:28,10800,IncomingTransfer,Salary,17919.01922
19471,718043583,04-05-24 9:28,359.66,IncomingTransfer,Freelance Payment,18278.67922
19472,718043583,04-08-24 12:28,455.95,Return,Best Buy Return,18734.62922
19473,718043583,04-08-24 13:28,868.47,Deposit,Mobile Deposit,19603.09922
19474,718043583,04-08-24 22:28,760.74,OnlineShopping,Etsy,18842.35922
19475,718043583,04-09-24 15:28,446.24,Withdrawal,Mobile App Withdrawal,18396.11922
19476,718043583,04-09-24 21:28,1900,Payment,Credit Card Payment,16496.11922
19477,718043583,04-09-24 22:28,900.14,Purchase,Restaurant,15595.97922
19478,718043583,04-11-24 15:28,427.76,Withdrawal,ATM Withdrawal,15168.21922
19479,718043583,4-13-24 22:28,328.45,OutgoingTransfer,Bank Transfer,14839.76922
19480,718043583,4-14-24 10:28,853.34,Deposit,Mobile Deposit,15693.10922
19481,718043583,4-14-24 19:28,325.37,OutgoingTransfer,Peer-to-Peer Transfer,15367.73922
19482,718043583,4-15-24 12:28,781.47,OutgoingTransfer,Peer-to-Peer Transfer,14586.26922
19483,718043583,4-16-24 21:28,4400,Payment,Rent Payment,10186.26922
19484,718043583,4-18-24 11:28,669.38,Withdrawal,Mobile App Withdrawal,9516.889218
19485,718043583,4-18-24 14:28,587.67,Purchase,Gas,8929.219218
19486,718043583,4-18-24 21:28,936.49,Return,Etsy Return,9865.709218
19487,718043583,4-19-24 11:28,355.67,Withdrawal,ATM Withdrawal,9510.039218
19488,718043583,4-21-24 13:28,913.89,OutgoingTransfer,Bank Transfer,8596.149218
19489,718043583,4-21-24 19:28,449.08,Purchase,Travel,8147.069218
19490,718043583,4-22-24 12:28,651.77,Deposit,Mobile Deposit,8798.839218
19491,718043583,4-23-24 11:28,528.54,OutgoingTransfer,Wire Transfer,8270.299218
19492,718043583,4-24-24 13:28,908.71,Purchase,Gas,7361.589218
19493,718043583,4-25-24 9:28,792.41,Deposit,Mobile Deposit,8153.999218
19494,718043583,4-25-24 19:28,675.96,IncomingTransfer,Freelance Payment,8829.959218
19495,718043583,4-27-24 12:28,771.61,Deposit,Mobile Deposit,9601.569218
19496,718043583,4-27-24 18:28,771.18,Deposit,Mobile Deposit,10372.74922
19497,718043583,4-30-24 13:28,818.7,Payment,Loan Payment,9554.049218
19498,718043583,4-30-24 18:28,703.4,OnlineShopping,Best Buy,8850.649218
19499,718043583,4-30-24 18:28,272.95,Deposit,Check Deposit,9123.599218
19500,718043583,4-30-24 19:28,638.21,Return,AliExpress Return,9761.809218
19501,718043583,05-01-24 20:28,332.95,IncomingTransfer,Freelance Payment,10094.75922
19502,718043583,05-02-24 19:28,526.53,Deposit,Cash Deposit,10621.28922
19503,718043583,05-05-24 15:28,519.92,OutgoingTransfer,International Transfer,10101.36922
19504,718043583,05-05-24 21:28,10800,IncomingTransfer,Salary,20901.36922
19505,718043583,05-07-24 9:28,465.3,Withdrawal,Branch Withdrawal,20436.06922
19506,718043583,05-08-24 23:28,898.02,OutgoingTransfer,Peer-to-Peer Transfer,19538.04922
19507,718043583,05-10-24 16:28,815.6,OutgoingTransfer,International Transfer,18722.44922
19508,718043583,05-10-24 21:28,1800,Payment,Credit Card Payment,16922.44922
19509,718043583,05-12-24 15:28,405.12,Deposit,Mobile Deposit,17327.56922
19510,718043583,5-14-24 9:28,892.86,Withdrawal,Branch Withdrawal,16434.70922
19511,718043583,5-14-24 12:28,942.2,OutgoingTransfer,Peer-to-Peer Transfer,15492.50922
19512,718043583,5-16-24 17:28,292.32,Withdrawal,Branch Withdrawal,15200.18922
19513,718043583,5-18-24 21:28,4000,Payment,Rent Payment,11200.18922
19514,718043583,5-21-24 15:28,675.22,Payment,Loan Payment,10524.96922
19515,718043583,5-22-24 19:28,207.33,IncomingTransfer,Freelance Payment,10732.29922
19516,718043583,5-22-24 23:28,677.25,Deposit,Mobile Deposit,11409.54922
19517,718043583,5-25-24 18:28,568.16,Deposit,Direct Deposit,11977.70922
19518,718043583,5-27-24 22:28,455.19,Deposit,Cash Deposit,12432.89922
19519,718043583,5-30-24 17:28,746.85,Withdrawal,Branch Withdrawal,11686.04922
19520,718043583,5-31-24 12:28,693.46,Payment,Bill Payment,10992.58922
19521,718043583,06-01-24 10:28,230.77,Withdrawal,ATM Withdrawal,10761.81922
19522,718043583,06-02-24 13:28,407.56,Withdrawal,ATM Withdrawal,10354.25922
19523,718043583,06-02-24 19:28,670.37,Deposit,Check Deposit,11024.62922
19524,718043583,06-03-24 10:28,598.18,Return,Target Return,11622.80922
19525,718043583,06-04-24 11:28,522.25,Payment,Loan Payment,11100.55922
19526,718043583,06-04-24 21:28,906.05,Return,Etsy Return,12006.60922
19527,718043583,06-05-24 21:28,10800,IncomingTransfer,Salary,22806.60922
19528,718043583,06-09-24 11:28,344.41,Purchase,Electronics,22462.19922
19529,718043583,06-09-24 12:28,258.33,Payment,Bill Payment,22203.86922
19530,718043583,06-09-24 20:28,743.89,OnlineShopping,Etsy,21459.97922
19531,718043583,06-10-24 21:28,1900,Payment,Credit Card Payment,19559.97922
19532,718043583,06-11-24 15:28,615.86,OnlineShopping,Best Buy,18944.11922
19533,718043583,06-11-24 21:28,4500,Payment,Rent Payment,14444.11922
19534,718043583,06-12-24 19:28,374.94,Withdrawal,Mobile App Withdrawal,14069.17922
19535,718043583,6-16-24 18:28,935.9,Payment,Loan Payment,13133.27922
19536,718043583,6-16-24 21:28,608.28,Deposit,Direct Deposit,13741.55922
19537,718043583,6-19-24 14:28,232.43,Withdrawal,ATM Withdrawal,13509.12922
19538,718043583,6-20-24 18:28,264.62,OutgoingTransfer,Peer-to-Peer Transfer,13244.50922
19539,718043583,6-22-24 15:28,719.6,OnlineShopping,eBay,12524.90922
19540,718043583,6-25-24 18:28,282.33,Deposit,Check Deposit,12807.23922
19541,718043583,6-26-24 12:28,432.82,Return,Store Return,13240.05922
19542,718043583,6-28-24 13:28,465.83,Payment,Bill Payment,12774.22922
19543,718043583,07-03-24 10:28,318.89,Return,Etsy Return,13093.11922
19544,718043583,07-03-24 21:28,10800,IncomingTransfer,Salary,23893.11922
19545,718043583,07-04-24 12:28,644.25,Return,eBay Return,24537.36922
19546,718043583,07-07-24 15:28,341.91,Return,Walmart Return,24879.27922
19547,718043583,07-07-24 19:28,728.08,Return,Store Return,25607.35922
19548,718043583,07-08-24 13:28,528.97,Return,Walmart Return,26136.32922
19549,718043583,07-08-24 21:28,1800,Payment,Credit Card Payment,24336.32922
19550,718043583,07-09-24 12:28,627.24,OnlineShopping,Target,23709.08922
19551,718043583,07-10-24 14:28,517.35,Withdrawal,Mobile App Withdrawal,23191.73922
19552,718043583,07-11-24 16:28,818.18,Return,Amazon Return,24009.91922
19553,718043583,07-12-24 15:28,283.88,Purchase,Restaurant,23726.03922
19554,718043583,7-13-24 12:28,447.62,Deposit,Direct Deposit,24173.65922
19555,718043583,7-13-24 21:28,4600,Payment,Rent Payment,19573.65922
19556,718043583,7-15-24 10:28,660,OnlineShopping,eBay,18913.65922
19557,718043583,7-16-24 18:28,862.88,Deposit,Cash Deposit,19776.53922
19558,718043583,7-17-24 11:28,905.19,Purchase,Entertainment,18871.34922
19559,718199133,1-31-24 15:28,220.41,Return,Target Return,1979.713606
19560,718199133,02-03-24 14:28,592.05,Payment,Loan Payment,1387.663606
19561,718199133,02-04-24 19:28,722.49,Return,Etsy Return,2110.153606
19562,718199133,02-04-24 21:28,8550,IncomingTransfer,Salary,10660.15361
19563,718199133,02-06-24 17:28,501.23,Purchase,Electronics,10158.92361
19564,718199133,02-09-24 21:28,2400,Payment,Credit Card Payment,7758.923606
19565,718199133,2-15-24 17:28,539.98,IncomingTransfer,Freelance Payment,8298.903606
19566,718199133,2-17-24 21:28,2200,Payment,Insurance Payment,6098.903606
19567,718199133,2-18-24 15:28,344.03,Deposit,Check Deposit,6442.933606
19568,718199133,2-21-24 9:28,272.84,Deposit,Mobile Deposit,6715.773606
19569,718199133,2-24-24 12:28,503.44,Payment,Loan Payment,6212.333606
19570,718199133,03-04-24 21:28,8550,IncomingTransfer,Salary,14762.33361
19571,718199133,03-09-24 21:28,3200,Payment,Credit Card Payment,11562.33361
19572,718199133,03-10-24 13:28,273.16,OutgoingTransfer,International Transfer,11289.17361
19573,718199133,03-11-24 21:28,2200,Payment,Subscription Payment,9089.173606
19574,718199133,03-12-24 9:28,260.16,Purchase,Clothing,8829.013606
19575,718199133,3-14-24 19:28,739.02,OnlineShopping,eBay,8089.993606
19576,718199133,3-15-24 22:28,194.02,Return,Target Return,8284.013606
19577,718199133,3-16-24 14:28,330.99,Deposit,Check Deposit,8615.003606
19578,718199133,04-01-24 21:28,8550,IncomingTransfer,Salary,17165.00361
19579,718199133,04-06-24 21:28,2800,Payment,Credit Card Payment,14365.00361
19580,718199133,04-09-24 17:28,173.01,Deposit,Mobile Deposit,14538.01361
19581,718199133,04-11-24 10:28,121.36,Payment,Bill Payment,14416.65361
19582,718199133,4-17-24 21:28,2900,Payment,Installment Payment,11516.65361
19583,718199133,4-27-24 14:28,153.16,Deposit,Mobile Deposit,11669.81361
19584,718199133,05-05-24 21:28,8550,IncomingTransfer,Salary,20219.81361
19585,718199133,05-10-24 21:28,3200,Payment,Credit Card Payment,17019.81361
19586,718199133,05-12-24 18:28,468.23,Return,Best Buy Return,17488.04361
19587,718199133,5-14-24 21:28,3600,Payment,Insurance Payment,13888.04361
19588,718199133,5-17-24 10:28,304.23,Payment,Loan Payment,13583.81361
19589,718199133,5-17-24 21:28,573.74,Purchase,Travel,13010.07361
19590,718199133,5-20-24 13:28,268.58,Deposit,Check Deposit,13278.65361
19591,718199133,5-30-24 19:28,234.72,Purchase,Grocery,13043.93361
19592,718199133,06-01-24 19:28,358.3,Return,eBay Return,13402.23361
19593,718199133,06-03-24 21:28,8550,IncomingTransfer,Salary,21952.23361
19594,718199133,06-08-24 21:28,3200,Payment,Credit Card Payment,18752.23361
19595,718199133,06-10-24 23:28,546.97,OutgoingTransfer,Peer-to-Peer Transfer,18205.26361
19596,718199133,6-13-24 22:28,356.86,OnlineShopping,Target,17848.40361
19597,718199133,6-15-24 21:28,3800,Payment,Installment Payment,14048.40361
19598,718199133,6-18-24 11:28,230.23,Deposit,Mobile Deposit,14278.63361
19599,718199133,6-27-24 22:28,498.29,Deposit,Check Deposit,14776.92361
19600,718199133,6-28-24 10:28,160.48,IncomingTransfer,Freelance Payment,14937.40361
19601,718199133,6-29-24 14:28,557.17,Return,eBay Return,15494.57361
19602,718199133,07-03-24 21:28,8550,IncomingTransfer,Salary,24044.57361
19603,718199133,07-04-24 15:28,519.03,Purchase,Furniture,23525.54361
19604,718199133,07-07-24 12:28,494.59,Return,Walmart Return,24020.13361
19605,718199133,07-08-24 21:28,3100,Payment,Credit Card Payment,20920.13361
19606,718199133,07-09-24 19:28,130.5,Withdrawal,Branch Withdrawal,20789.63361
19607,718199133,7-14-24 21:28,2400,Payment,Insurance Payment,18389.63361
19608,718246458,1-21-24 15:28,225.56,Purchase,Home Improvement,821.4980302
19609,718246458,1-21-24 20:28,568.17,Payment,Bill Payment,253.3280302
19610,718246458,1-26-24 17:28,115.77,OutgoingTransfer,Peer-to-Peer Transfer,137.5580302
19611,718246458,1-28-24 21:28,209.38,Withdrawal,ATM Withdrawal,-71.82196984
19612,718246458,1-30-24 19:28,160.93,Deposit,Check Deposit,89.10803016
19613,718246458,1-31-24 20:28,675.29,Return,AliExpress Return,764.3980302
19614,718246458,02-01-24 21:28,8800,IncomingTransfer,Salary,9564.39803
19615,718246458,02-03-24 11:28,702.07,Deposit,Mobile Deposit,10266.46803
19616,718246458,02-04-24 11:28,482.23,OnlineShopping,Target,9784.23803
19617,718246458,02-04-24 22:28,244.44,OutgoingTransfer,International Transfer,9539.79803
19618,718246458,02-05-24 16:28,350.29,Withdrawal,Branch Withdrawal,9189.50803
19619,718246458,02-06-24 19:28,179.74,Withdrawal,Branch Withdrawal,9009.76803
19620,718246458,02-06-24 21:28,2200,Payment,Credit Card Payment,6809.76803
19621,718246458,02-08-24 10:28,588.82,OutgoingTransfer,Bank Transfer,6220.94803
19622,718246458,02-09-24 9:28,424.33,OutgoingTransfer,Wire Transfer,5796.61803
19623,718246458,2-15-24 21:28,2300,Payment,Rent Payment,3496.61803
19624,718246458,2-20-24 21:28,189.87,Payment,Mortgage Payment,3306.74803
19625,718246458,2-26-24 15:28,601.47,OutgoingTransfer,Peer-to-Peer Transfer,2705.27803
19626,718246458,03-01-24 11:28,352.59,Deposit,Cash Deposit,3057.86803
19627,718246458,03-01-24 21:28,8800,IncomingTransfer,Salary,11857.86803
19628,718246458,03-02-24 10:28,140.84,Return,Walmart Return,11998.70803
19629,718246458,03-03-24 13:28,247.09,OutgoingTransfer,International Transfer,11751.61803
19630,718246458,03-05-24 15:28,377.54,Purchase,Clothing,11374.07803
19631,718246458,03-05-24 22:28,241.8,OnlineShopping,Walmart,11132.27803
19632,718246458,03-06-24 11:28,712.86,Deposit,Check Deposit,11845.13803
19633,718246458,03-06-24 21:28,2200,Payment,Credit Card Payment,9645.13803
19634,718246458,03-07-24 19:28,434.4,Purchase,Pharmacy,9210.73803
19635,718246458,03-08-24 18:28,738.97,Return,Etsy Return,9949.70803
19636,718246458,03-09-24 17:28,422.93,Purchase,Grocery,9526.77803
19637,718246458,03-12-24 15:28,150.92,Purchase,Clothing,9375.85803
19638,718246458,3-14-24 21:28,3500,Payment,Rent Payment,5875.85803
19639,718246458,3-17-24 11:28,141.39,Purchase,Home Improvement,5734.46803
19640,718246458,3-17-24 22:28,694.37,Withdrawal,Branch Withdrawal,5040.09803
19641,718246458,3-18-24 19:28,515.99,OnlineShopping,eBay,4524.10803
19642,718246458,3-18-24 19:28,502.68,Purchase,Restaurant,4021.42803
19643,718246458,3-18-24 22:28,402.65,Purchase,Clothing,3618.77803
19644,718246458,3-20-24 10:28,643.75,Deposit,Cash Deposit,4262.52803
19645,718246458,3-22-24 18:28,517.85,Withdrawal,Branch Withdrawal,3744.67803
19646,718246458,3-23-24 16:28,542.88,OutgoingTransfer,Peer-to-Peer Transfer,3201.79803
19647,718246458,3-23-24 21:28,229.9,Return,Store Return,3431.69803
19648,718246458,3-25-24 16:28,529.3,Deposit,Mobile Deposit,3960.99803
19649,718246458,3-27-24 11:28,415.72,OutgoingTransfer,Bank Transfer,3545.27803
19650,718246458,3-27-24 11:28,743.97,Purchase,Travel,2801.30803
19651,718246458,3-27-24 16:28,250.01,Purchase,Entertainment,2551.29803
19652,718246458,3-27-24 22:28,140.19,Payment,Bill Payment,2411.10803
19653,718246458,3-31-24 10:28,328.26,Payment,Bill Payment,2082.84803
19654,718246458,3-31-24 13:28,474.09,OnlineShopping,Best Buy,1608.75803
19655,718246458,04-04-24 19:28,695.58,Payment,Loan Payment,913.1780302
19656,718246458,04-04-24 21:28,8800,IncomingTransfer,Salary,9713.17803
19657,718246458,04-06-24 18:28,236.95,Return,Walmart Return,9950.12803
19658,718246458,04-08-24 23:28,490.6,Purchase,Clothing,9459.52803
19659,718246458,04-09-24 21:28,2400,Payment,Credit Card Payment,7059.52803
19660,718246458,04-10-24 11:28,386.92,OnlineShopping,Walmart,6672.60803
19661,718246458,04-10-24 13:28,666.07,OutgoingTransfer,Peer-to-Peer Transfer,6006.53803
19662,718246458,04-12-24 12:28,242.2,Return,AliExpress Return,6248.73803
19663,718246458,4-13-24 13:28,314.53,Withdrawal,Mobile App Withdrawal,5934.20803
19664,718246458,4-15-24 10:28,500.55,Withdrawal,ATM Withdrawal,5433.65803
19665,718246458,4-17-24 21:28,2800,Payment,Rent Payment,2633.65803
19666,718246458,4-18-24 21:28,447.42,Return,eBay Return,3081.07803
19667,718246458,4-19-24 21:28,256.89,Purchase,Home Improvement,2824.18803
19668,718246458,4-21-24 16:28,370.56,Withdrawal,Mobile App Withdrawal,2453.62803
19669,718246458,4-22-24 10:28,721.41,Purchase,Home Improvement,1732.21803
19670,718246458,4-24-24 11:28,128.73,Payment,Bill Payment,1603.48803
19671,718246458,4-26-24 13:28,591.08,Deposit,Check Deposit,2194.56803
19672,718246458,4-26-24 16:28,676.34,Return,AliExpress Return,2870.90803
19673,718246458,4-27-24 10:28,197.12,Purchase,Grocery,2673.78803
19674,718246458,4-27-24 13:28,212.62,Payment,Mortgage Payment,2461.16803
19675,718246458,4-27-24 15:28,251.37,Payment,Bill Payment,2209.79803
19676,718246458,4-28-24 13:28,146.11,OutgoingTransfer,Bank Transfer,2063.68803
19677,718246458,4-28-24 14:28,339.97,OutgoingTransfer,Bank Transfer,1723.71803
19678,718246458,05-01-24 21:28,8800,IncomingTransfer,Salary,10523.71803
19679,718246458,05-02-24 21:28,532.41,Purchase,Entertainment,9991.30803
19680,718246458,05-02-24 22:28,694.07,Return,AliExpress Return,10685.37803
19681,718246458,05-03-24 19:28,225.98,Withdrawal,ATM Withdrawal,10459.39803
19682,718246458,05-06-24 21:28,2500,Payment,Credit Card Payment,7959.39803
19683,718246458,05-07-24 11:28,583.62,Payment,Mortgage Payment,7375.77803
19684,718246458,05-07-24 23:28,593.46,IncomingTransfer,Freelance Payment,7969.23803
19685,718246458,05-09-24 22:28,483.19,Payment,Bill Payment,7486.04803
19686,718246458,05-12-24 11:28,629.99,OnlineShopping,AliExpress,6856.05803
19687,718246458,05-12-24 14:28,146.95,IncomingTransfer,Freelance Payment,7003.00803
19688,718246458,5-13-24 12:28,680.01,Purchase,Restaurant,6322.99803
19689,718246458,5-14-24 14:28,732.52,Return,Etsy Return,7055.51803
19690,718246458,5-14-24 22:28,204.35,OutgoingTransfer,Bank Transfer,6851.16803
19691,718246458,5-15-24 9:28,211.48,OnlineShopping,Best Buy,6639.68803
19692,718246458,5-18-24 14:28,468.12,Return,Store Return,7107.80803
19693,718246458,5-18-24 21:28,3600,Payment,Rent Payment,3507.80803
19694,718246458,5-21-24 14:28,568.59,Withdrawal,ATM Withdrawal,2939.21803
19695,718246458,5-24-24 14:28,634.07,Return,Store Return,3573.28803
19696,718246458,5-25-24 16:28,747.17,OnlineShopping,Best Buy,2826.11803
19697,718246458,5-26-24 12:28,497.5,Purchase,Gas,2328.61803
19698,718246458,5-26-24 17:28,304.9,Deposit,Cash Deposit,2633.51803
19699,718246458,5-29-24 18:28,248.49,Withdrawal,Branch Withdrawal,2385.02803
19700,718246458,5-31-24 23:28,261.32,Withdrawal,ATM Withdrawal,2123.70803
19701,718246458,06-03-24 19:28,126.42,Return,eBay Return,2250.12803
19702,718246458,06-04-24 12:28,258.69,Deposit,Direct Deposit,2508.81803
19703,718246458,06-05-24 10:28,582.41,Deposit,Mobile Deposit,3091.22803
19704,718246458,06-05-24 10:28,614.3,OnlineShopping,Best Buy,2476.92803
19705,718246458,06-05-24 21:28,8800,IncomingTransfer,Salary,11276.92803
19706,718246458,06-07-24 11:28,533.64,Deposit,Cash Deposit,11810.56803
19707,718246458,06-10-24 21:28,2200,Payment,Credit Card Payment,9610.56803
19708,718246458,6-15-24 10:28,357.92,Deposit,Mobile Deposit,9968.48803
19709,718246458,6-17-24 9:28,483.01,Deposit,Cash Deposit,10451.49803
19710,718246458,6-17-24 21:28,4500,Payment,Rent Payment,5951.49803
19711,718246458,6-18-24 16:28,156.75,Payment,Loan Payment,5794.74803
19712,718246458,6-19-24 11:28,601.69,Withdrawal,Mobile App Withdrawal,5193.05803
19713,718246458,6-20-24 21:28,689.95,Return,AliExpress Return,5883.00803
19714,718246458,6-21-24 11:28,309.16,Return,Target Return,6192.16803
19715,718246458,6-21-24 14:28,632.65,OnlineShopping,Etsy,5559.51803
19716,718246458,6-21-24 21:28,645.6,Withdrawal,ATM Withdrawal,4913.91803
19717,718246458,6-23-24 20:28,472.42,Withdrawal,ATM Withdrawal,4441.49803
19718,718246458,6-24-24 9:28,354.86,Payment,Mortgage Payment,4086.63803
19719,718246458,6-26-24 23:28,654.92,OutgoingTransfer,Wire Transfer,3431.71803
19720,718246458,6-28-24 13:28,732.3,Purchase,Entertainment,2699.41803
19721,718246458,6-28-24 16:28,112.79,Return,Store Return,2812.20803
19722,718246458,07-01-24 19:28,620.42,Deposit,Mobile Deposit,3432.62803
19723,718246458,07-02-24 15:28,552.94,Purchase,Pharmacy,2879.68803
19724,718246458,07-04-24 17:28,296.22,Deposit,Mobile Deposit,3175.90803
19725,718246458,07-05-24 21:28,8800,IncomingTransfer,Salary,11975.90803
19726,718246458,07-10-24 16:28,658.35,Deposit,Direct Deposit,12634.25803
19727,718246458,07-10-24 21:28,2300,Payment,Credit Card Payment,10334.25803
19728,718246458,7-14-24 22:28,695.56,Withdrawal,ATM Withdrawal,9638.69803
19729,718246458,7-15-24 12:28,128.87,Deposit,Check Deposit,9767.56803
19730,718246458,7-16-24 21:28,5400,Payment,Rent Payment,4367.56803
19731,718259433,1-21-24 10:28,392.41,Purchase,Gas,-392.41
19732,718259433,1-21-24 21:28,275.4,Withdrawal,ATM Withdrawal,-667.81
19733,718259433,1-27-24 13:28,45.44,Withdrawal,ATM Withdrawal,-713.25
19734,718259433,1-29-24 12:28,370.46,OnlineShopping,eBay,-1083.71
19735,718259433,02-01-24 18:28,34.33,Withdrawal,Mobile App Withdrawal,-1118.04
19736,718259433,02-03-24 15:28,461.43,Purchase,Clothing,-1579.47
19737,718259433,02-03-24 21:28,2800,IncomingTransfer,Salary,1220.53
19738,718259433,02-09-24 19:28,228.46,Return,Best Buy Return,1448.99
19739,718259433,02-12-24 10:28,96.16,Purchase,Travel,1352.83
19740,718259433,02-12-24 18:28,409.15,Purchase,Restaurant,943.68
19741,718259433,2-15-24 12:28,63.47,Withdrawal,Branch Withdrawal,880.21
19742,718259433,2-16-24 21:28,1200,Payment,Insurance Payment,-319.79
19743,718259433,2-17-24 13:28,116.99,Deposit,Mobile Deposit,-202.8
19744,718259433,2-23-24 23:28,218.47,Withdrawal,Branch Withdrawal,-421.27
19745,718259433,2-25-24 11:28,50.07,Purchase,Restaurant,-471.34
19746,718259433,2-26-24 16:28,232.27,IncomingTransfer,Freelance Payment,-239.07
19747,718259433,03-01-24 12:28,190.36,Deposit,Cash Deposit,-48.71
19748,718259433,03-01-24 21:28,2800,IncomingTransfer,Salary,2751.29
19749,718259433,03-06-24 18:28,255.56,Purchase,Gas,2495.73
19750,718259433,03-07-24 19:28,412.99,Purchase,Home Improvement,2082.74
19751,718259433,03-07-24 21:28,38.28,Purchase,Pharmacy,2044.46
19752,718259433,03-10-24 19:28,431.82,Return,Etsy Return,2476.28
19753,718259433,03-11-24 20:28,205.53,Purchase,Clothing,2270.75
19754,718259433,03-12-24 10:28,250.78,Deposit,Cash Deposit,2521.53
19755,718259433,3-15-24 21:28,1200,Payment,Installment Payment,1321.53
19756,718259433,3-21-24 9:28,155.53,Purchase,Grocery,1166
19757,718259433,3-22-24 14:28,429.21,Deposit,Check Deposit,1595.21
19758,718259433,3-25-24 23:28,101.17,OutgoingTransfer,International Transfer,1494.04
19759,718259433,3-27-24 14:28,104.17,Deposit,Cash Deposit,1598.21
19760,718259433,3-28-24 13:28,380.36,Purchase,Gas,1217.85
19761,718259433,3-31-24 15:28,307.68,Purchase,Grocery,910.17
19762,718259433,04-01-24 21:28,2800,IncomingTransfer,Salary,3710.17
19763,718259433,04-03-24 21:28,103.96,Withdrawal,Mobile App Withdrawal,3606.21
19764,718259433,04-05-24 15:28,292.92,Payment,Bill Payment,3313.29
19765,718259433,04-07-24 14:28,105.89,Payment,Loan Payment,3207.4
19766,718259433,04-08-24 22:28,163.75,Deposit,Check Deposit,3371.15
19767,718259433,04-11-24 20:28,360.3,Deposit,Mobile Deposit,3731.45
19768,718259433,4-15-24 19:28,398.31,Deposit,Mobile Deposit,4129.76
19769,718259433,4-18-24 15:28,243.39,Withdrawal,Branch Withdrawal,3886.37
19770,718259433,4-18-24 21:28,1000,Payment,Insurance Payment,2886.37
19771,718259433,4-19-24 23:28,184.07,OutgoingTransfer,Bank Transfer,2702.3
19772,718259433,4-21-24 18:28,462.32,Return,Target Return,3164.62
19773,718259433,4-21-24 19:28,225.12,IncomingTransfer,Freelance Payment,3389.74
19774,718259433,4-23-24 12:28,335.43,Return,Best Buy Return,3725.17
19775,718259433,4-23-24 13:28,352.93,Payment,Loan Payment,3372.24
19776,718259433,05-02-24 21:28,2800,IncomingTransfer,Salary,6172.24
19777,718259433,05-03-24 19:28,354.88,Payment,Bill Payment,5817.36
19778,718259433,05-10-24 21:28,1300,Payment,Insurance Payment,4517.36
19779,718259433,5-13-24 14:28,323.06,Purchase,Clothing,4194.3
19780,718259433,5-14-24 19:28,191.7,OutgoingTransfer,International Transfer,4002.6
19781,718259433,5-16-24 9:28,459.13,Deposit,Direct Deposit,4461.73
19782,718259433,5-16-24 12:28,148.98,Payment,Bill Payment,4312.75
19783,718259433,5-17-24 12:28,368.21,Payment,Bill Payment,3944.54
19784,718259433,5-25-24 12:28,162.37,Deposit,Cash Deposit,4106.91
19785,718259433,5-28-24 17:28,261.75,OnlineShopping,Target,3845.16
19786,718259433,5-29-24 18:28,379.62,OutgoingTransfer,International Transfer,3465.54
19787,718259433,06-01-24 16:28,447.18,OnlineShopping,Amazon,3018.36
19788,718259433,06-03-24 21:28,2800,IncomingTransfer,Salary,5818.36
19789,718259433,06-05-24 10:28,117.01,OnlineShopping,Walmart,5701.35
19790,718259433,06-06-24 14:28,460.96,Deposit,Direct Deposit,6162.31
19791,718259433,06-07-24 18:28,151.09,OnlineShopping,Best Buy,6011.22
19792,718259433,06-11-24 9:28,155.74,Purchase,Home Improvement,5855.48
19793,718259433,06-12-24 21:28,1000,Payment,Installment Payment,4855.48
19794,718259433,6-14-24 18:28,336.65,Withdrawal,Branch Withdrawal,4518.83
19795,718259433,6-24-24 13:28,66.55,Return,Best Buy Return,4585.38
19796,718259433,6-25-24 12:28,312.69,Withdrawal,ATM Withdrawal,4272.69
19797,718259433,6-26-24 17:28,284.63,Withdrawal,ATM Withdrawal,3988.06
19798,718259433,6-29-24 15:28,494.58,Return,AliExpress Return,4482.64
19799,718259433,07-03-24 10:28,56.39,Return,Target Return,4539.03
19800,718259433,07-04-24 9:28,328.09,Deposit,Cash Deposit,4867.12
19801,718259433,07-04-24 21:28,2800,IncomingTransfer,Salary,7667.12
19802,718259433,07-08-24 20:28,421.1,Deposit,Cash Deposit,8088.22
19803,718259433,7-15-24 22:28,86.29,Purchase,Home Improvement,8001.93
19804,718259433,7-17-24 14:28,199.16,IncomingTransfer,Freelance Payment,8201.09
19805,718259433,7-18-24 21:28,1100,Payment,Installment Payment,7101.09
19806,718344033,1-21-24 10:28,668.18,Deposit,Cash Deposit,1199.41665
19807,718344033,1-26-24 10:28,500.13,IncomingTransfer,Freelance Payment,1699.54665
19808,718344033,1-29-24 20:28,702.33,Payment,Bill Payment,997.2166499
19809,718344033,02-04-24 21:28,15550,IncomingTransfer,Salary,16547.21665
19810,718344033,02-08-24 22:28,580.19,Withdrawal,Mobile App Withdrawal,15967.02665
19811,718344033,02-09-24 21:28,1300,Payment,Credit Card Payment,14667.02665
19812,718344033,02-11-24 19:28,327.05,Withdrawal,Branch Withdrawal,14339.97665
19813,718344033,2-13-24 16:28,539.85,OnlineShopping,eBay,13800.12665
19814,718344033,2-13-24 21:28,4200,Payment,Rent Payment,9600.12665
19815,718344033,2-18-24 11:28,835.04,Withdrawal,ATM Withdrawal,8765.08665
19816,718344033,2-20-24 16:28,464.85,Withdrawal,Branch Withdrawal,8300.23665
19817,718344033,2-22-24 18:28,807.25,Purchase,Restaurant,7492.98665
19818,718344033,2-23-24 17:28,303.78,Withdrawal,Branch Withdrawal,7189.20665
19819,718344033,2-26-24 9:28,253.99,Return,Best Buy Return,7443.19665
19820,718344033,2-29-24 18:28,332.24,Deposit,Check Deposit,7775.43665
19821,718344033,03-02-24 15:28,765.38,OnlineShopping,Etsy,7010.05665
19822,718344033,03-03-24 21:28,15550,IncomingTransfer,Salary,22560.05665
19823,718344033,03-04-24 10:28,892.59,Withdrawal,ATM Withdrawal,21667.46665
19824,718344033,03-04-24 20:28,789.45,Payment,Bill Payment,20878.01665
19825,718344033,03-06-24 15:28,748.99,Deposit,Cash Deposit,21627.00665
19826,718344033,03-08-24 16:28,333.47,Deposit,Cash Deposit,21960.47665
19827,718344033,03-08-24 21:28,1400,Payment,Credit Card Payment,20560.47665
19828,718344033,03-10-24 20:28,566.04,Withdrawal,Branch Withdrawal,19994.43665
19829,718344033,03-12-24 16:28,645.48,Deposit,Cash Deposit,20639.91665
19830,718344033,03-12-24 22:28,529.55,Withdrawal,Branch Withdrawal,20110.36665
19831,718344033,3-13-24 16:28,839.14,OutgoingTransfer,Bank Transfer,19271.22665
19832,718344033,3-15-24 15:28,686.25,Withdrawal,ATM Withdrawal,18584.97665
19833,718344033,3-16-24 13:28,226.61,Return,Target Return,18811.58665
19834,718344033,3-16-24 17:28,605.41,Deposit,Mobile Deposit,19416.99665
19835,718344033,3-17-24 21:28,4800,Payment,Rent Payment,14616.99665
19836,718344033,04-02-24 19:28,635.58,Return,Walmart Return,15252.57665
19837,718344033,04-02-24 21:28,15550,IncomingTransfer,Salary,30802.57665
19838,718344033,04-05-24 20:28,941.19,Deposit,Check Deposit,31743.76665
19839,718344033,04-07-24 21:28,1200,Payment,Credit Card Payment,30543.76665
19840,718344033,04-11-24 21:28,7100,Payment,Rent Payment,23443.76665
19841,718344033,4-13-24 16:28,574.55,Purchase,Gas,22869.21665
19842,718344033,4-17-24 17:28,266.23,Withdrawal,Mobile App Withdrawal,22602.98665
19843,718344033,4-23-24 11:28,481.06,OutgoingTransfer,International Transfer,22121.92665
19844,718344033,4-24-24 12:28,245.64,Deposit,Check Deposit,22367.56665
19845,718344033,4-25-24 11:28,273.14,Purchase,Travel,22094.42665
19846,718344033,4-29-24 16:28,467.64,Purchase,Clothing,21626.78665
19847,718344033,05-01-24 20:28,704.96,OnlineShopping,AliExpress,20921.82665
19848,718344033,05-01-24 21:28,15550,IncomingTransfer,Salary,36471.82665
19849,718344033,05-01-24 22:28,226.6,Payment,Mortgage Payment,36245.22665
19850,718344033,05-03-24 15:28,434.74,OnlineShopping,Target,35810.48665
19851,718344033,05-04-24 21:28,798.07,Purchase,Pharmacy,35012.41665
19852,718344033,05-06-24 21:28,1200,Payment,Credit Card Payment,33812.41665
19853,718344033,05-07-24 22:28,802.76,Withdrawal,Mobile App Withdrawal,33009.65665
19854,718344033,05-10-24 21:28,354.64,OutgoingTransfer,Wire Transfer,32655.01665
19855,718344033,05-11-24 20:28,264.21,OnlineShopping,Etsy,32390.80665
19856,718344033,5-16-24 16:28,404.8,Purchase,Gas,31986.00665
19857,718344033,5-18-24 21:28,4900,Payment,Rent Payment,27086.00665
19858,718344033,5-23-24 11:28,888.86,OutgoingTransfer,International Transfer,26197.14665
19859,718344033,5-23-24 14:28,797.4,Withdrawal,Mobile App Withdrawal,25399.74665
19860,718344033,5-26-24 20:28,792.37,Return,Walmart Return,26192.11665
19861,718344033,5-27-24 13:28,533.58,Deposit,Check Deposit,26725.69665
19862,718344033,5-27-24 17:28,914.81,OnlineShopping,Etsy,25810.88665
19863,718344033,5-29-24 17:28,558.13,Purchase,Travel,25252.75665
19864,718344033,06-01-24 21:28,15550,IncomingTransfer,Salary,40802.75665
19865,718344033,06-02-24 18:28,297.17,Purchase,Furniture,40505.58665
19866,718344033,06-04-24 17:28,283.44,Withdrawal,Mobile App Withdrawal,40222.14665
19867,718344033,06-06-24 21:28,1200,Payment,Credit Card Payment,39022.14665
19868,718344033,06-07-24 12:28,866.05,Deposit,Cash Deposit,39888.19665
19869,718344033,06-10-24 17:28,888.42,Payment,Loan Payment,38999.77665
19870,718344033,06-11-24 21:28,6700,Payment,Rent Payment,32299.77665
19871,718344033,06-12-24 21:28,552.76,Return,Target Return,32852.53665
19872,718344033,6-16-24 12:28,289.67,Return,Etsy Return,33142.20665
19873,718344033,6-18-24 9:28,643.25,OnlineShopping,Best Buy,32498.95665
19874,718344033,6-25-24 13:28,943.57,Purchase,Entertainment,31555.38665
19875,718344033,6-29-24 12:28,484.85,OutgoingTransfer,International Transfer,31070.53665
19876,718344033,07-01-24 21:28,15550,IncomingTransfer,Salary,46620.53665
19877,718344033,07-03-24 9:28,877.23,Purchase,Clothing,45743.30665
19878,718344033,07-04-24 11:28,778.81,Return,Amazon Return,46522.11665
19879,718344033,07-06-24 21:28,1500,Payment,Credit Card Payment,45022.11665
19880,718344033,07-07-24 20:28,632.62,Payment,Bill Payment,44389.49665
19881,718344033,07-12-24 21:28,4000,Payment,Rent Payment,40389.49665
19882,718344033,7-17-24 12:28,922.82,Withdrawal,Mobile App Withdrawal,39466.67665
19883,718350033,1-20-24 21:28,30.64,Purchase,Entertainment,1460.021091
19884,718350033,1-23-24 12:28,235.34,Deposit,Mobile Deposit,1695.361091
19885,718350033,1-25-24 15:28,32.24,Payment,Loan Payment,1663.121091
19886,718350033,1-27-24 15:28,27.75,IncomingTransfer,Freelance Payment,1690.871091
19887,718350033,1-30-24 12:28,283.08,Return,Target Return,1973.951091
19888,718350033,1-31-24 17:28,358.99,Deposit,Mobile Deposit,2332.941091
19889,718350033,02-04-24 21:28,3600,IncomingTransfer,Salary,5932.941091
19890,718350033,02-08-24 11:28,127.38,OnlineShopping,AliExpress,5805.561091
19891,718350033,02-09-24 21:28,1900,Payment,Credit Card Payment,3905.561091
19892,718350033,02-10-24 17:28,376.73,OnlineShopping,Best Buy,3528.831091
19893,718350033,02-10-24 19:28,202.79,Payment,Mortgage Payment,3326.041091
19894,718350033,02-12-24 11:28,224.38,Withdrawal,Branch Withdrawal,3101.661091
19895,718350033,2-16-24 12:28,152.79,Purchase,Pharmacy,2948.871091
19896,718350033,2-16-24 21:28,1900,Payment,Rent Payment,1048.871091
19897,718350033,2-24-24 19:28,81.66,Purchase,Restaurant,967.2110911
19898,718350033,2-25-24 17:28,365.02,Deposit,Cash Deposit,1332.231091
19899,718350033,2-28-24 21:28,249,OnlineShopping,Best Buy,1083.231091
19900,718350033,03-01-24 23:28,145.15,Purchase,Grocery,938.0810911
19901,718350033,03-02-24 19:28,345.87,Purchase,Grocery,592.2110911
19902,718350033,03-02-24 21:28,164.15,OnlineShopping,Etsy,428.0610911
19903,718350033,03-03-24 11:28,160.83,OutgoingTransfer,Peer-to-Peer Transfer,267.2310911
19904,718350033,03-04-24 12:28,289.97,OutgoingTransfer,Peer-to-Peer Transfer,-22.73890894
19905,718350033,03-05-24 21:28,3600,IncomingTransfer,Salary,3577.261091
19906,718350033,03-06-24 10:28,174.34,Return,Store Return,3751.601091
19907,718350033,03-08-24 17:28,128.34,Deposit,Mobile Deposit,3879.941091
19908,718350033,03-10-24 15:28,190.26,Withdrawal,Branch Withdrawal,3689.681091
19909,718350033,03-10-24 21:28,2400,Payment,Credit Card Payment,1289.681091
19910,718350033,03-12-24 21:28,1700,Payment,Rent Payment,-410.3189089
19911,718350033,3-13-24 21:28,132.41,Withdrawal,ATM Withdrawal,-542.7289089
19912,718350033,3-17-24 17:28,269.53,Purchase,Restaurant,-812.2589089
19913,718350033,3-17-24 18:28,115.17,OnlineShopping,AliExpress,-927.4289089
19914,718350033,04-02-24 22:28,38.78,Payment,Mortgage Payment,-966.2089089
19915,718350033,04-05-24 11:28,334.45,Return,Store Return,-631.7589089
19916,718350033,04-05-24 21:28,3600,IncomingTransfer,Salary,2968.241091
19917,718350033,04-08-24 11:28,122.73,Payment,Bill Payment,2845.511091
19918,718350033,04-10-24 21:28,2300,Payment,Credit Card Payment,545.5110911
19919,718350033,04-12-24 18:28,290.23,IncomingTransfer,Freelance Payment,835.7410911
19920,718350033,4-13-24 10:28,61.3,Deposit,Cash Deposit,897.0410911
19921,718350033,4-13-24 14:28,303.55,Payment,Mortgage Payment,593.4910911
19922,718350033,4-13-24 15:28,25.03,Deposit,Direct Deposit,618.5210911
19923,718350033,4-16-24 21:28,1700,Payment,Rent Payment,-1081.478909
19924,718350033,4-18-24 9:28,175.25,Payment,Bill Payment,-1256.728909
19925,718350033,4-21-24 13:28,58.26,Deposit,Cash Deposit,-1198.468909
19926,718350033,4-22-24 23:28,99.63,Return,Best Buy Return,-1098.838909
19927,718350033,05-01-24 21:28,3600,IncomingTransfer,Salary,2501.161091
19928,718350033,05-06-24 21:28,2600,Payment,Credit Card Payment,-98.83890894
19929,718350033,05-11-24 19:28,118.44,Purchase,Home Improvement,-217.2789089
19930,718350033,5-13-24 21:28,136.21,Deposit,Mobile Deposit,-81.06890894
19931,718350033,5-16-24 12:28,52.6,Return,Best Buy Return,-28.46890894
19932,718350033,5-18-24 21:28,1600,Payment,Rent Payment,-1628.468909
19933,718350033,5-28-24 10:28,135.45,Payment,Bill Payment,-1763.918909
19934,718350033,5-31-24 12:28,39.1,Purchase,Clothing,-1803.018909
19935,718350033,5-31-24 13:28,332.88,Purchase,Electronics,-2135.898909
19936,718350033,06-02-24 22:28,227.47,Deposit,Check Deposit,-1908.428909
19937,718350033,06-03-24 20:28,74.98,Deposit,Cash Deposit,-1833.448909
19938,718350033,06-03-24 21:28,3600,IncomingTransfer,Salary,1766.551091
19939,718350033,06-05-24 11:28,26.21,Deposit,Direct Deposit,1792.761091
19940,718350033,06-06-24 10:28,387.71,Payment,Loan Payment,1405.051091
19941,718350033,06-08-24 21:28,2100,Payment,Credit Card Payment,-694.9489089
19942,718350033,06-12-24 10:28,347.13,IncomingTransfer,Freelance Payment,-347.8189089
19943,718350033,06-12-24 15:28,153.17,Purchase,Travel,-500.9889089
19944,718350033,6-13-24 21:28,1300,Payment,Rent Payment,-1800.988909
19945,718350033,6-14-24 23:28,157.95,Withdrawal,ATM Withdrawal,-1958.938909
19946,718350033,6-17-24 18:28,228.51,Purchase,Electronics,-2187.448909
19947,718350033,6-17-24 20:28,164.46,Withdrawal,Branch Withdrawal,-2351.908909
19948,718350033,6-23-24 21:28,234.03,Return,Best Buy Return,-2117.878909
19949,718350033,6-29-24 13:28,331.46,OnlineShopping,Target,-2449.338909
19950,718350033,07-01-24 21:28,3600,IncomingTransfer,Salary,1150.661091
19951,718350033,07-06-24 21:28,2800,Payment,Credit Card Payment,-1649.338909
19952,718350033,07-08-24 13:28,354.78,Purchase,Home Improvement,-2004.118909
19953,718350033,07-09-24 13:28,122.22,Purchase,Home Improvement,-2126.338909
19954,718350033,07-09-24 17:28,325.98,OutgoingTransfer,Peer-to-Peer Transfer,-2452.318909
19955,718350033,07-12-24 9:28,345.37,OnlineShopping,Target,-2797.688909
19956,718350033,7-16-24 9:28,314.6,Return,Store Return,-2483.088909
19957,718350033,7-16-24 9:28,371.27,Deposit,Direct Deposit,-2111.818909
19958,718350033,7-17-24 21:28,1200,Payment,Rent Payment,-3311.818909
19959,718362783,1-25-24 19:28,193.85,Deposit,Check Deposit,193.85
19960,718362783,1-26-24 23:28,337.92,Return,Etsy Return,531.77
19961,718362783,02-01-24 21:28,9000,IncomingTransfer,Salary,9531.77
19962,718362783,2-18-24 21:28,2500,Payment,Rent Payment,7031.77
19963,718362783,2-27-24 10:28,689.02,OnlineShopping,Walmart,6342.75
19964,718362783,03-02-24 17:28,526.68,OnlineShopping,eBay,5816.07
19965,718362783,03-04-24 21:28,9000,IncomingTransfer,Salary,14816.07
19966,718362783,03-06-24 9:28,270.72,OnlineShopping,Amazon,14545.35
19967,718362783,03-12-24 21:28,2300,Payment,Rent Payment,12245.35
19968,718362783,3-16-24 10:28,199.46,Purchase,Pharmacy,12045.89
19969,718362783,3-24-24 18:28,532.61,Purchase,Electronics,11513.28
19970,718362783,3-26-24 17:28,226.96,Return,Walmart Return,11740.24
19971,718362783,04-02-24 18:28,612.18,Payment,Mortgage Payment,11128.06
19972,718362783,04-05-24 21:28,9000,IncomingTransfer,Salary,20128.06
19973,718362783,4-16-24 21:28,3800,Payment,Rent Payment,16328.06
19974,718362783,4-20-24 13:28,285.58,Withdrawal,ATM Withdrawal,16042.48
19975,718362783,4-20-24 15:28,728.99,Purchase,Gas,15313.49
19976,718362783,05-04-24 21:28,9000,IncomingTransfer,Salary,24313.49
19977,718362783,5-17-24 21:28,2300,Payment,Rent Payment,22013.49
19978,718362783,5-18-24 20:28,464.21,OutgoingTransfer,International Transfer,21549.28
19979,718362783,5-23-24 10:28,242.92,Withdrawal,Branch Withdrawal,21306.36
19980,718362783,06-02-24 21:28,9000,IncomingTransfer,Salary,30306.36
19981,718362783,06-06-24 19:28,730.27,OnlineShopping,Best Buy,29576.09
19982,718362783,06-11-24 10:28,160.11,Withdrawal,ATM Withdrawal,29415.98
19983,718362783,06-11-24 21:28,4900,Payment,Rent Payment,24515.98
19984,718362783,6-15-24 20:28,540.83,Return,Target Return,25056.81
19985,718362783,6-18-24 23:28,538.68,Deposit,Check Deposit,25595.49
19986,718362783,07-03-24 21:28,9000,IncomingTransfer,Salary,34595.49
19987,718362783,07-09-24 9:28,511.49,Deposit,Mobile Deposit,35106.98
19988,718362783,07-10-24 21:28,2400,Payment,Rent Payment,32706.98
19989,718362783,7-14-24 16:28,216.43,Purchase,Electronics,32490.55
19990,718362783,7-17-24 15:28,104.13,OnlineShopping,AliExpress,32386.42
19991,718362783,7-17-24 22:28,501.87,OnlineShopping,AliExpress,31884.55
19992,718418958,1-22-24 11:28,197.12,Deposit,Check Deposit,197.12
19993,718418958,1-28-24 11:28,45.53,Purchase,Restaurant,151.59
19994,718418958,1-30-24 13:28,114.65,Deposit,Direct Deposit,266.24
19995,718418958,02-04-24 21:28,3150,IncomingTransfer,Salary,3416.24
19996,718418958,02-05-24 21:28,30.85,OutgoingTransfer,International Transfer,3385.39
19997,718418958,2-13-24 12:28,104.47,Withdrawal,Branch Withdrawal,3280.92
19998,718418958,2-13-24 21:28,1300,Payment,Rent Payment,1980.92
19999,718418958,2-22-24 16:28,25.49,Deposit,Cash Deposit,2006.41
20000,718418958,2-22-24 21:28,74.36,Deposit,Mobile Deposit,2080.77
20001,718418958,2-26-24 23:28,243.73,Purchase,Gas,1837.04
20002,718418958,03-01-24 21:28,3150,IncomingTransfer,Salary,4987.04
20003,718418958,03-03-24 17:28,140.73,Withdrawal,Mobile App Withdrawal,4846.31
20004,718418958,03-03-24 21:28,123.78,Deposit,Cash Deposit,4970.09
20005,718418958,03-07-24 19:28,40.14,Deposit,Cash Deposit,5010.23
20006,718418958,03-08-24 19:28,58.28,Deposit,Direct Deposit,5068.51
20007,718418958,03-08-24 21:28,177.67,Withdrawal,Mobile App Withdrawal,4890.84
20008,718418958,03-12-24 21:28,1300,Payment,Rent Payment,3590.84
20009,718418958,3-19-24 22:28,86.18,Deposit,Mobile Deposit,3677.02
20010,718418958,04-01-24 21:28,3150,IncomingTransfer,Salary,6827.02
20011,718418958,04-07-24 13:28,244.86,Deposit,Direct Deposit,7071.88
20012,718418958,04-09-24 9:28,11.37,OnlineShopping,Etsy,7060.51
20013,718418958,04-11-24 20:28,139.03,Payment,Bill Payment,6921.48
20014,718418958,04-12-24 21:28,1900,Payment,Rent Payment,5021.48
20015,718418958,4-14-24 20:28,100.4,OnlineShopping,Target,4921.08
20016,718418958,4-18-24 15:28,51.04,Return,AliExpress Return,4972.12
20017,718418958,4-19-24 20:28,156.83,Withdrawal,ATM Withdrawal,4815.29
20018,718418958,4-24-24 9:28,162.24,Deposit,Cash Deposit,4977.53
20019,718418958,4-24-24 15:28,31.75,OnlineShopping,Best Buy,4945.78
20020,718418958,4-25-24 22:28,33.28,Withdrawal,Mobile App Withdrawal,4912.5
20021,718418958,4-28-24 15:28,59.15,Payment,Bill Payment,4853.35
20022,718418958,05-03-24 9:28,198.91,Purchase,Travel,4654.44
20023,718418958,05-04-24 21:28,3150,IncomingTransfer,Salary,7804.44
20024,718418958,05-05-24 14:28,130.35,Withdrawal,Mobile App Withdrawal,7674.09
20025,718418958,5-14-24 21:28,1200,Payment,Rent Payment,6474.09
20026,718418958,5-20-24 17:28,236.3,Withdrawal,Mobile App Withdrawal,6237.79
20027,718418958,5-22-24 16:28,20.07,OutgoingTransfer,International Transfer,6217.72
20028,718418958,5-28-24 13:28,70.55,OutgoingTransfer,International Transfer,6147.17
20029,718418958,5-29-24 23:28,53.34,Return,Etsy Return,6200.51
20030,718418958,06-04-24 17:28,168.5,Return,Walmart Return,6369.01
20031,718418958,06-05-24 21:28,3150,IncomingTransfer,Salary,9519.01
20032,718418958,06-12-24 21:28,1900,Payment,Rent Payment,7619.01
20033,718418958,6-17-24 15:28,50.89,Deposit,Cash Deposit,7669.9
20034,718418958,6-22-24 17:28,26.28,OnlineShopping,Etsy,7643.62
20035,718418958,6-28-24 13:28,191.36,OutgoingTransfer,Bank Transfer,7452.26
20036,718418958,07-01-24 21:28,3150,IncomingTransfer,Salary,10602.26
20037,718418958,07-02-24 9:28,207.57,Deposit,Check Deposit,10809.83
20038,718418958,07-04-24 19:28,197.95,OutgoingTransfer,Peer-to-Peer Transfer,10611.88
20039,718418958,07-08-24 12:28,156.99,Withdrawal,Mobile App Withdrawal,10454.89
20040,718418958,07-11-24 21:28,85.17,Deposit,Direct Deposit,10540.06
20041,718418958,7-16-24 21:28,1700,Payment,Rent Payment,8840.06
20042,718420308,1-21-24 20:28,190.12,Withdrawal,Branch Withdrawal,1199.450018
20043,718420308,1-24-24 9:28,100.28,Purchase,Pharmacy,1099.170018
20044,718420308,1-24-24 19:28,206.74,IncomingTransfer,Freelance Payment,1305.910018
20045,718420308,1-28-24 17:28,128.73,Purchase,Furniture,1177.180018
20046,718420308,1-30-24 10:28,169.71,Purchase,Gas,1007.470018
20047,718420308,1-30-24 15:28,185.57,Purchase,Gas,821.9000178
20048,718420308,1-31-24 10:28,40.53,Payment,Mortgage Payment,781.3700178
20049,718420308,02-02-24 21:28,3150,IncomingTransfer,Salary,3931.370018
20050,718420308,02-04-24 19:28,142.65,Deposit,Cash Deposit,4074.020018
20051,718420308,02-07-24 21:28,2200,Payment,Credit Card Payment,1874.020018
20052,718420308,02-12-24 13:28,140.38,IncomingTransfer,Freelance Payment,2014.400018
20053,718420308,2-14-24 12:28,159.18,Payment,Loan Payment,1855.220018
20054,718420308,2-18-24 21:28,900,Payment,Rent Payment,955.2200178
20055,718420308,2-21-24 19:28,160.31,Purchase,Electronics,794.9100178
20056,718420308,2-23-24 23:28,137.86,Deposit,Direct Deposit,932.7700178
20057,718420308,2-26-24 10:28,190.63,Return,Walmart Return,1123.400018
20058,718420308,2-26-24 21:28,239.06,OutgoingTransfer,Wire Transfer,884.3400178
20059,718420308,2-27-24 16:28,52.37,Payment,Loan Payment,831.9700178
20060,718420308,03-03-24 21:28,3150,IncomingTransfer,Salary,3981.970018
20061,718420308,03-05-24 9:28,122.81,OutgoingTransfer,Bank Transfer,3859.160018
20062,718420308,03-05-24 11:28,170.5,Deposit,Check Deposit,4029.660018
20063,718420308,03-07-24 11:28,124.79,Deposit,Check Deposit,4154.450018
20064,718420308,03-08-24 21:28,2200,Payment,Credit Card Payment,1954.450018
20065,718420308,03-10-24 21:28,1400,Payment,Rent Payment,554.4500178
20066,718420308,3-14-24 11:28,222.31,OnlineShopping,Amazon,332.1400178
20067,718420308,3-20-24 23:28,20.03,Withdrawal,Mobile App Withdrawal,312.1100178
20068,718420308,3-21-24 15:28,165.52,IncomingTransfer,Freelance Payment,477.6300178
20069,718420308,3-22-24 18:28,11.21,OnlineShopping,Walmart,466.4200178
20070,718420308,3-23-24 10:28,133.16,Payment,Loan Payment,333.2600178
20071,718420308,3-28-24 16:28,181.55,Payment,Bill Payment,151.7100178
20072,718420308,3-28-24 19:28,149.22,OutgoingTransfer,International Transfer,2.49001785
20073,718420308,3-29-24 20:28,44.03,Return,Best Buy Return,46.52001785
20074,718420308,3-30-24 20:28,48.05,OutgoingTransfer,Bank Transfer,-1.52998215
20075,718420308,04-01-24 19:28,49.02,OutgoingTransfer,International Transfer,-50.54998215
20076,718420308,04-02-24 21:28,3150,IncomingTransfer,Salary,3099.450018
20077,718420308,04-04-24 15:28,185.58,OnlineShopping,Etsy,2913.870018
20078,718420308,04-05-24 22:28,223.51,OnlineShopping,Walmart,2690.360018
20079,718420308,04-06-24 14:28,134.1,OutgoingTransfer,Peer-to-Peer Transfer,2556.260018
20080,718420308,04-06-24 16:28,147.29,Withdrawal,ATM Withdrawal,2408.970018
20081,718420308,04-07-24 21:28,2500,Payment,Credit Card Payment,-91.02998215
20082,718420308,04-07-24 21:28,18.04,Deposit,Mobile Deposit,-72.98998215
20083,718420308,04-08-24 14:28,42.9,Deposit,Mobile Deposit,-30.08998215
20084,718420308,04-12-24 17:28,71.7,Withdrawal,Branch Withdrawal,-101.7899822
20085,718420308,4-16-24 21:28,1000,Payment,Rent Payment,-1101.789982
20086,718420308,4-20-24 10:28,163.86,Deposit,Cash Deposit,-937.9299822
20087,718420308,4-21-24 11:28,170.5,Withdrawal,ATM Withdrawal,-1108.429982
20088,718420308,4-21-24 14:28,161.2,Return,Best Buy Return,-947.2299822
20089,718420308,4-23-24 18:28,167.51,Withdrawal,ATM Withdrawal,-1114.739982
20090,718420308,4-24-24 12:28,149.57,Purchase,Grocery,-1264.309982
20091,718420308,4-25-24 20:28,133.05,Purchase,Travel,-1397.359982
20092,718420308,4-26-24 20:28,186.87,Deposit,Mobile Deposit,-1210.489982
20093,718420308,4-30-24 9:28,95.15,Purchase,Entertainment,-1305.639982
20094,718420308,05-01-24 21:28,3150,IncomingTransfer,Salary,1844.360018
20095,718420308,05-05-24 21:28,247.15,Payment,Bill Payment,1597.210018
20096,718420308,05-06-24 21:28,1800,Payment,Credit Card Payment,-202.7899822
20097,718420308,05-08-24 17:28,221.24,IncomingTransfer,Freelance Payment,18.45001785
20098,718420308,05-10-24 21:28,213.47,Withdrawal,Branch Withdrawal,-195.0199822
20099,718420308,05-12-24 21:28,1200,Payment,Rent Payment,-1395.019982
20100,718420308,5-17-24 16:28,237.16,Purchase,Travel,-1632.179982
20101,718420308,5-17-24 22:28,59.08,Deposit,Cash Deposit,-1573.099982
20102,718420308,5-18-24 15:28,218.87,Withdrawal,ATM Withdrawal,-1791.969982
20103,718420308,5-18-24 16:28,125.84,Deposit,Check Deposit,-1666.129982
20104,718420308,5-18-24 18:28,90.54,Return,eBay Return,-1575.589982
20105,718420308,5-18-24 22:28,102.22,Deposit,Mobile Deposit,-1473.369982
20106,718420308,5-20-24 19:28,66.72,Return,Amazon Return,-1406.649982
20107,718420308,5-20-24 23:28,105.77,Withdrawal,Mobile App Withdrawal,-1512.419982
20108,718420308,5-22-24 19:28,203.43,OnlineShopping,Target,-1715.849982
20109,718420308,5-25-24 17:28,88.32,Return,Amazon Return,-1627.529982
20110,718420308,5-30-24 11:28,32.8,Deposit,Direct Deposit,-1594.729982
20111,718420308,5-31-24 16:28,237.81,OutgoingTransfer,Wire Transfer,-1832.539982
20112,718420308,06-02-24 22:28,231.61,Purchase,Pharmacy,-2064.149982
20113,718420308,06-03-24 13:28,51.34,Payment,Bill Payment,-2115.489982
20114,718420308,06-03-24 18:28,169.14,Return,Etsy Return,-1946.349982
20115,718420308,06-04-24 21:28,3150,IncomingTransfer,Salary,1203.650018
20116,718420308,06-05-24 22:28,102.87,Purchase,Grocery,1100.780018
20117,718420308,06-09-24 21:28,1800,Payment,Credit Card Payment,-699.2199822
20118,718420308,06-10-24 13:28,108.2,Purchase,Pharmacy,-807.4199822
20119,718420308,06-10-24 19:28,248.95,Payment,Mortgage Payment,-1056.369982
20120,718420308,06-12-24 21:28,2000,Payment,Rent Payment,-3056.369982
20121,718420308,6-25-24 22:28,125.3,Purchase,Home Improvement,-3181.669982
20122,718420308,6-29-24 14:28,156.75,OnlineShopping,Amazon,-3338.419982
20123,718420308,07-05-24 21:28,3150,IncomingTransfer,Salary,-188.4199822
20124,718420308,07-09-24 16:28,48.41,Withdrawal,Branch Withdrawal,-236.8299822
20125,718420308,07-10-24 21:28,2100,Payment,Credit Card Payment,-2336.829982
20126,718420308,07-11-24 23:28,157.68,Withdrawal,ATM Withdrawal,-2494.509982
20127,718420308,07-12-24 21:28,2000,Payment,Rent Payment,-4494.509982
20128,718420308,7-14-24 12:28,217.57,Purchase,Grocery,-4712.079982
20129,718420308,7-15-24 22:28,137.92,OutgoingTransfer,Wire Transfer,-4849.999982
20130,718420308,7-17-24 10:28,66.39,Withdrawal,Branch Withdrawal,-4916.389982
20131,718420308,7-17-24 10:28,232.31,Purchase,Restaurant,-5148.699982
20132,718420308,7-17-24 16:28,195.95,IncomingTransfer,Freelance Payment,-4952.749982
20133,718420308,7-17-24 16:28,202.54,IncomingTransfer,Freelance Payment,-4750.209982
20134,718420308,7-17-24 17:28,131,Deposit,Check Deposit,-4619.209982
20135,718428033,1-24-24 22:28,140.29,Return,Etsy Return,1030.867224
20136,718428033,1-25-24 18:28,141.32,Payment,Bill Payment,889.5472236
20137,718428033,1-27-24 13:28,206.17,OutgoingTransfer,Peer-to-Peer Transfer,683.3772236
20138,718428033,1-29-24 10:28,192.43,Deposit,Mobile Deposit,875.8072236
20139,718428033,02-03-24 21:28,2150,IncomingTransfer,Salary,3025.807224
20140,718428033,02-04-24 17:28,12.65,IncomingTransfer,Freelance Payment,3038.457224
20141,718428033,02-08-24 14:28,78.84,Deposit,Cash Deposit,3117.297224
20142,718428033,02-08-24 21:28,2000,Payment,Credit Card Payment,1117.297224
20143,718428033,02-10-24 21:28,700,Payment,Subscription Payment,417.2972236
20144,718428033,2-14-24 9:28,139.68,Purchase,Restaurant,277.6172236
20145,718428033,2-19-24 15:28,46.71,Deposit,Direct Deposit,324.3272236
20146,718428033,2-20-24 10:28,98.73,Return,Target Return,423.0572236
20147,718428033,2-29-24 14:28,125.15,Payment,Mortgage Payment,297.9072236
20148,718428033,03-03-24 14:28,223.74,IncomingTransfer,Freelance Payment,521.6472236
20149,718428033,03-04-24 16:28,33.62,Purchase,Restaurant,488.0272236
20150,718428033,03-04-24 21:28,2150,IncomingTransfer,Salary,2638.027224
20151,718428033,03-06-24 15:28,21.87,Payment,Bill Payment,2616.157224
20152,718428033,03-09-24 21:28,1600,Payment,Credit Card Payment,1016.157224
20153,718428033,03-10-24 10:28,186.82,Deposit,Check Deposit,1202.977224
20154,718428033,03-11-24 13:28,179.24,Deposit,Check Deposit,1382.217224
20155,718428033,3-15-24 22:28,72.96,Withdrawal,Branch Withdrawal,1309.257224
20156,718428033,3-16-24 15:28,93.96,Purchase,Pharmacy,1215.297224
20157,718428033,3-18-24 21:28,600,Payment,Insurance Payment,615.2972236
20158,718428033,3-18-24 22:28,225.56,Deposit,Mobile Deposit,840.8572236
20159,718428033,3-23-24 16:28,122.99,Payment,Mortgage Payment,717.8672236
20160,718428033,3-25-24 14:28,42.96,Purchase,Clothing,674.9072236
20161,718428033,3-25-24 19:28,137.22,Purchase,Electronics,537.6872236
20162,718428033,3-27-24 9:28,64.13,Purchase,Home Improvement,473.5572236
20163,718428033,3-27-24 22:28,229.21,IncomingTransfer,Freelance Payment,702.7672236
20164,718428033,3-30-24 10:28,17.1,IncomingTransfer,Freelance Payment,719.8672236
20165,718428033,3-31-24 17:28,66.12,Purchase,Entertainment,653.7472236
20166,718428033,04-04-24 21:28,2150,IncomingTransfer,Salary,2803.747224
20167,718428033,04-06-24 17:28,33.38,OnlineShopping,Etsy,2770.367224
20168,718428033,04-09-24 17:28,102.67,Return,Amazon Return,2873.037224
20169,718428033,04-09-24 21:28,1700,Payment,Credit Card Payment,1173.037224
20170,718428033,04-09-24 23:28,133.02,OutgoingTransfer,Wire Transfer,1040.017224
20171,718428033,4-14-24 20:28,35.56,IncomingTransfer,Freelance Payment,1075.577224
20172,718428033,4-17-24 21:28,700,Payment,Insurance Payment,375.5772236
20173,718428033,4-18-24 21:28,221.75,Deposit,Cash Deposit,597.3272236
20174,718428033,4-19-24 9:28,221.04,Purchase,Home Improvement,376.2872236
20175,718428033,4-20-24 13:28,34.06,Purchase,Home Improvement,342.2272236
20176,718428033,4-20-24 16:28,182.61,Deposit,Cash Deposit,524.8372236
20177,718428033,4-25-24 11:28,222,Deposit,Check Deposit,746.8372236
20178,718428033,4-30-24 22:28,205.16,Purchase,Entertainment,541.6772236
20179,718428033,05-02-24 21:28,2150,IncomingTransfer,Salary,2691.677224
20180,718428033,05-04-24 16:28,182.77,Payment,Mortgage Payment,2508.907224
20181,718428033,05-07-24 16:28,162.81,Withdrawal,Mobile App Withdrawal,2346.097224
20182,718428033,05-07-24 21:28,2000,Payment,Credit Card Payment,346.0972236
20183,718428033,05-07-24 22:28,169.32,OutgoingTransfer,Peer-to-Peer Transfer,176.7772236
20184,718428033,05-09-24 11:28,198.82,Purchase,Restaurant,-22.04277642
20185,718428033,05-10-24 22:28,194.52,Purchase,Clothing,-216.5627764
20186,718428033,05-12-24 19:28,243.1,OnlineShopping,Etsy,-459.6627764
20187,718428033,5-16-24 14:28,80.54,OutgoingTransfer,Wire Transfer,-540.2027764
20188,718428033,5-16-24 21:28,800,Payment,Subscription Payment,-1340.202776
20189,718428033,5-17-24 12:28,79.5,Return,Store Return,-1260.702776
20190,718428033,5-20-24 12:28,160.42,Withdrawal,Branch Withdrawal,-1421.122776
20191,718428033,5-20-24 13:28,137.82,Purchase,Entertainment,-1558.942776
20192,718428033,5-21-24 17:28,97.28,Deposit,Cash Deposit,-1461.662776
20193,718428033,5-25-24 11:28,136.55,Withdrawal,Branch Withdrawal,-1598.212776
20194,718428033,5-25-24 20:28,132.61,Payment,Mortgage Payment,-1730.822776
20195,718428033,5-27-24 17:28,62.16,Return,Amazon Return,-1668.662776
20196,718428033,5-29-24 22:28,31.35,Return,Etsy Return,-1637.312776
20197,718428033,06-02-24 21:28,2150,IncomingTransfer,Salary,512.6872236
20198,718428033,06-04-24 12:28,71.67,Deposit,Check Deposit,584.3572236
20199,718428033,06-05-24 15:28,186.55,Purchase,Gas,397.8072236
20200,718428033,06-06-24 20:28,151.92,Withdrawal,ATM Withdrawal,245.8872236
20201,718428033,06-07-24 21:28,1900,Payment,Credit Card Payment,-1654.112776
20202,718428033,06-09-24 18:28,15.3,Withdrawal,Branch Withdrawal,-1669.412776
20203,718428033,06-10-24 13:28,98.16,Payment,Mortgage Payment,-1767.572776
20204,718428033,06-11-24 17:28,170.86,OnlineShopping,Best Buy,-1938.432776
20205,718428033,06-12-24 21:28,83.41,IncomingTransfer,Freelance Payment,-1855.022776
20206,718428033,06-12-24 21:28,85.51,Withdrawal,ATM Withdrawal,-1940.532776
20207,718428033,6-16-24 21:28,800,Payment,Installment Payment,-2740.532776
20208,718428033,6-19-24 10:28,207.01,Purchase,Home Improvement,-2947.542776
20209,718428033,6-22-24 11:28,13.88,Purchase,Pharmacy,-2961.422776
20210,718428033,6-26-24 15:28,204.94,Purchase,Home Improvement,-3166.362776
20211,718428033,6-27-24 15:28,138.28,Payment,Loan Payment,-3304.642776
20212,718428033,07-01-24 18:28,115.14,OutgoingTransfer,Bank Transfer,-3419.782776
20213,718428033,07-01-24 21:28,2150,IncomingTransfer,Salary,-1269.782776
20214,718428033,07-02-24 16:28,170.29,Purchase,Home Improvement,-1440.072776
20215,718428033,07-02-24 18:28,207.61,OutgoingTransfer,Wire Transfer,-1647.682776
20216,718428033,07-05-24 23:28,152.92,Deposit,Check Deposit,-1494.762776
20217,718428033,07-06-24 21:28,2100,Payment,Credit Card Payment,-3594.762776
20218,718428033,07-09-24 10:28,19.91,Deposit,Check Deposit,-3574.852776
20219,718428033,07-11-24 21:28,600,Payment,Insurance Payment,-4174.852776
20220,718428033,07-12-24 21:28,195.71,Deposit,Direct Deposit,-3979.142776
20221,718428033,7-16-24 12:28,148.9,Return,Target Return,-3830.242776
20222,718428033,7-17-24 14:28,136.77,Deposit,Check Deposit,-3693.472776
20223,718478883,1-20-24 21:28,53.64,Payment,Loan Payment,-53.64
20224,718478883,1-23-24 20:28,72.65,Deposit,Check Deposit,19.01
20225,718478883,1-23-24 21:28,199.3,Deposit,Direct Deposit,218.31
20226,718478883,1-24-24 18:28,193.56,Withdrawal,ATM Withdrawal,24.75
20227,718478883,1-25-24 12:28,186.05,Withdrawal,Mobile App Withdrawal,-161.3
20228,718478883,1-27-24 21:28,90.39,Purchase,Gas,-251.69
20229,718478883,1-28-24 19:28,21.04,Payment,Loan Payment,-272.73
20230,718478883,1-31-24 23:28,146.5,Withdrawal,ATM Withdrawal,-419.23
20231,718478883,02-01-24 9:28,57.64,Deposit,Check Deposit,-361.59
20232,718478883,02-05-24 17:28,207.77,Return,Best Buy Return,-153.82
20233,718478883,02-05-24 20:28,192.36,IncomingTransfer,Freelance Payment,38.54
20234,718478883,02-05-24 21:28,2600,IncomingTransfer,Salary,2638.54
20235,718478883,02-08-24 23:28,66.14,OnlineShopping,Best Buy,2572.4
20236,718478883,02-11-24 11:28,244.53,Withdrawal,Mobile App Withdrawal,2327.87
20237,718478883,02-12-24 13:28,190,Deposit,Check Deposit,2517.87
20238,718478883,02-12-24 21:28,1000,Payment,Subscription Payment,1517.87
20239,718478883,2-14-24 12:28,81.04,OutgoingTransfer,Bank Transfer,1436.83
20240,718478883,2-15-24 19:28,123.12,Return,eBay Return,1559.95
20241,718478883,2-15-24 20:28,196.34,Payment,Mortgage Payment,1363.61
20242,718478883,2-20-24 11:28,63.84,OnlineShopping,AliExpress,1299.77
20243,718478883,2-23-24 9:28,87.28,IncomingTransfer,Freelance Payment,1387.05
20244,718478883,2-27-24 22:28,111.5,OutgoingTransfer,Wire Transfer,1275.55
20245,718478883,2-28-24 17:28,158.15,OnlineShopping,Walmart,1117.4
20246,718478883,03-05-24 20:28,235.92,Purchase,Grocery,881.48
20247,718478883,03-05-24 21:28,2600,IncomingTransfer,Salary,3481.48
20248,718478883,03-12-24 14:28,121.94,Purchase,Restaurant,3359.54
20249,718478883,03-12-24 23:28,165.96,Return,Store Return,3525.5
20250,718478883,3-16-24 12:28,205.89,Payment,Loan Payment,3319.61
20251,718478883,3-16-24 21:28,1100,Payment,Subscription Payment,2219.61
20252,718478883,3-18-24 19:28,141.14,OnlineShopping,AliExpress,2078.47
20253,718478883,3-19-24 11:28,92.69,Payment,Bill Payment,1985.78
20254,718478883,3-22-24 16:28,68.89,Return,Walmart Return,2054.67
20255,718478883,3-23-24 12:28,217.77,Return,eBay Return,2272.44
20256,718478883,3-23-24 17:28,46.6,OnlineShopping,Best Buy,2225.84
20257,718478883,3-24-24 22:28,101.14,Purchase,Clothing,2124.7
20258,718478883,3-27-24 22:28,97.78,Withdrawal,ATM Withdrawal,2026.92
20259,718478883,3-30-24 18:28,215.1,Deposit,Cash Deposit,2242.02
20260,718478883,04-01-24 21:28,2600,IncomingTransfer,Salary,4842.02
20261,718478883,04-03-24 23:28,73.6,Payment,Loan Payment,4768.42
20262,718478883,04-07-24 11:28,247.31,Deposit,Cash Deposit,5015.73
20263,718478883,04-07-24 20:28,131.55,Payment,Bill Payment,4884.18
20264,718478883,04-12-24 19:28,208.15,OutgoingTransfer,Wire Transfer,4676.03
20265,718478883,04-12-24 21:28,900,Payment,Installment Payment,3776.03
20266,718478883,4-13-24 12:28,226.72,Purchase,Gas,3549.31
20267,718478883,4-13-24 13:28,201.74,Deposit,Direct Deposit,3751.05
20268,718478883,4-14-24 18:28,44.58,Deposit,Cash Deposit,3795.63
20269,718478883,4-15-24 10:28,196.5,Withdrawal,Branch Withdrawal,3599.13
20270,718478883,4-17-24 15:28,103.58,Return,Amazon Return,3702.71
20271,718478883,4-21-24 16:28,225.06,Return,Etsy Return,3927.77
20272,718478883,4-22-24 15:28,19.08,OnlineShopping,Walmart,3908.69
20273,718478883,4-22-24 20:28,39.4,Purchase,Electronics,3869.29
20274,718478883,4-24-24 22:28,224.5,Purchase,Restaurant,3644.79
20275,718478883,4-26-24 21:28,187.79,Withdrawal,Branch Withdrawal,3457
20276,718478883,4-27-24 13:28,179.05,Purchase,Entertainment,3277.95
20277,718478883,4-29-24 23:28,248.39,Return,AliExpress Return,3526.34
20278,718478883,05-01-24 20:28,222.58,Withdrawal,Branch Withdrawal,3303.76
20279,718478883,05-01-24 21:28,2600,IncomingTransfer,Salary,5903.76
20280,718478883,05-02-24 16:28,179.82,Payment,Loan Payment,5723.94
20281,718478883,05-03-24 21:28,200.39,Return,Amazon Return,5924.33
20282,718478883,05-04-24 20:28,192.6,OutgoingTransfer,Peer-to-Peer Transfer,5731.73
20283,718478883,5-15-24 12:28,243.69,Purchase,Travel,5488.04
20284,718478883,5-15-24 13:28,65.24,Deposit,Cash Deposit,5553.28
20285,718478883,5-16-24 21:28,800,Payment,Subscription Payment,4753.28
20286,718478883,5-17-24 14:28,64.69,Payment,Bill Payment,4688.59
20287,718478883,5-18-24 16:28,228.36,Withdrawal,Mobile App Withdrawal,4460.23
20288,718478883,5-20-24 15:28,155.57,OnlineShopping,Best Buy,4304.66
20289,718478883,5-22-24 9:28,70.95,OnlineShopping,Walmart,4233.71
20290,718478883,5-23-24 20:28,133.2,OutgoingTransfer,Wire Transfer,4100.51
20291,718478883,5-23-24 22:28,85.27,Purchase,Entertainment,4015.24
20292,718478883,5-26-24 10:28,222.84,Deposit,Mobile Deposit,4238.08
20293,718478883,06-01-24 11:28,145.37,Withdrawal,Mobile App Withdrawal,4092.71
20294,718478883,06-01-24 22:28,140.8,Withdrawal,Mobile App Withdrawal,3951.91
20295,718478883,06-03-24 18:28,87.68,Deposit,Mobile Deposit,4039.59
20296,718478883,06-04-24 21:28,2600,IncomingTransfer,Salary,6639.59
20297,718478883,06-07-24 14:28,219.3,Purchase,Travel,6420.29
20298,718478883,06-10-24 10:28,146.81,OnlineShopping,Best Buy,6273.48
20299,718478883,06-11-24 21:28,900,Payment,Installment Payment,5373.48
20300,718478883,06-12-24 17:28,76.07,Payment,Loan Payment,5297.41
20301,718478883,6-17-24 14:28,32.24,Purchase,Electronics,5265.17
20302,718478883,6-17-24 18:28,90.09,Purchase,Home Improvement,5175.08
20303,718478883,6-19-24 13:28,106.35,Purchase,Restaurant,5068.73
20304,718478883,6-20-24 10:28,200.01,Deposit,Mobile Deposit,5268.74
20305,718478883,6-20-24 11:28,124.72,OnlineShopping,eBay,5144.02
20306,718478883,6-26-24 16:28,155.54,Return,Store Return,5299.56
20307,718478883,6-27-24 20:28,177.93,Deposit,Mobile Deposit,5477.49
20308,718478883,07-01-24 17:28,139.1,Deposit,Cash Deposit,5616.59
20309,718478883,07-02-24 10:28,162.16,Withdrawal,ATM Withdrawal,5454.43
20310,718478883,07-04-24 22:28,97.18,OnlineShopping,Best Buy,5357.25
20311,718478883,07-05-24 21:28,2600,IncomingTransfer,Salary,7957.25
20312,718478883,07-08-24 12:28,48.26,OnlineShopping,Amazon,7908.99
20313,718478883,7-14-24 15:28,44.58,Withdrawal,Mobile App Withdrawal,7864.41
20314,718478883,7-15-24 16:28,70.58,Purchase,Gas,7793.83
20315,718478883,7-17-24 21:28,800,Payment,Insurance Payment,6993.83
20316,718492908,1-22-24 9:28,167.71,Deposit,Direct Deposit,1325.673413
20317,718492908,1-24-24 17:28,245.87,Return,Amazon Return,1571.543413
20318,718492908,1-26-24 11:28,143.04,Deposit,Check Deposit,1714.583413
20319,718492908,1-30-24 18:28,138.81,OnlineShopping,AliExpress,1575.773413
20320,718492908,02-03-24 21:28,3300,IncomingTransfer,Salary,4875.773413
20321,718492908,02-08-24 21:28,1600,Payment,Credit Card Payment,3275.773413
20322,718492908,02-09-24 19:28,163.22,Deposit,Direct Deposit,3438.993413
20323,718492908,02-10-24 16:28,158.91,Purchase,Gas,3280.083413
20324,718492908,02-11-24 21:28,1100,Payment,Rent Payment,2180.083413
20325,718492908,02-12-24 23:28,176.53,Withdrawal,ATM Withdrawal,2003.553413
20326,718492908,2-13-24 21:28,72.45,Purchase,Entertainment,1931.103413
20327,718492908,2-16-24 21:28,56.45,Withdrawal,Branch Withdrawal,1874.653413
20328,718492908,2-17-24 16:28,16.86,Withdrawal,Branch Withdrawal,1857.793413
20329,718492908,2-18-24 12:28,155.43,Payment,Bill Payment,1702.363413
20330,718492908,2-18-24 14:28,35.14,Withdrawal,Mobile App Withdrawal,1667.223413
20331,718492908,2-21-24 17:28,121.42,OnlineShopping,Target,1545.803413
20332,718492908,2-21-24 19:28,110.07,Return,Walmart Return,1655.873413
20333,718492908,2-22-24 18:28,50.48,Return,Target Return,1706.353413
20334,718492908,2-23-24 22:28,152.91,Withdrawal,Mobile App Withdrawal,1553.443413
20335,718492908,2-28-24 19:28,195.3,Withdrawal,ATM Withdrawal,1358.143413
20336,718492908,03-03-24 13:28,16.26,OnlineShopping,eBay,1341.883413
20337,718492908,03-03-24 20:28,45.92,Payment,Bill Payment,1295.963413
20338,718492908,03-05-24 21:28,3300,IncomingTransfer,Salary,4595.963413
20339,718492908,03-06-24 17:28,105.54,Deposit,Direct Deposit,4701.503413
20340,718492908,03-06-24 19:28,227.47,Return,Best Buy Return,4928.973413
20341,718492908,03-08-24 23:28,128.02,Payment,Bill Payment,4800.953413
20342,718492908,03-10-24 21:28,2200,Payment,Credit Card Payment,2600.953413
20343,718492908,03-12-24 12:28,194.44,Deposit,Mobile Deposit,2795.393413
20344,718492908,3-13-24 21:28,129.23,OnlineShopping,AliExpress,2666.163413
20345,718492908,3-13-24 23:28,102.81,OnlineShopping,Walmart,2563.353413
20346,718492908,3-17-24 21:28,1000,Payment,Rent Payment,1563.353413
20347,718492908,3-19-24 23:28,206.71,IncomingTransfer,Freelance Payment,1770.063413
20348,718492908,3-20-24 9:28,82.47,Withdrawal,Branch Withdrawal,1687.593413
20349,718492908,3-21-24 13:28,112.42,Purchase,Home Improvement,1575.173413
20350,718492908,3-21-24 16:28,194.99,IncomingTransfer,Freelance Payment,1770.163413
20351,718492908,3-22-24 15:28,166.34,Deposit,Cash Deposit,1936.503413
20352,718492908,3-25-24 23:28,84.41,Purchase,Clothing,1852.093413
20353,718492908,3-27-24 17:28,128.34,Deposit,Direct Deposit,1980.433413
20354,718492908,3-29-24 14:28,209.09,IncomingTransfer,Freelance Payment,2189.523413
20355,718492908,3-31-24 11:28,244.09,Withdrawal,ATM Withdrawal,1945.433413
20356,718492908,04-02-24 13:28,105.32,Deposit,Cash Deposit,2050.753413
20357,718492908,04-05-24 21:28,3300,IncomingTransfer,Salary,5350.753413
20358,718492908,04-07-24 11:28,131.18,Payment,Loan Payment,5219.573413
20359,718492908,04-07-24 11:28,214.9,Payment,Loan Payment,5004.673413
20360,718492908,04-08-24 14:28,54,IncomingTransfer,Freelance Payment,5058.673413
20361,718492908,04-08-24 15:28,32.54,Withdrawal,ATM Withdrawal,5026.133413
20362,718492908,04-10-24 21:28,2200,Payment,Credit Card Payment,2826.133413
20363,718492908,4-13-24 14:28,59.99,Withdrawal,Mobile App Withdrawal,2766.143413
20364,718492908,4-13-24 19:28,128.87,Deposit,Check Deposit,2895.013413
20365,718492908,4-16-24 17:28,27.15,Return,Amazon Return,2922.163413
20366,718492908,4-17-24 21:28,1400,Payment,Rent Payment,1522.163413
20367,718492908,4-18-24 22:28,40.34,Deposit,Mobile Deposit,1562.503413
20368,718492908,4-21-24 19:28,245.41,Purchase,Furniture,1317.093413
20369,718492908,4-23-24 12:28,148.98,OnlineShopping,Walmart,1168.113413
20370,718492908,4-26-24 20:28,95.81,Payment,Mortgage Payment,1072.303413
20371,718492908,4-27-24 13:28,104.12,Payment,Bill Payment,968.1834134
20372,718492908,4-27-24 20:28,182.08,OnlineShopping,Target,786.1034134
20373,718492908,4-28-24 13:28,28.85,Return,Amazon Return,814.9534134
20374,718492908,4-29-24 23:28,123.63,Withdrawal,ATM Withdrawal,691.3234134
20375,718492908,05-01-24 11:28,38.66,Purchase,Grocery,652.6634134
20376,718492908,05-03-24 22:28,18.48,Withdrawal,ATM Withdrawal,634.1834134
20377,718492908,05-04-24 21:28,3300,IncomingTransfer,Salary,3934.183413
20378,718492908,05-08-24 17:28,10.15,OutgoingTransfer,Wire Transfer,3924.033413
20379,718492908,05-09-24 21:28,2300,Payment,Credit Card Payment,1624.033413
20380,718492908,05-10-24 11:28,217.21,Purchase,Home Improvement,1406.823413
20381,718492908,05-12-24 11:28,174.67,OnlineShopping,Target,1232.153413
20382,718492908,5-14-24 17:28,228.14,Withdrawal,Mobile App Withdrawal,1004.013413
20383,718492908,5-17-24 9:28,30.26,Deposit,Check Deposit,1034.273413
20384,718492908,5-17-24 10:28,127.02,Withdrawal,Branch Withdrawal,907.2534134
20385,718492908,5-17-24 21:28,1800,Payment,Rent Payment,-892.7465866
20386,718492908,5-18-24 20:28,141.26,Return,Etsy Return,-751.4865866
20387,718492908,5-21-24 17:28,229.19,Deposit,Mobile Deposit,-522.2965866
20388,718492908,5-23-24 20:28,73.63,Purchase,Furniture,-595.9265866
20389,718492908,5-23-24 20:28,187.06,Deposit,Check Deposit,-408.8665866
20390,718492908,5-25-24 19:28,238.75,Withdrawal,Mobile App Withdrawal,-647.6165866
20391,718492908,5-25-24 20:28,97.86,OnlineShopping,Target,-745.4765866
20392,718492908,5-27-24 16:28,62.93,Purchase,Grocery,-808.4065866
20393,718492908,5-28-24 22:28,156.95,OutgoingTransfer,International Transfer,-965.3565866
20394,718492908,06-01-24 13:28,222.32,Payment,Mortgage Payment,-1187.676587
20395,718492908,06-02-24 20:28,236.43,Purchase,Home Improvement,-1424.106587
20396,718492908,06-04-24 21:28,3300,IncomingTransfer,Salary,1875.893413
20397,718492908,06-05-24 22:28,110.92,Purchase,Pharmacy,1764.973413
20398,718492908,06-09-24 12:28,127.06,Withdrawal,ATM Withdrawal,1637.913413
20399,718492908,06-09-24 21:28,1900,Payment,Credit Card Payment,-262.0865866
20400,718492908,6-14-24 21:28,1200,Payment,Rent Payment,-1462.086587
20401,718492908,6-16-24 15:28,197.28,Purchase,Entertainment,-1659.366587
20402,718492908,6-16-24 17:28,12.37,Payment,Bill Payment,-1671.736587
20403,718492908,6-22-24 20:28,77.52,Withdrawal,ATM Withdrawal,-1749.256587
20404,718492908,6-23-24 22:28,159.37,Purchase,Home Improvement,-1908.626587
20405,718492908,6-25-24 10:28,184.74,Purchase,Restaurant,-2093.366587
20406,718492908,6-25-24 18:28,186.4,Return,eBay Return,-1906.966587
20407,718492908,6-25-24 18:28,88.28,Return,Target Return,-1818.686587
20408,718492908,6-26-24 20:28,35.5,Purchase,Pharmacy,-1854.186587
20409,718492908,6-30-24 20:28,230.45,Purchase,Grocery,-2084.636587
20410,718492908,07-01-24 13:28,45.16,Deposit,Mobile Deposit,-2039.476587
20411,718492908,07-02-24 21:28,3300,IncomingTransfer,Salary,1260.523413
20412,718492908,07-03-24 12:28,155.7,Payment,Bill Payment,1104.823413
20413,718492908,07-07-24 20:28,152.77,Purchase,Furniture,952.0534134
20414,718492908,07-07-24 21:28,2300,Payment,Credit Card Payment,-1347.946587
20415,718492908,07-08-24 21:28,16.63,Return,Store Return,-1331.316587
20416,718492908,07-10-24 22:28,137.87,OnlineShopping,Walmart,-1469.186587
20417,718492908,07-11-24 22:28,33.65,Deposit,Direct Deposit,-1435.536587
20418,718492908,07-12-24 21:28,1700,Payment,Rent Payment,-3135.536587
20419,718492908,7-14-24 20:28,195.17,Return,AliExpress Return,-2940.366587
20420,718589133,1-21-24 12:28,81.96,Purchase,Electronics,841.1808809
20421,718589133,1-28-24 17:28,171.96,Return,AliExpress Return,1013.140881
20422,718589133,1-31-24 23:28,127.17,Purchase,Entertainment,885.9708809
20423,718589133,02-01-24 16:28,133.94,Purchase,Home Improvement,752.0308809
20424,718589133,02-02-24 23:28,25.61,OnlineShopping,Target,726.4208809
20425,718589133,02-03-24 21:28,1950,IncomingTransfer,Salary,2676.420881
20426,718589133,02-06-24 12:28,168.42,Return,eBay Return,2844.840881
20427,718589133,02-08-24 21:28,2300,Payment,Credit Card Payment,544.8408809
20428,718589133,02-11-24 12:28,55.88,Payment,Loan Payment,488.9608809
20429,718589133,02-11-24 21:28,800,Payment,Rent Payment,-311.0391191
20430,718589133,02-12-24 21:28,111.44,Purchase,Clothing,-422.4791191
20431,718589133,2-13-24 22:28,225.88,OutgoingTransfer,Wire Transfer,-648.3591191
20432,718589133,2-15-24 9:28,130.61,Purchase,Gas,-778.9691191
20433,718589133,2-19-24 16:28,143.15,OutgoingTransfer,Bank Transfer,-922.1191191
20434,718589133,2-23-24 14:28,118.15,OnlineShopping,Target,-1040.269119
20435,718589133,2-24-24 11:28,38.41,Return,Target Return,-1001.859119
20436,718589133,2-27-24 22:28,107.05,Purchase,Travel,-1108.909119
20437,718589133,03-01-24 10:28,224.36,Return,Target Return,-884.5491191
20438,718589133,03-02-24 21:28,1950,IncomingTransfer,Salary,1065.450881
20439,718589133,03-02-24 22:28,175.86,Withdrawal,Mobile App Withdrawal,889.5908809
20440,718589133,03-04-24 19:28,26.22,Return,Etsy Return,915.8108809
20441,718589133,03-06-24 17:28,141.87,Deposit,Direct Deposit,1057.680881
20442,718589133,03-07-24 21:28,1700,Payment,Credit Card Payment,-642.3191191
20443,718589133,03-11-24 14:28,49.62,Deposit,Check Deposit,-592.6991191
20444,718589133,3-15-24 19:28,57.85,Purchase,Pharmacy,-650.5491191
20445,718589133,3-17-24 17:28,181.77,OutgoingTransfer,Bank Transfer,-832.3191191
20446,718589133,3-17-24 18:28,176.06,OnlineShopping,Etsy,-1008.379119
20447,718589133,3-18-24 21:28,1200,Payment,Rent Payment,-2208.379119
20448,718589133,3-21-24 17:28,63.45,OnlineShopping,AliExpress,-2271.829119
20449,718589133,3-27-24 16:28,63.29,OnlineShopping,Best Buy,-2335.119119
20450,718589133,3-29-24 15:28,199.74,Payment,Mortgage Payment,-2534.859119
20451,718589133,3-31-24 16:28,237.96,Deposit,Direct Deposit,-2296.899119
20452,718589133,04-01-24 21:28,1950,IncomingTransfer,Salary,-346.8991191
20453,718589133,04-06-24 18:28,25.43,OutgoingTransfer,International Transfer,-372.3291191
20454,718589133,04-06-24 21:28,1900,Payment,Credit Card Payment,-2272.329119
20455,718589133,04-12-24 12:28,239.39,OutgoingTransfer,Bank Transfer,-2511.719119
20456,718589133,4-13-24 21:28,700,Payment,Rent Payment,-3211.719119
20457,718589133,4-21-24 22:28,163.55,Withdrawal,Branch Withdrawal,-3375.269119
20458,718589133,4-25-24 15:28,199.82,Purchase,Entertainment,-3575.089119
20459,718589133,4-29-24 17:28,239.16,Withdrawal,Mobile App Withdrawal,-3814.249119
20460,718589133,4-30-24 19:28,169.2,OnlineShopping,AliExpress,-3983.449119
20461,718589133,05-02-24 10:28,189.73,Return,Best Buy Return,-3793.719119
20462,718589133,05-02-24 15:28,65.73,Payment,Bill Payment,-3859.449119
20463,718589133,05-03-24 14:28,100.84,Payment,Loan Payment,-3960.289119
20464,718589133,05-03-24 21:28,1950,IncomingTransfer,Salary,-2010.289119
20465,718589133,05-05-24 16:28,174.73,OutgoingTransfer,Peer-to-Peer Transfer,-2185.019119
20466,718589133,05-08-24 10:28,32.59,Purchase,Gas,-2217.609119
20467,718589133,05-08-24 21:28,1800,Payment,Credit Card Payment,-4017.609119
20468,718589133,05-12-24 21:28,600,Payment,Rent Payment,-4617.609119
20469,718589133,5-24-24 21:28,164.89,OutgoingTransfer,Bank Transfer,-4782.499119
20470,718589133,5-29-24 20:28,19.43,IncomingTransfer,Freelance Payment,-4763.069119
20471,718589133,06-02-24 18:28,176.28,Return,Amazon Return,-4586.789119
20472,718589133,06-04-24 20:28,202.22,Purchase,Grocery,-4789.009119
20473,718589133,06-04-24 21:28,59.75,IncomingTransfer,Freelance Payment,-4729.259119
20474,718589133,06-05-24 12:28,191.6,Purchase,Pharmacy,-4920.859119
20475,718589133,06-05-24 21:28,1950,IncomingTransfer,Salary,-2970.859119
20476,718589133,06-07-24 19:28,241.84,Deposit,Mobile Deposit,-2729.019119
20477,718589133,06-08-24 16:28,247.67,Return,Store Return,-2481.349119
20478,718589133,06-09-24 16:28,86.31,Deposit,Check Deposit,-2395.039119
20479,718589133,06-10-24 21:28,1900,Payment,Credit Card Payment,-4295.039119
20480,718589133,06-12-24 21:28,700,Payment,Rent Payment,-4995.039119
20481,718589133,6-13-24 12:28,243.67,Deposit,Mobile Deposit,-4751.369119
20482,718589133,6-14-24 13:28,225.06,Payment,Bill Payment,-4976.429119
20483,718589133,6-14-24 14:28,50.88,Purchase,Home Improvement,-5027.309119
20484,718589133,6-17-24 20:28,32.24,OnlineShopping,Walmart,-5059.549119
20485,718589133,6-22-24 11:28,17.94,IncomingTransfer,Freelance Payment,-5041.609119
20486,718589133,07-01-24 19:28,18.02,OutgoingTransfer,Wire Transfer,-5059.629119
20487,718589133,07-02-24 21:28,1950,IncomingTransfer,Salary,-3109.629119
20488,718589133,07-03-24 19:28,186.26,Payment,Bill Payment,-3295.889119
20489,718589133,07-06-24 14:28,52.52,Return,Etsy Return,-3243.369119
20490,718589133,07-07-24 21:28,1800,Payment,Credit Card Payment,-5043.369119
20491,718589133,07-09-24 12:28,243.22,Deposit,Check Deposit,-4800.149119
20492,718589133,07-09-24 20:28,98.46,Purchase,Entertainment,-4898.609119
20493,718589133,07-10-24 9:28,128.26,Withdrawal,Branch Withdrawal,-5026.869119
20494,718589133,7-13-24 12:28,71.4,Withdrawal,Mobile App Withdrawal,-5098.269119
20495,718589133,7-14-24 13:28,121.29,Deposit,Cash Deposit,-4976.979119
20496,718589133,7-14-24 13:28,102.79,Return,Amazon Return,-4874.189119
20497,718589133,7-14-24 22:28,91.34,Deposit,Direct Deposit,-4782.849119
20498,718589133,7-17-24 16:28,174.98,Deposit,Cash Deposit,-4607.869119
20499,718589133,7-18-24 21:28,600,Payment,Rent Payment,-5207.869119
20500,718629858,1-22-24 10:28,245.54,Purchase,Entertainment,-245.54
20501,718629858,1-27-24 10:28,102.08,OnlineShopping,Best Buy,-347.62
20502,718629858,1-27-24 17:28,272.71,Return,Target Return,-74.91
20503,718629858,02-02-24 17:28,482.39,Deposit,Check Deposit,407.48
20504,718629858,02-05-24 21:28,2450,IncomingTransfer,Salary,2857.48
20505,718629858,02-07-24 17:28,307.62,OnlineShopping,Walmart,2549.86
20506,718629858,02-07-24 22:28,378.92,Deposit,Direct Deposit,2928.78
20507,718629858,02-12-24 20:28,78.68,Withdrawal,ATM Withdrawal,2850.1
20508,718629858,2-13-24 13:28,481.86,Purchase,Gas,2368.24
20509,718629858,2-13-24 19:28,393.33,OnlineShopping,Walmart,1974.91
20510,718629858,2-17-24 21:28,1100,Payment,Rent Payment,874.91
20511,718629858,2-19-24 18:28,381.94,Withdrawal,Mobile App Withdrawal,492.97
20512,718629858,2-20-24 9:28,445.55,Return,Best Buy Return,938.52
20513,718629858,2-21-24 9:28,158.17,OutgoingTransfer,Wire Transfer,780.35
20514,718629858,2-22-24 20:28,283.22,Purchase,Electronics,497.13
20515,718629858,2-28-24 20:28,440.87,OutgoingTransfer,Peer-to-Peer Transfer,56.26
20516,718629858,03-01-24 9:28,464.06,Deposit,Cash Deposit,520.32
20517,718629858,03-02-24 12:28,370.95,Deposit,Mobile Deposit,891.27
20518,718629858,03-03-24 17:28,196.55,IncomingTransfer,Freelance Payment,1087.82
20519,718629858,03-04-24 21:28,2450,IncomingTransfer,Salary,3537.82
20520,718629858,03-10-24 10:28,314.61,Deposit,Cash Deposit,3852.43
20521,718629858,03-10-24 21:28,1500,Payment,Rent Payment,2352.43
20522,718629858,3-17-24 15:28,458.44,Deposit,Check Deposit,2810.87
20523,718629858,3-22-24 22:28,344.46,OutgoingTransfer,Wire Transfer,2466.41
20524,718629858,3-23-24 14:28,327.45,Return,Target Return,2793.86
20525,718629858,3-23-24 20:28,374.63,Payment,Bill Payment,2419.23
20526,718629858,3-26-24 15:28,349.02,Withdrawal,Mobile App Withdrawal,2070.21
20527,718629858,3-31-24 14:28,364.32,OutgoingTransfer,International Transfer,1705.89
20528,718629858,04-01-24 9:28,83.18,Purchase,Grocery,1622.71
20529,718629858,04-01-24 15:28,403.06,OnlineShopping,Walmart,1219.65
20530,718629858,04-01-24 21:28,2450,IncomingTransfer,Salary,3669.65
20531,718629858,04-02-24 12:28,170.25,Deposit,Mobile Deposit,3839.9
20532,718629858,04-03-24 17:28,361.02,Deposit,Check Deposit,4200.92
20533,718629858,04-04-24 12:28,128.24,Withdrawal,Mobile App Withdrawal,4072.68
20534,718629858,04-04-24 13:28,227.62,Deposit,Check Deposit,4300.3
20535,718629858,04-05-24 14:28,497.11,Payment,Loan Payment,3803.19
20536,718629858,04-07-24 12:28,490.24,Return,Store Return,4293.43
20537,718629858,04-09-24 14:28,90.68,Deposit,Check Deposit,4384.11
20538,718629858,04-10-24 21:28,1100,Payment,Rent Payment,3284.11
20539,718629858,04-11-24 22:28,114.18,OutgoingTransfer,Peer-to-Peer Transfer,3169.93
20540,718629858,4-17-24 18:28,311.94,Withdrawal,ATM Withdrawal,2857.99
20541,718629858,4-18-24 9:28,328.81,Deposit,Mobile Deposit,3186.8
20542,718629858,4-18-24 12:28,215.31,Return,Best Buy Return,3402.11
20543,718629858,4-19-24 10:28,333.39,OnlineShopping,Etsy,3068.72
20544,718629858,4-24-24 16:28,230.61,Withdrawal,Branch Withdrawal,2838.11
20545,718629858,4-25-24 14:28,337.04,Deposit,Mobile Deposit,3175.15
20546,718629858,4-25-24 15:28,153.1,Deposit,Mobile Deposit,3328.25
20547,718629858,4-29-24 20:28,217.27,Payment,Mortgage Payment,3110.98
20548,718629858,05-01-24 20:28,165.85,Return,Amazon Return,3276.83
20549,718629858,05-02-24 11:28,188.39,OnlineShopping,Target,3088.44
20550,718629858,05-05-24 21:28,2450,IncomingTransfer,Salary,5538.44
20551,718629858,05-06-24 22:28,495.07,OutgoingTransfer,Bank Transfer,5043.37
20552,718629858,05-07-24 11:28,213.74,OnlineShopping,Etsy,4829.63
20553,718629858,05-11-24 16:28,384.14,Purchase,Pharmacy,4445.49
20554,718629858,5-13-24 12:28,314.52,Purchase,Grocery,4130.97
20555,718629858,5-13-24 19:28,55.82,Withdrawal,ATM Withdrawal,4075.15
20556,718629858,5-15-24 20:28,102.96,Deposit,Mobile Deposit,4178.11
20557,718629858,5-15-24 21:28,1500,Payment,Rent Payment,2678.11
20558,718629858,5-18-24 16:28,302.35,Purchase,Home Improvement,2375.76
20559,718629858,5-20-24 22:28,339.4,OnlineShopping,AliExpress,2036.36
20560,718629858,5-21-24 13:28,51.26,IncomingTransfer,Freelance Payment,2087.62
20561,718629858,5-21-24 20:28,414.96,Deposit,Cash Deposit,2502.58
20562,718629858,5-22-24 20:28,486.91,Return,AliExpress Return,2989.49
20563,718629858,5-23-24 10:28,419.42,Return,Etsy Return,3408.91
20564,718629858,5-23-24 11:28,18.57,Withdrawal,Mobile App Withdrawal,3390.34
20565,718629858,5-24-24 23:28,31.28,Deposit,Mobile Deposit,3421.62
20566,718629858,5-28-24 16:28,172.82,Withdrawal,Mobile App Withdrawal,3248.8
20567,718629858,5-28-24 19:28,447.68,Withdrawal,Branch Withdrawal,2801.12
20568,718629858,5-29-24 11:28,37.07,Deposit,Mobile Deposit,2838.19
20569,718629858,5-30-24 15:28,230.77,Deposit,Cash Deposit,3068.96
20570,718629858,5-31-24 21:28,428.78,Deposit,Mobile Deposit,3497.74
20571,718629858,06-01-24 12:28,147.71,Purchase,Electronics,3350.03
20572,718629858,06-01-24 13:28,55.97,IncomingTransfer,Freelance Payment,3406
20573,718629858,06-03-24 10:28,446.92,Payment,Bill Payment,2959.08
20574,718629858,06-03-24 10:28,218.06,Payment,Mortgage Payment,2741.02
20575,718629858,06-03-24 16:28,81.67,IncomingTransfer,Freelance Payment,2822.69
20576,718629858,06-04-24 18:28,494.57,IncomingTransfer,Freelance Payment,3317.26
20577,718629858,06-04-24 21:28,2450,IncomingTransfer,Salary,5767.26
20578,718629858,06-06-24 12:28,495.69,Payment,Loan Payment,5271.57
20579,718629858,06-06-24 23:28,475.05,Withdrawal,Branch Withdrawal,4796.52
20580,718629858,06-09-24 10:28,392.35,Return,AliExpress Return,5188.87
20581,718629858,06-11-24 13:28,152.75,Deposit,Mobile Deposit,5341.62
20582,718629858,6-13-24 18:28,365.16,Deposit,Mobile Deposit,5706.78
20583,718629858,6-14-24 21:28,1200,Payment,Rent Payment,4506.78
20584,718629858,6-14-24 22:28,154.48,Purchase,Clothing,4352.3
20585,718629858,6-18-24 14:28,96.34,Deposit,Direct Deposit,4448.64
20586,718629858,6-18-24 17:28,317.97,Payment,Mortgage Payment,4130.67
20587,718629858,6-19-24 11:28,299.18,Withdrawal,Branch Withdrawal,3831.49
20588,718629858,6-22-24 11:28,425.64,Withdrawal,Mobile App Withdrawal,3405.85
20589,718629858,6-23-24 16:28,150.53,Purchase,Pharmacy,3255.32
20590,718629858,6-25-24 13:28,461.33,IncomingTransfer,Freelance Payment,3716.65
20591,718629858,6-27-24 18:28,75.62,Payment,Bill Payment,3641.03
20592,718629858,6-28-24 19:28,103.15,Purchase,Entertainment,3537.88
20593,718629858,07-03-24 22:28,215.07,Deposit,Direct Deposit,3752.95
20594,718629858,07-04-24 11:28,421.92,Withdrawal,Mobile App Withdrawal,3331.03
20595,718629858,07-05-24 21:28,2450,IncomingTransfer,Salary,5781.03
20596,718629858,07-09-24 12:28,405.26,OnlineShopping,Walmart,5375.77
20597,718629858,07-10-24 21:28,1500,Payment,Rent Payment,3875.77
20598,718629858,07-11-24 14:28,245.86,Payment,Mortgage Payment,3629.91
20599,718629858,07-12-24 12:28,172.52,Purchase,Restaurant,3457.39
20600,718629858,7-16-24 23:28,247.59,Purchase,Entertainment,3209.8
20601,718634058,1-20-24 13:28,42.72,Purchase,Furniture,534.6686874
20602,718634058,1-23-24 11:28,337.08,Return,Best Buy Return,871.7486874
20603,718634058,1-24-24 10:28,262.82,Return,Target Return,1134.568687
20604,718634058,1-24-24 18:28,269.69,IncomingTransfer,Freelance Payment,1404.258687
20605,718634058,1-26-24 15:28,10.17,Withdrawal,Mobile App Withdrawal,1394.088687
20606,718634058,1-27-24 14:28,125.59,Deposit,Cash Deposit,1519.678687
20607,718634058,1-30-24 9:28,391.76,Deposit,Check Deposit,1911.438687
20608,718634058,02-01-24 16:28,239.47,Return,Walmart Return,2150.908687
20609,718634058,02-02-24 11:28,464.26,OnlineShopping,Walmart,1686.648687
20610,718634058,02-02-24 17:28,269.36,OutgoingTransfer,Peer-to-Peer Transfer,1417.288687
20611,718634058,02-02-24 21:28,3700,IncomingTransfer,Salary,5117.288687
20612,718634058,02-03-24 19:28,490.08,OutgoingTransfer,Bank Transfer,4627.208687
20613,718634058,02-04-24 16:28,412.37,Deposit,Check Deposit,5039.578687
20614,718634058,02-04-24 19:28,499.63,IncomingTransfer,Freelance Payment,5539.208687
20615,718634058,02-07-24 21:28,900,Payment,Credit Card Payment,4639.208687
20616,718634058,02-09-24 17:28,270.56,IncomingTransfer,Freelance Payment,4909.768687
20617,718634058,02-11-24 22:28,125.37,Payment,Loan Payment,4784.398687
20618,718634058,2-14-24 14:28,281.71,OnlineShopping,Amazon,4502.688687
20619,718634058,2-14-24 22:28,414.6,Purchase,Furniture,4088.088687
20620,718634058,2-15-24 9:28,230.05,Deposit,Direct Deposit,4318.138687
20621,718634058,2-15-24 20:28,429.91,Purchase,Clothing,3888.228687
20622,718634058,2-17-24 21:28,1300,Payment,Subscription Payment,2588.228687
20623,718634058,2-18-24 22:28,215.06,Deposit,Direct Deposit,2803.288687
20624,718634058,2-19-24 12:28,249.22,OnlineShopping,Best Buy,2554.068687
20625,718634058,2-22-24 14:28,210.98,Payment,Loan Payment,2343.088687
20626,718634058,2-23-24 12:28,161.16,Deposit,Mobile Deposit,2504.248687
20627,718634058,2-25-24 11:28,167.15,Withdrawal,ATM Withdrawal,2337.098687
20628,718634058,2-26-24 12:28,378.07,OnlineShopping,Target,1959.028687
20629,718634058,2-26-24 18:28,325.71,Purchase,Home Improvement,1633.318687
20630,718634058,2-27-24 22:28,263.36,Purchase,Electronics,1369.958687
20631,718634058,2-28-24 12:28,452.4,Withdrawal,Mobile App Withdrawal,917.5586874
20632,718634058,2-29-24 11:28,481.37,Deposit,Cash Deposit,1398.928687
20633,718634058,2-29-24 15:28,51.06,Return,eBay Return,1449.988687
20634,718634058,03-05-24 13:28,311.66,OutgoingTransfer,Wire Transfer,1138.328687
20635,718634058,03-05-24 21:28,3700,IncomingTransfer,Salary,4838.328687
20636,718634058,03-08-24 15:28,298.35,Deposit,Cash Deposit,5136.678687
20637,718634058,03-08-24 17:28,208.31,Purchase,Entertainment,4928.368687
20638,718634058,03-10-24 21:28,900,Payment,Credit Card Payment,4028.368687
20639,718634058,03-12-24 9:28,363.54,OutgoingTransfer,Wire Transfer,3664.828687
20640,718634058,3-13-24 19:28,447.51,Withdrawal,Branch Withdrawal,3217.318687
20641,718634058,3-13-24 21:28,1400,Payment,Subscription Payment,1817.318687
20642,718634058,3-14-24 11:28,234.18,Purchase,Electronics,1583.138687
20643,718634058,3-14-24 14:28,285.99,OnlineShopping,Walmart,1297.148687
20644,718634058,3-16-24 17:28,244.53,OutgoingTransfer,International Transfer,1052.618687
20645,718634058,3-17-24 16:28,219.59,Withdrawal,Branch Withdrawal,833.0286874
20646,718634058,3-17-24 20:28,151.24,Withdrawal,Mobile App Withdrawal,681.7886874
20647,718634058,3-17-24 22:28,337.3,OutgoingTransfer,International Transfer,344.4886874
20648,718634058,3-20-24 15:28,305.97,Payment,Loan Payment,38.51868743
20649,718634058,3-22-24 20:28,185.12,Deposit,Cash Deposit,223.6386874
20650,718634058,3-24-24 11:28,127.24,Purchase,Gas,96.39868743
20651,718634058,3-27-24 21:28,238.25,Deposit,Check Deposit,334.6486874
20652,718634058,3-28-24 22:28,146.6,OutgoingTransfer,Bank Transfer,188.0486874
20653,718634058,3-28-24 23:28,185.33,Return,AliExpress Return,373.3786874
20654,718634058,3-30-24 19:28,208.44,Payment,Mortgage Payment,164.9386874
20655,718634058,3-31-24 19:28,265.81,OnlineShopping,Amazon,-100.8713126
20656,718634058,04-02-24 15:28,353.56,Deposit,Direct Deposit,252.6886874
20657,718634058,04-02-24 20:28,332.59,OnlineShopping,AliExpress,-79.90131257
20658,718634058,04-04-24 20:28,170.47,Deposit,Cash Deposit,90.56868743
20659,718634058,04-04-24 21:28,3700,IncomingTransfer,Salary,3790.568687
20660,718634058,04-09-24 21:28,800,Payment,Credit Card Payment,2990.568687
20661,718634058,04-10-24 13:28,388.76,Purchase,Gas,2601.808687
20662,718634058,04-10-24 18:28,388.71,OutgoingTransfer,Peer-to-Peer Transfer,2213.098687
20663,718634058,4-16-24 21:28,1700,Payment,Subscription Payment,513.0986874
20664,718634058,4-18-24 11:28,365.15,Purchase,Home Improvement,147.9486874
20665,718634058,4-23-24 11:28,310.65,OutgoingTransfer,Peer-to-Peer Transfer,-162.7013126
20666,718634058,4-23-24 17:28,371.91,Return,Target Return,209.2086874
20667,718634058,4-25-24 14:28,459.82,Withdrawal,ATM Withdrawal,-250.6113126
20668,718634058,4-27-24 15:28,197.44,OnlineShopping,Target,-448.0513126
20669,718634058,4-27-24 17:28,414.07,Deposit,Check Deposit,-33.98131257
20670,718634058,4-29-24 14:28,199.82,Deposit,Cash Deposit,165.8386874
20671,718634058,4-30-24 13:28,441.87,Return,Best Buy Return,607.7086874
20672,718634058,05-01-24 23:28,499.95,Deposit,Cash Deposit,1107.658687
20673,718634058,05-02-24 21:28,3700,IncomingTransfer,Salary,4807.658687
20674,718634058,05-06-24 18:28,484.48,Payment,Loan Payment,4323.178687
20675,718634058,05-07-24 21:28,900,Payment,Credit Card Payment,3423.178687
20676,718634058,05-07-24 21:28,397.55,OnlineShopping,Amazon,3025.628687
20677,718634058,05-09-24 11:28,55.02,Deposit,Cash Deposit,3080.648687
20678,718634058,05-09-24 11:28,179.46,Payment,Loan Payment,2901.188687
20679,718634058,05-09-24 18:28,468.83,Purchase,Home Improvement,2432.358687
20680,718634058,05-11-24 13:28,303.56,Purchase,Pharmacy,2128.798687
20681,718634058,05-12-24 17:28,94.52,IncomingTransfer,Freelance Payment,2223.318687
20682,718634058,5-13-24 16:28,477.07,OnlineShopping,AliExpress,1746.248687
20683,718634058,5-13-24 20:28,210.9,IncomingTransfer,Freelance Payment,1957.148687
20684,718634058,5-14-24 16:28,259.52,OnlineShopping,Target,1697.628687
20685,718634058,5-14-24 21:28,1200,Payment,Insurance Payment,497.6286874
20686,718634058,5-18-24 20:28,49.37,Purchase,Grocery,448.2586874
20687,718634058,5-19-24 13:28,385.8,Deposit,Direct Deposit,834.0586874
20688,718634058,5-21-24 21:28,419.56,Purchase,Restaurant,414.4986874
20689,718634058,5-21-24 23:28,388.23,Return,Store Return,802.7286874
20690,718634058,5-22-24 17:28,461.68,Deposit,Cash Deposit,1264.408687
20691,718634058,5-23-24 23:28,462.94,IncomingTransfer,Freelance Payment,1727.348687
20692,718634058,5-24-24 17:28,303.74,Return,eBay Return,2031.088687
20693,718634058,06-02-24 21:28,3700,IncomingTransfer,Salary,5731.088687
20694,718634058,06-03-24 9:28,168.58,IncomingTransfer,Freelance Payment,5899.668687
20695,718634058,06-03-24 21:28,445.74,Withdrawal,Mobile App Withdrawal,5453.928687
20696,718634058,06-04-24 11:28,257.55,IncomingTransfer,Freelance Payment,5711.478687
20697,718634058,06-05-24 9:28,326.42,OutgoingTransfer,Bank Transfer,5385.058687
20698,718634058,06-06-24 18:28,294.49,Purchase,Gas,5090.568687
20699,718634058,06-07-24 21:28,800,Payment,Credit Card Payment,4290.568687
20700,718634058,6-14-24 9:28,331.49,OnlineShopping,Walmart,3959.078687
20701,718634058,6-17-24 22:28,274.71,Withdrawal,Branch Withdrawal,3684.368687
20702,718634058,6-18-24 16:28,283.27,Return,Amazon Return,3967.638687
20703,718634058,6-18-24 21:28,1100,Payment,Subscription Payment,2867.638687
20704,718634058,6-18-24 22:28,171.14,Return,Walmart Return,3038.778687
20705,718634058,6-22-24 20:28,455.31,OutgoingTransfer,Bank Transfer,2583.468687
20706,718634058,6-29-24 21:28,21.21,Deposit,Mobile Deposit,2604.678687
20707,718634058,6-29-24 21:28,407.58,Payment,Bill Payment,2197.098687
20708,718634058,07-01-24 14:28,380.73,Payment,Mortgage Payment,1816.368687
20709,718634058,07-02-24 15:28,328.24,Purchase,Pharmacy,1488.128687
20710,718634058,07-05-24 21:28,3700,IncomingTransfer,Salary,5188.128687
20711,718634058,07-08-24 18:28,97.08,Payment,Mortgage Payment,5091.048687
20712,718634058,07-10-24 21:28,800,Payment,Credit Card Payment,4291.048687
20713,718634058,07-11-24 9:28,192.02,Payment,Loan Payment,4099.028687
20714,718634058,07-12-24 21:28,1100,Payment,Installment Payment,2999.028687
20715,718634058,7-13-24 13:28,245.16,OutgoingTransfer,Wire Transfer,2753.868687
20716,718634058,7-16-24 13:28,328.18,Deposit,Direct Deposit,3082.048687
20717,718634058,7-16-24 16:28,37.28,Withdrawal,Mobile App Withdrawal,3044.768687
20718,718634058,7-16-24 19:28,140.27,Return,Target Return,3185.038687
20719,718651083,1-25-24 17:28,398.47,Payment,Bill Payment,-118.6133216
20720,718651083,1-27-24 12:28,215.22,Deposit,Check Deposit,96.60667837
20721,718651083,1-29-24 16:28,424.67,OnlineShopping,AliExpress,-328.0633216
20722,718651083,1-31-24 22:28,318.48,Payment,Mortgage Payment,-646.5433216
20723,718651083,02-02-24 11:28,325.72,Deposit,Check Deposit,-320.8233216
20724,718651083,02-03-24 11:28,324.49,Purchase,Electronics,-645.3133216
20725,718651083,02-03-24 18:28,429.85,Withdrawal,ATM Withdrawal,-1075.163322
20726,718651083,02-04-24 21:28,5700,IncomingTransfer,Salary,4624.836678
20727,718651083,02-07-24 14:28,234.25,Deposit,Mobile Deposit,4859.086678
20728,718651083,02-09-24 21:28,700,Payment,Credit Card Payment,4159.086678
20729,718651083,02-09-24 22:28,123.61,Purchase,Electronics,4035.476678
20730,718651083,02-11-24 14:28,426.22,Deposit,Mobile Deposit,4461.696678
20731,718651083,02-12-24 23:28,95.42,Purchase,Home Improvement,4366.276678
20732,718651083,2-15-24 14:28,176.78,OnlineShopping,eBay,4189.496678
20733,718651083,2-15-24 21:28,3000,Payment,Rent Payment,1189.496678
20734,718651083,2-16-24 9:28,128.86,Payment,Bill Payment,1060.636678
20735,718651083,2-23-24 18:28,210.16,Withdrawal,Branch Withdrawal,850.4766784
20736,718651083,2-24-24 18:28,339.04,Withdrawal,Branch Withdrawal,511.4366784
20737,718651083,2-28-24 23:28,101.96,Payment,Mortgage Payment,409.4766784
20738,718651083,03-04-24 21:28,5700,IncomingTransfer,Salary,6109.476678
20739,718651083,03-05-24 10:28,392.81,Purchase,Pharmacy,5716.666678
20740,718651083,03-05-24 11:28,454.31,Purchase,Restaurant,5262.356678
20741,718651083,03-05-24 17:28,322.01,Purchase,Clothing,4940.346678
20742,718651083,03-06-24 15:28,243.27,Deposit,Cash Deposit,5183.616678
20743,718651083,03-06-24 17:28,67.26,Purchase,Electronics,5116.356678
20744,718651083,03-09-24 21:28,600,Payment,Credit Card Payment,4516.356678
20745,718651083,03-12-24 9:28,106.85,Purchase,Travel,4409.506678
20746,718651083,3-16-24 21:28,2300,Payment,Rent Payment,2109.506678
20747,718651083,3-24-24 19:28,498.97,IncomingTransfer,Freelance Payment,2608.476678
20748,718651083,3-24-24 21:28,422.58,Purchase,Entertainment,2185.896678
20749,718651083,3-24-24 22:28,285.78,OnlineShopping,Etsy,1900.116678
20750,718651083,3-26-24 10:28,180.16,Purchase,Gas,1719.956678
20751,718651083,3-27-24 22:28,368.52,Purchase,Grocery,1351.436678
20752,718651083,3-30-24 19:28,156.21,Withdrawal,Mobile App Withdrawal,1195.226678
20753,718651083,04-01-24 15:28,180.51,OutgoingTransfer,Peer-to-Peer Transfer,1014.716678
20754,718651083,04-03-24 23:28,432.96,Withdrawal,Branch Withdrawal,581.7566784
20755,718651083,04-04-24 13:28,15.28,Return,Target Return,597.0366784
20756,718651083,04-05-24 21:28,5700,IncomingTransfer,Salary,6297.036678
20757,718651083,04-06-24 13:28,484.1,Deposit,Cash Deposit,6781.136678
20758,718651083,04-06-24 20:28,71.86,Purchase,Pharmacy,6709.276678
20759,718651083,04-10-24 17:28,441.15,Deposit,Direct Deposit,7150.426678
20760,718651083,04-10-24 21:28,600,Payment,Credit Card Payment,6550.426678
20761,718651083,04-10-24 23:28,137.58,Payment,Bill Payment,6412.846678
20762,718651083,4-18-24 21:28,3300,Payment,Rent Payment,3112.846678
20763,718651083,4-22-24 10:28,29.84,Deposit,Direct Deposit,3142.686678
20764,718651083,4-24-24 11:28,48.51,Return,Best Buy Return,3191.196678
20765,718651083,4-24-24 15:28,33.53,Purchase,Grocery,3157.666678
20766,718651083,4-28-24 17:28,318.97,Deposit,Cash Deposit,3476.636678
20767,718651083,4-29-24 9:28,89.58,Return,Best Buy Return,3566.216678
20768,718651083,05-01-24 20:28,352.38,OutgoingTransfer,Wire Transfer,3213.836678
20769,718651083,05-01-24 21:28,5700,IncomingTransfer,Salary,8913.836678
20770,718651083,05-02-24 15:28,292.98,Purchase,Gas,8620.856678
20771,718651083,05-04-24 16:28,248.81,Deposit,Direct Deposit,8869.666678
20772,718651083,05-04-24 17:28,492.87,Purchase,Home Improvement,8376.796678
20773,718651083,05-05-24 22:28,472.03,Withdrawal,ATM Withdrawal,7904.766678
20774,718651083,05-06-24 21:28,600,Payment,Credit Card Payment,7304.766678
20775,718651083,05-10-24 13:28,98.35,OutgoingTransfer,Peer-to-Peer Transfer,7206.416678
20776,718651083,05-10-24 21:28,2400,Payment,Rent Payment,4806.416678
20777,718651083,5-16-24 21:28,329.17,Payment,Mortgage Payment,4477.246678
20778,718651083,5-18-24 11:28,111.31,Return,Etsy Return,4588.556678
20779,718651083,5-21-24 11:28,55.74,Payment,Mortgage Payment,4532.816678
20780,718651083,5-23-24 17:28,254.13,Return,Store Return,4786.946678
20781,718651083,5-27-24 23:28,228.33,OutgoingTransfer,Bank Transfer,4558.616678
20782,718651083,5-28-24 15:28,384.55,OnlineShopping,Etsy,4174.066678
20783,718651083,5-29-24 9:28,385.48,Purchase,Entertainment,3788.586678
20784,718651083,06-01-24 21:28,5700,IncomingTransfer,Salary,9488.586678
20785,718651083,06-02-24 14:28,277.98,Deposit,Direct Deposit,9766.566678
20786,718651083,06-02-24 17:28,117.09,Purchase,Restaurant,9649.476678
20787,718651083,06-06-24 14:28,417.73,Purchase,Entertainment,9231.746678
20788,718651083,06-06-24 21:28,700,Payment,Credit Card Payment,8531.746678
20789,718651083,06-10-24 22:28,473.44,Withdrawal,Mobile App Withdrawal,8058.306678
20790,718651083,6-14-24 21:28,3400,Payment,Rent Payment,4658.306678
20791,718651083,6-17-24 18:28,199.86,Purchase,Clothing,4458.446678
20792,718651083,6-18-24 15:28,274.96,OutgoingTransfer,Bank Transfer,4183.486678
20793,718651083,6-22-24 15:28,157.67,Deposit,Direct Deposit,4341.156678
20794,718651083,6-26-24 14:28,423.56,Deposit,Direct Deposit,4764.716678
20795,718651083,6-29-24 16:28,73.24,OutgoingTransfer,Peer-to-Peer Transfer,4691.476678
20796,718651083,07-01-24 21:28,5700,IncomingTransfer,Salary,10391.47668
20797,718651083,07-06-24 20:28,92.2,OnlineShopping,Walmart,10299.27668
20798,718651083,07-06-24 21:28,600,Payment,Credit Card Payment,9699.276678
20799,718651083,07-06-24 21:28,133.64,OnlineShopping,Etsy,9565.636678
20800,718651083,07-09-24 11:28,79.2,OnlineShopping,Best Buy,9486.436678
20801,718651083,07-10-24 22:28,184.71,Purchase,Furniture,9301.726678
20802,718651083,07-11-24 18:28,225.73,OnlineShopping,Walmart,9075.996678
20803,718651083,07-12-24 21:28,2500,Payment,Rent Payment,6575.996678
20804,718651083,7-15-24 10:28,153.09,Purchase,Clothing,6422.906678
20805,718653333,1-21-24 10:28,93.24,OnlineShopping,Best Buy,-93.24
20806,718653333,02-01-24 21:28,46.9,Purchase,Gas,-140.14
20807,718653333,02-03-24 21:28,2950,IncomingTransfer,Salary,2809.86
20808,718653333,02-10-24 17:28,214.23,Purchase,Restaurant,2595.63
20809,718653333,02-11-24 12:28,225.72,Purchase,Electronics,2369.91
20810,718653333,02-12-24 16:28,102.36,OnlineShopping,Best Buy,2267.55
20811,718653333,02-12-24 19:28,225.86,Payment,Loan Payment,2041.69
20812,718653333,2-14-24 9:28,241.78,Purchase,Furniture,1799.91
20813,718653333,2-15-24 21:28,1900,Payment,Rent Payment,-100.09
20814,718653333,2-23-24 16:28,111.28,Return,Best Buy Return,11.19
20815,718653333,2-23-24 22:28,73.92,Deposit,Mobile Deposit,85.11
20816,718653333,2-28-24 20:28,48.83,Return,Best Buy Return,133.94
20817,718653333,03-05-24 21:28,2950,IncomingTransfer,Salary,3083.94
20818,718653333,03-07-24 17:28,205.82,Deposit,Check Deposit,3289.76
20819,718653333,3-16-24 21:28,900,Payment,Rent Payment,2389.76
20820,718653333,3-28-24 13:28,246.21,Purchase,Home Improvement,2143.55
20821,718653333,04-05-24 21:28,2950,IncomingTransfer,Salary,5093.55
20822,718653333,04-07-24 22:28,149.61,Withdrawal,ATM Withdrawal,4943.94
20823,718653333,04-10-24 16:28,192,OnlineShopping,Target,4751.94
20824,718653333,04-10-24 21:28,1300,Payment,Rent Payment,3451.94
20825,718653333,04-11-24 12:28,226.74,Purchase,Home Improvement,3225.2
20826,718653333,4-27-24 20:28,75.13,OutgoingTransfer,Peer-to-Peer Transfer,3150.07
20827,718653333,05-02-24 16:28,70.46,Withdrawal,ATM Withdrawal,3079.61
20828,718653333,05-04-24 11:28,77.35,IncomingTransfer,Freelance Payment,3156.96
20829,718653333,05-04-24 21:28,2950,IncomingTransfer,Salary,6106.96
20830,718653333,05-08-24 11:28,236.93,Payment,Bill Payment,5870.03
20831,718653333,05-10-24 21:28,1300,Payment,Rent Payment,4570.03
20832,718653333,5-17-24 15:28,160.68,OutgoingTransfer,Wire Transfer,4409.35
20833,718653333,5-17-24 20:28,236.72,Purchase,Grocery,4172.63
20834,718653333,5-19-24 22:28,237.77,IncomingTransfer,Freelance Payment,4410.4
20835,718653333,06-05-24 16:28,189.71,Payment,Bill Payment,4220.69
20836,718653333,06-05-24 21:28,2950,IncomingTransfer,Salary,7170.69
20837,718653333,6-15-24 21:28,1400,Payment,Rent Payment,5770.69
20838,718653333,6-18-24 20:28,152.89,OnlineShopping,Target,5617.8
20839,718653333,6-21-24 20:28,55.96,OutgoingTransfer,Wire Transfer,5561.84
20840,718653333,6-26-24 15:28,112.91,Purchase,Gas,5448.93
20841,718653333,6-29-24 18:28,109.07,Withdrawal,Mobile App Withdrawal,5339.86
20842,718653333,07-02-24 17:28,144.41,Deposit,Check Deposit,5484.27
20843,718653333,07-02-24 20:28,138.43,Return,Etsy Return,5622.7
20844,718653333,07-05-24 21:28,2950,IncomingTransfer,Salary,8572.7
20845,718653333,07-10-24 19:28,103.02,Purchase,Entertainment,8469.68
20846,718653333,7-13-24 21:28,1500,Payment,Rent Payment,6969.68
20847,718653333,7-15-24 14:28,239.05,IncomingTransfer,Freelance Payment,7208.73
20848,718726833,1-21-24 19:28,643.73,OutgoingTransfer,International Transfer,-643.73
20849,718726833,1-25-24 13:28,420.72,Withdrawal,Mobile App Withdrawal,-1064.45
20850,718726833,1-29-24 12:28,388.62,OnlineShopping,eBay,-1453.07
20851,718726833,02-02-24 21:28,8050,IncomingTransfer,Salary,6596.93
20852,718726833,02-10-24 21:28,2300,Payment,Rent Payment,4296.93
20853,718726833,02-11-24 22:28,490.82,Deposit,Mobile Deposit,4787.75
20854,718726833,2-13-24 10:28,503.44,Payment,Mortgage Payment,4284.31
20855,718726833,2-15-24 11:28,467.01,Withdrawal,ATM Withdrawal,3817.3
20856,718726833,03-01-24 13:28,737.06,Deposit,Mobile Deposit,4554.36
20857,718726833,03-05-24 21:28,8050,IncomingTransfer,Salary,12604.36
20858,718726833,03-08-24 9:28,481.52,Return,Store Return,13085.88
20859,718726833,03-08-24 15:28,168.15,OnlineShopping,Target,12917.73
20860,718726833,03-11-24 20:28,593.12,Payment,Mortgage Payment,12324.61
20861,718726833,03-11-24 21:28,3800,Payment,Rent Payment,8524.61
20862,718726833,03-11-24 23:28,527.35,OnlineShopping,AliExpress,7997.26
20863,718726833,3-15-24 11:28,416.23,Withdrawal,Branch Withdrawal,7581.03
20864,718726833,3-31-24 18:28,734.71,OutgoingTransfer,Wire Transfer,6846.32
20865,718726833,04-04-24 21:28,8050,IncomingTransfer,Salary,14896.32
20866,718726833,4-13-24 15:28,385.4,Withdrawal,Mobile App Withdrawal,14510.92
20867,718726833,4-15-24 22:28,586.71,Return,Walmart Return,15097.63
20868,718726833,4-16-24 21:28,3300,Payment,Rent Payment,11797.63
20869,718726833,4-23-24 18:28,697.19,Return,AliExpress Return,12494.82
20870,718726833,4-27-24 16:28,715.34,Deposit,Mobile Deposit,13210.16
20871,718726833,05-02-24 16:28,367.9,Withdrawal,Mobile App Withdrawal,12842.26
20872,718726833,05-03-24 20:28,321.86,Deposit,Mobile Deposit,13164.12
20873,718726833,05-05-24 21:28,8050,IncomingTransfer,Salary,21214.12
20874,718726833,05-10-24 12:28,296.45,IncomingTransfer,Freelance Payment,21510.57
20875,718726833,05-10-24 14:28,409.71,Deposit,Direct Deposit,21920.28
20876,718726833,05-10-24 18:28,455.91,OutgoingTransfer,Bank Transfer,21464.37
20877,718726833,05-11-24 10:28,432.99,IncomingTransfer,Freelance Payment,21897.36
20878,718726833,5-13-24 21:28,4000,Payment,Rent Payment,17897.36
20879,718726833,5-14-24 17:28,309.74,Purchase,Gas,17587.62
20880,718726833,5-17-24 23:28,640.68,Purchase,Grocery,16946.94
20881,718726833,5-19-24 15:28,738.53,Deposit,Check Deposit,17685.47
20882,718726833,5-19-24 21:28,110.49,Withdrawal,Mobile App Withdrawal,17574.98
20883,718726833,5-23-24 10:28,539.45,OnlineShopping,Target,17035.53
20884,718726833,06-04-24 21:28,8050,IncomingTransfer,Salary,25085.53
20885,718726833,06-11-24 21:28,5200,Payment,Rent Payment,19885.53
20886,718726833,6-21-24 16:28,139.39,Payment,Loan Payment,19746.14
20887,718726833,6-22-24 21:28,107.69,Withdrawal,ATM Withdrawal,19638.45
20888,718726833,6-30-24 10:28,433.35,IncomingTransfer,Freelance Payment,20071.8
20889,718726833,6-30-24 18:28,169.15,Deposit,Check Deposit,20240.95
20890,718726833,07-02-24 21:28,8050,IncomingTransfer,Salary,28290.95
20891,718726833,07-03-24 23:28,148.92,Purchase,Clothing,28142.03
20892,718726833,07-05-24 22:28,508.29,Withdrawal,Branch Withdrawal,27633.74
20893,718726833,07-06-24 20:28,429.1,Deposit,Direct Deposit,28062.84
20894,718726833,07-12-24 21:28,4600,Payment,Rent Payment,23462.84
20895,718726833,7-16-24 13:28,267.37,Withdrawal,Branch Withdrawal,23195.47
20896,718737708,1-21-24 17:28,729.77,Deposit,Mobile Deposit,1753.140024
20897,718737708,1-24-24 10:28,292.35,Return,Target Return,2045.490024
20898,718737708,1-27-24 11:28,513.39,Purchase,Entertainment,1532.100024
20899,718737708,02-01-24 21:28,9200,IncomingTransfer,Salary,10732.10002
20900,718737708,02-04-24 13:28,463.46,Payment,Mortgage Payment,10268.64002
20901,718737708,02-05-24 16:28,480.01,Deposit,Direct Deposit,10748.65002
20902,718737708,02-06-24 21:28,1400,Payment,Credit Card Payment,9348.650024
20903,718737708,02-10-24 18:28,262.37,Payment,Loan Payment,9086.280024
20904,718737708,02-11-24 17:28,546.33,Purchase,Restaurant,8539.950024
20905,718737708,2-13-24 9:28,582.62,Purchase,Travel,7957.330024
20906,718737708,2-15-24 9:28,152.05,Return,eBay Return,8109.380024
20907,718737708,2-15-24 19:28,434.73,OnlineShopping,Walmart,7674.650024
20908,718737708,2-18-24 21:28,2300,Payment,Insurance Payment,5374.650024
20909,718737708,2-23-24 20:28,647.89,Deposit,Check Deposit,6022.540024
20910,718737708,2-25-24 16:28,421.12,IncomingTransfer,Freelance Payment,6443.660024
20911,718737708,2-25-24 17:28,508.17,Payment,Loan Payment,5935.490024
20912,718737708,2-26-24 9:28,596.12,Withdrawal,Mobile App Withdrawal,5339.370024
20913,718737708,2-28-24 13:28,295.93,Withdrawal,ATM Withdrawal,5043.440024
20914,718737708,2-28-24 17:28,369.5,Purchase,Gas,4673.940024
20915,718737708,2-29-24 23:28,552.17,OnlineShopping,Walmart,4121.770024
20916,718737708,03-01-24 20:28,675.64,Withdrawal,ATM Withdrawal,3446.130024
20917,718737708,03-04-24 21:28,9200,IncomingTransfer,Salary,12646.13002
20918,718737708,03-08-24 19:28,632.54,Return,Walmart Return,13278.67002
20919,718737708,03-09-24 17:28,120.39,Return,eBay Return,13399.06002
20920,718737708,03-09-24 21:28,1600,Payment,Credit Card Payment,11799.06002
20921,718737708,03-10-24 21:28,3700,Payment,Insurance Payment,8099.060024
20922,718737708,03-12-24 13:28,350.33,Deposit,Check Deposit,8449.390024
20923,718737708,3-13-24 11:28,684.95,Purchase,Pharmacy,7764.440024
20924,718737708,3-14-24 15:28,494.19,Withdrawal,Branch Withdrawal,7270.250024
20925,718737708,3-15-24 9:28,260.31,Payment,Loan Payment,7009.940024
20926,718737708,3-15-24 12:28,687.96,Return,AliExpress Return,7697.900024
20927,718737708,3-15-24 14:28,297.22,Purchase,Restaurant,7400.680024
20928,718737708,3-16-24 21:28,105.48,Deposit,Mobile Deposit,7506.160024
20929,718737708,3-20-24 22:28,524.32,Purchase,Pharmacy,6981.840024
20930,718737708,3-31-24 11:28,164.51,Withdrawal,Mobile App Withdrawal,6817.330024
20931,718737708,04-02-24 22:28,702.33,Withdrawal,ATM Withdrawal,6115.000024
20932,718737708,04-05-24 21:28,9200,IncomingTransfer,Salary,15315.00002
20933,718737708,04-06-24 14:28,597.42,OnlineShopping,Target,14717.58002
20934,718737708,04-09-24 19:28,566.05,Purchase,Grocery,14151.53002
20935,718737708,04-10-24 11:28,622.75,Return,Etsy Return,14774.28002
20936,718737708,04-10-24 21:28,1300,Payment,Credit Card Payment,13474.28002
20937,718737708,04-10-24 21:28,3600,Payment,Installment Payment,9874.280024
20938,718737708,4-14-24 14:28,406.66,Purchase,Restaurant,9467.620024
20939,718737708,4-14-24 17:28,187.85,OutgoingTransfer,Wire Transfer,9279.770024
20940,718737708,4-16-24 15:28,171.94,IncomingTransfer,Freelance Payment,9451.710024
20941,718737708,4-17-24 14:28,656.9,Purchase,Furniture,8794.810024
20942,718737708,4-18-24 9:28,555.6,Return,Etsy Return,9350.410024
20943,718737708,4-18-24 22:28,167.6,Purchase,Entertainment,9182.810024
20944,718737708,4-24-24 16:28,360.56,Return,AliExpress Return,9543.370024
20945,718737708,4-28-24 22:28,310.52,Deposit,Cash Deposit,9853.890024
20946,718737708,4-30-24 12:28,126.52,Purchase,Furniture,9727.370024
20947,718737708,05-03-24 12:28,448.95,OnlineShopping,Etsy,9278.420024
20948,718737708,05-04-24 19:28,122.47,Return,Etsy Return,9400.890024
20949,718737708,05-05-24 21:28,9200,IncomingTransfer,Salary,18600.89002
20950,718737708,05-06-24 20:28,353.93,OutgoingTransfer,International Transfer,18246.96002
20951,718737708,05-10-24 21:28,1400,Payment,Credit Card Payment,16846.96002
20952,718737708,05-11-24 21:28,4000,Payment,Installment Payment,12846.96002
20953,718737708,05-12-24 10:28,438.9,Purchase,Grocery,12408.06002
20954,718737708,05-12-24 18:28,531.67,OnlineShopping,eBay,11876.39002
20955,718737708,5-15-24 14:28,181.19,Return,Store Return,12057.58002
20956,718737708,5-20-24 16:28,616.21,Withdrawal,ATM Withdrawal,11441.37002
20957,718737708,5-26-24 13:28,466.34,Withdrawal,ATM Withdrawal,10975.03002
20958,718737708,5-27-24 22:28,280.24,Return,Amazon Return,11255.27002
20959,718737708,06-02-24 12:28,541.32,Payment,Mortgage Payment,10713.95002
20960,718737708,06-03-24 21:28,9200,IncomingTransfer,Salary,19913.95002
20961,718737708,06-08-24 21:28,1300,Payment,Credit Card Payment,18613.95002
20962,718737708,06-10-24 21:28,2800,Payment,Insurance Payment,15813.95002
20963,718737708,06-10-24 21:28,177.45,OnlineShopping,Amazon,15636.50002
20964,718737708,6-13-24 17:28,182.23,Purchase,Restaurant,15454.27002
20965,718737708,6-13-24 20:28,724.93,Deposit,Cash Deposit,16179.20002
20966,718737708,6-15-24 13:28,722.38,Withdrawal,Mobile App Withdrawal,15456.82002
20967,718737708,6-17-24 22:28,622.29,Deposit,Cash Deposit,16079.11002
20968,718737708,6-21-24 23:28,571.3,Purchase,Clothing,15507.81002
20969,718737708,6-24-24 10:28,396.07,OnlineShopping,Walmart,15111.74002
20970,718737708,6-28-24 13:28,297.07,Withdrawal,Branch Withdrawal,14814.67002
20971,718737708,6-30-24 11:28,406.9,Payment,Mortgage Payment,14407.77002
20972,718737708,07-02-24 21:28,9200,IncomingTransfer,Salary,23607.77002
20973,718737708,07-05-24 18:28,164.28,Payment,Mortgage Payment,23443.49002
20974,718737708,07-07-24 21:28,1400,Payment,Credit Card Payment,22043.49002
20975,718737708,07-08-24 12:28,587.26,Deposit,Direct Deposit,22630.75002
20976,718737708,07-08-24 12:28,293.06,Purchase,Restaurant,22337.69002
20977,718737708,07-12-24 21:28,2300,Payment,Subscription Payment,20037.69002
20978,718737708,7-14-24 11:28,233.22,OnlineShopping,Target,19804.47002
20979,718737708,7-16-24 12:28,285.52,Withdrawal,Mobile App Withdrawal,19518.95002
20980,719075883,1-21-24 15:28,127.02,OnlineShopping,AliExpress,1181.628041
20981,719075883,1-22-24 16:28,88.46,Purchase,Pharmacy,1093.168041
20982,719075883,1-31-24 14:28,378.66,Deposit,Check Deposit,1471.828041
20983,719075883,02-01-24 21:28,4250,IncomingTransfer,Salary,5721.828041
20984,719075883,02-02-24 12:28,139.51,Return,Amazon Return,5861.338041
20985,719075883,02-03-24 17:28,254.53,Purchase,Entertainment,5606.808041
20986,719075883,02-05-24 10:28,89.08,IncomingTransfer,Freelance Payment,5695.888041
20987,719075883,02-06-24 21:28,3000,Payment,Credit Card Payment,2695.888041
20988,719075883,02-07-24 22:28,262.13,OutgoingTransfer,Wire Transfer,2433.758041
20989,719075883,02-09-24 22:28,285.79,Purchase,Pharmacy,2147.968041
20990,719075883,02-12-24 22:28,107.82,OnlineShopping,Amazon,2040.148041
20991,719075883,2-13-24 21:28,1200,Payment,Rent Payment,840.1480409
20992,719075883,2-16-24 15:28,232.88,Purchase,Furniture,607.2680409
20993,719075883,2-21-24 9:28,134.72,Purchase,Entertainment,472.5480409
20994,719075883,2-21-24 17:28,239.22,Withdrawal,Branch Withdrawal,233.3280409
20995,719075883,2-23-24 12:28,398.49,Purchase,Grocery,-165.1619591
20996,719075883,2-23-24 21:28,103.29,Purchase,Restaurant,-268.4519591
20997,719075883,2-25-24 18:28,263.53,Deposit,Cash Deposit,-4.921959136
20998,719075883,2-26-24 16:28,286.81,Purchase,Pharmacy,-291.7319591
20999,719075883,03-03-24 13:28,108.1,Withdrawal,Branch Withdrawal,-399.8319591
21000,719075883,03-03-24 14:28,389.75,Purchase,Home Improvement,-789.5819591
21001,719075883,03-04-24 21:28,4250,IncomingTransfer,Salary,3460.418041
21002,719075883,03-05-24 10:28,178.66,OutgoingTransfer,Bank Transfer,3281.758041
21003,719075883,03-05-24 15:28,114.99,Return,eBay Return,3396.748041
21004,719075883,03-09-24 12:28,129.51,Purchase,Clothing,3267.238041
21005,719075883,03-09-24 20:28,65.12,Withdrawal,ATM Withdrawal,3202.118041
21006,719075883,03-09-24 20:28,83.94,OutgoingTransfer,International Transfer,3118.178041
21007,719075883,03-09-24 21:28,2500,Payment,Credit Card Payment,618.1780409
21008,719075883,3-14-24 21:28,1700,Payment,Rent Payment,-1081.821959
21009,719075883,3-15-24 14:28,39.1,Deposit,Check Deposit,-1042.721959
21010,719075883,3-18-24 14:28,291.15,Deposit,Cash Deposit,-751.5719591
21011,719075883,3-18-24 15:28,163.95,Withdrawal,Mobile App Withdrawal,-915.5219591
21012,719075883,3-20-24 12:28,185.81,Purchase,Electronics,-1101.331959
21013,719075883,3-21-24 14:28,232.28,Payment,Bill Payment,-1333.611959
21014,719075883,3-27-24 22:28,66.14,Deposit,Check Deposit,-1267.471959
21015,719075883,3-31-24 11:28,179.53,OnlineShopping,Etsy,-1447.001959
21016,719075883,04-02-24 21:28,4250,IncomingTransfer,Salary,2802.998041
21017,719075883,04-03-24 11:28,182.97,Payment,Bill Payment,2620.028041
21018,719075883,04-07-24 21:28,2100,Payment,Credit Card Payment,520.0280409
21019,719075883,04-07-24 21:28,127.59,IncomingTransfer,Freelance Payment,647.6180409
21020,719075883,04-09-24 18:28,175.4,Deposit,Mobile Deposit,823.0180409
21021,719075883,4-16-24 21:28,2700,Payment,Rent Payment,-1876.981959
21022,719075883,4-20-24 19:28,168.98,Deposit,Check Deposit,-1708.001959
21023,719075883,4-21-24 20:28,184.87,Return,Etsy Return,-1523.131959
21024,719075883,4-28-24 11:28,324.34,OnlineShopping,Best Buy,-1847.471959
21025,719075883,05-01-24 21:28,4250,IncomingTransfer,Salary,2402.528041
21026,719075883,05-02-24 14:28,251.8,Withdrawal,ATM Withdrawal,2150.728041
21027,719075883,05-06-24 16:28,247.76,Purchase,Travel,1902.968041
21028,719075883,05-06-24 21:28,2700,Payment,Credit Card Payment,-797.0319591
21029,719075883,05-08-24 11:28,360.13,Withdrawal,Branch Withdrawal,-1157.161959
21030,719075883,05-12-24 10:28,369.3,IncomingTransfer,Freelance Payment,-787.8619591
21031,719075883,5-14-24 16:28,29.1,Deposit,Check Deposit,-758.7619591
21032,719075883,5-16-24 16:28,47.74,OutgoingTransfer,International Transfer,-806.5019591
21033,719075883,5-16-24 21:28,1900,Payment,Rent Payment,-2706.501959
21034,719075883,5-18-24 12:28,47.41,Payment,Mortgage Payment,-2753.911959
21035,719075883,5-20-24 11:28,169.36,Payment,Mortgage Payment,-2923.271959
21036,719075883,5-22-24 22:28,23.51,Withdrawal,Mobile App Withdrawal,-2946.781959
21037,719075883,5-27-24 13:28,110.72,OnlineShopping,AliExpress,-3057.501959
21038,719075883,5-28-24 18:28,189.51,Return,eBay Return,-2867.991959
21039,719075883,5-28-24 19:28,172.09,Deposit,Direct Deposit,-2695.901959
21040,719075883,5-28-24 22:28,319.2,Deposit,Cash Deposit,-2376.701959
21041,719075883,5-31-24 11:28,111.6,Purchase,Pharmacy,-2488.301959
21042,719075883,06-02-24 21:28,4250,IncomingTransfer,Salary,1761.698041
21043,719075883,06-05-24 18:28,271.09,Deposit,Direct Deposit,2032.788041
21044,719075883,06-06-24 18:28,50.1,OnlineShopping,Walmart,1982.688041
21045,719075883,06-07-24 21:28,2700,Payment,Credit Card Payment,-717.3119591
21046,719075883,06-10-24 13:28,233.27,Deposit,Mobile Deposit,-484.0419591
21047,719075883,06-11-24 20:28,360.08,Purchase,Pharmacy,-844.1219591
21048,719075883,06-12-24 21:28,1900,Payment,Rent Payment,-2744.121959
21049,719075883,6-18-24 13:28,228.72,Return,eBay Return,-2515.401959
21050,719075883,6-19-24 17:28,115.29,Payment,Bill Payment,-2630.691959
21051,719075883,6-19-24 23:28,327.06,Payment,Bill Payment,-2957.751959
21052,719075883,6-21-24 19:28,146.7,Deposit,Mobile Deposit,-2811.051959
21053,719075883,6-25-24 13:28,31.91,Withdrawal,ATM Withdrawal,-2842.961959
21054,719075883,6-28-24 10:28,253.76,Purchase,Grocery,-3096.721959
21055,719075883,6-30-24 15:28,110.75,Purchase,Pharmacy,-3207.471959
21056,719075883,07-01-24 11:28,352.78,Deposit,Direct Deposit,-2854.691959
21057,719075883,07-05-24 21:28,4250,IncomingTransfer,Salary,1395.308041
21058,719075883,07-10-24 21:28,2400,Payment,Credit Card Payment,-1004.691959
21059,719075883,07-11-24 17:28,58.74,Purchase,Entertainment,-1063.431959
21060,719075883,07-12-24 10:28,398.92,IncomingTransfer,Freelance Payment,-664.5119591
21061,719075883,7-15-24 19:28,60.42,Payment,Bill Payment,-724.9319591
21062,719075883,7-16-24 21:28,1100,Payment,Rent Payment,-1824.931959
21063,719075883,7-17-24 18:28,300.09,Payment,Loan Payment,-2125.021959
21064,719085933,1-21-24 21:28,156.09,Deposit,Mobile Deposit,902.3185342
21065,719085933,1-22-24 10:28,478.87,Purchase,Gas,423.4485342
21066,719085933,1-23-24 23:28,554.78,Deposit,Direct Deposit,978.2285342
21067,719085933,1-27-24 14:28,727.91,Deposit,Direct Deposit,1706.138534
21068,719085933,1-28-24 12:28,287.61,OnlineShopping,eBay,1418.528534
21069,719085933,1-28-24 17:28,245.44,OutgoingTransfer,Wire Transfer,1173.088534
21070,719085933,1-29-24 9:28,272.44,IncomingTransfer,Freelance Payment,1445.528534
21071,719085933,1-29-24 16:28,565.29,Purchase,Entertainment,880.2385342
21072,719085933,02-01-24 21:28,8250,IncomingTransfer,Salary,9130.238534
21073,719085933,02-03-24 17:28,392.68,Withdrawal,ATM Withdrawal,8737.558534
21074,719085933,02-06-24 13:28,358.01,Purchase,Clothing,8379.548534
21075,719085933,02-06-24 21:28,900,Payment,Credit Card Payment,7479.548534
21076,719085933,02-07-24 19:28,151.71,Deposit,Mobile Deposit,7631.258534
21077,719085933,02-08-24 11:28,741,OutgoingTransfer,Wire Transfer,6890.258534
21078,719085933,02-11-24 21:28,2300,Payment,Rent Payment,4590.258534
21079,719085933,2-14-24 17:28,615.73,IncomingTransfer,Freelance Payment,5205.988534
21080,719085933,2-15-24 16:28,325.74,Return,Store Return,5531.728534
21081,719085933,2-22-24 19:28,117.92,Withdrawal,Mobile App Withdrawal,5413.808534
21082,719085933,2-24-24 17:28,624.86,Deposit,Cash Deposit,6038.668534
21083,719085933,2-27-24 20:28,489.28,Deposit,Check Deposit,6527.948534
21084,719085933,03-01-24 15:28,544.22,OnlineShopping,Etsy,5983.728534
21085,719085933,03-01-24 21:28,8250,IncomingTransfer,Salary,14233.72853
21086,719085933,03-02-24 10:28,185.52,Return,Amazon Return,14419.24853
21087,719085933,03-05-24 14:28,745.32,Purchase,Grocery,13673.92853
21088,719085933,03-06-24 21:28,900,Payment,Credit Card Payment,12773.92853
21089,719085933,03-06-24 22:28,353.45,Withdrawal,Mobile App Withdrawal,12420.47853
21090,719085933,03-08-24 12:28,601.4,Purchase,Pharmacy,11819.07853
21091,719085933,3-13-24 15:28,440.6,Deposit,Direct Deposit,12259.67853
21092,719085933,3-17-24 21:28,4900,Payment,Rent Payment,7359.678534
21093,719085933,3-19-24 16:28,410.51,Purchase,Entertainment,6949.168534
21094,719085933,3-20-24 22:28,666.54,Purchase,Gas,6282.628534
21095,719085933,3-25-24 12:28,348.68,OutgoingTransfer,International Transfer,5933.948534
21096,719085933,3-26-24 14:28,619.1,Deposit,Mobile Deposit,6553.048534
21097,719085933,3-28-24 21:28,585.09,Deposit,Mobile Deposit,7138.138534
21098,719085933,3-30-24 13:28,683.56,Purchase,Home Improvement,6454.578534
21099,719085933,04-01-24 12:28,496.06,Purchase,Grocery,5958.518534
21100,719085933,04-05-24 15:28,704.1,IncomingTransfer,Freelance Payment,6662.618534
21101,719085933,04-05-24 21:28,8250,IncomingTransfer,Salary,14912.61853
21102,719085933,04-06-24 14:28,432.85,Purchase,Home Improvement,14479.76853
21103,719085933,04-07-24 21:28,406.41,OutgoingTransfer,Peer-to-Peer Transfer,14073.35853
21104,719085933,04-08-24 23:28,389.91,Return,Walmart Return,14463.26853
21105,719085933,04-10-24 21:28,1100,Payment,Credit Card Payment,13363.26853
21106,719085933,4-15-24 21:28,4300,Payment,Rent Payment,9063.268534
21107,719085933,4-18-24 9:28,730.45,Purchase,Restaurant,8332.818534
21108,719085933,4-19-24 11:28,386.41,Purchase,Home Improvement,7946.408534
21109,719085933,4-19-24 19:28,182.29,Payment,Loan Payment,7764.118534
21110,719085933,4-22-24 12:28,204.84,OutgoingTransfer,International Transfer,7559.278534
21111,719085933,4-22-24 16:28,535.23,Deposit,Cash Deposit,8094.508534
21112,719085933,4-24-24 14:28,547.62,OutgoingTransfer,Bank Transfer,7546.888534
21113,719085933,4-25-24 19:28,198.55,OutgoingTransfer,Bank Transfer,7348.338534
21114,719085933,4-26-24 20:28,680.53,OnlineShopping,Walmart,6667.808534
21115,719085933,4-27-24 15:28,287.52,OutgoingTransfer,International Transfer,6380.288534
21116,719085933,05-01-24 21:28,8250,IncomingTransfer,Salary,14630.28853
21117,719085933,05-06-24 11:28,236.72,Return,Etsy Return,14867.00853
21118,719085933,05-06-24 21:28,1300,Payment,Credit Card Payment,13567.00853
21119,719085933,05-10-24 21:28,2500,Payment,Rent Payment,11067.00853
21120,719085933,05-11-24 12:28,478.34,Purchase,Furniture,10588.66853
21121,719085933,5-14-24 17:28,433.16,OutgoingTransfer,Peer-to-Peer Transfer,10155.50853
21122,719085933,5-16-24 23:28,291.54,OnlineShopping,eBay,9863.968534
21123,719085933,5-20-24 11:28,176.19,OnlineShopping,eBay,9687.778534
21124,719085933,5-26-24 15:28,197.74,Withdrawal,Branch Withdrawal,9490.038534
21125,719085933,5-28-24 15:28,131.03,Return,Walmart Return,9621.068534
21126,719085933,5-31-24 14:28,333.73,Purchase,Pharmacy,9287.338534
21127,719085933,06-02-24 19:28,606.99,OnlineShopping,Best Buy,8680.348534
21128,719085933,06-03-24 21:28,8250,IncomingTransfer,Salary,16930.34853
21129,719085933,06-08-24 21:28,1100,Payment,Credit Card Payment,15830.34853
21130,719085933,06-10-24 21:28,2900,Payment,Rent Payment,12930.34853
21131,719085933,06-11-24 14:28,548.11,Withdrawal,Branch Withdrawal,12382.23853
21132,719085933,06-12-24 19:28,218.63,Purchase,Clothing,12163.60853
21133,719085933,6-18-24 10:28,645.39,Deposit,Check Deposit,12808.99853
21134,719085933,6-24-24 11:28,317.99,IncomingTransfer,Freelance Payment,13126.98853
21135,719085933,6-25-24 9:28,191.26,Withdrawal,Branch Withdrawal,12935.72853
21136,719085933,6-27-24 12:28,449.88,Purchase,Gas,12485.84853
21137,719085933,07-04-24 21:28,8250,IncomingTransfer,Salary,20735.84853
21138,719085933,07-05-24 14:28,622,Purchase,Furniture,20113.84853
21139,719085933,07-05-24 23:28,484.79,Return,Etsy Return,20598.63853
21140,719085933,07-09-24 20:28,201.44,Payment,Loan Payment,20397.19853
21141,719085933,07-09-24 21:28,1000,Payment,Credit Card Payment,19397.19853
21142,719085933,7-14-24 20:28,678.91,Withdrawal,Mobile App Withdrawal,18718.28853
21143,719085933,7-14-24 21:28,3800,Payment,Rent Payment,14918.28853
21144,719085933,7-16-24 12:28,297.34,OutgoingTransfer,International Transfer,14620.94853
21145,719085933,7-17-24 19:28,638.15,OutgoingTransfer,Peer-to-Peer Transfer,13982.79853
21146,719242533,02-01-24 21:28,6300,IncomingTransfer,Salary,8294.832741
21147,719242533,02-06-24 21:28,2500,Payment,Credit Card Payment,5794.832741
21148,719242533,02-10-24 21:28,1700,Payment,Installment Payment,4094.832741
21149,719242533,02-12-24 17:28,98.25,OnlineShopping,Walmart,3996.582741
21150,719242533,2-13-24 18:28,370.93,Return,Etsy Return,4367.512741
21151,719242533,2-19-24 16:28,188.19,IncomingTransfer,Freelance Payment,4555.702741
21152,719242533,2-23-24 13:28,506.1,Purchase,Entertainment,4049.602741
21153,719242533,2-29-24 20:28,262.85,Payment,Loan Payment,3786.752741
21154,719242533,03-03-24 21:28,6300,IncomingTransfer,Salary,10086.75274
21155,719242533,03-04-24 17:28,393.1,Purchase,Clothing,9693.652741
21156,719242533,03-05-24 17:28,436.42,OnlineShopping,Best Buy,9257.232741
21157,719242533,03-06-24 16:28,357.4,Purchase,Grocery,8899.832741
21158,719242533,03-06-24 17:28,180.52,Purchase,Furniture,8719.312741
21159,719242533,03-06-24 22:28,421.03,Deposit,Direct Deposit,9140.342741
21160,719242533,03-08-24 21:28,3000,Payment,Credit Card Payment,6140.342741
21161,719242533,03-12-24 21:28,2200,Payment,Subscription Payment,3940.342741
21162,719242533,3-14-24 13:28,466.55,Return,Store Return,4406.892741
21163,719242533,3-16-24 12:28,264.43,Deposit,Check Deposit,4671.322741
21164,719242533,3-18-24 20:28,218.85,Payment,Bill Payment,4452.472741
21165,719242533,3-22-24 17:28,254.97,OutgoingTransfer,Bank Transfer,4197.502741
21166,719242533,3-23-24 16:28,65.06,Deposit,Cash Deposit,4262.562741
21167,719242533,3-27-24 9:28,130.64,IncomingTransfer,Freelance Payment,4393.202741
21168,719242533,3-28-24 21:28,463.26,Purchase,Travel,3929.942741
21169,719242533,04-01-24 23:28,497.87,IncomingTransfer,Freelance Payment,4427.812741
21170,719242533,04-03-24 9:28,101.41,Withdrawal,Mobile App Withdrawal,4326.402741
21171,719242533,04-04-24 21:28,6300,IncomingTransfer,Salary,10626.40274
21172,719242533,04-06-24 11:28,425.19,Payment,Loan Payment,10201.21274
21173,719242533,04-09-24 21:28,2700,Payment,Credit Card Payment,7501.212741
21174,719242533,04-11-24 18:28,485.72,OnlineShopping,Walmart,7015.492741
21175,719242533,4-14-24 11:28,124.56,Return,AliExpress Return,7140.052741
21176,719242533,4-15-24 18:28,89.49,Withdrawal,ATM Withdrawal,7050.562741
21177,719242533,4-18-24 21:28,2300,Payment,Insurance Payment,4750.562741
21178,719242533,4-20-24 19:28,459.65,Purchase,Entertainment,4290.912741
21179,719242533,4-21-24 10:28,410.48,Purchase,Electronics,3880.432741
21180,719242533,4-27-24 17:28,283.05,OutgoingTransfer,Bank Transfer,3597.382741
21181,719242533,4-30-24 11:28,397.48,IncomingTransfer,Freelance Payment,3994.862741
21182,719242533,05-04-24 21:28,6300,IncomingTransfer,Salary,10294.86274
21183,719242533,05-09-24 21:28,3500,Payment,Credit Card Payment,6794.862741
21184,719242533,05-11-24 11:28,527.54,Purchase,Clothing,6267.322741
21185,719242533,5-14-24 21:28,1900,Payment,Insurance Payment,4367.322741
21186,719242533,5-18-24 15:28,72.95,Payment,Loan Payment,4294.372741
21187,719242533,5-18-24 19:28,99.68,Payment,Loan Payment,4194.692741
21188,719242533,5-22-24 18:28,399.24,OutgoingTransfer,Peer-to-Peer Transfer,3795.452741
21189,719242533,06-02-24 13:28,542.92,Payment,Mortgage Payment,3252.532741
21190,719242533,06-05-24 21:28,6300,IncomingTransfer,Salary,9552.532741
21191,719242533,06-10-24 21:28,3300,Payment,Credit Card Payment,6252.532741
21192,719242533,6-17-24 21:28,2100,Payment,Subscription Payment,4152.532741
21193,719242533,6-20-24 12:28,452.46,OutgoingTransfer,Wire Transfer,3700.072741
21194,719242533,6-24-24 13:28,332.93,Withdrawal,Mobile App Withdrawal,3367.142741
21195,719242533,6-30-24 13:28,61.29,Deposit,Mobile Deposit,3428.432741
21196,719242533,07-03-24 21:28,6300,IncomingTransfer,Salary,9728.432741
21197,719242533,07-08-24 21:28,3200,Payment,Credit Card Payment,6528.432741
21198,719242533,07-10-24 13:28,463.71,Return,AliExpress Return,6992.142741
21199,719242533,07-12-24 10:28,479.13,IncomingTransfer,Freelance Payment,7471.272741
21200,719242533,7-13-24 22:28,326.1,Payment,Mortgage Payment,7145.172741
21201,719242533,7-14-24 21:28,2400,Payment,Installment Payment,4745.172741
21202,719277033,1-21-24 13:28,35.07,Deposit,Mobile Deposit,539.4809828
21203,719277033,1-25-24 20:28,39.01,Deposit,Direct Deposit,578.4909828
21204,719277033,1-30-24 19:28,174.23,OnlineShopping,AliExpress,404.2609828
21205,719277033,02-04-24 21:28,90.1,OutgoingTransfer,International Transfer,314.1609828
21206,719277033,02-04-24 21:28,64.13,Return,Amazon Return,378.2909828
21207,719277033,02-05-24 21:28,3500,IncomingTransfer,Salary,3878.290983
21208,719277033,02-08-24 9:28,169.06,Payment,Mortgage Payment,3709.230983
21209,719277033,02-09-24 23:28,84.66,Withdrawal,Branch Withdrawal,3624.570983
21210,719277033,02-10-24 14:28,156.45,Withdrawal,Mobile App Withdrawal,3468.120983
21211,719277033,02-10-24 21:28,700,Payment,Credit Card Payment,2768.120983
21212,719277033,02-11-24 10:28,236.3,Return,eBay Return,3004.420983
21213,719277033,02-11-24 19:28,104.35,Withdrawal,Mobile App Withdrawal,2900.070983
21214,719277033,02-11-24 21:28,1300,Payment,Insurance Payment,1600.070983
21215,719277033,2-14-24 23:28,358.52,IncomingTransfer,Freelance Payment,1958.590983
21216,719277033,2-17-24 19:28,187.78,Withdrawal,Mobile App Withdrawal,1770.810983
21217,719277033,2-19-24 11:28,135.79,Withdrawal,Mobile App Withdrawal,1635.020983
21218,719277033,2-21-24 14:28,325.32,Purchase,Gas,1309.700983
21219,719277033,2-23-24 14:28,257.17,Purchase,Pharmacy,1052.530983
21220,719277033,2-25-24 20:28,168.13,Return,Store Return,1220.660983
21221,719277033,2-29-24 19:28,312.8,Withdrawal,Mobile App Withdrawal,907.8609828
21222,719277033,2-29-24 21:28,318.85,Withdrawal,Branch Withdrawal,589.0109828
21223,719277033,03-01-24 21:28,141.98,Deposit,Direct Deposit,730.9909828
21224,719277033,03-04-24 14:28,285.59,Purchase,Home Improvement,445.4009828
21225,719277033,03-05-24 21:28,3500,IncomingTransfer,Salary,3945.400983
21226,719277033,03-07-24 9:28,205.42,Purchase,Clothing,3739.980983
21227,719277033,03-08-24 10:28,241.46,Purchase,Entertainment,3498.520983
21228,719277033,03-10-24 21:28,1000,Payment,Credit Card Payment,2498.520983
21229,719277033,3-14-24 11:28,304.88,Deposit,Direct Deposit,2803.400983
21230,719277033,3-15-24 13:28,171.11,Purchase,Gas,2632.290983
21231,719277033,3-17-24 21:28,1100,Payment,Subscription Payment,1532.290983
21232,719277033,3-19-24 13:28,96.76,Purchase,Grocery,1435.530983
21233,719277033,3-21-24 9:28,387.59,Withdrawal,Mobile App Withdrawal,1047.940983
21234,719277033,3-26-24 20:28,89.97,Purchase,Home Improvement,957.9709828
21235,719277033,3-26-24 21:28,210.87,Withdrawal,Branch Withdrawal,747.1009828
21236,719277033,3-29-24 22:28,391.73,Withdrawal,Mobile App Withdrawal,355.3709828
21237,719277033,3-30-24 14:28,247.42,Purchase,Gas,107.9509828
21238,719277033,3-30-24 17:28,270.95,Payment,Bill Payment,-162.9990172
21239,719277033,04-03-24 15:28,140.15,Deposit,Mobile Deposit,-22.8490172
21240,719277033,04-04-24 9:28,347.4,Deposit,Check Deposit,324.5509828
21241,719277033,04-05-24 13:28,370.59,Purchase,Restaurant,-46.0390172
21242,719277033,04-05-24 21:28,3500,IncomingTransfer,Salary,3453.960983
21243,719277033,04-10-24 21:28,1000,Payment,Credit Card Payment,2453.960983
21244,719277033,04-11-24 21:28,1600,Payment,Subscription Payment,853.9609828
21245,719277033,4-16-24 18:28,76.01,Deposit,Cash Deposit,929.9709828
21246,719277033,4-17-24 15:28,272.33,Deposit,Check Deposit,1202.300983
21247,719277033,4-19-24 15:28,22.45,Withdrawal,Branch Withdrawal,1179.850983
21248,719277033,4-26-24 20:28,89.53,Purchase,Gas,1090.320983
21249,719277033,4-28-24 16:28,130.81,Deposit,Mobile Deposit,1221.130983
21250,719277033,05-01-24 20:28,163.9,Return,eBay Return,1385.030983
21251,719277033,05-02-24 21:28,3500,IncomingTransfer,Salary,4885.030983
21252,719277033,05-07-24 21:28,800,Payment,Credit Card Payment,4085.030983
21253,719277033,5-13-24 19:28,81.41,Withdrawal,Mobile App Withdrawal,4003.620983
21254,719277033,5-13-24 21:28,1500,Payment,Insurance Payment,2503.620983
21255,719277033,5-26-24 22:28,225.71,Withdrawal,ATM Withdrawal,2277.910983
21256,719277033,5-29-24 16:28,375.46,Deposit,Cash Deposit,2653.370983
21257,719277033,5-29-24 20:28,34.49,Payment,Bill Payment,2618.880983
21258,719277033,5-30-24 17:28,137.6,Withdrawal,ATM Withdrawal,2481.280983
21259,719277033,06-05-24 21:28,3500,IncomingTransfer,Salary,5981.280983
21260,719277033,06-05-24 23:28,367.21,OutgoingTransfer,Wire Transfer,5614.070983
21261,719277033,06-06-24 21:28,36.12,Payment,Mortgage Payment,5577.950983
21262,719277033,06-07-24 15:28,43.42,Return,Walmart Return,5621.370983
21263,719277033,06-08-24 22:28,318.76,Deposit,Mobile Deposit,5940.130983
21264,719277033,06-10-24 21:28,1000,Payment,Credit Card Payment,4940.130983
21265,719277033,6-15-24 21:28,1100,Payment,Insurance Payment,3840.130983
21266,719277033,6-21-24 20:28,367.32,OnlineShopping,Etsy,3472.810983
21267,719277033,6-22-24 20:28,257.17,Deposit,Cash Deposit,3729.980983
21268,719277033,6-23-24 21:28,225.23,Deposit,Mobile Deposit,3955.210983
21269,719277033,6-28-24 13:28,389.63,Return,Store Return,4344.840983
21270,719277033,6-29-24 10:28,231.08,Purchase,Home Improvement,4113.760983
21271,719277033,07-01-24 21:28,3500,IncomingTransfer,Salary,7613.760983
21272,719277033,07-01-24 21:28,250.77,OutgoingTransfer,International Transfer,7362.990983
21273,719277033,07-06-24 21:28,1000,Payment,Credit Card Payment,6362.990983
21274,719277033,07-08-24 14:28,28.71,Payment,Bill Payment,6334.280983
21275,719277033,07-09-24 12:28,59.41,Deposit,Check Deposit,6393.690983
21276,719277033,07-11-24 9:28,358.72,OnlineShopping,Walmart,6034.970983
21277,719277033,7-13-24 21:28,275.44,Purchase,Gas,5759.530983
21278,719277033,7-15-24 11:28,195.49,Return,Store Return,5955.020983
21279,719277033,7-15-24 21:28,1400,Payment,Installment Payment,4555.020983
21280,719277033,7-15-24 22:28,226.23,Payment,Loan Payment,4328.790983
21281,719277033,7-17-24 9:28,315.14,OnlineShopping,Etsy,4013.650983
21282,719315508,1-26-24 16:28,82.93,Return,Etsy Return,2240.511122
21283,719315508,1-29-24 11:28,144.56,OnlineShopping,Etsy,2095.951122
21284,719315508,1-31-24 9:28,103.53,OnlineShopping,Target,1992.421122
21285,719315508,02-03-24 14:28,230.93,Return,eBay Return,2223.351122
21286,719315508,02-03-24 21:28,3950,IncomingTransfer,Salary,6173.351122
21287,719315508,02-08-24 21:28,3100,Payment,Credit Card Payment,3073.351122
21288,719315508,02-10-24 17:28,248.29,Payment,Mortgage Payment,2825.061122
21289,719315508,2-13-24 21:28,1200,Payment,Installment Payment,1625.061122
21290,719315508,03-02-24 21:28,3950,IncomingTransfer,Salary,5575.061122
21291,719315508,03-07-24 21:28,3600,Payment,Credit Card Payment,1975.061122
21292,719315508,03-08-24 21:28,188.5,Return,AliExpress Return,2163.561122
21293,719315508,03-10-24 22:28,371.63,Withdrawal,Branch Withdrawal,1791.931122
21294,719315508,3-13-24 14:28,25.88,OnlineShopping,Etsy,1766.051122
21295,719315508,3-14-24 21:28,1600,Payment,Insurance Payment,166.0511218
21296,719315508,3-16-24 11:28,85.98,Deposit,Check Deposit,252.0311218
21297,719315508,04-01-24 21:28,3950,IncomingTransfer,Salary,4202.031122
21298,719315508,04-06-24 21:28,2600,Payment,Credit Card Payment,1602.031122
21299,719315508,04-07-24 20:28,222.74,Deposit,Direct Deposit,1824.771122
21300,719315508,4-16-24 20:28,118.78,Purchase,Entertainment,1705.991122
21301,719315508,4-18-24 14:28,202.13,Withdrawal,ATM Withdrawal,1503.861122
21302,719315508,4-18-24 21:28,1200,Payment,Insurance Payment,303.8611218
21303,719315508,4-29-24 9:28,166.4,Return,Target Return,470.2611218
21304,719315508,05-01-24 15:28,181.37,Deposit,Mobile Deposit,651.6311218
21305,719315508,05-02-24 21:28,3950,IncomingTransfer,Salary,4601.631122
21306,719315508,05-07-24 21:28,2700,Payment,Credit Card Payment,1901.631122
21307,719315508,05-08-24 23:28,91.95,OutgoingTransfer,Wire Transfer,1809.681122
21308,719315508,05-11-24 15:28,228.17,Purchase,Restaurant,1581.511122
21309,719315508,05-11-24 21:28,1600,Payment,Subscription Payment,-18.48887821
21310,719315508,5-16-24 12:28,354.56,Deposit,Check Deposit,336.0711218
21311,719315508,5-26-24 10:28,328.37,OutgoingTransfer,Wire Transfer,7.701121787
21312,719315508,5-27-24 10:28,20.18,Deposit,Check Deposit,27.88112179
21313,719315508,06-03-24 20:28,350.82,Deposit,Check Deposit,378.7011218
21314,719315508,06-04-24 21:28,3950,IncomingTransfer,Salary,4328.701122
21315,719315508,06-09-24 21:28,2600,Payment,Credit Card Payment,1728.701122
21316,719315508,6-17-24 21:28,1000,Payment,Subscription Payment,728.7011218
21317,719315508,6-27-24 15:28,155.14,Withdrawal,ATM Withdrawal,573.5611218
21318,719315508,07-02-24 20:28,62.1,Purchase,Pharmacy,511.4611218
21319,719315508,07-02-24 21:28,250.79,Purchase,Home Improvement,260.6711218
21320,719315508,07-03-24 21:28,3950,IncomingTransfer,Salary,4210.671122
21321,719315508,07-05-24 21:28,142.54,Deposit,Direct Deposit,4353.211122
21322,719315508,07-08-24 21:28,2700,Payment,Credit Card Payment,1653.211122
21323,719315508,07-11-24 21:28,1000,Payment,Installment Payment,653.2111218
21324,719315508,7-16-24 16:28,114.22,Purchase,Furniture,538.9911218
21325,719327808,1-26-24 11:28,335.05,OutgoingTransfer,Peer-to-Peer Transfer,1484.807113
21326,719327808,1-28-24 20:28,33.66,Purchase,Home Improvement,1451.147113
21327,719327808,1-29-24 15:28,53.04,Purchase,Restaurant,1398.107113
21328,719327808,02-01-24 21:28,2000,IncomingTransfer,Salary,3398.107113
21329,719327808,02-06-24 21:28,3700,Payment,Credit Card Payment,-301.892887
21330,719327808,02-10-24 21:28,148.74,Purchase,Clothing,-450.632887
21331,719327808,2-15-24 18:28,57.59,Payment,Loan Payment,-508.222887
21332,719327808,2-16-24 21:28,900,Payment,Rent Payment,-1408.222887
21333,719327808,2-18-24 15:28,344.79,IncomingTransfer,Freelance Payment,-1063.432887
21334,719327808,2-19-24 21:28,313.7,Deposit,Cash Deposit,-749.732887
21335,719327808,2-21-24 23:28,182.8,Payment,Bill Payment,-932.532887
21336,719327808,2-24-24 14:28,357.22,OnlineShopping,eBay,-1289.752887
21337,719327808,03-02-24 21:28,2000,IncomingTransfer,Salary,710.247113
21338,719327808,03-03-24 11:28,118.99,Deposit,Check Deposit,829.237113
21339,719327808,03-07-24 21:28,3100,Payment,Credit Card Payment,-2270.762887
21340,719327808,03-11-24 21:28,900,Payment,Rent Payment,-3170.762887
21341,719327808,3-16-24 22:28,384.94,Purchase,Furniture,-3555.702887
21342,719327808,3-18-24 21:28,365.41,OnlineShopping,Best Buy,-3921.112887
21343,719327808,3-20-24 17:28,40.89,Return,Etsy Return,-3880.222887
21344,719327808,3-21-24 17:28,91.25,Deposit,Check Deposit,-3788.972887
21345,719327808,3-28-24 22:28,90.44,Withdrawal,ATM Withdrawal,-3879.412887
21346,719327808,3-31-24 21:28,374.46,Return,Etsy Return,-3504.952887
21347,719327808,04-04-24 16:28,141.76,Deposit,Cash Deposit,-3363.192887
21348,719327808,04-05-24 21:28,2000,IncomingTransfer,Salary,-1363.192887
21349,719327808,04-10-24 21:28,3700,Payment,Credit Card Payment,-5063.192887
21350,719327808,04-12-24 21:28,1000,Payment,Rent Payment,-6063.192887
21351,719327808,4-14-24 19:28,457.32,Purchase,Travel,-6520.512887
21352,719327808,4-16-24 19:28,125.81,OutgoingTransfer,Bank Transfer,-6646.322887
21353,719327808,4-20-24 18:28,85.43,Return,AliExpress Return,-6560.892887
21354,719327808,4-26-24 21:28,47.36,OnlineShopping,Target,-6608.252887
21355,719327808,4-29-24 16:28,150.53,Return,Store Return,-6457.722887
21356,719327808,05-05-24 21:28,2000,IncomingTransfer,Salary,-4457.722887
21357,719327808,05-10-24 18:28,259.47,Withdrawal,ATM Withdrawal,-4717.192887
21358,719327808,05-10-24 21:28,3400,Payment,Credit Card Payment,-8117.192887
21359,719327808,5-16-24 21:28,1200,Payment,Rent Payment,-9317.192887
21360,719327808,5-17-24 18:28,247.13,Purchase,Travel,-9564.322887
21361,719327808,5-22-24 13:28,129.48,Deposit,Check Deposit,-9434.842887
21362,719327808,5-26-24 21:28,372.24,Deposit,Check Deposit,-9062.602887
21363,719327808,5-29-24 16:28,66.37,Deposit,Cash Deposit,-8996.232887
21364,719327808,5-30-24 17:28,420.69,Deposit,Direct Deposit,-8575.542887
21365,719327808,06-01-24 15:28,451.24,Withdrawal,Mobile App Withdrawal,-9026.782887
21366,719327808,06-01-24 18:28,77.32,OnlineShopping,AliExpress,-9104.102887
21367,719327808,06-03-24 18:28,303.12,OnlineShopping,Etsy,-9407.222887
21368,719327808,06-04-24 21:28,2000,IncomingTransfer,Salary,-7407.222887
21369,719327808,06-09-24 21:28,2800,Payment,Credit Card Payment,-10207.22289
21370,719327808,6-14-24 21:28,700,Payment,Rent Payment,-10907.22289
21371,719327808,6-15-24 15:28,433.55,Payment,Bill Payment,-11340.77289
21372,719327808,07-05-24 21:28,2000,IncomingTransfer,Salary,-9340.772887
21373,719327808,07-06-24 11:28,36.27,Withdrawal,Branch Withdrawal,-9377.042887
21374,719327808,07-10-24 15:28,214.72,OnlineShopping,Target,-9591.762887
21375,719327808,07-10-24 21:28,3100,Payment,Credit Card Payment,-12691.76289
21376,719327808,7-15-24 21:28,900,Payment,Rent Payment,-13591.76289
21377,719363283,1-25-24 20:28,59.73,Payment,Bill Payment,-59.73
21378,719363283,1-27-24 21:28,142.54,IncomingTransfer,Freelance Payment,82.81
21379,719363283,02-01-24 17:28,215.83,Purchase,Furniture,-133.02
21380,719363283,02-05-24 21:28,1700,IncomingTransfer,Salary,1566.98
21381,719363283,02-09-24 11:28,27.53,OutgoingTransfer,Wire Transfer,1539.45
21382,719363283,02-11-24 21:28,800,Payment,Rent Payment,739.45
21383,719363283,2-14-24 11:28,58.97,Payment,Loan Payment,680.48
21384,719363283,2-15-24 10:28,102.23,Deposit,Cash Deposit,782.71
21385,719363283,2-24-24 11:28,142.96,Withdrawal,Branch Withdrawal,639.75
21386,719363283,2-28-24 13:28,190.7,OnlineShopping,AliExpress,449.05
21387,719363283,03-05-24 21:28,1700,IncomingTransfer,Salary,2149.05
21388,719363283,03-06-24 9:28,53.64,OutgoingTransfer,Peer-to-Peer Transfer,2095.41
21389,719363283,03-10-24 19:28,168.75,Deposit,Cash Deposit,2264.16
21390,719363283,03-11-24 22:28,50.41,Deposit,Mobile Deposit,2314.57
21391,719363283,03-12-24 15:28,17.59,Withdrawal,Mobile App Withdrawal,2296.98
21392,719363283,3-14-24 12:28,44.04,Deposit,Cash Deposit,2341.02
21393,719363283,3-14-24 21:28,400,Payment,Rent Payment,1941.02
21394,719363283,3-18-24 20:28,56.12,IncomingTransfer,Freelance Payment,1997.14
21395,719363283,3-19-24 15:28,170.36,Deposit,Mobile Deposit,2167.5
21396,719363283,3-21-24 15:28,15.53,Deposit,Direct Deposit,2183.03
21397,719363283,3-22-24 16:28,21.35,Deposit,Direct Deposit,2204.38
21398,719363283,3-22-24 23:28,119.9,Return,Target Return,2324.28
21399,719363283,3-23-24 17:28,83.05,Withdrawal,ATM Withdrawal,2241.23
21400,719363283,3-25-24 12:28,63.94,Payment,Bill Payment,2177.29
21401,719363283,04-02-24 9:28,196.71,Return,Amazon Return,2374
21402,719363283,04-04-24 21:28,1700,IncomingTransfer,Salary,4074
21403,719363283,04-07-24 15:28,247.08,Return,Target Return,4321.08
21404,719363283,04-07-24 17:28,236.29,Purchase,Electronics,4084.79
21405,719363283,04-08-24 17:28,157.94,Deposit,Cash Deposit,4242.73
21406,719363283,04-10-24 18:28,39.95,Purchase,Gas,4202.78
21407,719363283,04-12-24 22:28,81.93,IncomingTransfer,Freelance Payment,4284.71
21408,719363283,4-13-24 16:28,145.14,Withdrawal,Branch Withdrawal,4139.57
21409,719363283,4-14-24 21:28,900,Payment,Rent Payment,3239.57
21410,719363283,4-17-24 16:28,110.6,OnlineShopping,AliExpress,3128.97
21411,719363283,4-18-24 11:28,240.79,OnlineShopping,Amazon,2888.18
21412,719363283,4-28-24 19:28,197.17,Deposit,Check Deposit,3085.35
21413,719363283,05-02-24 12:28,110.09,Withdrawal,ATM Withdrawal,2975.26
21414,719363283,05-02-24 22:28,172.42,Deposit,Check Deposit,3147.68
21415,719363283,05-04-24 11:28,84.7,OnlineShopping,Etsy,3062.98
21416,719363283,05-05-24 21:28,1700,IncomingTransfer,Salary,4762.98
21417,719363283,05-06-24 14:28,59.38,Deposit,Mobile Deposit,4822.36
21418,719363283,05-11-24 13:28,247.51,Return,Amazon Return,5069.87
21419,719363283,05-12-24 21:28,400,Payment,Rent Payment,4669.87
21420,719363283,5-13-24 23:28,31.74,Purchase,Pharmacy,4638.13
21421,719363283,5-27-24 23:28,130.33,Withdrawal,Branch Withdrawal,4507.8
21422,719363283,5-31-24 19:28,109.84,Return,AliExpress Return,4617.64
21423,719363283,06-02-24 16:28,197.45,Deposit,Cash Deposit,4815.09
21424,719363283,06-04-24 21:28,1700,IncomingTransfer,Salary,6515.09
21425,719363283,06-09-24 12:28,111.77,Deposit,Direct Deposit,6626.86
21426,719363283,06-09-24 22:28,13.91,Purchase,Restaurant,6612.95
21427,719363283,06-11-24 15:28,201.68,Withdrawal,ATM Withdrawal,6411.27
21428,719363283,6-13-24 21:28,700,Payment,Rent Payment,5711.27
21429,719363283,6-16-24 12:28,234.45,OnlineShopping,Best Buy,5476.82
21430,719363283,6-16-24 22:28,227.47,OutgoingTransfer,International Transfer,5249.35
21431,719363283,6-24-24 12:28,93.04,Deposit,Mobile Deposit,5342.39
21432,719363283,6-27-24 9:28,145.27,Purchase,Gas,5197.12
21433,719363283,07-01-24 21:28,1700,IncomingTransfer,Salary,6897.12
21434,719363283,07-12-24 21:28,400,Payment,Rent Payment,6497.12
21435,719363283,7-15-24 12:28,66.35,Deposit,Cash Deposit,6563.47
21436,719446833,1-21-24 20:28,218.04,Deposit,Mobile Deposit,1206.642812
21437,719446833,1-24-24 15:28,206.67,OutgoingTransfer,Peer-to-Peer Transfer,999.9728117
21438,719446833,1-27-24 11:28,64.42,Purchase,Home Improvement,935.5528117
21439,719446833,1-30-24 18:28,57.85,OnlineShopping,Walmart,877.7028117
21440,719446833,02-01-24 11:28,126.89,Withdrawal,ATM Withdrawal,750.8128117
21441,719446833,02-02-24 20:28,124.97,Payment,Bill Payment,625.8428117
21442,719446833,02-05-24 20:28,20.77,Deposit,Mobile Deposit,646.6128117
21443,719446833,02-06-24 12:28,134.76,Deposit,Cash Deposit,781.3728117
21444,719446833,02-07-24 10:28,196.14,Payment,Loan Payment,585.2328117
21445,719446833,02-09-24 12:28,173.23,Withdrawal,ATM Withdrawal,412.0028117
21446,719446833,2-13-24 10:28,195,Deposit,Direct Deposit,607.0028117
21447,719446833,2-17-24 15:28,143.68,Withdrawal,Branch Withdrawal,463.3228117
21448,719446833,2-23-24 10:28,226.38,Deposit,Check Deposit,689.7028117
21449,719446833,2-25-24 11:28,167.26,OnlineShopping,Etsy,522.4428117
21450,719446833,2-28-24 23:28,177.72,Purchase,Travel,344.7228117
21451,719446833,03-02-24 13:28,82.14,OutgoingTransfer,Peer-to-Peer Transfer,262.5828117
21452,719446833,03-04-24 21:28,66.53,Purchase,Pharmacy,196.0528117
21453,719446833,03-06-24 21:28,130.44,Return,Amazon Return,326.4928117
21454,719446833,03-10-24 10:28,161.44,OnlineShopping,Best Buy,165.0528117
21455,719446833,03-11-24 21:28,241.34,Payment,Mortgage Payment,-76.28718835
21456,719446833,03-12-24 12:28,198.13,Deposit,Cash Deposit,121.8428117
21457,719446833,03-12-24 18:28,136.51,IncomingTransfer,Freelance Payment,258.3528117
21458,719446833,3-13-24 12:28,216,Purchase,Restaurant,42.35281165
21459,719446833,3-16-24 11:28,153.22,OutgoingTransfer,International Transfer,-110.8671883
21460,719446833,3-17-24 22:28,117.03,OutgoingTransfer,Bank Transfer,-227.8971883
21461,719446833,3-18-24 20:28,176.75,Purchase,Pharmacy,-404.6471883
21462,719446833,3-19-24 9:28,30.23,IncomingTransfer,Freelance Payment,-374.4171883
21463,719446833,3-21-24 13:28,138.29,Withdrawal,Mobile App Withdrawal,-512.7071883
21464,719446833,3-22-24 22:28,42.94,OnlineShopping,Target,-555.6471883
21465,719446833,3-24-24 22:28,161.37,Deposit,Check Deposit,-394.2771883
21466,719446833,3-25-24 13:28,23.94,Purchase,Clothing,-418.2171883
21467,719446833,3-26-24 15:28,186.27,Purchase,Clothing,-604.4871883
21468,719446833,3-27-24 16:28,84.85,Payment,Loan Payment,-689.3371883
21469,719446833,3-27-24 22:28,205.27,Purchase,Gas,-894.6071883
21470,719446833,3-28-24 11:28,13.84,Purchase,Entertainment,-908.4471883
21471,719446833,3-29-24 18:28,17.18,Payment,Mortgage Payment,-925.6271883
21472,719446833,3-31-24 16:28,206.73,Purchase,Travel,-1132.357188
21473,719446833,3-31-24 20:28,53.27,OutgoingTransfer,Peer-to-Peer Transfer,-1185.627188
21474,719446833,04-01-24 19:28,122.58,Return,Amazon Return,-1063.047188
21475,719446833,04-04-24 13:28,249.13,Deposit,Direct Deposit,-813.9171883
21476,719446833,04-06-24 19:28,11.57,Purchase,Entertainment,-825.4871883
21477,719446833,04-09-24 10:28,126.8,Return,Target Return,-698.6871883
21478,719446833,04-09-24 20:28,217.61,OnlineShopping,Target,-916.2971883
21479,719446833,04-10-24 16:28,27.78,Payment,Loan Payment,-944.0771883
21480,719446833,04-12-24 9:28,46.72,Withdrawal,Mobile App Withdrawal,-990.7971883
21481,719446833,4-15-24 18:28,131.7,IncomingTransfer,Freelance Payment,-859.0971883
21482,719446833,4-17-24 18:28,62.33,Withdrawal,Mobile App Withdrawal,-921.4271883
21483,719446833,4-26-24 9:28,163.16,Deposit,Direct Deposit,-758.2671883
21484,719446833,4-26-24 20:28,69.49,Purchase,Restaurant,-827.7571883
21485,719446833,4-26-24 22:28,96.33,Payment,Mortgage Payment,-924.0871883
21486,719446833,4-26-24 23:28,30.6,Deposit,Check Deposit,-893.4871883
21487,719446833,4-30-24 9:28,207.54,Purchase,Restaurant,-1101.027188
21488,719446833,05-07-24 20:28,39.14,OutgoingTransfer,Peer-to-Peer Transfer,-1140.167188
21489,719446833,05-10-24 22:28,126.21,Purchase,Home Improvement,-1266.377188
21490,719446833,05-11-24 11:28,30.38,OutgoingTransfer,Wire Transfer,-1296.757188
21491,719446833,5-15-24 20:28,205.62,Purchase,Furniture,-1502.377188
21492,719446833,5-18-24 21:28,154.55,Withdrawal,Branch Withdrawal,-1656.927188
21493,719446833,5-21-24 22:28,73.37,OnlineShopping,eBay,-1730.297188
21494,719446833,5-22-24 10:28,85.95,Purchase,Home Improvement,-1816.247188
21495,719446833,5-24-24 17:28,48.95,OnlineShopping,Amazon,-1865.197188
21496,719446833,5-24-24 19:28,135.27,OnlineShopping,Walmart,-2000.467188
21497,719446833,5-26-24 15:28,10.45,Return,Etsy Return,-1990.017188
21498,719446833,5-27-24 23:28,64.01,Purchase,Gas,-2054.027188
21499,719446833,5-28-24 9:28,152.9,Deposit,Cash Deposit,-1901.127188
21500,719446833,5-30-24 12:28,101.36,Deposit,Cash Deposit,-1799.767188
21501,719446833,06-01-24 14:28,28.06,IncomingTransfer,Freelance Payment,-1771.707188
21502,719446833,06-01-24 17:28,111.16,Deposit,Mobile Deposit,-1660.547188
21503,719446833,06-02-24 15:28,78.76,Deposit,Check Deposit,-1581.787188
21504,719446833,06-09-24 10:28,129.68,Purchase,Pharmacy,-1711.467188
21505,719446833,06-09-24 16:28,141.98,Payment,Bill Payment,-1853.447188
21506,719446833,6-18-24 19:28,99.47,IncomingTransfer,Freelance Payment,-1753.977188
21507,719446833,6-22-24 10:28,90.19,OnlineShopping,Etsy,-1844.167188
21508,719446833,6-26-24 14:28,150.37,Withdrawal,ATM Withdrawal,-1994.537188
21509,719446833,07-04-24 15:28,17.2,Purchase,Travel,-2011.737188
21510,719446833,07-04-24 19:28,238.23,Return,Etsy Return,-1773.507188
21511,719446833,07-06-24 14:28,233.1,Purchase,Home Improvement,-2006.607188
21512,719446833,07-10-24 20:28,10.1,Purchase,Gas,-2016.707188
21513,719446833,07-11-24 17:28,127.12,OnlineShopping,Best Buy,-2143.827188
21514,719446833,07-11-24 21:28,167.97,Deposit,Mobile Deposit,-1975.857188
21515,719446833,07-12-24 9:28,85.78,OnlineShopping,eBay,-2061.637188
21516,719446833,7-13-24 16:28,197,IncomingTransfer,Freelance Payment,-1864.637188
21517,719446833,7-13-24 18:28,84.68,Return,Target Return,-1779.957188
21518,719446833,7-15-24 21:28,121.78,Return,Amazon Return,-1658.177188
21519,719474583,1-23-24 10:28,603.9,Return,Walmart Return,1939.631475
21520,719474583,1-25-24 12:28,331.28,Purchase,Restaurant,1608.351475
21521,719474583,1-28-24 14:28,366.84,Withdrawal,Mobile App Withdrawal,1241.511475
21522,719474583,02-01-24 9:28,451.72,Return,Target Return,1693.231475
21523,719474583,02-02-24 21:28,9200,IncomingTransfer,Salary,10893.23148
21524,719474583,02-03-24 15:28,699.34,Deposit,Direct Deposit,11592.57148
21525,719474583,02-05-24 9:28,348.36,Deposit,Direct Deposit,11940.93148
21526,719474583,02-07-24 21:28,2400,Payment,Credit Card Payment,9540.931475
21527,719474583,02-07-24 22:28,697.03,IncomingTransfer,Freelance Payment,10237.96148
21528,719474583,2-16-24 18:28,355.88,IncomingTransfer,Freelance Payment,10593.84148
21529,719474583,2-18-24 21:28,2500,Payment,Installment Payment,8093.841475
21530,719474583,2-21-24 18:28,470.24,Withdrawal,Mobile App Withdrawal,7623.601475
21531,719474583,2-26-24 14:28,343.04,Return,eBay Return,7966.641475
21532,719474583,2-28-24 21:28,734.66,OutgoingTransfer,Bank Transfer,7231.981475
21533,719474583,2-29-24 22:28,451.74,Withdrawal,Mobile App Withdrawal,6780.241475
21534,719474583,03-02-24 21:28,9200,IncomingTransfer,Salary,15980.24148
21535,719474583,03-03-24 10:28,306.21,OnlineShopping,AliExpress,15674.03148
21536,719474583,03-07-24 21:28,1900,Payment,Credit Card Payment,13774.03148
21537,719474583,03-12-24 13:28,506.5,Return,Walmart Return,14280.53148
21538,719474583,03-12-24 21:28,2700,Payment,Insurance Payment,11580.53148
21539,719474583,3-14-24 14:28,210.88,Deposit,Direct Deposit,11791.41148
21540,719474583,3-16-24 11:28,130.81,Purchase,Electronics,11660.60148
21541,719474583,3-17-24 15:28,402.42,Deposit,Check Deposit,12063.02148
21542,719474583,3-23-24 22:28,355.99,Withdrawal,Branch Withdrawal,11707.03148
21543,719474583,3-26-24 18:28,132.76,Withdrawal,Branch Withdrawal,11574.27148
21544,719474583,3-27-24 11:28,633.96,Deposit,Check Deposit,12208.23148
21545,719474583,3-30-24 15:28,608.73,Purchase,Clothing,11599.50148
21546,719474583,04-02-24 20:28,684.28,Purchase,Travel,10915.22148
21547,719474583,04-03-24 13:28,161.54,Deposit,Direct Deposit,11076.76148
21548,719474583,04-03-24 18:28,293.38,Withdrawal,Branch Withdrawal,10783.38148
21549,719474583,04-05-24 21:28,9200,IncomingTransfer,Salary,19983.38148
21550,719474583,04-10-24 21:28,2200,Payment,Credit Card Payment,17783.38148
21551,719474583,04-11-24 21:28,2600,Payment,Subscription Payment,15183.38148
21552,719474583,4-18-24 10:28,549.18,OutgoingTransfer,International Transfer,14634.20148
21553,719474583,4-18-24 14:28,519.28,Purchase,Pharmacy,14114.92148
21554,719474583,4-21-24 14:28,553.75,Deposit,Direct Deposit,14668.67148
21555,719474583,4-23-24 18:28,295.26,IncomingTransfer,Freelance Payment,14963.93148
21556,719474583,4-27-24 18:28,110.34,OnlineShopping,Best Buy,14853.59148
21557,719474583,4-29-24 19:28,504.63,Payment,Bill Payment,14348.96148
21558,719474583,4-30-24 17:28,186.95,OutgoingTransfer,International Transfer,14162.01148
21559,719474583,4-30-24 23:28,148.44,Purchase,Home Improvement,14013.57148
21560,719474583,05-01-24 17:28,486.8,Return,eBay Return,14500.37148
21561,719474583,05-01-24 23:28,731.99,OutgoingTransfer,Wire Transfer,13768.38148
21562,719474583,05-04-24 21:28,9200,IncomingTransfer,Salary,22968.38148
21563,719474583,05-08-24 17:28,183.3,Payment,Mortgage Payment,22785.08148
21564,719474583,05-09-24 21:28,2300,Payment,Credit Card Payment,20485.08148
21565,719474583,5-15-24 22:28,597.09,Deposit,Mobile Deposit,21082.17148
21566,719474583,5-18-24 21:28,3000,Payment,Installment Payment,18082.17148
21567,719474583,5-28-24 21:28,495.64,Purchase,Grocery,17586.53148
21568,719474583,5-29-24 9:28,290.33,OnlineShopping,Etsy,17296.20148
21569,719474583,5-29-24 10:28,106.53,Withdrawal,Mobile App Withdrawal,17189.67148
21570,719474583,5-29-24 12:28,712.52,Deposit,Cash Deposit,17902.19148
21571,719474583,5-29-24 13:28,673.07,Return,Target Return,18575.26148
21572,719474583,06-02-24 21:28,9200,IncomingTransfer,Salary,27775.26148
21573,719474583,06-05-24 18:28,490.7,Deposit,Mobile Deposit,28265.96148
21574,719474583,06-07-24 21:28,2200,Payment,Credit Card Payment,26065.96148
21575,719474583,06-11-24 12:28,342.35,Purchase,Clothing,25723.61148
21576,719474583,6-13-24 20:28,584.38,Deposit,Direct Deposit,26307.99148
21577,719474583,6-14-24 21:28,2400,Payment,Installment Payment,23907.99148
21578,719474583,6-19-24 19:28,139.12,Deposit,Mobile Deposit,24047.11148
21579,719474583,6-20-24 13:28,480.81,IncomingTransfer,Freelance Payment,24527.92148
21580,719474583,6-20-24 20:28,264.45,Withdrawal,Mobile App Withdrawal,24263.47148
21581,719474583,6-23-24 15:28,190.79,Withdrawal,Branch Withdrawal,24072.68148
21582,719474583,6-25-24 21:28,255.29,OutgoingTransfer,Peer-to-Peer Transfer,23817.39148
21583,719474583,6-28-24 21:28,495.98,Withdrawal,ATM Withdrawal,23321.41148
21584,719474583,6-29-24 12:28,267.42,Purchase,Restaurant,23053.99148
21585,719474583,07-04-24 21:28,9200,IncomingTransfer,Salary,32253.99148
21586,719474583,07-09-24 21:28,2100,Payment,Credit Card Payment,30153.99148
21587,719474583,7-15-24 21:28,3600,Payment,Subscription Payment,26553.99148
21588,719474583,7-16-24 14:28,691.91,Purchase,Entertainment,25862.08148
21589,719474583,7-17-24 13:28,496.03,OnlineShopping,Etsy,25366.05148
21590,719505483,1-20-24 22:28,214.72,Withdrawal,Branch Withdrawal,-214.72
21591,719505483,1-22-24 22:28,57.46,Payment,Loan Payment,-272.18
21592,719505483,1-23-24 20:28,59.71,Purchase,Furniture,-331.89
21593,719505483,1-24-24 18:28,170.58,Deposit,Check Deposit,-161.31
21594,719505483,1-25-24 17:28,249.64,Withdrawal,Branch Withdrawal,-410.95
21595,719505483,1-26-24 15:28,368.49,Purchase,Grocery,-779.44
21596,719505483,1-26-24 17:28,128.62,Withdrawal,Branch Withdrawal,-908.06
21597,719505483,1-28-24 19:28,77.46,Return,eBay Return,-830.6
21598,719505483,1-31-24 11:28,116.34,IncomingTransfer,Freelance Payment,-714.26
21599,719505483,02-01-24 21:28,2950,IncomingTransfer,Salary,2235.74
21600,719505483,02-04-24 19:28,96.77,OnlineShopping,Walmart,2138.97
21601,719505483,02-04-24 19:28,468.64,Withdrawal,Mobile App Withdrawal,1670.33
21602,719505483,02-06-24 14:28,58.21,Payment,Bill Payment,1612.12
21603,719505483,02-06-24 20:28,72.6,Purchase,Grocery,1539.52
21604,719505483,02-07-24 9:28,125.05,Deposit,Cash Deposit,1664.57
21605,719505483,02-08-24 11:28,70.34,Payment,Bill Payment,1594.23
21606,719505483,02-11-24 15:28,114.72,OnlineShopping,eBay,1479.51
21607,719505483,02-11-24 16:28,435.64,OnlineShopping,Amazon,1043.87
21608,719505483,2-13-24 21:28,1800,Payment,Rent Payment,-756.13
21609,719505483,2-14-24 9:28,182.23,Return,AliExpress Return,-573.9
21610,719505483,2-14-24 13:28,238.61,Withdrawal,Branch Withdrawal,-812.51
21611,719505483,2-14-24 22:28,278.76,Withdrawal,ATM Withdrawal,-1091.27
21612,719505483,2-16-24 20:28,315.01,Payment,Mortgage Payment,-1406.28
21613,719505483,2-20-24 9:28,124.08,Deposit,Direct Deposit,-1282.2
21614,719505483,2-22-24 13:28,491.74,Payment,Loan Payment,-1773.94
21615,719505483,2-28-24 13:28,139.43,OutgoingTransfer,International Transfer,-1913.37
21616,719505483,03-01-24 21:28,2950,IncomingTransfer,Salary,1036.63
21617,719505483,03-08-24 9:28,14.67,Withdrawal,Mobile App Withdrawal,1021.96
21618,719505483,03-10-24 12:28,153.36,OutgoingTransfer,Bank Transfer,868.6
21619,719505483,03-12-24 21:28,800,Payment,Rent Payment,68.6
21620,719505483,3-13-24 19:28,362.09,Return,Store Return,430.69
21621,719505483,3-14-24 10:28,322.67,IncomingTransfer,Freelance Payment,753.36
21622,719505483,3-14-24 14:28,105.22,Withdrawal,ATM Withdrawal,648.14
21623,719505483,3-14-24 18:28,88.7,Purchase,Entertainment,559.44
21624,719505483,3-16-24 11:28,19.84,Payment,Bill Payment,539.6
21625,719505483,3-18-24 17:28,241.45,Deposit,Direct Deposit,781.05
21626,719505483,3-18-24 19:28,379.4,OutgoingTransfer,Bank Transfer,401.65
21627,719505483,3-22-24 11:28,215.82,Withdrawal,Mobile App Withdrawal,185.83
21628,719505483,3-24-24 19:28,117.52,Payment,Bill Payment,68.31
21629,719505483,3-27-24 19:28,443.01,OnlineShopping,Etsy,-374.7
21630,719505483,3-28-24 11:28,361.85,Purchase,Restaurant,-736.55
21631,719505483,3-30-24 17:28,45.14,Purchase,Home Improvement,-781.69
21632,719505483,3-30-24 19:28,179.8,IncomingTransfer,Freelance Payment,-601.89
21633,719505483,3-30-24 20:28,372.62,Return,Store Return,-229.27
21634,719505483,04-02-24 14:28,360.33,Purchase,Pharmacy,-589.6
21635,719505483,04-05-24 21:28,2950,IncomingTransfer,Salary,2360.4
21636,719505483,04-06-24 22:28,494.23,Withdrawal,Branch Withdrawal,1866.17
21637,719505483,04-09-24 13:28,253.08,Purchase,Restaurant,1613.09
21638,719505483,04-10-24 21:28,100.75,Return,Best Buy Return,1713.84
21639,719505483,04-12-24 23:28,21.27,Deposit,Cash Deposit,1735.11
21640,719505483,4-13-24 16:28,440.87,Return,eBay Return,2175.98
21641,719505483,4-14-24 21:28,1600,Payment,Rent Payment,575.98
21642,719505483,4-17-24 16:28,339.4,Deposit,Mobile Deposit,915.38
21643,719505483,4-18-24 22:28,67.7,Deposit,Direct Deposit,983.08
21644,719505483,4-19-24 13:28,459.06,Return,Etsy Return,1442.14
21645,719505483,4-20-24 20:28,279.31,IncomingTransfer,Freelance Payment,1721.45
21646,719505483,4-22-24 16:28,37.19,OnlineShopping,Best Buy,1684.26
21647,719505483,4-23-24 21:28,40.85,Return,Amazon Return,1725.11
21648,719505483,4-23-24 22:28,354.29,Return,Best Buy Return,2079.4
21649,719505483,4-24-24 10:28,478.78,Purchase,Furniture,1600.62
21650,719505483,4-26-24 17:28,375.92,Purchase,Travel,1224.7
21651,719505483,4-27-24 16:28,253.31,Purchase,Clothing,971.39
21652,719505483,4-28-24 16:28,181.89,Deposit,Mobile Deposit,1153.28
21653,719505483,4-28-24 18:28,409.12,Withdrawal,ATM Withdrawal,744.16
21654,719505483,05-01-24 10:28,363.02,OutgoingTransfer,International Transfer,381.14
21655,719505483,05-02-24 19:28,485.96,Deposit,Mobile Deposit,867.1
21656,719505483,05-02-24 21:28,219.4,Deposit,Cash Deposit,1086.5
21657,719505483,05-03-24 11:28,347.89,Purchase,Travel,738.61
21658,719505483,05-03-24 13:28,124.42,Payment,Bill Payment,614.19
21659,719505483,05-03-24 21:28,2950,IncomingTransfer,Salary,3564.19
21660,719505483,05-05-24 15:28,161.5,Withdrawal,ATM Withdrawal,3402.69
21661,719505483,05-06-24 16:28,330.44,OutgoingTransfer,Bank Transfer,3072.25
21662,719505483,05-07-24 9:28,99.55,OnlineShopping,Etsy,2972.7
21663,719505483,05-08-24 11:28,333.36,Withdrawal,Mobile App Withdrawal,2639.34
21664,719505483,05-08-24 12:28,344.21,Deposit,Cash Deposit,2983.55
21665,719505483,05-10-24 9:28,142.52,Return,Walmart Return,3126.07
21666,719505483,5-18-24 20:28,21.43,Return,Target Return,3147.5
21667,719505483,5-18-24 21:28,1400,Payment,Rent Payment,1747.5
21668,719505483,5-26-24 15:28,104.54,OutgoingTransfer,Wire Transfer,1642.96
21669,719505483,06-01-24 12:28,300.85,Purchase,Home Improvement,1342.11
21670,719505483,06-02-24 21:28,2950,IncomingTransfer,Salary,4292.11
21671,719505483,06-04-24 20:28,288.36,Deposit,Mobile Deposit,4580.47
21672,719505483,06-07-24 11:28,371.23,OnlineShopping,eBay,4209.24
21673,719505483,06-07-24 13:28,452.96,Purchase,Electronics,3756.28
21674,719505483,06-08-24 22:28,251.07,Withdrawal,Branch Withdrawal,3505.21
21675,719505483,06-12-24 9:28,42.02,Purchase,Grocery,3463.19
21676,719505483,6-13-24 13:28,451.82,OnlineShopping,Amazon,3011.37
21677,719505483,6-18-24 17:28,63.27,Payment,Bill Payment,2948.1
21678,719505483,6-18-24 21:28,1600,Payment,Rent Payment,1348.1
21679,719505483,6-21-24 10:28,280.9,Return,eBay Return,1629
21680,719505483,6-21-24 22:28,239.05,Return,Walmart Return,1868.05
21681,719505483,6-26-24 16:28,254.47,OutgoingTransfer,International Transfer,1613.58
21682,719505483,6-26-24 23:28,457.83,Purchase,Entertainment,1155.75
21683,719505483,6-27-24 15:28,233.8,Return,Etsy Return,1389.55
21684,719505483,07-03-24 21:28,2950,IncomingTransfer,Salary,4339.55
21685,719505483,07-04-24 11:28,111.42,Purchase,Electronics,4228.13
21686,719505483,07-04-24 16:28,28.52,OutgoingTransfer,Bank Transfer,4199.61
21687,719505483,07-12-24 21:28,423.87,Withdrawal,Branch Withdrawal,3775.74
21688,719505483,7-14-24 14:28,421.81,Purchase,Pharmacy,3353.93
21689,719505483,7-15-24 10:28,249.01,Payment,Bill Payment,3104.92
21690,719505483,7-16-24 21:28,1100,Payment,Rent Payment,2004.92
21691,719577258,1-20-24 19:28,161.36,Deposit,Check Deposit,161.36
21692,719577258,1-23-24 14:28,67.89,Purchase,Home Improvement,93.47
21693,719577258,1-28-24 20:28,124.51,OutgoingTransfer,Bank Transfer,-31.04
21694,719577258,02-04-24 21:28,2500,IncomingTransfer,Salary,2468.96
21695,719577258,02-10-24 13:28,12.09,OutgoingTransfer,International Transfer,2456.87
21696,719577258,2-14-24 18:28,19.77,Withdrawal,Branch Withdrawal,2437.1
21697,719577258,2-14-24 21:28,900,Payment,Rent Payment,1537.1
21698,719577258,2-15-24 20:28,62.27,OnlineShopping,Walmart,1474.83
21699,719577258,2-16-24 17:28,56.37,Withdrawal,ATM Withdrawal,1418.46
21700,719577258,2-24-24 13:28,168.91,Payment,Loan Payment,1249.55
21701,719577258,03-03-24 13:28,138.62,Payment,Mortgage Payment,1110.93
21702,719577258,03-03-24 21:28,2500,IncomingTransfer,Salary,3610.93
21703,719577258,03-05-24 10:28,57.7,Withdrawal,ATM Withdrawal,3553.23
21704,719577258,03-10-24 21:28,900,Payment,Rent Payment,2653.23
21705,719577258,3-17-24 19:28,235.01,Withdrawal,ATM Withdrawal,2418.22
21706,719577258,3-17-24 19:28,185.55,Payment,Bill Payment,2232.67
21707,719577258,3-22-24 10:28,183.92,Withdrawal,ATM Withdrawal,2048.75
21708,719577258,3-23-24 20:28,60.53,Deposit,Check Deposit,2109.28
21709,719577258,3-27-24 11:28,120.65,Purchase,Home Improvement,1988.63
21710,719577258,04-03-24 21:28,2500,IncomingTransfer,Salary,4488.63
21711,719577258,04-11-24 21:28,1000,Payment,Rent Payment,3488.63
21712,719577258,4-17-24 21:28,112.12,Deposit,Check Deposit,3600.75
21713,719577258,4-22-24 13:28,148.17,OnlineShopping,eBay,3452.58
21714,719577258,4-22-24 16:28,238.13,Purchase,Home Improvement,3214.45
21715,719577258,05-04-24 13:28,92.7,Withdrawal,ATM Withdrawal,3121.75
21716,719577258,05-04-24 21:28,2500,IncomingTransfer,Salary,5621.75
21717,719577258,05-11-24 22:28,130.18,Purchase,Clothing,5491.57
21718,719577258,5-14-24 21:28,1600,Payment,Rent Payment,3891.57
21719,719577258,5-23-24 20:28,91.19,Purchase,Gas,3800.38
21720,719577258,5-25-24 19:28,113.25,Purchase,Gas,3687.13
21721,719577258,5-25-24 19:28,217.57,Deposit,Mobile Deposit,3904.7
21722,719577258,5-29-24 19:28,31.76,Purchase,Home Improvement,3872.94
21723,719577258,5-30-24 17:28,203.96,Purchase,Pharmacy,3668.98
21724,719577258,5-31-24 15:28,178.1,Return,Store Return,3847.08
21725,719577258,5-31-24 22:28,70.11,IncomingTransfer,Freelance Payment,3917.19
21726,719577258,06-04-24 21:28,2500,IncomingTransfer,Salary,6417.19
21727,719577258,06-10-24 14:28,72.74,Deposit,Mobile Deposit,6489.93
21728,719577258,06-10-24 20:28,200.81,Return,Store Return,6690.74
21729,719577258,06-11-24 10:28,127.99,Withdrawal,ATM Withdrawal,6562.75
21730,719577258,06-12-24 21:28,700,Payment,Rent Payment,5862.75
21731,719577258,6-14-24 14:28,113.32,Payment,Loan Payment,5749.43
21732,719577258,6-16-24 18:28,57.29,Return,eBay Return,5806.72
21733,719577258,6-17-24 18:28,82.96,OutgoingTransfer,International Transfer,5723.76
21734,719577258,6-17-24 20:28,129.9,OutgoingTransfer,Wire Transfer,5593.86
21735,719577258,6-20-24 18:28,228.81,Withdrawal,ATM Withdrawal,5365.05
21736,719577258,6-22-24 11:28,184.19,Payment,Loan Payment,5180.86
21737,719577258,6-22-24 12:28,22.7,Withdrawal,ATM Withdrawal,5158.16
21738,719577258,6-22-24 18:28,246.11,OutgoingTransfer,Peer-to-Peer Transfer,4912.05
21739,719577258,6-28-24 11:28,87.24,IncomingTransfer,Freelance Payment,4999.29
21740,719577258,07-05-24 21:28,2500,IncomingTransfer,Salary,7499.29
21741,719577258,7-15-24 21:28,700,Payment,Rent Payment,6799.29
21742,719580033,1-20-24 17:28,419.32,Return,eBay Return,2232.874055
21743,719580033,02-02-24 21:28,6650,IncomingTransfer,Salary,8882.874055
21744,719580033,02-04-24 16:28,86.17,Return,Amazon Return,8969.044055
21745,719580033,02-06-24 15:28,136.9,Deposit,Direct Deposit,9105.944055
21746,719580033,02-07-24 21:28,2500,Payment,Credit Card Payment,6605.944055
21747,719580033,2-13-24 21:28,2700,Payment,Insurance Payment,3905.944055
21748,719580033,2-15-24 14:28,218.41,Purchase,Electronics,3687.534055
21749,719580033,03-01-24 21:28,6650,IncomingTransfer,Salary,10337.53406
21750,719580033,03-06-24 21:28,2300,Payment,Credit Card Payment,8037.534055
21751,719580033,3-13-24 17:28,202.23,Deposit,Cash Deposit,8239.764055
21752,719580033,3-16-24 21:28,2300,Payment,Installment Payment,5939.764055
21753,719580033,3-30-24 16:28,85.14,OnlineShopping,eBay,5854.624055
21754,719580033,04-01-24 11:28,176.9,Purchase,Pharmacy,5677.724055
21755,719580033,04-04-24 21:28,6650,IncomingTransfer,Salary,12327.72406
21756,719580033,04-09-24 21:28,3000,Payment,Credit Card Payment,9327.724055
21757,719580033,4-13-24 21:28,1700,Payment,Insurance Payment,7627.724055
21758,719580033,4-14-24 13:28,219.54,IncomingTransfer,Freelance Payment,7847.264055
21759,719580033,4-15-24 13:28,507.28,Withdrawal,Branch Withdrawal,7339.984055
21760,719580033,4-27-24 18:28,293.77,Deposit,Direct Deposit,7633.754055
21761,719580033,4-30-24 14:28,87.2,Deposit,Check Deposit,7720.954055
21762,719580033,05-03-24 12:28,144.61,OnlineShopping,Etsy,7576.344055
21763,719580033,05-03-24 21:28,6650,IncomingTransfer,Salary,14226.34406
21764,719580033,05-08-24 21:28,3000,Payment,Credit Card Payment,11226.34406
21765,719580033,5-13-24 21:28,2100,Payment,Insurance Payment,9126.344055
21766,719580033,5-15-24 22:28,160.17,Purchase,Grocery,8966.174055
21767,719580033,5-22-24 21:28,427.22,Deposit,Cash Deposit,9393.394055
21768,719580033,5-28-24 19:28,164.09,Return,eBay Return,9557.484055
21769,719580033,06-01-24 21:28,6650,IncomingTransfer,Salary,16207.48406
21770,719580033,06-02-24 12:28,79.36,Purchase,Pharmacy,16128.12406
21771,719580033,06-05-24 23:28,537.14,OnlineShopping,Etsy,15590.98406
21772,719580033,06-06-24 21:28,2500,Payment,Credit Card Payment,13090.98406
21773,719580033,06-10-24 17:28,395.98,Withdrawal,Mobile App Withdrawal,12695.00406
21774,719580033,06-10-24 21:28,1800,Payment,Installment Payment,10895.00406
21775,719580033,6-17-24 18:28,496.46,Return,Store Return,11391.46406
21776,719580033,6-24-24 18:28,348.1,OnlineShopping,AliExpress,11043.36406
21777,719580033,07-01-24 21:28,6650,IncomingTransfer,Salary,17693.36406
21778,719580033,07-06-24 21:28,3000,Payment,Credit Card Payment,14693.36406
21779,719580033,07-10-24 23:28,419.74,Withdrawal,Branch Withdrawal,14273.62406
21780,719580033,7-16-24 21:28,3000,Payment,Installment Payment,11273.62406
21781,719594433,1-24-24 12:28,210.64,Payment,Mortgage Payment,993.8395917
21782,719594433,1-26-24 21:28,110.46,Payment,Bill Payment,883.3795917
21783,719594433,1-27-24 18:28,394.8,Deposit,Mobile Deposit,1278.179592
21784,719594433,1-30-24 18:28,376.71,Deposit,Mobile Deposit,1654.889592
21785,719594433,1-31-24 17:28,164.26,Deposit,Mobile Deposit,1819.149592
21786,719594433,02-04-24 21:28,2000,IncomingTransfer,Salary,3819.149592
21787,719594433,02-05-24 10:28,446.43,Purchase,Electronics,3372.719592
21788,719594433,02-05-24 23:28,440.64,OnlineShopping,Walmart,2932.079592
21789,719594433,02-06-24 10:28,46.39,Deposit,Check Deposit,2978.469592
21790,719594433,02-07-24 16:28,339.84,OutgoingTransfer,International Transfer,2638.629592
21791,719594433,02-09-24 21:28,1500,Payment,Credit Card Payment,1138.629592
21792,719594433,2-14-24 22:28,488.39,Purchase,Furniture,650.2395917
21793,719594433,2-16-24 15:28,364.58,Purchase,Travel,285.6595917
21794,719594433,2-18-24 21:28,700,Payment,Installment Payment,-414.3404083
21795,719594433,2-18-24 21:28,266.57,Payment,Bill Payment,-680.9104083
21796,719594433,2-19-24 15:28,352.39,OnlineShopping,Amazon,-1033.300408
21797,719594433,2-24-24 11:28,63.81,Deposit,Check Deposit,-969.4904083
21798,719594433,2-27-24 22:28,206.14,Deposit,Direct Deposit,-763.3504083
21799,719594433,2-29-24 15:28,499.49,OnlineShopping,Target,-1262.840408
21800,719594433,03-01-24 21:28,2000,IncomingTransfer,Salary,737.1595917
21801,719594433,03-06-24 21:28,1600,Payment,Credit Card Payment,-862.8404083
21802,719594433,03-06-24 21:28,493.24,Payment,Bill Payment,-1356.080408
21803,719594433,03-08-24 22:28,366.77,OnlineShopping,Walmart,-1722.850408
21804,719594433,03-10-24 18:28,415.23,Withdrawal,Mobile App Withdrawal,-2138.080408
21805,719594433,3-13-24 12:28,153.74,Deposit,Direct Deposit,-1984.340408
21806,719594433,3-13-24 21:28,207.29,Withdrawal,ATM Withdrawal,-2191.630408
21807,719594433,3-15-24 21:28,500,Payment,Installment Payment,-2691.630408
21808,719594433,3-17-24 17:28,206.74,Deposit,Check Deposit,-2484.890408
21809,719594433,3-18-24 22:28,424.36,Deposit,Cash Deposit,-2060.530408
21810,719594433,3-20-24 19:28,362.66,Return,eBay Return,-1697.870408
21811,719594433,3-22-24 16:28,50.59,Return,Etsy Return,-1647.280408
21812,719594433,3-23-24 13:28,17.57,Deposit,Check Deposit,-1629.710408
21813,719594433,3-25-24 19:28,188.03,Payment,Loan Payment,-1817.740408
21814,719594433,3-30-24 12:28,421.56,Purchase,Travel,-2239.300408
21815,719594433,04-02-24 21:28,2000,IncomingTransfer,Salary,-239.3004083
21816,719594433,04-07-24 21:28,1800,Payment,Credit Card Payment,-2039.300408
21817,719594433,04-11-24 18:28,130.83,Deposit,Check Deposit,-1908.470408
21818,719594433,4-15-24 11:28,32.05,Purchase,Pharmacy,-1940.520408
21819,719594433,4-16-24 21:28,800,Payment,Subscription Payment,-2740.520408
21820,719594433,4-17-24 9:28,258.93,IncomingTransfer,Freelance Payment,-2481.590408
21821,719594433,4-21-24 18:28,149.02,Purchase,Furniture,-2630.610408
21822,719594433,4-22-24 15:28,57.35,OnlineShopping,AliExpress,-2687.960408
21823,719594433,4-24-24 20:28,118.86,Deposit,Mobile Deposit,-2569.100408
21824,719594433,4-27-24 13:28,362.02,OutgoingTransfer,Wire Transfer,-2931.120408
21825,719594433,4-29-24 17:28,413.59,Return,Best Buy Return,-2517.530408
21826,719594433,4-30-24 18:28,483.37,Withdrawal,ATM Withdrawal,-3000.900408
21827,719594433,05-02-24 21:28,2000,IncomingTransfer,Salary,-1000.900408
21828,719594433,05-03-24 15:28,60.94,IncomingTransfer,Freelance Payment,-939.9604083
21829,719594433,05-04-24 17:28,403.02,Purchase,Gas,-1342.980408
21830,719594433,05-07-24 21:28,1900,Payment,Credit Card Payment,-3242.980408
21831,719594433,05-09-24 15:28,141.24,Deposit,Direct Deposit,-3101.740408
21832,719594433,05-10-24 21:28,80.84,Payment,Bill Payment,-3182.580408
21833,719594433,05-11-24 15:28,345.74,Payment,Bill Payment,-3528.320408
21834,719594433,5-14-24 21:28,27.48,Purchase,Grocery,-3555.800408
21835,719594433,5-15-24 21:28,700,Payment,Subscription Payment,-4255.800408
21836,719594433,5-21-24 11:28,298.14,Deposit,Mobile Deposit,-3957.660408
21837,719594433,5-22-24 9:28,177.89,Purchase,Travel,-4135.550408
21838,719594433,5-24-24 9:28,498.28,OutgoingTransfer,Bank Transfer,-4633.830408
21839,719594433,5-24-24 9:28,255.35,OutgoingTransfer,Wire Transfer,-4889.180408
21840,719594433,5-26-24 15:28,373.59,Withdrawal,ATM Withdrawal,-5262.770408
21841,719594433,5-27-24 18:28,89.34,Withdrawal,Branch Withdrawal,-5352.110408
21842,719594433,5-28-24 10:28,91.54,Payment,Mortgage Payment,-5443.650408
21843,719594433,5-30-24 11:28,75.05,Withdrawal,Branch Withdrawal,-5518.700408
21844,719594433,06-04-24 16:28,309.61,Withdrawal,ATM Withdrawal,-5828.310408
21845,719594433,06-05-24 19:28,354.95,Return,Best Buy Return,-5473.360408
21846,719594433,06-05-24 20:28,110.44,Payment,Bill Payment,-5583.800408
21847,719594433,06-05-24 21:28,2000,IncomingTransfer,Salary,-3583.800408
21848,719594433,06-08-24 21:28,322.71,Payment,Bill Payment,-3906.510408
21849,719594433,06-10-24 19:28,118.36,Deposit,Direct Deposit,-3788.150408
21850,719594433,06-10-24 21:28,1800,Payment,Credit Card Payment,-5588.150408
21851,719594433,6-16-24 15:28,28.4,Payment,Mortgage Payment,-5616.550408
21852,719594433,6-17-24 19:28,122.12,Purchase,Pharmacy,-5738.670408
21853,719594433,6-18-24 14:28,194.56,Deposit,Mobile Deposit,-5544.110408
21854,719594433,6-18-24 21:28,500,Payment,Subscription Payment,-6044.110408
21855,719594433,6-22-24 11:28,283.28,OutgoingTransfer,Wire Transfer,-6327.390408
21856,719594433,6-25-24 14:28,239.53,Payment,Bill Payment,-6566.920408
21857,719594433,07-01-24 9:28,69.26,Purchase,Clothing,-6636.180408
21858,719594433,07-04-24 12:28,181.21,Purchase,Furniture,-6817.390408
21859,719594433,07-04-24 19:28,345.49,Deposit,Mobile Deposit,-6471.900408
21860,719594433,07-05-24 21:28,2000,IncomingTransfer,Salary,-4471.900408
21861,719594433,07-06-24 18:28,265.75,Withdrawal,Mobile App Withdrawal,-4737.650408
21862,719594433,07-10-24 21:28,1900,Payment,Credit Card Payment,-6637.650408
21863,719594433,07-10-24 23:28,232.85,Withdrawal,Branch Withdrawal,-6870.500408
21864,719594433,07-11-24 21:28,700,Payment,Subscription Payment,-7570.500408
21865,719625933,1-20-24 10:28,812.3,Purchase,Furniture,29.19963558
21866,719625933,1-23-24 11:28,530.24,OnlineShopping,eBay,-501.0403644
21867,719625933,1-23-24 15:28,450.94,Payment,Bill Payment,-951.9803644
21868,719625933,1-24-24 16:28,750.68,OnlineShopping,Amazon,-1702.660364
21869,719625933,1-28-24 22:28,438.57,OnlineShopping,eBay,-2141.230364
21870,719625933,02-01-24 21:28,13650,IncomingTransfer,Salary,11508.76964
21871,719625933,02-04-24 10:28,696.35,Deposit,Direct Deposit,12205.11964
21872,719625933,02-04-24 16:28,248.25,Purchase,Home Improvement,11956.86964
21873,719625933,02-04-24 17:28,888.53,OutgoingTransfer,Peer-to-Peer Transfer,11068.33964
21874,719625933,02-04-24 18:28,360.63,Payment,Loan Payment,10707.70964
21875,719625933,02-04-24 21:28,408.14,Purchase,Electronics,10299.56964
21876,719625933,02-06-24 15:28,583.31,Withdrawal,Mobile App Withdrawal,9716.259636
21877,719625933,02-06-24 21:28,1600,Payment,Credit Card Payment,8116.259636
21878,719625933,02-07-24 12:28,451.71,Return,Etsy Return,8567.969636
21879,719625933,02-07-24 22:28,298.86,Return,eBay Return,8866.829636
21880,719625933,02-08-24 10:28,254,IncomingTransfer,Freelance Payment,9120.829636
21881,719625933,02-11-24 11:28,752.6,Withdrawal,Branch Withdrawal,8368.229636
21882,719625933,02-11-24 12:28,606.03,IncomingTransfer,Freelance Payment,8974.259636
21883,719625933,02-11-24 16:28,401.87,IncomingTransfer,Freelance Payment,9376.129636
21884,719625933,02-11-24 20:28,535.15,IncomingTransfer,Freelance Payment,9911.279636
21885,719625933,02-11-24 22:28,610.73,Deposit,Mobile Deposit,10522.00964
21886,719625933,02-12-24 12:28,462.42,Withdrawal,Mobile App Withdrawal,10059.58964
21887,719625933,2-15-24 21:28,3400,Payment,Rent Payment,6659.589636
21888,719625933,2-20-24 9:28,286.29,Deposit,Check Deposit,6945.879636
21889,719625933,2-21-24 16:28,425.15,OnlineShopping,Amazon,6520.729636
21890,719625933,2-25-24 22:28,347.11,Withdrawal,ATM Withdrawal,6173.619636
21891,719625933,2-26-24 21:28,273.44,Deposit,Direct Deposit,6447.059636
21892,719625933,2-27-24 15:28,562.88,Deposit,Cash Deposit,7009.939636
21893,719625933,03-03-24 10:28,927.54,Purchase,Entertainment,6082.399636
21894,719625933,03-05-24 14:28,272.59,OnlineShopping,Best Buy,5809.809636
21895,719625933,03-05-24 21:28,13650,IncomingTransfer,Salary,19459.80964
21896,719625933,03-06-24 18:28,555.41,Deposit,Check Deposit,20015.21964
21897,719625933,03-06-24 20:28,376.47,Deposit,Mobile Deposit,20391.68964
21898,719625933,03-07-24 15:28,559.49,Payment,Loan Payment,19832.19964
21899,719625933,03-08-24 9:28,468.07,Payment,Loan Payment,19364.12964
21900,719625933,03-10-24 21:28,1600,Payment,Credit Card Payment,17764.12964
21901,719625933,03-10-24 21:28,7400,Payment,Rent Payment,10364.12964
21902,719625933,03-12-24 23:28,723.93,OutgoingTransfer,Bank Transfer,9640.199636
21903,719625933,3-18-24 19:28,425.27,Withdrawal,ATM Withdrawal,9214.929636
21904,719625933,3-22-24 18:28,529.77,Purchase,Pharmacy,8685.159636
21905,719625933,3-29-24 14:28,901.19,Payment,Loan Payment,7783.969636
21906,719625933,3-30-24 11:28,268.8,Purchase,Gas,7515.169636
21907,719625933,3-30-24 21:28,612.45,Deposit,Cash Deposit,8127.619636
21908,719625933,3-31-24 12:28,797.57,OutgoingTransfer,Wire Transfer,7330.049636
21909,719625933,04-01-24 11:28,327.34,Deposit,Mobile Deposit,7657.389636
21910,719625933,04-01-24 18:28,294.96,Return,AliExpress Return,7952.349636
21911,719625933,04-01-24 21:28,13650,IncomingTransfer,Salary,21602.34964
21912,719625933,04-02-24 23:28,590.2,OnlineShopping,Etsy,21012.14964
21913,719625933,04-03-24 22:28,470,Purchase,Grocery,20542.14964
21914,719625933,04-05-24 15:28,728.57,Purchase,Clothing,19813.57964
21915,719625933,04-06-24 21:28,1400,Payment,Credit Card Payment,18413.57964
21916,719625933,04-08-24 20:28,434.43,Purchase,Gas,17979.14964
21917,719625933,04-10-24 16:28,823.59,Return,Store Return,18802.73964
21918,719625933,4-13-24 21:28,3900,Payment,Rent Payment,14902.73964
21919,719625933,4-19-24 16:28,585.34,Withdrawal,ATM Withdrawal,14317.39964
21920,719625933,4-21-24 12:28,518.76,Withdrawal,ATM Withdrawal,13798.63964
21921,719625933,4-21-24 21:28,273.64,Purchase,Clothing,13524.99964
21922,719625933,4-22-24 9:28,500.51,OnlineShopping,Walmart,13024.48964
21923,719625933,4-22-24 21:28,626.1,Withdrawal,Branch Withdrawal,12398.38964
21924,719625933,4-24-24 9:28,893.7,OutgoingTransfer,Bank Transfer,11504.68964
21925,719625933,4-29-24 17:28,578.84,OnlineShopping,Amazon,10925.84964
21926,719625933,4-30-24 17:28,855.74,OnlineShopping,Walmart,10070.10964
21927,719625933,05-01-24 17:28,868.71,Purchase,Home Improvement,9201.399636
21928,719625933,05-02-24 10:28,346.73,OnlineShopping,eBay,8854.669636
21929,719625933,05-02-24 14:28,751.71,Deposit,Check Deposit,9606.379636
21930,719625933,05-02-24 21:28,13650,IncomingTransfer,Salary,23256.37964
21931,719625933,05-02-24 22:28,525.65,Withdrawal,ATM Withdrawal,22730.72964
21932,719625933,05-07-24 21:28,1700,Payment,Credit Card Payment,21030.72964
21933,719625933,05-10-24 19:28,271.75,Payment,Bill Payment,20758.97964
21934,719625933,05-12-24 13:28,760.52,IncomingTransfer,Freelance Payment,21519.49964
21935,719625933,5-15-24 9:28,578.67,Payment,Bill Payment,20940.82964
21936,719625933,5-15-24 14:28,764.77,Payment,Mortgage Payment,20176.05964
21937,719625933,5-15-24 23:28,732.21,OnlineShopping,Best Buy,19443.84964
21938,719625933,5-16-24 14:28,488.03,Withdrawal,Mobile App Withdrawal,18955.81964
21939,719625933,5-17-24 21:28,7300,Payment,Rent Payment,11655.81964
21940,719625933,5-18-24 16:28,775.25,Withdrawal,ATM Withdrawal,10880.56964
21941,719625933,5-21-24 9:28,443.73,Purchase,Gas,10436.83964
21942,719625933,5-26-24 20:28,394.39,Withdrawal,ATM Withdrawal,10042.44964
21943,719625933,5-26-24 22:28,438.49,OutgoingTransfer,Wire Transfer,9603.959636
21944,719625933,5-27-24 15:28,299.09,Deposit,Cash Deposit,9903.049636
21945,719625933,5-28-24 16:28,581.25,IncomingTransfer,Freelance Payment,10484.29964
21946,719625933,5-30-24 16:28,418.65,Withdrawal,Branch Withdrawal,10065.64964
21947,719625933,5-31-24 17:28,542.83,OnlineShopping,Etsy,9522.819636
21948,719625933,06-03-24 18:28,408.26,OnlineShopping,Best Buy,9114.559636
21949,719625933,06-04-24 17:28,226.33,Payment,Loan Payment,8888.229636
21950,719625933,06-04-24 17:28,647.49,Withdrawal,ATM Withdrawal,8240.739636
21951,719625933,06-05-24 15:28,739.43,Purchase,Entertainment,7501.309636
21952,719625933,06-05-24 21:28,13650,IncomingTransfer,Salary,21151.30964
21953,719625933,06-07-24 12:28,413.74,Payment,Mortgage Payment,20737.56964
21954,719625933,06-10-24 15:28,536.93,OnlineShopping,Walmart,20200.63964
21955,719625933,06-10-24 21:28,1300,Payment,Credit Card Payment,18900.63964
21956,719625933,06-12-24 11:28,832.32,Deposit,Check Deposit,19732.95964
21957,719625933,06-12-24 16:28,775.77,Payment,Bill Payment,18957.18964
21958,719625933,06-12-24 21:28,3800,Payment,Rent Payment,15157.18964
21959,719625933,6-17-24 19:28,279.88,Withdrawal,Branch Withdrawal,14877.30964
21960,719625933,6-17-24 20:28,832.01,OutgoingTransfer,Wire Transfer,14045.29964
21961,719625933,6-19-24 16:28,941.02,Payment,Bill Payment,13104.27964
21962,719625933,6-21-24 9:28,812.98,Purchase,Restaurant,12291.29964
21963,719625933,6-23-24 19:28,943.24,Purchase,Furniture,11348.05964
21964,719625933,6-24-24 22:28,259.54,Return,Amazon Return,11607.59964
21965,719625933,6-27-24 19:28,654.25,Purchase,Grocery,10953.34964
21966,719625933,6-28-24 19:28,945.14,OutgoingTransfer,Peer-to-Peer Transfer,10008.20964
21967,719625933,6-29-24 12:28,384.75,Return,Amazon Return,10392.95964
21968,719625933,6-30-24 10:28,418.24,Purchase,Restaurant,9974.719636
21969,719625933,6-30-24 16:28,795.92,Purchase,Gas,9178.799636
21970,719625933,07-01-24 15:28,386.38,Purchase,Gas,8792.419636
21971,719625933,07-05-24 21:28,13650,IncomingTransfer,Salary,22442.41964
21972,719625933,07-08-24 11:28,285.8,OutgoingTransfer,Peer-to-Peer Transfer,22156.61964
21973,719625933,07-09-24 14:28,487.51,Payment,Loan Payment,21669.10964
21974,719625933,07-10-24 21:28,1400,Payment,Credit Card Payment,20269.10964
21975,719625933,07-11-24 21:28,8700,Payment,Rent Payment,11569.10964
21976,719625933,7-14-24 11:28,843.26,Payment,Loan Payment,10725.84964
21977,719625933,7-15-24 9:28,786.72,Withdrawal,Mobile App Withdrawal,9939.129636
21978,719625933,7-17-24 15:28,547.29,Purchase,Electronics,9391.839636
21979,719672283,1-20-24 10:28,96.17,Withdrawal,ATM Withdrawal,844.7085797
21980,719672283,1-29-24 18:28,221.54,Purchase,Home Improvement,623.1685797
21981,719672283,02-01-24 22:28,233.08,Deposit,Cash Deposit,856.2485797
21982,719672283,02-02-24 21:28,5100,IncomingTransfer,Salary,5956.24858
21983,719672283,02-04-24 12:28,70.81,OnlineShopping,Amazon,5885.43858
21984,719672283,02-04-24 12:28,331.82,Return,eBay Return,6217.25858
21985,719672283,02-07-24 21:28,2100,Payment,Credit Card Payment,4117.25858
21986,719672283,02-08-24 16:28,53.73,Purchase,Grocery,4063.52858
21987,719672283,02-08-24 21:28,285.44,Purchase,Home Improvement,3778.08858
21988,719672283,2-17-24 18:28,390.53,OutgoingTransfer,Bank Transfer,3387.55858
21989,719672283,2-17-24 21:28,1700,Payment,Rent Payment,1687.55858
21990,719672283,2-21-24 10:28,433.29,IncomingTransfer,Freelance Payment,2120.84858
21991,719672283,2-26-24 22:28,254.51,Deposit,Mobile Deposit,2375.35858
21992,719672283,03-01-24 12:28,548.97,Return,Best Buy Return,2924.32858
21993,719672283,03-01-24 19:28,469.55,OnlineShopping,Walmart,2454.77858
21994,719672283,03-02-24 21:28,5100,IncomingTransfer,Salary,7554.77858
21995,719672283,03-04-24 10:28,238.31,IncomingTransfer,Freelance Payment,7793.08858
21996,719672283,03-05-24 20:28,475.44,Deposit,Check Deposit,8268.52858
21997,719672283,03-07-24 13:28,220.36,Purchase,Entertainment,8048.16858
21998,719672283,03-07-24 21:28,2300,Payment,Credit Card Payment,5748.16858
21999,719672283,03-08-24 11:28,51.97,Purchase,Gas,5696.19858
22000,719672283,3-13-24 21:28,1900,Payment,Rent Payment,3796.19858
22001,719672283,3-16-24 14:28,273.29,Payment,Loan Payment,3522.90858
22002,719672283,3-19-24 17:28,401.33,Deposit,Cash Deposit,3924.23858
22003,719672283,3-24-24 15:28,109.45,IncomingTransfer,Freelance Payment,4033.68858
22004,719672283,3-24-24 19:28,498.22,Return,Target Return,4531.90858
22005,719672283,04-04-24 21:28,5100,IncomingTransfer,Salary,9631.90858
22006,719672283,04-06-24 17:28,519.72,OutgoingTransfer,Peer-to-Peer Transfer,9112.18858
22007,719672283,04-09-24 21:28,2300,Payment,Credit Card Payment,6812.18858
22008,719672283,04-10-24 22:28,484.75,Purchase,Restaurant,6327.43858
22009,719672283,04-11-24 21:28,1800,Payment,Rent Payment,4527.43858
22010,719672283,4-20-24 12:28,139.54,Purchase,Electronics,4387.89858
22011,719672283,4-20-24 15:28,482.35,Purchase,Gas,3905.54858
22012,719672283,4-23-24 14:28,145.37,Deposit,Mobile Deposit,4050.91858
22013,719672283,4-25-24 9:28,396.61,Return,Walmart Return,4447.52858
22014,719672283,4-27-24 16:28,155.99,IncomingTransfer,Freelance Payment,4603.51858
22015,719672283,05-03-24 21:28,5100,IncomingTransfer,Salary,9703.51858
22016,719672283,05-05-24 15:28,261.21,Withdrawal,Branch Withdrawal,9442.30858
22017,719672283,05-05-24 15:28,501.2,Purchase,Gas,8941.10858
22018,719672283,05-07-24 19:28,119.23,IncomingTransfer,Freelance Payment,9060.33858
22019,719672283,05-07-24 21:28,477.49,Purchase,Gas,8582.84858
22020,719672283,05-08-24 21:28,2200,Payment,Credit Card Payment,6382.84858
22021,719672283,05-10-24 12:28,72.02,Payment,Loan Payment,6310.82858
22022,719672283,05-12-24 15:28,60.58,OnlineShopping,eBay,6250.24858
22023,719672283,5-13-24 12:28,488.88,OnlineShopping,eBay,5761.36858
22024,719672283,5-14-24 17:28,243.36,Payment,Mortgage Payment,5518.00858
22025,719672283,5-15-24 13:28,243.27,Purchase,Clothing,5274.73858
22026,719672283,5-16-24 21:28,1900,Payment,Rent Payment,3374.73858
22027,719672283,5-19-24 21:28,77.19,OnlineShopping,Best Buy,3297.54858
22028,719672283,5-20-24 16:28,335.33,Deposit,Direct Deposit,3632.87858
22029,719672283,5-28-24 15:28,322.19,Deposit,Mobile Deposit,3955.06858
22030,719672283,5-29-24 18:28,186.26,Payment,Loan Payment,3768.80858
22031,719672283,06-03-24 9:28,276.85,Withdrawal,Branch Withdrawal,3491.95858
22032,719672283,06-03-24 10:28,128.57,OnlineShopping,Walmart,3363.38858
22033,719672283,06-03-24 15:28,497.82,Deposit,Cash Deposit,3861.20858
22034,719672283,06-03-24 16:28,525.21,Deposit,Cash Deposit,4386.41858
22035,719672283,06-04-24 21:28,5100,IncomingTransfer,Salary,9486.41858
22036,719672283,06-06-24 9:28,98.34,Return,Walmart Return,9584.75858
22037,719672283,06-07-24 15:28,151.91,Deposit,Check Deposit,9736.66858
22038,719672283,06-09-24 21:28,1700,Payment,Credit Card Payment,8036.66858
22039,719672283,06-10-24 10:28,428.81,IncomingTransfer,Freelance Payment,8465.47858
22040,719672283,06-11-24 21:28,423.27,OutgoingTransfer,Bank Transfer,8042.20858
22041,719672283,6-14-24 15:28,392.81,Deposit,Check Deposit,8435.01858
22042,719672283,6-16-24 20:28,505.97,Withdrawal,Branch Withdrawal,7929.04858
22043,719672283,6-17-24 15:28,347.88,Withdrawal,ATM Withdrawal,7581.16858
22044,719672283,6-18-24 21:28,1300,Payment,Rent Payment,6281.16858
22045,719672283,6-18-24 23:28,384.72,Deposit,Cash Deposit,6665.88858
22046,719672283,6-22-24 13:28,490.56,Withdrawal,ATM Withdrawal,6175.32858
22047,719672283,6-25-24 18:28,73.77,Purchase,Entertainment,6101.55858
22048,719672283,6-25-24 21:28,526.96,IncomingTransfer,Freelance Payment,6628.51858
22049,719672283,6-28-24 15:28,506.23,Deposit,Direct Deposit,7134.74858
22050,719672283,6-29-24 22:28,327.32,OnlineShopping,Best Buy,6807.42858
22051,719672283,6-30-24 10:28,547.31,Payment,Bill Payment,6260.11858
22052,719672283,07-02-24 16:28,95.01,Purchase,Home Improvement,6165.10858
22053,719672283,07-03-24 21:28,5100,IncomingTransfer,Salary,11265.10858
22054,719672283,07-07-24 18:28,84.16,Deposit,Direct Deposit,11349.26858
22055,719672283,07-08-24 14:28,369.92,Withdrawal,Branch Withdrawal,10979.34858
22056,719672283,07-08-24 21:28,1800,Payment,Credit Card Payment,9179.34858
22057,719672283,07-10-24 14:28,136.88,OutgoingTransfer,Peer-to-Peer Transfer,9042.46858
22058,719672283,7-13-24 11:28,380.87,IncomingTransfer,Freelance Payment,9423.33858
22059,719672283,7-17-24 21:28,3200,Payment,Rent Payment,6223.33858
22060,719887008,1-20-24 12:28,210.61,Return,AliExpress Return,1054.492218
22061,719887008,1-24-24 9:28,185.9,OnlineShopping,Amazon,868.5922176
22062,719887008,1-28-24 16:28,180.25,OnlineShopping,AliExpress,688.3422176
22063,719887008,1-29-24 10:28,84.93,Return,Walmart Return,773.2722176
22064,719887008,02-01-24 9:28,235.77,OnlineShopping,Etsy,537.5022176
22065,719887008,02-02-24 17:28,153.22,Withdrawal,ATM Withdrawal,384.2822176
22066,719887008,02-05-24 21:28,3050,IncomingTransfer,Salary,3434.282218
22067,719887008,02-10-24 13:28,133.07,OnlineShopping,Best Buy,3301.212218
22068,719887008,02-10-24 21:28,1500,Payment,Credit Card Payment,1801.212218
22069,719887008,02-12-24 9:28,245.08,Purchase,Electronics,1556.132218
22070,719887008,02-12-24 21:28,1100,Payment,Subscription Payment,456.1322176
22071,719887008,2-14-24 23:28,76.44,Withdrawal,Mobile App Withdrawal,379.6922176
22072,719887008,2-15-24 20:28,108.11,OutgoingTransfer,Bank Transfer,271.5822176
22073,719887008,2-16-24 18:28,242.53,OnlineShopping,Best Buy,29.05221756
22074,719887008,2-16-24 23:28,73.26,Withdrawal,Mobile App Withdrawal,-44.20778244
22075,719887008,2-17-24 19:28,42.66,OutgoingTransfer,Wire Transfer,-86.86778244
22076,719887008,2-21-24 17:28,97.36,Return,Amazon Return,10.49221756
22077,719887008,2-23-24 10:28,186.58,Payment,Loan Payment,-176.0877824
22078,719887008,2-25-24 15:28,50.37,Deposit,Cash Deposit,-125.7177824
22079,719887008,03-01-24 11:28,168.21,Purchase,Furniture,-293.9277824
22080,719887008,03-02-24 21:28,3050,IncomingTransfer,Salary,2756.072218
22081,719887008,03-07-24 21:28,1500,Payment,Credit Card Payment,1256.072218
22082,719887008,03-08-24 16:28,65.05,Deposit,Mobile Deposit,1321.122218
22083,719887008,03-09-24 14:28,244.33,Return,eBay Return,1565.452218
22084,719887008,03-09-24 21:28,81.79,OutgoingTransfer,International Transfer,1483.662218
22085,719887008,03-10-24 15:28,120,Purchase,Entertainment,1363.662218
22086,719887008,03-11-24 17:28,231.76,Payment,Loan Payment,1131.902218
22087,719887008,3-15-24 21:28,1000,Payment,Subscription Payment,131.9022176
22088,719887008,3-16-24 15:28,43.98,Withdrawal,Mobile App Withdrawal,87.92221756
22089,719887008,3-18-24 14:28,126.1,Purchase,Travel,-38.17778244
22090,719887008,3-18-24 16:28,242.39,Payment,Bill Payment,-280.5677824
22091,719887008,3-19-24 22:28,203.77,Withdrawal,Mobile App Withdrawal,-484.3377824
22092,719887008,3-22-24 14:28,176.49,Return,Etsy Return,-307.8477824
22093,719887008,3-22-24 21:28,111.94,Deposit,Direct Deposit,-195.9077824
22094,719887008,3-27-24 11:28,193.47,Return,Target Return,-2.437782443
22095,719887008,3-27-24 11:28,23.43,Return,Etsy Return,20.99221756
22096,719887008,3-29-24 22:28,84.81,Withdrawal,Mobile App Withdrawal,-63.81778244
22097,719887008,04-01-24 16:28,60.08,Payment,Mortgage Payment,-123.8977824
22098,719887008,04-05-24 21:28,3050,IncomingTransfer,Salary,2926.102218
22099,719887008,04-07-24 17:28,199.5,Return,Etsy Return,3125.602218
22100,719887008,04-08-24 19:28,139.4,OnlineShopping,eBay,2986.202218
22101,719887008,04-09-24 18:28,13.85,OnlineShopping,Best Buy,2972.352218
22102,719887008,04-09-24 19:28,211.01,Deposit,Check Deposit,3183.362218
22103,719887008,04-10-24 21:28,1700,Payment,Credit Card Payment,1483.362218
22104,719887008,04-11-24 15:28,248.09,Deposit,Direct Deposit,1731.452218
22105,719887008,04-12-24 15:28,53.72,Payment,Loan Payment,1677.732218
22106,719887008,4-14-24 18:28,124.41,Deposit,Check Deposit,1802.142218
22107,719887008,4-16-24 19:28,146.17,IncomingTransfer,Freelance Payment,1948.312218
22108,719887008,4-16-24 21:28,1300,Payment,Installment Payment,648.3122176
22109,719887008,4-16-24 21:28,147.8,Purchase,Gas,500.5122176
22110,719887008,4-17-24 15:28,72.93,IncomingTransfer,Freelance Payment,573.4422176
22111,719887008,4-18-24 19:28,167.65,Deposit,Direct Deposit,741.0922176
22112,719887008,4-20-24 16:28,55.7,Purchase,Grocery,685.3922176
22113,719887008,4-20-24 18:28,228.79,Purchase,Pharmacy,456.6022176
22114,719887008,4-22-24 12:28,104.57,Purchase,Electronics,352.0322176
22115,719887008,4-24-24 16:28,20.34,Purchase,Pharmacy,331.6922176
22116,719887008,4-26-24 18:28,218.57,Payment,Bill Payment,113.1222176
22117,719887008,4-27-24 16:28,77.17,Deposit,Check Deposit,190.2922176
22118,719887008,4-29-24 12:28,187.75,Payment,Mortgage Payment,2.542217557
22119,719887008,4-30-24 21:28,18.46,Withdrawal,Branch Withdrawal,-15.91778244
22120,719887008,05-03-24 10:28,84.87,Return,eBay Return,68.95221756
22121,719887008,05-04-24 19:28,176.75,Deposit,Cash Deposit,245.7022176
22122,719887008,05-04-24 21:28,3050,IncomingTransfer,Salary,3295.702218
22123,719887008,05-05-24 16:28,206.55,Purchase,Furniture,3089.152218
22124,719887008,05-09-24 21:28,1400,Payment,Credit Card Payment,1689.152218
22125,719887008,05-10-24 21:28,1100,Payment,Insurance Payment,589.1522176
22126,719887008,5-14-24 21:28,60.15,Purchase,Pharmacy,529.0022176
22127,719887008,5-23-24 17:28,57.4,Deposit,Cash Deposit,586.4022176
22128,719887008,5-30-24 19:28,33.69,Withdrawal,Mobile App Withdrawal,552.7122176
22129,719887008,5-31-24 10:28,18.22,Withdrawal,ATM Withdrawal,534.4922176
22130,719887008,06-01-24 21:28,3050,IncomingTransfer,Salary,3584.492218
22131,719887008,06-06-24 9:28,113.75,Payment,Bill Payment,3470.742218
22132,719887008,06-06-24 21:28,1600,Payment,Credit Card Payment,1870.742218
22133,719887008,06-07-24 13:28,133.67,OnlineShopping,AliExpress,1737.072218
22134,719887008,06-07-24 14:28,217.55,IncomingTransfer,Freelance Payment,1954.622218
22135,719887008,06-08-24 11:28,125.16,Return,Amazon Return,2079.782218
22136,719887008,06-08-24 18:28,107.96,Deposit,Cash Deposit,2187.742218
22137,719887008,06-11-24 21:28,1100,Payment,Subscription Payment,1087.742218
22138,719887008,6-13-24 11:28,177.78,OutgoingTransfer,Bank Transfer,909.9622176
22139,719887008,6-13-24 13:28,55.05,Deposit,Direct Deposit,965.0122176
22140,719887008,6-13-24 22:28,202.14,Payment,Bill Payment,762.8722176
22141,719887008,6-15-24 11:28,243.97,Purchase,Travel,518.9022176
22142,719887008,6-15-24 13:28,231.78,Withdrawal,Branch Withdrawal,287.1222176
22143,719887008,6-15-24 17:28,209.95,IncomingTransfer,Freelance Payment,497.0722176
22144,719887008,6-15-24 20:28,45.25,Return,Walmart Return,542.3222176
22145,719887008,6-17-24 15:28,208.4,Purchase,Travel,333.9222176
22146,719887008,6-22-24 10:28,140.5,IncomingTransfer,Freelance Payment,474.4222176
22147,719887008,6-22-24 17:28,45.05,OutgoingTransfer,Wire Transfer,429.3722176
22148,719887008,6-22-24 19:28,111.12,Payment,Mortgage Payment,318.2522176
22149,719887008,6-26-24 20:28,145.81,Purchase,Entertainment,172.4422176
22150,719887008,6-28-24 10:28,164.69,OutgoingTransfer,International Transfer,7.752217557
22151,719887008,6-28-24 16:28,202.65,OutgoingTransfer,Wire Transfer,-194.8977824
22152,719887008,07-02-24 21:28,3050,IncomingTransfer,Salary,2855.102218
22153,719887008,07-07-24 14:28,67.5,OutgoingTransfer,Bank Transfer,2787.602218
22154,719887008,07-07-24 21:28,1400,Payment,Credit Card Payment,1387.602218
22155,719887008,07-09-24 9:28,123.76,OutgoingTransfer,Wire Transfer,1263.842218
22156,719887008,07-11-24 21:28,184.29,OutgoingTransfer,Peer-to-Peer Transfer,1079.552218
22157,719887008,7-14-24 12:28,74.78,Deposit,Direct Deposit,1154.332218
22158,719887008,7-18-24 21:28,1000,Payment,Installment Payment,154.3322176
22159,719912808,1-22-24 12:28,135.29,Deposit,Cash Deposit,135.29
22160,719912808,1-23-24 17:28,199.13,Purchase,Electronics,-63.84
22161,719912808,1-25-24 21:28,98.21,IncomingTransfer,Freelance Payment,34.37
22162,719912808,1-27-24 12:28,472.77,Purchase,Clothing,-438.4
22163,719912808,1-27-24 18:28,68.73,Withdrawal,Branch Withdrawal,-507.13
22164,719912808,1-27-24 20:28,391.34,Purchase,Furniture,-898.47
22165,719912808,02-01-24 21:28,6100,IncomingTransfer,Salary,5201.53
22166,719912808,02-01-24 21:28,294.36,Deposit,Mobile Deposit,5495.89
22167,719912808,02-03-24 10:28,133.97,OnlineShopping,Amazon,5361.92
22168,719912808,02-04-24 14:28,441.57,OnlineShopping,Target,4920.35
22169,719912808,02-05-24 21:28,90.5,Deposit,Check Deposit,5010.85
22170,719912808,02-09-24 22:28,525.16,Purchase,Travel,4485.69
22171,719912808,02-10-24 21:28,2200,Payment,Insurance Payment,2285.69
22172,719912808,02-11-24 14:28,106.99,Deposit,Mobile Deposit,2392.68
22173,719912808,2-13-24 20:28,407.73,Purchase,Gas,1984.95
22174,719912808,2-14-24 15:28,117.83,Withdrawal,ATM Withdrawal,1867.12
22175,719912808,2-15-24 17:28,447.96,Withdrawal,Branch Withdrawal,1419.16
22176,719912808,2-17-24 16:28,443.16,Return,Target Return,1862.32
22177,719912808,2-19-24 19:28,327.31,IncomingTransfer,Freelance Payment,2189.63
22178,719912808,2-22-24 15:28,60.28,Withdrawal,Mobile App Withdrawal,2129.35
22179,719912808,2-22-24 19:28,363.9,Purchase,Pharmacy,1765.45
22180,719912808,2-26-24 10:28,231.76,Return,eBay Return,1997.21
22181,719912808,2-27-24 13:28,111.96,Return,Best Buy Return,2109.17
22182,719912808,03-03-24 11:28,254.93,Return,Walmart Return,2364.1
22183,719912808,03-04-24 10:28,430.62,Payment,Loan Payment,1933.48
22184,719912808,03-04-24 21:28,529.29,Withdrawal,ATM Withdrawal,1404.19
22185,719912808,03-05-24 21:28,6100,IncomingTransfer,Salary,7504.19
22186,719912808,03-08-24 18:28,136.11,Deposit,Direct Deposit,7640.3
22187,719912808,03-08-24 20:28,152.49,Withdrawal,Branch Withdrawal,7487.81
22188,719912808,03-09-24 19:28,231.14,Payment,Loan Payment,7256.67
22189,719912808,03-10-24 12:28,377.24,Withdrawal,Mobile App Withdrawal,6879.43
22190,719912808,03-10-24 15:28,90.43,Withdrawal,Branch Withdrawal,6789
22191,719912808,3-17-24 15:28,308.02,Payment,Bill Payment,6480.98
22192,719912808,3-17-24 21:28,2600,Payment,Subscription Payment,3880.98
22193,719912808,3-18-24 12:28,97.38,OutgoingTransfer,Bank Transfer,3783.6
22194,719912808,3-18-24 17:28,210.72,Withdrawal,Mobile App Withdrawal,3572.88
22195,719912808,04-04-24 21:28,6100,IncomingTransfer,Salary,9672.88
22196,719912808,04-06-24 19:28,285.74,Purchase,Restaurant,9387.14
22197,719912808,04-06-24 21:28,61.52,Deposit,Check Deposit,9448.66
22198,719912808,04-11-24 19:28,487.02,Purchase,Grocery,8961.64
22199,719912808,04-11-24 22:28,56.86,Deposit,Cash Deposit,9018.5
22200,719912808,04-12-24 19:28,399.77,Deposit,Direct Deposit,9418.27
22201,719912808,4-13-24 10:28,230.21,Payment,Mortgage Payment,9188.06
22202,719912808,4-13-24 11:28,361.59,Withdrawal,Mobile App Withdrawal,8826.47
22203,719912808,4-13-24 13:28,450.45,Purchase,Clothing,8376.02
22204,719912808,4-14-24 21:28,2600,Payment,Insurance Payment,5776.02
22205,719912808,4-18-24 9:28,122.22,Return,eBay Return,5898.24
22206,719912808,4-24-24 21:28,367.41,Deposit,Cash Deposit,6265.65
22207,719912808,4-27-24 12:28,201.83,Purchase,Clothing,6063.82
22208,719912808,4-27-24 19:28,421.35,Purchase,Entertainment,5642.47
22209,719912808,05-02-24 15:28,446.53,Purchase,Electronics,5195.94
22210,719912808,05-04-24 13:28,195.35,Payment,Mortgage Payment,5000.59
22211,719912808,05-04-24 20:28,485.61,Payment,Mortgage Payment,4514.98
22212,719912808,05-05-24 10:28,158.54,Payment,Bill Payment,4356.44
22213,719912808,05-05-24 21:28,6100,IncomingTransfer,Salary,10456.44
22214,719912808,05-11-24 21:28,1900,Payment,Subscription Payment,8556.44
22215,719912808,05-12-24 11:28,102,Return,Walmart Return,8658.44
22216,719912808,5-13-24 17:28,506.87,Withdrawal,ATM Withdrawal,8151.57
22217,719912808,5-22-24 15:28,390.12,Deposit,Check Deposit,8541.69
22218,719912808,5-22-24 18:28,461.11,Purchase,Clothing,8080.58
22219,719912808,5-22-24 23:28,289.43,Purchase,Home Improvement,7791.15
22220,719912808,5-23-24 9:28,371.16,OnlineShopping,eBay,7419.99
22221,719912808,5-24-24 12:28,485.53,Deposit,Cash Deposit,7905.52
22222,719912808,5-31-24 18:28,233.48,Deposit,Mobile Deposit,8139
22223,719912808,06-01-24 21:28,6100,IncomingTransfer,Salary,14239
22224,719912808,06-03-24 14:28,501.38,Deposit,Check Deposit,14740.38
22225,719912808,06-04-24 9:28,231.64,OnlineShopping,AliExpress,14508.74
22226,719912808,06-09-24 22:28,170.28,OutgoingTransfer,Peer-to-Peer Transfer,14338.46
22227,719912808,06-09-24 22:28,350.97,Withdrawal,Branch Withdrawal,13987.49
22228,719912808,06-11-24 21:28,410.55,OutgoingTransfer,Bank Transfer,13576.94
22229,719912808,6-16-24 21:28,1900,Payment,Subscription Payment,11676.94
22230,719912808,6-18-24 11:28,400.12,Withdrawal,Mobile App Withdrawal,11276.82
22231,719912808,6-24-24 18:28,511.37,Purchase,Travel,10765.45
22232,719912808,6-25-24 13:28,531.03,Payment,Mortgage Payment,10234.42
22233,719912808,6-28-24 23:28,517.86,Payment,Bill Payment,9716.56
22234,719912808,6-30-24 19:28,123.58,Deposit,Cash Deposit,9840.14
22235,719912808,07-04-24 21:28,6100,IncomingTransfer,Salary,15940.14
22236,719912808,07-05-24 19:28,196.97,IncomingTransfer,Freelance Payment,16137.11
22237,719912808,07-07-24 11:28,218.77,Return,Target Return,16355.88
22238,719912808,07-10-24 12:28,99.62,Withdrawal,ATM Withdrawal,16256.26
22239,719912808,07-11-24 16:28,57.41,Deposit,Direct Deposit,16313.67
22240,719912808,07-12-24 21:28,1700,Payment,Insurance Payment,14613.67
22241,719912808,7-13-24 19:28,383.89,Withdrawal,Mobile App Withdrawal,14229.78
22242,719912808,7-16-24 13:28,327.09,Purchase,Electronics,13902.69
22243,719918358,1-20-24 21:28,113.14,Purchase,Clothing,1147.196904
22244,719918358,1-26-24 13:28,89.08,OnlineShopping,Walmart,1058.116904
22245,719918358,1-27-24 18:28,169.48,Deposit,Check Deposit,1227.596904
22246,719918358,1-28-24 16:28,169.01,Purchase,Grocery,1058.586904
22247,719918358,1-28-24 20:28,33.83,Purchase,Restaurant,1024.756904
22248,719918358,1-30-24 12:28,220.44,Return,Walmart Return,1245.196904
22249,719918358,1-30-24 17:28,73.01,Payment,Loan Payment,1172.186904
22250,719918358,1-31-24 23:28,192,Deposit,Check Deposit,1364.186904
22251,719918358,02-02-24 17:28,79.15,Deposit,Mobile Deposit,1443.336904
22252,719918358,02-02-24 21:28,2550,IncomingTransfer,Salary,3993.336904
22253,719918358,02-03-24 20:28,114.1,IncomingTransfer,Freelance Payment,4107.436904
22254,719918358,02-05-24 23:28,63.05,IncomingTransfer,Freelance Payment,4170.486904
22255,719918358,02-06-24 10:28,194.95,Deposit,Check Deposit,4365.436904
22256,719918358,02-07-24 11:28,144.57,Payment,Bill Payment,4220.866904
22257,719918358,02-07-24 14:28,10.97,OnlineShopping,eBay,4209.896904
22258,719918358,02-07-24 21:28,3600,Payment,Credit Card Payment,609.8969045
22259,719918358,02-10-24 10:28,44.94,OutgoingTransfer,Bank Transfer,564.9569045
22260,719918358,02-10-24 21:28,124.74,Deposit,Cash Deposit,689.6969045
22261,719918358,02-12-24 11:28,57.84,OutgoingTransfer,International Transfer,631.8569045
22262,719918358,2-15-24 11:28,135.17,OnlineShopping,Amazon,496.6869045
22263,719918358,2-16-24 21:28,1600,Payment,Rent Payment,-1103.313096
22264,719918358,2-17-24 22:28,36.7,Deposit,Mobile Deposit,-1066.613096
22265,719918358,2-20-24 14:28,225.38,OnlineShopping,Walmart,-1291.993096
22266,719918358,2-23-24 14:28,133.23,OutgoingTransfer,Wire Transfer,-1425.223096
22267,719918358,2-23-24 20:28,201.31,OnlineShopping,Amazon,-1626.533096
22268,719918358,2-25-24 12:28,160.31,IncomingTransfer,Freelance Payment,-1466.223096
22269,719918358,2-26-24 14:28,19.28,Purchase,Furniture,-1485.503096
22270,719918358,2-27-24 21:28,98.72,Payment,Bill Payment,-1584.223096
22271,719918358,2-29-24 22:28,77.53,IncomingTransfer,Freelance Payment,-1506.693096
22272,719918358,03-01-24 9:28,205.53,Payment,Loan Payment,-1712.223096
22273,719918358,03-01-24 11:28,178.41,Deposit,Direct Deposit,-1533.813096
22274,719918358,03-01-24 14:28,36.23,Purchase,Restaurant,-1570.043096
22275,719918358,03-01-24 17:28,100.44,OnlineShopping,Best Buy,-1670.483096
22276,719918358,03-01-24 18:28,141.12,Withdrawal,Branch Withdrawal,-1811.603096
22277,719918358,03-04-24 21:28,2550,IncomingTransfer,Salary,738.3969045
22278,719918358,03-04-24 21:28,135.08,Payment,Mortgage Payment,603.3169045
22279,719918358,03-06-24 12:28,191.31,OutgoingTransfer,Peer-to-Peer Transfer,412.0069045
22280,719918358,03-06-24 15:28,244.31,Withdrawal,ATM Withdrawal,167.6969045
22281,719918358,03-08-24 15:28,177.04,Purchase,Gas,-9.343095521
22282,719918358,03-09-24 21:28,3700,Payment,Credit Card Payment,-3709.343096
22283,719918358,03-11-24 14:28,65.74,Return,eBay Return,-3643.603096
22284,719918358,03-11-24 17:28,27.7,Return,Etsy Return,-3615.903096
22285,719918358,3-13-24 18:28,130.89,Payment,Loan Payment,-3746.793096
22286,719918358,3-14-24 11:28,203.63,Deposit,Direct Deposit,-3543.163096
22287,719918358,3-14-24 18:28,66.91,Deposit,Cash Deposit,-3476.253096
22288,719918358,3-18-24 13:28,45.72,Deposit,Check Deposit,-3430.533096
22289,719918358,3-18-24 21:28,1200,Payment,Rent Payment,-4630.533096
22290,719918358,3-19-24 20:28,147.4,OnlineShopping,Best Buy,-4777.933096
22291,719918358,3-20-24 18:28,64.47,IncomingTransfer,Freelance Payment,-4713.463096
22292,719918358,3-23-24 17:28,159.21,Return,Store Return,-4554.253096
22293,719918358,3-23-24 21:28,203.83,Deposit,Direct Deposit,-4350.423096
22294,719918358,3-30-24 15:28,110.66,OnlineShopping,Etsy,-4461.083096
22295,719918358,04-04-24 16:28,122.57,OutgoingTransfer,International Transfer,-4583.653096
22296,719918358,04-04-24 21:28,2550,IncomingTransfer,Salary,-2033.653096
22297,719918358,04-04-24 23:28,194.36,Deposit,Check Deposit,-1839.293096
22298,719918358,04-07-24 18:28,236.03,OutgoingTransfer,Bank Transfer,-2075.323096
22299,719918358,04-08-24 23:28,38.37,OutgoingTransfer,International Transfer,-2113.693096
22300,719918358,04-09-24 21:28,3500,Payment,Credit Card Payment,-5613.693096
22301,719918358,04-10-24 15:28,115.13,OutgoingTransfer,Peer-to-Peer Transfer,-5728.823096
22302,719918358,04-12-24 23:28,194.55,OnlineShopping,Walmart,-5923.373096
22303,719918358,4-13-24 19:28,132.47,Purchase,Gas,-6055.843096
22304,719918358,4-15-24 14:28,58.08,Withdrawal,Branch Withdrawal,-6113.923096
22305,719918358,4-17-24 21:28,1500,Payment,Rent Payment,-7613.923096
22306,719918358,4-20-24 15:28,145.94,IncomingTransfer,Freelance Payment,-7467.983096
22307,719918358,4-22-24 19:28,228.35,Purchase,Clothing,-7696.333096
22308,719918358,4-27-24 19:28,123.67,Payment,Mortgage Payment,-7820.003096
22309,719918358,4-28-24 22:28,99.55,Deposit,Check Deposit,-7720.453096
22310,719918358,05-01-24 16:28,180.52,OnlineShopping,Etsy,-7900.973096
22311,719918358,05-01-24 21:28,2550,IncomingTransfer,Salary,-5350.973096
22312,719918358,05-02-24 11:28,109.79,Return,AliExpress Return,-5241.183096
22313,719918358,05-02-24 12:28,193.28,Purchase,Entertainment,-5434.463096
22314,719918358,05-02-24 23:28,53.75,OnlineShopping,eBay,-5488.213096
22315,719918358,05-03-24 18:28,38.52,Deposit,Check Deposit,-5449.693096
22316,719918358,05-05-24 18:28,46.29,Payment,Loan Payment,-5495.983096
22317,719918358,05-06-24 21:28,2600,Payment,Credit Card Payment,-8095.983096
22318,719918358,05-09-24 16:28,229.01,OnlineShopping,Amazon,-8324.993096
22319,719918358,05-09-24 20:28,115.3,Withdrawal,Branch Withdrawal,-8440.293096
22320,719918358,5-13-24 11:28,217.24,Payment,Bill Payment,-8657.533096
22321,719918358,5-14-24 21:28,1000,Payment,Rent Payment,-9657.533096
22322,719918358,5-14-24 23:28,201.23,Purchase,Restaurant,-9858.763096
22323,719918358,5-18-24 10:28,242.86,Purchase,Gas,-10101.6231
22324,719918358,5-20-24 15:28,159.87,Payment,Loan Payment,-10261.4931
22325,719918358,5-20-24 21:28,48.76,Deposit,Cash Deposit,-10212.7331
22326,719918358,5-22-24 17:28,42.35,Return,Etsy Return,-10170.3831
22327,719918358,5-27-24 17:28,182.29,Deposit,Check Deposit,-9988.093096
22328,719918358,5-27-24 20:28,32.32,OutgoingTransfer,Bank Transfer,-10020.4131
22329,719918358,5-28-24 15:28,71.87,IncomingTransfer,Freelance Payment,-9948.543096
22330,719918358,5-29-24 13:28,134.77,Deposit,Check Deposit,-9813.773096
22331,719918358,5-30-24 21:28,121.14,Payment,Mortgage Payment,-9934.913096
22332,719918358,5-31-24 18:28,74.85,IncomingTransfer,Freelance Payment,-9860.063096
22333,719918358,06-01-24 21:28,2550,IncomingTransfer,Salary,-7310.063096
22334,719918358,06-03-24 22:28,62.39,Return,Walmart Return,-7247.673096
22335,719918358,06-06-24 21:28,2800,Payment,Credit Card Payment,-10047.6731
22336,719918358,06-08-24 10:28,227.98,Return,Amazon Return,-9819.693096
22337,719918358,06-09-24 22:28,25.94,OutgoingTransfer,Wire Transfer,-9845.633096
22338,719918358,06-10-24 21:28,142.74,Deposit,Direct Deposit,-9702.893096
22339,719918358,06-11-24 15:28,164.01,OnlineShopping,eBay,-9866.903096
22340,719918358,6-14-24 12:28,230.35,OutgoingTransfer,International Transfer,-10097.2531
22341,719918358,6-15-24 21:28,1100,Payment,Rent Payment,-11197.2531
22342,719918358,6-16-24 10:28,27.63,IncomingTransfer,Freelance Payment,-11169.6231
22343,719918358,6-19-24 11:28,130.53,Payment,Loan Payment,-11300.1531
22344,719918358,6-21-24 20:28,137.37,Purchase,Gas,-11437.5231
22345,719918358,6-23-24 12:28,218.11,Purchase,Furniture,-11655.6331
22346,719918358,07-04-24 23:28,30,Deposit,Check Deposit,-11625.6331
22347,719918358,07-05-24 21:28,2550,IncomingTransfer,Salary,-9075.633096
22348,719918358,07-10-24 21:28,3000,Payment,Credit Card Payment,-12075.6331
22349,719918358,7-18-24 21:28,1200,Payment,Rent Payment,-13275.6331
22350,720001758,1-21-24 15:28,119.17,OnlineShopping,Target,913.453335
22351,720001758,1-23-24 10:28,240.3,Withdrawal,ATM Withdrawal,673.153335
22352,720001758,1-23-24 11:28,38.49,OutgoingTransfer,Bank Transfer,634.663335
22353,720001758,1-24-24 9:28,63.78,OnlineShopping,Walmart,570.883335
22354,720001758,1-24-24 14:28,61.98,Payment,Loan Payment,508.903335
22355,720001758,02-01-24 16:28,165.44,OutgoingTransfer,Wire Transfer,343.463335
22356,720001758,02-01-24 19:28,108.35,Purchase,Travel,235.113335
22357,720001758,02-01-24 20:28,168.91,Deposit,Cash Deposit,404.023335
22358,720001758,02-03-24 21:28,2150,IncomingTransfer,Salary,2554.023335
22359,720001758,02-05-24 9:28,219.26,Deposit,Direct Deposit,2773.283335
22360,720001758,02-05-24 15:28,243.25,Withdrawal,Branch Withdrawal,2530.033335
22361,720001758,02-07-24 20:28,79.71,Deposit,Mobile Deposit,2609.743335
22362,720001758,02-08-24 21:28,1200,Payment,Credit Card Payment,1409.743335
22363,720001758,02-10-24 22:28,51.02,Deposit,Cash Deposit,1460.763335
22364,720001758,2-13-24 12:28,30.58,Deposit,Check Deposit,1491.343335
22365,720001758,2-15-24 12:28,146.6,Deposit,Check Deposit,1637.943335
22366,720001758,2-17-24 13:28,98.95,Return,eBay Return,1736.893335
22367,720001758,2-18-24 21:28,1000,Payment,Rent Payment,736.893335
22368,720001758,2-19-24 19:28,18.48,Payment,Loan Payment,718.413335
22369,720001758,2-19-24 19:28,121.58,OnlineShopping,Amazon,596.833335
22370,720001758,2-24-24 21:28,13.56,Deposit,Direct Deposit,610.393335
22371,720001758,2-26-24 14:28,36.28,Purchase,Travel,574.113335
22372,720001758,2-29-24 22:28,170.52,IncomingTransfer,Freelance Payment,744.633335
22373,720001758,2-29-24 22:28,53.08,Purchase,Restaurant,691.553335
22374,720001758,03-01-24 21:28,2150,IncomingTransfer,Salary,2841.553335
22375,720001758,03-02-24 10:28,227.95,Withdrawal,Mobile App Withdrawal,2613.603335
22376,720001758,03-02-24 20:28,197.03,Payment,Mortgage Payment,2416.573335
22377,720001758,03-03-24 14:28,239.48,Deposit,Cash Deposit,2656.053335
22378,720001758,03-06-24 12:28,193.57,Return,Best Buy Return,2849.623335
22379,720001758,03-06-24 21:28,1600,Payment,Credit Card Payment,1249.623335
22380,720001758,03-07-24 15:28,227.29,Payment,Loan Payment,1022.333335
22381,720001758,03-07-24 22:28,94.8,Withdrawal,Branch Withdrawal,927.533335
22382,720001758,03-10-24 15:28,197.95,Withdrawal,Branch Withdrawal,729.583335
22383,720001758,03-12-24 17:28,131.3,Deposit,Cash Deposit,860.883335
22384,720001758,3-14-24 23:28,75.85,Deposit,Mobile Deposit,936.733335
22385,720001758,3-15-24 15:28,215.55,OnlineShopping,Walmart,721.183335
22386,720001758,3-17-24 11:28,248.44,Purchase,Home Improvement,472.743335
22387,720001758,3-17-24 21:28,1100,Payment,Rent Payment,-627.256665
22388,720001758,3-18-24 23:28,191.48,Withdrawal,Mobile App Withdrawal,-818.736665
22389,720001758,3-24-24 19:28,191.62,OnlineShopping,AliExpress,-1010.356665
22390,720001758,3-25-24 12:28,40.79,Purchase,Home Improvement,-1051.146665
22391,720001758,3-26-24 12:28,130.9,OutgoingTransfer,Wire Transfer,-1182.046665
22392,720001758,3-28-24 17:28,145.73,OnlineShopping,Amazon,-1327.776665
22393,720001758,3-28-24 21:28,176.75,Deposit,Check Deposit,-1151.026665
22394,720001758,3-29-24 12:28,181.12,Purchase,Electronics,-1332.146665
22395,720001758,3-29-24 19:28,245.6,OnlineShopping,Best Buy,-1577.746665
22396,720001758,3-30-24 21:28,197.66,Withdrawal,ATM Withdrawal,-1775.406665
22397,720001758,3-31-24 10:28,125.01,Deposit,Check Deposit,-1650.396665
22398,720001758,04-01-24 21:28,2150,IncomingTransfer,Salary,499.603335
22399,720001758,04-03-24 17:28,172.18,Payment,Bill Payment,327.423335
22400,720001758,04-03-24 18:28,229.72,Purchase,Gas,97.70333499
22401,720001758,04-04-24 19:28,42.39,Purchase,Entertainment,55.31333499
22402,720001758,04-05-24 16:28,122.52,Deposit,Check Deposit,177.833335
22403,720001758,04-05-24 17:28,137.84,Purchase,Grocery,39.99333499
22404,720001758,04-06-24 21:28,1800,Payment,Credit Card Payment,-1760.006665
22405,720001758,04-10-24 15:28,144.27,Purchase,Electronics,-1904.276665
22406,720001758,04-10-24 16:28,73.16,Deposit,Cash Deposit,-1831.116665
22407,720001758,04-10-24 21:28,1300,Payment,Rent Payment,-3131.116665
22408,720001758,04-11-24 21:28,78.3,Return,Best Buy Return,-3052.816665
22409,720001758,04-11-24 23:28,173.04,Purchase,Gas,-3225.856665
22410,720001758,4-14-24 10:28,220.57,Deposit,Check Deposit,-3005.286665
22411,720001758,4-16-24 17:28,62.86,IncomingTransfer,Freelance Payment,-2942.426665
22412,720001758,4-21-24 10:28,239.76,Payment,Loan Payment,-3182.186665
22413,720001758,4-23-24 14:28,107.43,Purchase,Clothing,-3289.616665
22414,720001758,4-26-24 20:28,187.6,OnlineShopping,AliExpress,-3477.216665
22415,720001758,4-27-24 14:28,96.08,Purchase,Home Improvement,-3573.296665
22416,720001758,4-27-24 15:28,169.53,Deposit,Cash Deposit,-3403.766665
22417,720001758,4-28-24 22:28,204.4,Withdrawal,Mobile App Withdrawal,-3608.166665
22418,720001758,4-29-24 11:28,80.25,Purchase,Clothing,-3688.416665
22419,720001758,4-30-24 20:28,75.95,Purchase,Gas,-3764.366665
22420,720001758,4-30-24 20:28,60.66,Deposit,Check Deposit,-3703.706665
22421,720001758,05-01-24 23:28,49.91,Deposit,Cash Deposit,-3653.796665
22422,720001758,05-02-24 17:28,77.07,Purchase,Electronics,-3730.866665
22423,720001758,05-03-24 21:28,2150,IncomingTransfer,Salary,-1580.866665
22424,720001758,05-08-24 21:28,1700,Payment,Credit Card Payment,-3280.866665
22425,720001758,05-12-24 20:28,227.72,OutgoingTransfer,Peer-to-Peer Transfer,-3508.586665
22426,720001758,05-12-24 21:28,1100,Payment,Rent Payment,-4608.586665
22427,720001758,5-16-24 20:28,150.66,Return,Store Return,-4457.926665
22428,720001758,5-18-24 10:28,49.69,Purchase,Travel,-4507.616665
22429,720001758,5-26-24 13:28,96.65,OutgoingTransfer,Wire Transfer,-4604.266665
22430,720001758,06-02-24 21:28,2150,IncomingTransfer,Salary,-2454.266665
22431,720001758,06-04-24 21:28,98.79,Return,eBay Return,-2355.476665
22432,720001758,06-05-24 22:28,51.91,Purchase,Travel,-2407.386665
22433,720001758,06-07-24 21:28,1700,Payment,Credit Card Payment,-4107.386665
22434,720001758,06-08-24 18:28,146.89,Purchase,Clothing,-4254.276665
22435,720001758,06-10-24 23:28,219.74,Payment,Loan Payment,-4474.016665
22436,720001758,06-11-24 21:28,1000,Payment,Rent Payment,-5474.016665
22437,720001758,6-14-24 17:28,53.84,Purchase,Furniture,-5527.856665
22438,720001758,6-14-24 21:28,11.18,Return,AliExpress Return,-5516.676665
22439,720001758,6-17-24 17:28,96.32,Return,Walmart Return,-5420.356665
22440,720001758,6-18-24 12:28,120.78,Return,AliExpress Return,-5299.576665
22441,720001758,6-18-24 16:28,72.88,Withdrawal,ATM Withdrawal,-5372.456665
22442,720001758,6-19-24 15:28,201.54,Withdrawal,Branch Withdrawal,-5573.996665
22443,720001758,6-19-24 22:28,249.5,Payment,Mortgage Payment,-5823.496665
22444,720001758,6-20-24 22:28,195.02,Return,Store Return,-5628.476665
22445,720001758,6-21-24 9:28,155.7,OnlineShopping,Best Buy,-5784.176665
22446,720001758,6-24-24 19:28,225.4,Return,AliExpress Return,-5558.776665
22447,720001758,6-27-24 11:28,238.28,Return,Target Return,-5320.496665
22448,720001758,6-27-24 13:28,174.32,Payment,Bill Payment,-5494.816665
22449,720001758,6-27-24 17:28,218.73,Deposit,Cash Deposit,-5276.086665
22450,720001758,07-03-24 21:28,2150,IncomingTransfer,Salary,-3126.086665
22451,720001758,07-05-24 14:28,174.27,Payment,Loan Payment,-3300.356665
22452,720001758,07-05-24 23:28,35.18,Payment,Bill Payment,-3335.536665
22453,720001758,07-06-24 17:28,174.74,IncomingTransfer,Freelance Payment,-3160.796665
22454,720001758,07-06-24 18:28,97.84,OnlineShopping,AliExpress,-3258.636665
22455,720001758,07-07-24 19:28,204.78,OutgoingTransfer,Wire Transfer,-3463.416665
22456,720001758,07-08-24 21:28,1800,Payment,Credit Card Payment,-5263.416665
22457,720001758,07-12-24 17:28,121.26,Purchase,Gas,-5384.676665
22458,720001758,7-13-24 16:28,89.28,Deposit,Mobile Deposit,-5295.396665
22459,720001758,7-15-24 21:28,1300,Payment,Rent Payment,-6595.396665
22460,720001758,7-17-24 12:28,26.37,OnlineShopping,eBay,-6621.766665
22461,720001758,7-17-24 14:28,19.65,OnlineShopping,Walmart,-6641.416665
22462,720031908,1-20-24 22:28,525.63,Deposit,Check Deposit,525.63
22463,720031908,1-22-24 18:28,258.22,Deposit,Direct Deposit,783.85
22464,720031908,1-22-24 23:28,72.37,OutgoingTransfer,Bank Transfer,711.48
22465,720031908,1-28-24 13:28,230.68,OutgoingTransfer,Wire Transfer,480.8
22466,720031908,1-28-24 18:28,452.14,OutgoingTransfer,International Transfer,28.66
22467,720031908,02-01-24 17:28,314.93,Purchase,Home Improvement,-286.27
22468,720031908,02-03-24 21:28,5000,IncomingTransfer,Salary,4713.73
22469,720031908,02-07-24 16:28,350.6,Withdrawal,Mobile App Withdrawal,4363.13
22470,720031908,02-08-24 11:28,334.36,Withdrawal,Mobile App Withdrawal,4028.77
22471,720031908,02-09-24 10:28,136.93,Payment,Bill Payment,3891.84
22472,720031908,02-09-24 13:28,321.42,Return,Best Buy Return,4213.26
22473,720031908,02-11-24 21:28,1600,Payment,Insurance Payment,2613.26
22474,720031908,2-13-24 21:28,61.63,Deposit,Mobile Deposit,2674.89
22475,720031908,2-15-24 13:28,541.7,Deposit,Mobile Deposit,3216.59
22476,720031908,2-15-24 23:28,483.84,OnlineShopping,AliExpress,2732.75
22477,720031908,2-18-24 14:28,429.71,Purchase,Restaurant,2303.04
22478,720031908,2-18-24 16:28,144.07,OutgoingTransfer,Bank Transfer,2158.97
22479,720031908,2-19-24 10:28,493.55,Withdrawal,Mobile App Withdrawal,1665.42
22480,720031908,2-19-24 17:28,109.51,Withdrawal,Branch Withdrawal,1555.91
22481,720031908,2-21-24 21:28,216.84,OutgoingTransfer,International Transfer,1339.07
22482,720031908,2-22-24 13:28,106.52,Deposit,Direct Deposit,1445.59
22483,720031908,2-28-24 11:28,503.19,Purchase,Gas,942.4
22484,720031908,2-28-24 18:28,498.71,Purchase,Home Improvement,443.69
22485,720031908,2-29-24 11:28,316.61,Purchase,Electronics,127.08
22486,720031908,2-29-24 20:28,125.65,Deposit,Check Deposit,252.73
22487,720031908,03-03-24 10:28,74.64,Deposit,Cash Deposit,327.37
22488,720031908,03-03-24 20:28,398.77,Payment,Mortgage Payment,-71.4
22489,720031908,03-04-24 20:28,132.73,OutgoingTransfer,Peer-to-Peer Transfer,-204.13
22490,720031908,03-04-24 21:28,5000,IncomingTransfer,Salary,4795.87
22491,720031908,03-12-24 21:28,1800,Payment,Subscription Payment,2995.87
22492,720031908,3-15-24 12:28,384.67,Withdrawal,Mobile App Withdrawal,2611.2
22493,720031908,3-22-24 21:28,414.04,Return,Best Buy Return,3025.24
22494,720031908,3-24-24 13:28,466.09,OutgoingTransfer,Wire Transfer,2559.15
22495,720031908,3-24-24 15:28,154.21,Purchase,Pharmacy,2404.94
22496,720031908,3-25-24 22:28,59.11,Deposit,Mobile Deposit,2464.05
22497,720031908,3-29-24 11:28,475.43,Deposit,Direct Deposit,2939.48
22498,720031908,04-01-24 19:28,330.28,Deposit,Mobile Deposit,3269.76
22499,720031908,04-02-24 17:28,447.37,Deposit,Check Deposit,3717.13
22500,720031908,04-04-24 10:28,183.02,Withdrawal,Branch Withdrawal,3534.11
22501,720031908,04-04-24 15:28,71.19,Deposit,Direct Deposit,3605.3
22502,720031908,04-04-24 21:28,5000,IncomingTransfer,Salary,8605.3
22503,720031908,04-10-24 22:28,488.01,Withdrawal,Mobile App Withdrawal,8117.29
22504,720031908,4-14-24 20:28,51.76,Deposit,Check Deposit,8169.05
22505,720031908,4-15-24 21:28,2000,Payment,Subscription Payment,6169.05
22506,720031908,4-15-24 22:28,253.98,Deposit,Mobile Deposit,6423.03
22507,720031908,4-16-24 13:28,77.66,OnlineShopping,Best Buy,6345.37
22508,720031908,4-21-24 18:28,232.64,Withdrawal,Mobile App Withdrawal,6112.73
22509,720031908,4-23-24 16:28,291.81,Payment,Mortgage Payment,5820.92
22510,720031908,4-24-24 15:28,419.33,Deposit,Check Deposit,6240.25
22511,720031908,4-25-24 15:28,144.61,Payment,Bill Payment,6095.64
22512,720031908,4-25-24 16:28,219.3,Purchase,Grocery,5876.34
22513,720031908,4-28-24 18:28,310.34,Deposit,Cash Deposit,6186.68
22514,720031908,4-29-24 19:28,436.06,Deposit,Mobile Deposit,6622.74
22515,720031908,05-02-24 16:28,407.61,Withdrawal,ATM Withdrawal,6215.13
22516,720031908,05-05-24 13:28,143.09,Withdrawal,Branch Withdrawal,6072.04
22517,720031908,05-05-24 21:28,5000,IncomingTransfer,Salary,11072.04
22518,720031908,05-08-24 14:28,350.29,IncomingTransfer,Freelance Payment,11422.33
22519,720031908,05-12-24 21:28,1400,Payment,Insurance Payment,10022.33
22520,720031908,5-17-24 10:28,361.94,Purchase,Furniture,9660.39
22521,720031908,5-18-24 12:28,480.27,Purchase,Pharmacy,9180.12
22522,720031908,5-23-24 17:28,190.45,Deposit,Cash Deposit,9370.57
22523,720031908,5-23-24 22:28,302.53,IncomingTransfer,Freelance Payment,9673.1
22524,720031908,5-25-24 18:28,126.59,Payment,Loan Payment,9546.51
22525,720031908,5-30-24 16:28,149.37,Deposit,Mobile Deposit,9695.88
22526,720031908,5-30-24 17:28,432.98,Withdrawal,Branch Withdrawal,9262.9
22527,720031908,5-31-24 20:28,63.71,Deposit,Check Deposit,9326.61
22528,720031908,06-04-24 21:28,5000,IncomingTransfer,Salary,14326.61
22529,720031908,06-05-24 19:28,411.47,Withdrawal,Branch Withdrawal,13915.14
22530,720031908,06-07-24 14:28,294.71,Deposit,Check Deposit,14209.85
22531,720031908,06-07-24 23:28,137.13,Purchase,Entertainment,14072.72
22532,720031908,06-11-24 21:28,121.35,IncomingTransfer,Freelance Payment,14194.07
22533,720031908,6-13-24 21:28,1600,Payment,Insurance Payment,12594.07
22534,720031908,6-15-24 14:28,323.53,Purchase,Travel,12270.54
22535,720031908,6-15-24 16:28,312.04,Purchase,Travel,11958.5
22536,720031908,6-16-24 14:28,300.8,OutgoingTransfer,International Transfer,11657.7
22537,720031908,6-19-24 11:28,255.86,Withdrawal,Branch Withdrawal,11401.84
22538,720031908,6-25-24 10:28,386.78,Deposit,Check Deposit,11788.62
22539,720031908,07-01-24 21:28,5000,IncomingTransfer,Salary,16788.62
22540,720031908,07-04-24 18:28,359.27,Purchase,Clothing,16429.35
22541,720031908,07-04-24 18:28,173.39,Withdrawal,Mobile App Withdrawal,16255.96
22542,720031908,07-08-24 12:28,224.37,Withdrawal,ATM Withdrawal,16031.59
22543,720031908,07-10-24 21:28,532.69,Withdrawal,Branch Withdrawal,15498.9
22544,720031908,07-12-24 10:28,525.3,Deposit,Cash Deposit,16024.2
22545,720031908,7-13-24 18:28,230.74,Purchase,Restaurant,15793.46
22546,720031908,7-16-24 15:28,545,Withdrawal,Branch Withdrawal,15248.46
22547,720031908,7-17-24 21:28,1300,Payment,Subscription Payment,13948.46
22548,720044658,1-21-24 18:28,222.66,Return,Best Buy Return,1317.70073
22549,720044658,1-25-24 12:28,116.7,Purchase,Entertainment,1201.00073
22550,720044658,1-28-24 17:28,445.92,OnlineShopping,Walmart,755.0807304
22551,720044658,02-01-24 11:28,377.71,Deposit,Mobile Deposit,1132.79073
22552,720044658,02-02-24 21:28,5000,IncomingTransfer,Salary,6132.79073
22553,720044658,02-04-24 10:28,439.77,Deposit,Cash Deposit,6572.56073
22554,720044658,02-07-24 21:28,2600,Payment,Credit Card Payment,3972.56073
22555,720044658,02-11-24 21:28,1400,Payment,Insurance Payment,2572.56073
22556,720044658,2-18-24 12:28,75.6,Withdrawal,ATM Withdrawal,2496.96073
22557,720044658,2-27-24 19:28,532.27,OutgoingTransfer,Wire Transfer,1964.69073
22558,720044658,2-28-24 11:28,166.35,Return,Etsy Return,2131.04073
22559,720044658,2-28-24 11:28,185.79,Purchase,Restaurant,1945.25073
22560,720044658,2-28-24 21:28,106.06,OnlineShopping,eBay,1839.19073
22561,720044658,2-29-24 10:28,164.21,Purchase,Travel,1674.98073
22562,720044658,03-03-24 19:28,404.73,Withdrawal,Branch Withdrawal,1270.25073
22563,720044658,03-04-24 21:28,5000,IncomingTransfer,Salary,6270.25073
22564,720044658,03-09-24 21:28,2700,Payment,Credit Card Payment,3570.25073
22565,720044658,03-12-24 17:28,529.54,IncomingTransfer,Freelance Payment,4099.79073
22566,720044658,03-12-24 22:28,233.57,OutgoingTransfer,Peer-to-Peer Transfer,3866.22073
22567,720044658,3-14-24 21:28,1400,Payment,Subscription Payment,2466.22073
22568,720044658,3-19-24 12:28,527.71,OutgoingTransfer,Bank Transfer,1938.51073
22569,720044658,3-24-24 14:28,56.21,OnlineShopping,Best Buy,1882.30073
22570,720044658,3-27-24 11:28,97.07,Deposit,Mobile Deposit,1979.37073
22571,720044658,3-27-24 13:28,425.44,Return,eBay Return,2404.81073
22572,720044658,3-29-24 18:28,154.47,Purchase,Clothing,2250.34073
22573,720044658,3-31-24 11:28,60.34,OnlineShopping,AliExpress,2190.00073
22574,720044658,04-04-24 10:28,478.01,OnlineShopping,Amazon,1711.99073
22575,720044658,04-05-24 21:28,5000,IncomingTransfer,Salary,6711.99073
22576,720044658,04-08-24 23:28,60.45,Payment,Loan Payment,6651.54073
22577,720044658,04-10-24 21:28,2200,Payment,Credit Card Payment,4451.54073
22578,720044658,04-12-24 21:28,1300,Payment,Subscription Payment,3151.54073
22579,720044658,4-13-24 13:28,516.47,Purchase,Travel,2635.07073
22580,720044658,4-24-24 18:28,522.53,Payment,Loan Payment,2112.54073
22581,720044658,4-29-24 13:28,80.79,Deposit,Mobile Deposit,2193.33073
22582,720044658,05-05-24 21:28,5000,IncomingTransfer,Salary,7193.33073
22583,720044658,05-08-24 14:28,439.4,Purchase,Pharmacy,6753.93073
22584,720044658,05-10-24 21:28,2900,Payment,Credit Card Payment,3853.93073
22585,720044658,05-10-24 23:28,176.42,OnlineShopping,Walmart,3677.51073
22586,720044658,5-14-24 21:28,2000,Payment,Subscription Payment,1677.51073
22587,720044658,5-14-24 22:28,223.09,OutgoingTransfer,International Transfer,1454.42073
22588,720044658,5-14-24 23:28,430.93,Deposit,Direct Deposit,1885.35073
22589,720044658,5-15-24 18:28,59.97,Purchase,Travel,1825.38073
22590,720044658,5-19-24 17:28,252.73,Payment,Loan Payment,1572.65073
22591,720044658,5-28-24 18:28,413.29,Return,Target Return,1985.94073
22592,720044658,5-28-24 19:28,161.89,Return,Store Return,2147.83073
22593,720044658,5-29-24 17:28,341.29,IncomingTransfer,Freelance Payment,2489.12073
22594,720044658,5-31-24 21:28,224.21,Purchase,Furniture,2264.91073
22595,720044658,06-03-24 16:28,508.01,OutgoingTransfer,Wire Transfer,1756.90073
22596,720044658,06-04-24 21:28,5000,IncomingTransfer,Salary,6756.90073
22597,720044658,06-05-24 13:28,360.12,OutgoingTransfer,Wire Transfer,6396.78073
22598,720044658,06-09-24 21:28,2300,Payment,Credit Card Payment,4096.78073
22599,720044658,06-11-24 10:28,150.68,Payment,Bill Payment,3946.10073
22600,720044658,6-15-24 15:28,95.31,OnlineShopping,Target,3850.79073
22601,720044658,6-16-24 13:28,474.97,Purchase,Restaurant,3375.82073
22602,720044658,6-18-24 21:28,1900,Payment,Subscription Payment,1475.82073
22603,720044658,6-21-24 9:28,407.86,OutgoingTransfer,Peer-to-Peer Transfer,1067.96073
22604,720044658,6-25-24 11:28,470.19,Purchase,Entertainment,597.7707304
22605,720044658,6-27-24 20:28,431.5,OutgoingTransfer,Peer-to-Peer Transfer,166.2707304
22606,720044658,07-01-24 21:28,5000,IncomingTransfer,Salary,5166.27073
22607,720044658,07-06-24 19:28,484.37,Deposit,Cash Deposit,5650.64073
22608,720044658,07-06-24 21:28,2900,Payment,Credit Card Payment,2750.64073
22609,720044658,7-13-24 20:28,523.51,OutgoingTransfer,Bank Transfer,2227.13073
22610,720044658,7-14-24 21:28,2200,Payment,Insurance Payment,27.13073045
22611,720044658,7-17-24 10:28,126.65,Return,eBay Return,153.7807304
22612,720054183,1-20-24 11:28,90.87,OnlineShopping,Etsy,1228.862155
22613,720054183,1-24-24 19:28,113.34,Withdrawal,ATM Withdrawal,1115.522155
22614,720054183,1-29-24 19:28,43.92,OutgoingTransfer,Peer-to-Peer Transfer,1071.602155
22615,720054183,02-04-24 16:28,256.74,Withdrawal,Mobile App Withdrawal,814.8621545
22616,720054183,02-05-24 21:28,4500,IncomingTransfer,Salary,5314.862155
22617,720054183,02-06-24 14:28,242.56,Payment,Loan Payment,5072.302155
22618,720054183,02-06-24 18:28,121.99,IncomingTransfer,Freelance Payment,5194.292155
22619,720054183,02-08-24 13:28,52,OutgoingTransfer,International Transfer,5142.292155
22620,720054183,02-10-24 21:28,3200,Payment,Credit Card Payment,1942.292155
22621,720054183,02-11-24 21:28,1600,Payment,Rent Payment,342.2921545
22622,720054183,02-12-24 15:28,299.56,Purchase,Furniture,42.73215452
22623,720054183,2-13-24 15:28,159.89,Return,AliExpress Return,202.6221545
22624,720054183,2-13-24 19:28,360.21,Payment,Mortgage Payment,-157.5878455
22625,720054183,2-14-24 16:28,155.1,Deposit,Direct Deposit,-2.487845481
22626,720054183,2-15-24 20:28,124.06,OutgoingTransfer,Wire Transfer,-126.5478455
22627,720054183,2-18-24 12:28,168.46,Deposit,Mobile Deposit,41.91215452
22628,720054183,2-18-24 14:28,29.2,OnlineShopping,Walmart,12.71215452
22629,720054183,2-18-24 21:28,338.25,Withdrawal,ATM Withdrawal,-325.5378455
22630,720054183,2-25-24 16:28,288.77,Deposit,Direct Deposit,-36.76784548
22631,720054183,2-26-24 12:28,361.14,Payment,Loan Payment,-397.9078455
22632,720054183,2-27-24 14:28,110.7,Withdrawal,Mobile App Withdrawal,-508.6078455
22633,720054183,2-29-24 14:28,323.81,Deposit,Direct Deposit,-184.7978455
22634,720054183,03-03-24 16:28,150.76,Purchase,Electronics,-335.5578455
22635,720054183,03-04-24 21:28,4500,IncomingTransfer,Salary,4164.442155
22636,720054183,03-07-24 15:28,70.36,Withdrawal,Branch Withdrawal,4094.082155
22637,720054183,03-09-24 14:28,338.32,OnlineShopping,eBay,3755.762155
22638,720054183,03-09-24 21:28,3100,Payment,Credit Card Payment,655.7621545
22639,720054183,03-11-24 17:28,169.57,OnlineShopping,Best Buy,486.1921545
22640,720054183,03-12-24 9:28,275.62,Deposit,Mobile Deposit,761.8121545
22641,720054183,3-14-24 21:28,1800,Payment,Rent Payment,-1038.187845
22642,720054183,3-15-24 19:28,53.6,Purchase,Pharmacy,-1091.787845
22643,720054183,3-16-24 15:28,222.18,Withdrawal,Mobile App Withdrawal,-1313.967845
22644,720054183,3-16-24 18:28,303.91,Return,Best Buy Return,-1010.057845
22645,720054183,3-20-24 18:28,302.43,Deposit,Check Deposit,-707.6278455
22646,720054183,3-21-24 20:28,122.5,Return,eBay Return,-585.1278455
22647,720054183,3-26-24 17:28,51.47,IncomingTransfer,Freelance Payment,-533.6578455
22648,720054183,3-31-24 17:28,246.9,Withdrawal,Branch Withdrawal,-780.5578455
22649,720054183,04-02-24 23:28,64.7,Purchase,Travel,-845.2578455
22650,720054183,04-03-24 18:28,103.65,OnlineShopping,Walmart,-948.9078455
22651,720054183,04-05-24 12:28,285.71,Return,Best Buy Return,-663.1978455
22652,720054183,04-05-24 21:28,4500,IncomingTransfer,Salary,3836.802155
22653,720054183,04-05-24 21:28,120.28,Deposit,Cash Deposit,3957.082155
22654,720054183,04-06-24 10:28,46.34,Purchase,Entertainment,3910.742155
22655,720054183,04-10-24 21:28,3000,Payment,Credit Card Payment,910.7421545
22656,720054183,04-10-24 22:28,303.03,Withdrawal,Mobile App Withdrawal,607.7121545
22657,720054183,4-13-24 21:28,2700,Payment,Rent Payment,-2092.287845
22658,720054183,4-15-24 10:28,371.17,OutgoingTransfer,Wire Transfer,-2463.457845
22659,720054183,4-16-24 16:28,296.38,Withdrawal,Branch Withdrawal,-2759.837845
22660,720054183,4-17-24 14:28,295.67,Deposit,Cash Deposit,-2464.167845
22661,720054183,4-20-24 21:28,132.76,Deposit,Cash Deposit,-2331.407845
22662,720054183,4-22-24 23:28,231.21,Deposit,Direct Deposit,-2100.197845
22663,720054183,4-27-24 22:28,187.07,OnlineShopping,Target,-2287.267845
22664,720054183,05-01-24 10:28,235.98,Deposit,Mobile Deposit,-2051.287845
22665,720054183,05-01-24 16:28,113,Purchase,Home Improvement,-2164.287845
22666,720054183,05-02-24 11:28,205.01,Withdrawal,Mobile App Withdrawal,-2369.297845
22667,720054183,05-02-24 20:28,109.63,Purchase,Pharmacy,-2478.927845
22668,720054183,05-03-24 21:28,4500,IncomingTransfer,Salary,2021.072155
22669,720054183,05-04-24 10:28,288.08,OnlineShopping,Walmart,1732.992155
22670,720054183,05-04-24 14:28,395.75,Withdrawal,ATM Withdrawal,1337.242155
22671,720054183,05-06-24 19:28,335.38,Withdrawal,Branch Withdrawal,1001.862155
22672,720054183,05-06-24 21:28,33.29,Return,Best Buy Return,1035.152155
22673,720054183,05-08-24 21:28,2900,Payment,Credit Card Payment,-1864.847845
22674,720054183,05-10-24 15:28,225.77,Purchase,Furniture,-2090.617845
22675,720054183,05-10-24 16:28,184.95,Deposit,Cash Deposit,-1905.667845
22676,720054183,5-13-24 21:28,2400,Payment,Rent Payment,-4305.667845
22677,720054183,5-18-24 17:28,226.24,Deposit,Mobile Deposit,-4079.427845
22678,720054183,5-21-24 10:28,222.47,Withdrawal,Branch Withdrawal,-4301.897845
22679,720054183,5-22-24 13:28,291.16,Purchase,Gas,-4593.057845
22680,720054183,5-29-24 23:28,129.81,OnlineShopping,Walmart,-4722.867845
22681,720054183,5-30-24 15:28,150.03,Purchase,Entertainment,-4872.897845
22682,720054183,5-30-24 16:28,264.66,Deposit,Mobile Deposit,-4608.237845
22683,720054183,5-31-24 9:28,195.87,IncomingTransfer,Freelance Payment,-4412.367845
22684,720054183,5-31-24 15:28,192.08,Purchase,Restaurant,-4604.447845
22685,720054183,06-02-24 12:28,300.57,OutgoingTransfer,Bank Transfer,-4905.017845
22686,720054183,06-02-24 14:28,263.14,Deposit,Direct Deposit,-4641.877845
22687,720054183,06-02-24 17:28,187.99,Deposit,Check Deposit,-4453.887845
22688,720054183,06-02-24 21:28,4500,IncomingTransfer,Salary,46.11215452
22689,720054183,06-04-24 13:28,392.78,Deposit,Check Deposit,438.8921545
22690,720054183,06-06-24 12:28,352,OutgoingTransfer,Peer-to-Peer Transfer,86.89215452
22691,720054183,06-07-24 21:28,2700,Payment,Credit Card Payment,-2613.107845
22692,720054183,06-08-24 14:28,290.17,Withdrawal,Branch Withdrawal,-2903.277845
22693,720054183,06-11-24 10:28,376.6,Return,Best Buy Return,-2526.677845
22694,720054183,6-13-24 19:28,162.73,OutgoingTransfer,International Transfer,-2689.407845
22695,720054183,6-14-24 9:28,178.43,Deposit,Direct Deposit,-2510.977845
22696,720054183,6-15-24 21:28,102.95,Purchase,Grocery,-2613.927845
22697,720054183,6-15-24 22:28,38.85,Return,Amazon Return,-2575.077845
22698,720054183,6-16-24 21:28,1700,Payment,Rent Payment,-4275.077845
22699,720054183,6-18-24 16:28,189.88,OutgoingTransfer,Wire Transfer,-4464.957845
22700,720054183,6-19-24 14:28,305.11,OutgoingTransfer,Bank Transfer,-4770.067845
22701,720054183,6-21-24 17:28,392.95,Withdrawal,ATM Withdrawal,-5163.017845
22702,720054183,6-26-24 14:28,106.02,Purchase,Furniture,-5269.037845
22703,720054183,07-01-24 18:28,135.77,Return,AliExpress Return,-5133.267845
22704,720054183,07-03-24 17:28,35.15,Payment,Mortgage Payment,-5168.417845
22705,720054183,07-04-24 21:28,4500,IncomingTransfer,Salary,-668.4178455
22706,720054183,07-07-24 15:28,61.34,Withdrawal,ATM Withdrawal,-729.7578455
22707,720054183,07-07-24 22:28,174.37,Payment,Bill Payment,-904.1278455
22708,720054183,07-09-24 21:28,2300,Payment,Credit Card Payment,-3204.127845
22709,720054183,07-11-24 19:28,149.12,Purchase,Clothing,-3353.247845
22710,720054183,7-13-24 16:28,231.96,Return,Etsy Return,-3121.287845
22711,720054183,7-13-24 17:28,196.3,OnlineShopping,Etsy,-3317.587845
22712,720054183,7-14-24 17:28,22.81,OutgoingTransfer,Peer-to-Peer Transfer,-3340.397845
22713,720054183,7-17-24 9:28,64.68,OnlineShopping,Best Buy,-3405.077845
22714,720054183,7-17-24 16:28,379.91,Purchase,Entertainment,-3784.987845
22715,720054183,7-18-24 21:28,1200,Payment,Rent Payment,-4984.987845
22716,720067083,1-22-24 17:28,200.76,OutgoingTransfer,Bank Transfer,458.803237
22717,720067083,1-23-24 16:28,75.72,Payment,Bill Payment,383.083237
22718,720067083,1-28-24 16:28,132.89,Payment,Mortgage Payment,250.193237
22719,720067083,1-29-24 14:28,31.61,Return,Etsy Return,281.803237
22720,720067083,1-29-24 20:28,175.24,Purchase,Gas,106.563237
22721,720067083,02-01-24 14:28,117.05,Purchase,Entertainment,-10.48676301
22722,720067083,02-03-24 21:28,2600,IncomingTransfer,Salary,2589.513237
22723,720067083,02-04-24 22:28,121.09,IncomingTransfer,Freelance Payment,2710.603237
22724,720067083,02-06-24 12:28,226.14,Purchase,Gas,2484.463237
22725,720067083,02-07-24 17:28,66.76,Purchase,Electronics,2417.703237
22726,720067083,02-08-24 21:28,900,Payment,Credit Card Payment,1517.703237
22727,720067083,02-11-24 12:28,210.72,Return,Target Return,1728.423237
22728,720067083,02-12-24 21:28,52.12,OnlineShopping,AliExpress,1676.303237
22729,720067083,02-12-24 22:28,65.97,Purchase,Grocery,1610.333237
22730,720067083,2-15-24 21:28,1700,Payment,Rent Payment,-89.66676301
22731,720067083,2-18-24 21:28,95.5,Deposit,Direct Deposit,5.833236986
22732,720067083,2-19-24 14:28,85.87,Deposit,Direct Deposit,91.70323699
22733,720067083,2-21-24 9:28,140.28,Deposit,Cash Deposit,231.983237
22734,720067083,2-23-24 14:28,48.15,Deposit,Direct Deposit,280.133237
22735,720067083,2-23-24 17:28,130.6,OutgoingTransfer,International Transfer,149.533237
22736,720067083,03-01-24 15:28,106.82,Payment,Mortgage Payment,42.71323699
22737,720067083,03-02-24 21:28,207.56,Withdrawal,ATM Withdrawal,-164.846763
22738,720067083,03-03-24 21:28,2600,IncomingTransfer,Salary,2435.153237
22739,720067083,03-06-24 16:28,160.56,Purchase,Travel,2274.593237
22740,720067083,03-07-24 21:28,72.55,Deposit,Direct Deposit,2347.143237
22741,720067083,03-08-24 21:28,1200,Payment,Credit Card Payment,1147.143237
22742,720067083,03-09-24 17:28,62.38,Deposit,Direct Deposit,1209.523237
22743,720067083,03-12-24 22:28,247.45,IncomingTransfer,Freelance Payment,1456.973237
22744,720067083,3-13-24 9:28,132.32,Return,Walmart Return,1589.293237
22745,720067083,3-16-24 21:28,1000,Payment,Rent Payment,589.293237
22746,720067083,3-21-24 20:28,113.51,Return,Walmart Return,702.803237
22747,720067083,3-23-24 22:28,59.34,Payment,Mortgage Payment,643.463237
22748,720067083,3-25-24 10:28,242.38,Withdrawal,Mobile App Withdrawal,401.083237
22749,720067083,3-27-24 10:28,227.03,OnlineShopping,Etsy,174.053237
22750,720067083,04-01-24 18:28,171.05,Payment,Loan Payment,3.003236986
22751,720067083,04-04-24 18:28,238.21,OutgoingTransfer,Bank Transfer,-235.206763
22752,720067083,04-05-24 21:28,2600,IncomingTransfer,Salary,2364.793237
22753,720067083,04-09-24 21:28,11.53,Withdrawal,Branch Withdrawal,2353.263237
22754,720067083,04-10-24 21:28,1000,Payment,Credit Card Payment,1353.263237
22755,720067083,04-12-24 14:28,88.7,IncomingTransfer,Freelance Payment,1441.963237
22756,720067083,4-13-24 18:28,99.63,Purchase,Furniture,1342.333237
22757,720067083,4-15-24 19:28,243.38,Return,Best Buy Return,1585.713237
22758,720067083,4-16-24 15:28,97.77,Deposit,Cash Deposit,1683.483237
22759,720067083,4-17-24 21:28,1200,Payment,Rent Payment,483.483237
22760,720067083,4-18-24 13:28,223.12,Deposit,Mobile Deposit,706.603237
22761,720067083,4-24-24 23:28,139.18,Withdrawal,Branch Withdrawal,567.423237
22762,720067083,4-28-24 10:28,218.09,Payment,Loan Payment,349.333237
22763,720067083,05-01-24 18:28,31.38,Deposit,Mobile Deposit,380.713237
22764,720067083,05-01-24 23:28,229.16,Payment,Mortgage Payment,151.553237
22765,720067083,05-02-24 9:28,170.24,OutgoingTransfer,Wire Transfer,-18.68676301
22766,720067083,05-03-24 21:28,2600,IncomingTransfer,Salary,2581.313237
22767,720067083,05-08-24 21:28,1000,Payment,Credit Card Payment,1581.313237
22768,720067083,05-12-24 18:28,241.74,OutgoingTransfer,Peer-to-Peer Transfer,1339.573237
22769,720067083,5-15-24 21:28,1600,Payment,Rent Payment,-260.426763
22770,720067083,5-15-24 21:28,193.21,Withdrawal,Branch Withdrawal,-453.636763
22771,720067083,5-16-24 21:28,158.47,Purchase,Gas,-612.106763
22772,720067083,5-17-24 21:28,102.68,Withdrawal,Mobile App Withdrawal,-714.786763
22773,720067083,06-03-24 21:28,2600,IncomingTransfer,Salary,1885.213237
22774,720067083,06-03-24 21:28,83.4,Purchase,Restaurant,1801.813237
22775,720067083,06-06-24 13:28,145.84,Purchase,Clothing,1655.973237
22776,720067083,06-06-24 16:28,153.37,Payment,Mortgage Payment,1502.603237
22777,720067083,06-07-24 12:28,232.37,Payment,Bill Payment,1270.233237
22778,720067083,06-08-24 21:28,1100,Payment,Credit Card Payment,170.233237
22779,720067083,06-11-24 16:28,10.37,Purchase,Electronics,159.863237
22780,720067083,06-11-24 17:28,90.97,Purchase,Entertainment,68.89323699
22781,720067083,06-12-24 14:28,231.02,Purchase,Clothing,-162.126763
22782,720067083,06-12-24 23:28,245.56,Deposit,Direct Deposit,83.43323699
22783,720067083,6-13-24 15:28,148.09,OutgoingTransfer,Wire Transfer,-64.65676301
22784,720067083,6-14-24 21:28,1000,Payment,Rent Payment,-1064.656763
22785,720067083,6-16-24 14:28,90.69,Payment,Bill Payment,-1155.346763
22786,720067083,6-17-24 21:28,72.33,OutgoingTransfer,Peer-to-Peer Transfer,-1227.676763
22787,720067083,6-18-24 20:28,78.49,Purchase,Travel,-1306.166763
22788,720067083,6-20-24 13:28,64.83,IncomingTransfer,Freelance Payment,-1241.336763
22789,720067083,6-22-24 14:28,217.45,Purchase,Restaurant,-1458.786763
22790,720067083,6-22-24 14:28,249.11,Purchase,Electronics,-1707.896763
22791,720067083,6-23-24 13:28,40.9,Withdrawal,Branch Withdrawal,-1748.796763
22792,720067083,6-25-24 10:28,125.49,Withdrawal,Mobile App Withdrawal,-1874.286763
22793,720067083,6-28-24 16:28,108.61,OnlineShopping,Amazon,-1982.896763
22794,720067083,07-01-24 14:28,46.74,Deposit,Mobile Deposit,-1936.156763
22795,720067083,07-01-24 20:28,197.6,Deposit,Check Deposit,-1738.556763
22796,720067083,07-03-24 22:28,69.56,OutgoingTransfer,International Transfer,-1808.116763
22797,720067083,07-05-24 21:28,2600,IncomingTransfer,Salary,791.883237
22798,720067083,07-09-24 11:28,199.25,Deposit,Cash Deposit,991.133237
22799,720067083,07-10-24 21:28,1100,Payment,Credit Card Payment,-108.866763
22800,720067083,07-11-24 17:28,153.92,IncomingTransfer,Freelance Payment,45.05323699
22801,720067083,07-11-24 23:28,110.39,Deposit,Mobile Deposit,155.443237
22802,720067083,07-12-24 23:28,12.41,Purchase,Electronics,143.033237
22803,720067083,7-13-24 21:28,800,Payment,Rent Payment,-656.966763
22804,720067083,7-13-24 21:28,102.58,Payment,Bill Payment,-759.546763
22805,720067083,7-14-24 12:28,158.75,Withdrawal,ATM Withdrawal,-918.296763
22806,720067083,7-15-24 9:28,120.23,OutgoingTransfer,Bank Transfer,-1038.526763
22807,720067083,7-17-24 13:28,63.22,Withdrawal,Mobile App Withdrawal,-1101.746763
22808,720115683,1-28-24 13:28,419.41,Withdrawal,Mobile App Withdrawal,889.7834931
22809,720115683,1-29-24 11:28,620.21,OnlineShopping,eBay,269.5734931
22810,720115683,1-31-24 19:28,407.65,Payment,Mortgage Payment,-138.0765069
22811,720115683,02-02-24 12:28,213.59,Purchase,Grocery,-351.6665069
22812,720115683,02-04-24 21:28,8200,IncomingTransfer,Salary,7848.333493
22813,720115683,02-06-24 23:28,544.33,Deposit,Mobile Deposit,8392.663493
22814,720115683,02-07-24 21:28,358.66,Withdrawal,Mobile App Withdrawal,8034.003493
22815,720115683,02-09-24 13:28,444.17,Deposit,Cash Deposit,8478.173493
22816,720115683,02-09-24 21:28,2200,Payment,Credit Card Payment,6278.173493
22817,720115683,02-11-24 17:28,261.27,OnlineShopping,Etsy,6016.903493
22818,720115683,02-12-24 14:28,652.22,Return,AliExpress Return,6669.123493
22819,720115683,2-17-24 21:28,3700,Payment,Subscription Payment,2969.123493
22820,720115683,2-18-24 10:28,595.87,Deposit,Check Deposit,3564.993493
22821,720115683,2-23-24 14:28,748.28,Deposit,Check Deposit,4313.273493
22822,720115683,03-02-24 10:28,369.08,IncomingTransfer,Freelance Payment,4682.353493
22823,720115683,03-02-24 15:28,151.44,Payment,Loan Payment,4530.913493
22824,720115683,03-03-24 12:28,744.14,IncomingTransfer,Freelance Payment,5275.053493
22825,720115683,03-03-24 21:28,8200,IncomingTransfer,Salary,13475.05349
22826,720115683,03-07-24 12:28,692.71,Withdrawal,Branch Withdrawal,12782.34349
22827,720115683,03-08-24 21:28,2000,Payment,Credit Card Payment,10782.34349
22828,720115683,3-18-24 21:28,3400,Payment,Insurance Payment,7382.343493
22829,720115683,3-25-24 10:28,192.74,Withdrawal,Branch Withdrawal,7189.603493
22830,720115683,3-29-24 14:28,672.5,Deposit,Check Deposit,7862.103493
22831,720115683,3-30-24 19:28,617.65,IncomingTransfer,Freelance Payment,8479.753493
22832,720115683,04-01-24 15:28,515.51,Withdrawal,ATM Withdrawal,7964.243493
22833,720115683,04-01-24 19:28,368.07,Payment,Bill Payment,7596.173493
22834,720115683,04-02-24 21:28,8200,IncomingTransfer,Salary,15796.17349
22835,720115683,04-04-24 10:28,655.88,OnlineShopping,eBay,15140.29349
22836,720115683,04-04-24 20:28,136,Withdrawal,ATM Withdrawal,15004.29349
22837,720115683,04-07-24 20:28,370.28,Purchase,Pharmacy,14634.01349
22838,720115683,04-07-24 21:28,1900,Payment,Credit Card Payment,12734.01349
22839,720115683,04-09-24 11:28,514.01,Deposit,Check Deposit,13248.02349
22840,720115683,4-15-24 10:28,302.86,OutgoingTransfer,Bank Transfer,12945.16349
22841,720115683,4-15-24 21:28,366.12,OnlineShopping,Walmart,12579.04349
22842,720115683,4-18-24 21:28,2700,Payment,Insurance Payment,9879.043493
22843,720115683,4-25-24 23:28,150.66,Payment,Loan Payment,9728.383493
22844,720115683,4-30-24 14:28,571.38,Purchase,Furniture,9157.003493
22845,720115683,05-01-24 16:28,273.49,Withdrawal,Mobile App Withdrawal,8883.513493
22846,720115683,05-04-24 21:28,8200,IncomingTransfer,Salary,17083.51349
22847,720115683,05-09-24 21:28,2200,Payment,Credit Card Payment,14883.51349
22848,720115683,5-13-24 21:28,623.23,OnlineShopping,eBay,14260.28349
22849,720115683,5-16-24 11:28,154.89,Deposit,Check Deposit,14415.17349
22850,720115683,5-17-24 14:28,575.32,Payment,Bill Payment,13839.85349
22851,720115683,5-17-24 16:28,290.53,OnlineShopping,AliExpress,13549.32349
22852,720115683,5-17-24 21:28,2300,Payment,Installment Payment,11249.32349
22853,720115683,5-22-24 10:28,561.85,OutgoingTransfer,International Transfer,10687.47349
22854,720115683,06-03-24 18:28,696.57,IncomingTransfer,Freelance Payment,11384.04349
22855,720115683,06-04-24 12:28,677.3,Purchase,Furniture,10706.74349
22856,720115683,06-04-24 21:28,8200,IncomingTransfer,Salary,18906.74349
22857,720115683,06-09-24 21:28,1800,Payment,Credit Card Payment,17106.74349
22858,720115683,06-11-24 11:28,402.48,Payment,Loan Payment,16704.26349
22859,720115683,6-15-24 21:28,3400,Payment,Insurance Payment,13304.26349
22860,720115683,6-23-24 10:28,205.98,OnlineShopping,Best Buy,13098.28349
22861,720115683,07-01-24 21:28,8200,IncomingTransfer,Salary,21298.28349
22862,720115683,07-04-24 17:28,725.89,Purchase,Pharmacy,20572.39349
22863,720115683,07-05-24 9:28,555.31,Return,Walmart Return,21127.70349
22864,720115683,07-06-24 21:28,1900,Payment,Credit Card Payment,19227.70349
22865,720115683,07-09-24 18:28,159.99,Return,Best Buy Return,19387.69349
22866,720115683,7-16-24 13:28,446.28,Purchase,Furniture,18941.41349
22867,720115683,7-16-24 21:28,2900,Payment,Subscription Payment,16041.41349
22868,720175008,1-26-24 13:28,366.67,Withdrawal,Branch Withdrawal,1263.218243
22869,720175008,1-27-24 11:28,52.43,Purchase,Restaurant,1210.788243
22870,720175008,02-05-24 13:28,134.82,Payment,Mortgage Payment,1075.968243
22871,720175008,02-05-24 21:28,4200,IncomingTransfer,Salary,5275.968243
22872,720175008,02-10-24 21:28,2100,Payment,Credit Card Payment,3175.968243
22873,720175008,2-13-24 21:28,1900,Payment,Rent Payment,1275.968243
22874,720175008,2-15-24 21:28,340.24,Deposit,Direct Deposit,1616.208243
22875,720175008,2-16-24 18:28,344.15,OnlineShopping,Walmart,1272.058243
22876,720175008,2-18-24 20:28,128.87,Payment,Loan Payment,1143.188243
22877,720175008,2-19-24 9:28,183.41,Withdrawal,Branch Withdrawal,959.7782431
22878,720175008,2-27-24 22:28,166.21,Deposit,Check Deposit,1125.988243
22879,720175008,03-01-24 23:28,380.3,OutgoingTransfer,Wire Transfer,745.6882431
22880,720175008,03-02-24 14:28,238.28,Deposit,Direct Deposit,983.9682431
22881,720175008,03-02-24 21:28,4200,IncomingTransfer,Salary,5183.968243
22882,720175008,03-04-24 23:28,46.39,Deposit,Direct Deposit,5230.358243
22883,720175008,03-05-24 15:28,360.55,OnlineShopping,Target,4869.808243
22884,720175008,03-06-24 20:28,157.72,Purchase,Restaurant,4712.088243
22885,720175008,03-07-24 21:28,2400,Payment,Credit Card Payment,2312.088243
22886,720175008,03-10-24 21:28,2500,Payment,Rent Payment,-187.9117569
22887,720175008,03-11-24 14:28,265.69,Purchase,Gas,-453.6017569
22888,720175008,3-17-24 19:28,280.42,Return,Walmart Return,-173.1817569
22889,720175008,3-18-24 14:28,190.83,OnlineShopping,Best Buy,-364.0117569
22890,720175008,3-23-24 15:28,155.81,Deposit,Mobile Deposit,-208.2017569
22891,720175008,3-25-24 21:28,381.04,Purchase,Furniture,-589.2417569
22892,720175008,3-26-24 15:28,182.39,Withdrawal,Mobile App Withdrawal,-771.6317569
22893,720175008,3-28-24 13:28,290.83,Purchase,Home Improvement,-1062.461757
22894,720175008,3-30-24 22:28,26.09,OnlineShopping,Walmart,-1088.551757
22895,720175008,04-01-24 15:28,122.81,Return,Store Return,-965.7417569
22896,720175008,04-01-24 21:28,4200,IncomingTransfer,Salary,3234.258243
22897,720175008,04-03-24 16:28,212.95,Deposit,Mobile Deposit,3447.208243
22898,720175008,04-06-24 15:28,222.98,OutgoingTransfer,Peer-to-Peer Transfer,3224.228243
22899,720175008,04-06-24 17:28,333.45,Withdrawal,ATM Withdrawal,2890.778243
22900,720175008,04-06-24 18:28,247.9,Purchase,Clothing,2642.878243
22901,720175008,04-06-24 21:28,2100,Payment,Credit Card Payment,542.8782431
22902,720175008,04-07-24 20:28,156.31,IncomingTransfer,Freelance Payment,699.1882431
22903,720175008,04-09-24 9:28,107.63,Withdrawal,Mobile App Withdrawal,591.5582431
22904,720175008,04-11-24 21:28,1300,Payment,Rent Payment,-708.4417569
22905,720175008,4-17-24 20:28,48.67,IncomingTransfer,Freelance Payment,-659.7717569
22906,720175008,4-19-24 20:28,46.6,Deposit,Direct Deposit,-613.1717569
22907,720175008,05-03-24 21:28,4200,IncomingTransfer,Salary,3586.828243
22908,720175008,05-06-24 22:28,124.44,Deposit,Direct Deposit,3711.268243
22909,720175008,05-07-24 17:28,389.33,Deposit,Direct Deposit,4100.598243
22910,720175008,05-08-24 21:28,2100,Payment,Credit Card Payment,2000.598243
22911,720175008,05-11-24 20:28,352.98,Deposit,Cash Deposit,2353.578243
22912,720175008,05-12-24 21:28,1700,Payment,Rent Payment,653.5782431
22913,720175008,5-14-24 22:28,61.51,OnlineShopping,Etsy,592.0682431
22914,720175008,5-17-24 9:28,140.05,Withdrawal,Branch Withdrawal,452.0182431
22915,720175008,5-17-24 19:28,130.09,OnlineShopping,Walmart,321.9282431
22916,720175008,5-19-24 21:28,168.01,OutgoingTransfer,Wire Transfer,153.9182431
22917,720175008,5-21-24 17:28,219.23,Purchase,Furniture,-65.31175686
22918,720175008,5-23-24 17:28,179.26,OutgoingTransfer,Peer-to-Peer Transfer,-244.5717569
22919,720175008,5-25-24 12:28,383.05,Withdrawal,Branch Withdrawal,-627.6217569
22920,720175008,5-25-24 13:28,356.91,Deposit,Cash Deposit,-270.7117569
22921,720175008,5-27-24 16:28,130.31,OutgoingTransfer,Peer-to-Peer Transfer,-401.0217569
22922,720175008,5-28-24 10:28,139.69,Purchase,Gas,-540.7117569
22923,720175008,5-28-24 12:28,289.36,Purchase,Travel,-830.0717569
22924,720175008,5-30-24 14:28,381.03,Deposit,Check Deposit,-449.0417569
22925,720175008,5-31-24 11:28,146.62,Withdrawal,Branch Withdrawal,-595.6617569
22926,720175008,06-03-24 17:28,153.27,Purchase,Gas,-748.9317569
22927,720175008,06-04-24 13:28,260.03,Payment,Bill Payment,-1008.961757
22928,720175008,06-05-24 21:28,4200,IncomingTransfer,Salary,3191.038243
22929,720175008,06-05-24 21:28,186.57,Withdrawal,Mobile App Withdrawal,3004.468243
22930,720175008,06-07-24 19:28,49.47,OnlineShopping,Best Buy,2954.998243
22931,720175008,06-09-24 16:28,180.69,Withdrawal,ATM Withdrawal,2774.308243
22932,720175008,06-10-24 18:28,367.37,Deposit,Cash Deposit,3141.678243
22933,720175008,06-10-24 21:28,2300,Payment,Credit Card Payment,841.6782431
22934,720175008,06-12-24 14:28,242.17,Purchase,Electronics,599.5082431
22935,720175008,06-12-24 16:28,379.08,Return,Target Return,978.5882431
22936,720175008,6-13-24 14:28,240.2,Withdrawal,Branch Withdrawal,738.3882431
22937,720175008,6-14-24 11:28,318.43,OnlineShopping,Amazon,419.9582431
22938,720175008,6-17-24 21:28,2400,Payment,Rent Payment,-1980.041757
22939,720175008,6-18-24 20:28,271.55,OnlineShopping,Walmart,-2251.591757
22940,720175008,6-22-24 12:28,265.64,OnlineShopping,AliExpress,-2517.231757
22941,720175008,6-26-24 20:28,138.6,OutgoingTransfer,Wire Transfer,-2655.831757
22942,720175008,07-01-24 19:28,155.41,Purchase,Electronics,-2811.241757
22943,720175008,07-01-24 21:28,4200,IncomingTransfer,Salary,1388.758243
22944,720175008,07-06-24 12:28,164.62,Deposit,Mobile Deposit,1553.378243
22945,720175008,07-06-24 21:28,2700,Payment,Credit Card Payment,-1146.621757
22946,720175008,07-07-24 17:28,54.55,Payment,Mortgage Payment,-1201.171757
22947,720175008,07-08-24 23:28,222.25,Withdrawal,Branch Withdrawal,-1423.421757
22948,720175008,07-11-24 9:28,219.97,Purchase,Grocery,-1643.391757
22949,720175008,7-13-24 12:28,37.64,IncomingTransfer,Freelance Payment,-1605.751757
22950,720175008,7-15-24 21:28,2200,Payment,Rent Payment,-3805.751757
22951,720175008,7-17-24 22:28,48.35,Purchase,Gas,-3854.101757
22952,720243933,1-24-24 21:28,310.63,OutgoingTransfer,Peer-to-Peer Transfer,-310.63
22953,720243933,1-30-24 15:28,408.57,Purchase,Entertainment,-719.2
22954,720243933,1-31-24 19:28,404.04,OnlineShopping,Target,-1123.24
22955,720243933,1-31-24 19:28,397,OnlineShopping,Walmart,-1520.24
22956,720243933,02-02-24 15:28,310.62,OnlineShopping,Target,-1830.86
22957,720243933,02-02-24 21:28,6600,IncomingTransfer,Salary,4769.14
22958,720243933,02-09-24 10:28,219.79,IncomingTransfer,Freelance Payment,4988.93
22959,720243933,02-09-24 14:28,503.79,Deposit,Check Deposit,5492.72
22960,720243933,2-15-24 11:28,64.97,Deposit,Mobile Deposit,5557.69
22961,720243933,2-16-24 9:28,523.34,Purchase,Travel,5034.35
22962,720243933,2-16-24 18:28,365.84,OnlineShopping,Amazon,4668.51
22963,720243933,2-17-24 21:28,2000,Payment,Rent Payment,2668.51
22964,720243933,2-22-24 17:28,199.98,Deposit,Check Deposit,2868.49
22965,720243933,2-24-24 21:28,346.26,OutgoingTransfer,Bank Transfer,2522.23
22966,720243933,03-05-24 21:28,6600,IncomingTransfer,Salary,9122.23
22967,720243933,03-05-24 23:28,473.89,Withdrawal,Branch Withdrawal,8648.34
22968,720243933,03-07-24 17:28,255.86,Purchase,Home Improvement,8392.48
22969,720243933,3-14-24 13:28,97.66,Withdrawal,ATM Withdrawal,8294.82
22970,720243933,3-14-24 21:28,2800,Payment,Rent Payment,5494.82
22971,720243933,3-15-24 18:28,441.94,Withdrawal,Mobile App Withdrawal,5052.88
22972,720243933,3-20-24 22:28,245.56,OnlineShopping,eBay,4807.32
22973,720243933,3-23-24 11:28,216.23,Withdrawal,Mobile App Withdrawal,4591.09
22974,720243933,3-23-24 15:28,354.91,Return,Target Return,4946
22975,720243933,3-24-24 21:28,99.34,Deposit,Check Deposit,5045.34
22976,720243933,3-26-24 15:28,159.26,IncomingTransfer,Freelance Payment,5204.6
22977,720243933,04-03-24 20:28,385.18,IncomingTransfer,Freelance Payment,5589.78
22978,720243933,04-05-24 21:28,6600,IncomingTransfer,Salary,12189.78
22979,720243933,04-11-24 19:28,247.03,Withdrawal,Mobile App Withdrawal,11942.75
22980,720243933,4-13-24 17:28,153.87,Withdrawal,Branch Withdrawal,11788.88
22981,720243933,4-13-24 21:28,3000,Payment,Rent Payment,8788.88
22982,720243933,4-20-24 19:28,91.2,OnlineShopping,Amazon,8697.68
22983,720243933,4-20-24 21:28,113.62,OutgoingTransfer,Wire Transfer,8584.06
22984,720243933,4-25-24 18:28,231.33,IncomingTransfer,Freelance Payment,8815.39
22985,720243933,4-27-24 21:28,236.41,Purchase,Clothing,8578.98
22986,720243933,05-03-24 14:28,430.75,Deposit,Direct Deposit,9009.73
22987,720243933,05-03-24 21:28,6600,IncomingTransfer,Salary,15609.73
22988,720243933,05-08-24 19:28,270.35,Deposit,Cash Deposit,15880.08
22989,720243933,05-11-24 21:28,3300,Payment,Rent Payment,12580.08
22990,720243933,05-12-24 15:28,251.67,Purchase,Grocery,12328.41
22991,720243933,5-14-24 19:28,540.43,OutgoingTransfer,Peer-to-Peer Transfer,11787.98
22992,720243933,06-01-24 18:28,514.89,Purchase,Home Improvement,11273.09
22993,720243933,06-02-24 13:28,154.39,IncomingTransfer,Freelance Payment,11427.48
22994,720243933,06-04-24 21:28,6600,IncomingTransfer,Salary,18027.48
22995,720243933,06-08-24 13:28,351.04,Withdrawal,ATM Withdrawal,17676.44
22996,720243933,06-11-24 9:28,491.1,OnlineShopping,Amazon,17185.34
22997,720243933,06-12-24 21:28,4300,Payment,Rent Payment,12885.34
22998,720243933,6-15-24 12:28,319.71,Purchase,Pharmacy,12565.63
22999,720243933,6-16-24 19:28,230.83,Withdrawal,Branch Withdrawal,12334.8
23000,720243933,6-17-24 12:28,84.33,Purchase,Gas,12250.47
23001,720243933,6-19-24 23:28,279.76,Deposit,Mobile Deposit,12530.23
23002,720243933,6-30-24 15:28,472.7,Purchase,Furniture,12057.53
23003,720243933,07-01-24 21:28,6600,IncomingTransfer,Salary,18657.53
23004,720243933,07-02-24 10:28,465.41,OutgoingTransfer,Bank Transfer,18192.12
23005,720243933,07-02-24 21:28,421.12,OnlineShopping,Etsy,17771
23006,720243933,07-03-24 20:28,454.33,Purchase,Clothing,17316.67
23007,720243933,07-07-24 18:28,232.41,Purchase,Gas,17084.26
23008,720243933,07-09-24 10:28,283.63,Return,AliExpress Return,17367.89
23009,720243933,07-12-24 19:28,151.53,OutgoingTransfer,Wire Transfer,17216.36
23010,720243933,07-12-24 19:28,404.18,Payment,Loan Payment,16812.18
23011,720243933,7-14-24 12:28,84.14,Payment,Bill Payment,16728.04
23012,720243933,7-18-24 21:28,1700,Payment,Rent Payment,15028.04
23013,720272958,1-20-24 18:28,896.88,Return,Store Return,896.88
23014,720272958,1-23-24 16:28,587.36,Withdrawal,Branch Withdrawal,309.52
23015,720272958,1-24-24 18:28,541.3,Payment,Bill Payment,-231.78
23016,720272958,02-01-24 21:28,13250,IncomingTransfer,Salary,13018.22
23017,720272958,2-15-24 21:28,7100,Payment,Rent Payment,5918.22
23018,720272958,2-15-24 23:28,207.88,OnlineShopping,Target,5710.34
23019,720272958,03-01-24 21:28,13250,IncomingTransfer,Salary,18960.34
23020,720272958,03-10-24 18:28,392.92,Payment,Mortgage Payment,18567.42
23021,720272958,3-17-24 21:28,7000,Payment,Rent Payment,11567.42
23022,720272958,3-20-24 22:28,380.59,Purchase,Home Improvement,11186.83
23023,720272958,3-22-24 16:28,671.81,IncomingTransfer,Freelance Payment,11858.64
23024,720272958,3-23-24 18:28,790.15,Withdrawal,Branch Withdrawal,11068.49
23025,720272958,3-31-24 12:28,251.44,OnlineShopping,Walmart,10817.05
23026,720272958,04-05-24 21:28,13250,IncomingTransfer,Salary,24067.05
23027,720272958,04-11-24 21:28,8400,Payment,Rent Payment,15667.05
23028,720272958,4-15-24 22:28,729.83,Withdrawal,ATM Withdrawal,14937.22
23029,720272958,4-16-24 9:28,689.76,Deposit,Mobile Deposit,15626.98
23030,720272958,4-19-24 14:28,403.04,Withdrawal,ATM Withdrawal,15223.94
23031,720272958,05-01-24 21:28,13250,IncomingTransfer,Salary,28473.94
23032,720272958,05-09-24 23:28,358.78,Payment,Loan Payment,28115.16
23033,720272958,05-11-24 14:28,823.43,Return,Walmart Return,28938.59
23034,720272958,5-14-24 21:28,8000,Payment,Rent Payment,20938.59
23035,720272958,5-23-24 23:28,695.01,OnlineShopping,eBay,20243.58
23036,720272958,06-04-24 21:28,13250,IncomingTransfer,Salary,33493.58
23037,720272958,06-07-24 18:28,379.79,Deposit,Cash Deposit,33873.37
23038,720272958,06-11-24 20:28,451.49,Return,Etsy Return,34324.86
23039,720272958,6-16-24 21:28,7300,Payment,Rent Payment,27024.86
23040,720272958,6-22-24 20:28,940.87,Purchase,Restaurant,26083.99
23041,720272958,6-23-24 19:28,836.95,Purchase,Home Improvement,25247.04
23042,720272958,6-30-24 22:28,783.54,Payment,Loan Payment,24463.5
23043,720272958,07-02-24 23:28,474.37,Deposit,Check Deposit,24937.87
23044,720272958,07-03-24 21:28,13250,IncomingTransfer,Salary,38187.87
23045,720272958,07-05-24 12:28,589.57,OnlineShopping,Amazon,37598.3
23046,720272958,07-07-24 14:28,536.2,OnlineShopping,eBay,37062.1
23047,720272958,07-12-24 10:28,328.18,Return,eBay Return,37390.28
23048,720272958,7-14-24 21:28,8300,Payment,Rent Payment,29090.28
23049,720272958,7-14-24 21:28,947.6,OnlineShopping,Amazon,28142.68
23050,720301458,1-20-24 21:28,348.25,OutgoingTransfer,Peer-to-Peer Transfer,1170.863859
23051,720301458,1-24-24 10:28,894.15,Withdrawal,ATM Withdrawal,276.7138585
23052,720301458,02-01-24 20:28,923.18,Withdrawal,ATM Withdrawal,-646.4661415
23053,720301458,02-03-24 21:28,15000,IncomingTransfer,Salary,14353.53386
23054,720301458,02-07-24 23:28,798.79,Deposit,Cash Deposit,15152.32386
23055,720301458,02-08-24 16:28,282.89,Purchase,Furniture,14869.43386
23056,720301458,02-08-24 21:28,2600,Payment,Credit Card Payment,12269.43386
23057,720301458,02-10-24 11:28,231.71,IncomingTransfer,Freelance Payment,12501.14386
23058,720301458,2-15-24 21:28,6300,Payment,Installment Payment,6201.143859
23059,720301458,2-17-24 14:28,705.36,Purchase,Gas,5495.783859
23060,720301458,2-22-24 13:28,558.13,Payment,Mortgage Payment,4937.653859
23061,720301458,2-24-24 10:28,855.8,Deposit,Direct Deposit,5793.453859
23062,720301458,2-25-24 19:28,372.96,Withdrawal,Mobile App Withdrawal,5420.493859
23063,720301458,2-26-24 11:28,449.26,Withdrawal,Branch Withdrawal,4971.233859
23064,720301458,03-02-24 19:28,657.88,Withdrawal,ATM Withdrawal,4313.353859
23065,720301458,03-03-24 13:28,749.73,IncomingTransfer,Freelance Payment,5063.083859
23066,720301458,03-04-24 21:28,15000,IncomingTransfer,Salary,20063.08386
23067,720301458,03-05-24 19:28,333.35,Return,Store Return,20396.43386
23068,720301458,03-09-24 21:28,2300,Payment,Credit Card Payment,18096.43386
23069,720301458,03-10-24 12:28,321.48,Purchase,Home Improvement,17774.95386
23070,720301458,03-12-24 21:28,5500,Payment,Subscription Payment,12274.95386
23071,720301458,3-15-24 9:28,748.58,Deposit,Direct Deposit,13023.53386
23072,720301458,3-15-24 16:28,727.61,Withdrawal,ATM Withdrawal,12295.92386
23073,720301458,3-15-24 19:28,758.94,OutgoingTransfer,Bank Transfer,11536.98386
23074,720301458,3-17-24 17:28,486.82,OutgoingTransfer,Wire Transfer,11050.16386
23075,720301458,3-22-24 19:28,483.73,Purchase,Clothing,10566.43386
23076,720301458,3-25-24 10:28,391.27,OnlineShopping,eBay,10175.16386
23077,720301458,3-25-24 23:28,835.24,Deposit,Direct Deposit,11010.40386
23078,720301458,3-31-24 16:28,902.4,Withdrawal,Mobile App Withdrawal,10108.00386
23079,720301458,04-02-24 9:28,298.43,Purchase,Gas,9809.573859
23080,720301458,04-05-24 21:28,15000,IncomingTransfer,Salary,24809.57386
23081,720301458,04-07-24 14:28,467.05,Withdrawal,Branch Withdrawal,24342.52386
23082,720301458,04-10-24 21:28,2500,Payment,Credit Card Payment,21842.52386
23083,720301458,04-10-24 21:28,6000,Payment,Installment Payment,15842.52386
23084,720301458,04-11-24 15:28,259.92,Payment,Bill Payment,15582.60386
23085,720301458,04-11-24 17:28,613.25,Deposit,Direct Deposit,16195.85386
23086,720301458,04-12-24 12:28,392.25,Deposit,Direct Deposit,16588.10386
23087,720301458,4-16-24 19:28,766.82,Withdrawal,Mobile App Withdrawal,15821.28386
23088,720301458,4-19-24 11:28,662.95,Withdrawal,ATM Withdrawal,15158.33386
23089,720301458,4-19-24 18:28,463.08,Deposit,Direct Deposit,15621.41386
23090,720301458,4-26-24 22:28,498.65,Payment,Loan Payment,15122.76386
23091,720301458,4-27-24 15:28,338.52,IncomingTransfer,Freelance Payment,15461.28386
23092,720301458,05-02-24 15:28,857.76,Purchase,Gas,14603.52386
23093,720301458,05-02-24 21:28,15000,IncomingTransfer,Salary,29603.52386
23094,720301458,05-04-24 19:28,428.87,Deposit,Check Deposit,30032.39386
23095,720301458,05-07-24 21:28,2400,Payment,Credit Card Payment,27632.39386
23096,720301458,05-08-24 16:28,228.58,Return,AliExpress Return,27860.97386
23097,720301458,05-10-24 19:28,770.37,Return,eBay Return,28631.34386
23098,720301458,05-11-24 21:28,5100,Payment,Insurance Payment,23531.34386
23099,720301458,5-15-24 14:28,630.34,Payment,Loan Payment,22901.00386
23100,720301458,5-19-24 12:28,837.75,Return,Amazon Return,23738.75386
23101,720301458,5-21-24 14:28,730.07,Purchase,Travel,23008.68386
23102,720301458,5-22-24 19:28,689.89,Deposit,Mobile Deposit,23698.57386
23103,720301458,5-24-24 9:28,362.79,OutgoingTransfer,Wire Transfer,23335.78386
23104,720301458,5-24-24 20:28,673.1,Deposit,Direct Deposit,24008.88386
23105,720301458,5-30-24 17:28,313.52,Return,Walmart Return,24322.40386
23106,720301458,5-31-24 20:28,471.18,Purchase,Grocery,23851.22386
23107,720301458,06-01-24 13:28,431.71,Purchase,Restaurant,23419.51386
23108,720301458,06-03-24 10:28,843.95,Purchase,Clothing,22575.56386
23109,720301458,06-03-24 21:28,15000,IncomingTransfer,Salary,37575.56386
23110,720301458,06-08-24 19:28,255.15,Return,Store Return,37830.71386
23111,720301458,06-08-24 21:28,2300,Payment,Credit Card Payment,35530.71386
23112,720301458,06-10-24 21:28,5900,Payment,Subscription Payment,29630.71386
23113,720301458,06-11-24 13:28,272.76,Purchase,Home Improvement,29357.95386
23114,720301458,6-13-24 19:28,841.59,Withdrawal,Mobile App Withdrawal,28516.36386
23115,720301458,6-19-24 15:28,494.13,Withdrawal,Mobile App Withdrawal,28022.23386
23116,720301458,6-22-24 12:28,413.47,Purchase,Furniture,27608.76386
23117,720301458,6-23-24 15:28,746.66,Withdrawal,Mobile App Withdrawal,26862.10386
23118,720301458,6-23-24 21:28,243.82,OnlineShopping,Etsy,26618.28386
23119,720301458,6-26-24 16:28,921.92,Deposit,Cash Deposit,27540.20386
23120,720301458,6-28-24 11:28,363.25,Withdrawal,Mobile App Withdrawal,27176.95386
23121,720301458,6-29-24 18:28,711.54,OutgoingTransfer,International Transfer,26465.41386
23122,720301458,07-01-24 13:28,754.69,Purchase,Clothing,25710.72386
23123,720301458,07-02-24 21:28,15000,IncomingTransfer,Salary,40710.72386
23124,720301458,07-03-24 13:28,845.39,OnlineShopping,eBay,39865.33386
23125,720301458,07-04-24 17:28,929.5,Deposit,Cash Deposit,40794.83386
23126,720301458,07-04-24 20:28,552.25,Deposit,Mobile Deposit,41347.08386
23127,720301458,07-07-24 21:28,2400,Payment,Credit Card Payment,38947.08386
23128,720301458,07-09-24 19:28,739.92,Deposit,Direct Deposit,39687.00386
23129,720301458,07-10-24 20:28,568.16,OutgoingTransfer,Bank Transfer,39118.84386
23130,720301458,07-11-24 16:28,659.26,Withdrawal,Branch Withdrawal,38459.58386
23131,720301458,7-14-24 21:28,6300,Payment,Installment Payment,32159.58386
23132,720307683,1-20-24 15:28,125.9,Deposit,Check Deposit,539.6257534
23133,720307683,1-25-24 20:28,66.92,IncomingTransfer,Freelance Payment,606.5457534
23134,720307683,1-30-24 18:28,205.98,Purchase,Travel,400.5657534
23135,720307683,1-31-24 13:28,60.49,Payment,Mortgage Payment,340.0757534
23136,720307683,02-02-24 23:28,152.24,Withdrawal,Mobile App Withdrawal,187.8357534
23137,720307683,02-03-24 21:28,219.89,Payment,Mortgage Payment,-32.05424657
23138,720307683,02-07-24 12:28,170.99,OnlineShopping,Etsy,-203.0442466
23139,720307683,02-07-24 22:28,124.63,Payment,Bill Payment,-327.6742466
23140,720307683,2-14-24 14:28,79.04,OutgoingTransfer,Wire Transfer,-406.7142466
23141,720307683,2-16-24 18:28,112.68,Withdrawal,ATM Withdrawal,-519.3942466
23142,720307683,2-18-24 20:28,148.39,Payment,Bill Payment,-667.7842466
23143,720307683,2-23-24 21:28,84.98,Return,eBay Return,-582.8042466
23144,720307683,2-24-24 15:28,140.9,Purchase,Grocery,-723.7042466
23145,720307683,2-26-24 18:28,209.99,Purchase,Electronics,-933.6942466
23146,720307683,2-27-24 11:28,241.31,Deposit,Direct Deposit,-692.3842466
23147,720307683,2-29-24 9:28,171.49,Deposit,Mobile Deposit,-520.8942466
23148,720307683,03-03-24 21:28,177.97,Purchase,Entertainment,-698.8642466
23149,720307683,03-10-24 13:28,88.1,OutgoingTransfer,Wire Transfer,-786.9642466
23150,720307683,3-14-24 19:28,176.07,Return,Store Return,-610.8942466
23151,720307683,3-14-24 19:28,182.36,OutgoingTransfer,Bank Transfer,-793.2542466
23152,720307683,3-16-24 20:28,10.58,OutgoingTransfer,International Transfer,-803.8342466
23153,720307683,3-22-24 16:28,177.65,Deposit,Mobile Deposit,-626.1842466
23154,720307683,3-22-24 23:28,242.8,Deposit,Mobile Deposit,-383.3842466
23155,720307683,3-23-24 13:28,30.06,OnlineShopping,Target,-413.4442466
23156,720307683,3-23-24 15:28,51.11,IncomingTransfer,Freelance Payment,-362.3342466
23157,720307683,3-24-24 21:28,115.77,Payment,Mortgage Payment,-478.1042466
23158,720307683,04-02-24 9:28,147.41,Deposit,Mobile Deposit,-330.6942466
23159,720307683,04-02-24 14:28,120.77,Deposit,Direct Deposit,-209.9242466
23160,720307683,04-04-24 17:28,229.91,Withdrawal,ATM Withdrawal,-439.8342466
23161,720307683,04-08-24 18:28,212.58,Purchase,Gas,-652.4142466
23162,720307683,04-08-24 21:28,97.87,OutgoingTransfer,Wire Transfer,-750.2842466
23163,720307683,04-09-24 21:28,86.74,Return,Store Return,-663.5442466
23164,720307683,04-10-24 11:28,54.08,Withdrawal,Mobile App Withdrawal,-717.6242466
23165,720307683,04-11-24 21:28,84.21,OnlineShopping,Etsy,-801.8342466
23166,720307683,4-13-24 17:28,43.21,Purchase,Grocery,-845.0442466
23167,720307683,4-20-24 18:28,52.75,Purchase,Electronics,-897.7942466
23168,720307683,4-22-24 15:28,133.46,Deposit,Check Deposit,-764.3342466
23169,720307683,4-22-24 21:28,99.91,Return,Store Return,-664.4242466
23170,720307683,4-28-24 12:28,96.87,IncomingTransfer,Freelance Payment,-567.5542466
23171,720307683,4-29-24 23:28,222.99,Deposit,Direct Deposit,-344.5642466
23172,720307683,05-07-24 14:28,99.52,Return,Store Return,-245.0442466
23173,720307683,05-12-24 16:28,136.09,Payment,Loan Payment,-381.1342466
23174,720307683,5-15-24 17:28,11.69,OnlineShopping,Walmart,-392.8242466
23175,720307683,5-16-24 18:28,87.85,Withdrawal,Mobile App Withdrawal,-480.6742466
23176,720307683,5-18-24 21:28,165.63,Payment,Mortgage Payment,-646.3042466
23177,720307683,5-19-24 19:28,187.11,Withdrawal,Branch Withdrawal,-833.4142466
23178,720307683,5-22-24 14:28,222.06,Purchase,Home Improvement,-1055.474247
23179,720307683,5-23-24 14:28,151.63,Payment,Mortgage Payment,-1207.104247
23180,720307683,5-28-24 14:28,228.56,Withdrawal,Mobile App Withdrawal,-1435.664247
23181,720307683,5-31-24 12:28,197.33,OnlineShopping,Etsy,-1632.994247
23182,720307683,5-31-24 22:28,83.68,Payment,Bill Payment,-1716.674247
23183,720307683,06-03-24 11:28,224.02,Withdrawal,Branch Withdrawal,-1940.694247
23184,720307683,06-09-24 21:28,116.89,OutgoingTransfer,Bank Transfer,-2057.584247
23185,720307683,06-10-24 15:28,53.33,Payment,Bill Payment,-2110.914247
23186,720307683,06-10-24 21:28,30.75,OnlineShopping,AliExpress,-2141.664247
23187,720307683,6-14-24 18:28,67.1,Purchase,Clothing,-2208.764247
23188,720307683,6-15-24 21:28,89.25,Deposit,Direct Deposit,-2119.514247
23189,720307683,6-17-24 11:28,55.8,Deposit,Check Deposit,-2063.714247
23190,720307683,6-18-24 18:28,10.89,IncomingTransfer,Freelance Payment,-2052.824247
23191,720307683,6-20-24 15:28,198.94,Withdrawal,Mobile App Withdrawal,-2251.764247
23192,720307683,6-20-24 20:28,73.04,Purchase,Electronics,-2324.804247
23193,720307683,6-21-24 12:28,27.09,Deposit,Cash Deposit,-2297.714247
23194,720307683,6-22-24 14:28,45.8,Deposit,Direct Deposit,-2251.914247
23195,720307683,6-24-24 12:28,245.85,OnlineShopping,Amazon,-2497.764247
23196,720307683,6-27-24 13:28,23.54,Return,Amazon Return,-2474.224247
23197,720307683,6-28-24 23:28,82.33,Deposit,Mobile Deposit,-2391.894247
23198,720307683,6-29-24 14:28,54.92,Withdrawal,ATM Withdrawal,-2446.814247
23199,720307683,07-04-24 12:28,116.18,Deposit,Mobile Deposit,-2330.634247
23200,720307683,07-06-24 21:28,121.24,OnlineShopping,Amazon,-2451.874247
23201,720307683,07-09-24 14:28,120.41,Return,Amazon Return,-2331.464247
23202,720307683,07-10-24 9:28,91.41,Withdrawal,Branch Withdrawal,-2422.874247
23203,720307683,07-10-24 10:28,158.01,IncomingTransfer,Freelance Payment,-2264.864247
23204,720307683,07-10-24 17:28,54.03,Return,Amazon Return,-2210.834247
23205,720307683,07-10-24 19:28,93.42,OutgoingTransfer,Wire Transfer,-2304.254247
23206,720307683,07-12-24 15:28,134.27,Deposit,Direct Deposit,-2169.984247
23207,720307683,07-12-24 15:28,200.15,Deposit,Mobile Deposit,-1969.834247
23208,720307683,07-12-24 22:28,142.86,Return,Walmart Return,-1826.974247
23209,720307683,7-17-24 12:28,124.39,Purchase,Entertainment,-1951.364247
23210,720314583,1-29-24 10:28,588.58,OutgoingTransfer,Bank Transfer,596.288713
23211,720314583,02-03-24 19:28,512.39,OnlineShopping,Target,83.89871299
23212,720314583,02-05-24 13:28,109.34,Purchase,Clothing,-25.44128701
23213,720314583,02-05-24 21:28,6700,IncomingTransfer,Salary,6674.558713
23214,720314583,02-08-24 13:28,654.67,OnlineShopping,Target,6019.888713
23215,720314583,02-10-24 14:28,246.95,Withdrawal,ATM Withdrawal,5772.938713
23216,720314583,02-10-24 21:28,1900,Payment,Credit Card Payment,3872.938713
23217,720314583,02-12-24 21:28,2700,Payment,Subscription Payment,1172.938713
23218,720314583,2-19-24 11:28,598.86,Return,Best Buy Return,1771.798713
23219,720314583,2-21-24 15:28,662.2,Withdrawal,Mobile App Withdrawal,1109.598713
23220,720314583,2-25-24 13:28,556.81,Purchase,Travel,552.788713
23221,720314583,03-03-24 14:28,730.53,Withdrawal,Branch Withdrawal,-177.741287
23222,720314583,03-03-24 21:28,6700,IncomingTransfer,Salary,6522.258713
23223,720314583,03-06-24 9:28,513.48,Purchase,Home Improvement,6008.778713
23224,720314583,03-08-24 21:28,2400,Payment,Credit Card Payment,3608.778713
23225,720314583,03-12-24 14:28,265.61,IncomingTransfer,Freelance Payment,3874.388713
23226,720314583,3-15-24 22:28,557.9,Payment,Mortgage Payment,3316.488713
23227,720314583,3-16-24 21:28,2700,Payment,Installment Payment,616.488713
23228,720314583,3-17-24 10:28,334.36,OutgoingTransfer,Peer-to-Peer Transfer,282.128713
23229,720314583,04-04-24 21:28,6700,IncomingTransfer,Salary,6982.128713
23230,720314583,04-05-24 13:28,379.38,Withdrawal,Branch Withdrawal,6602.748713
23231,720314583,04-07-24 14:28,670.39,Purchase,Restaurant,5932.358713
23232,720314583,04-08-24 12:28,405.53,OutgoingTransfer,Wire Transfer,5526.828713
23233,720314583,04-09-24 21:28,2800,Payment,Credit Card Payment,2726.828713
23234,720314583,04-11-24 14:28,228.73,Deposit,Cash Deposit,2955.558713
23235,720314583,4-13-24 21:28,2300,Payment,Insurance Payment,655.558713
23236,720314583,4-22-24 19:28,722.51,OutgoingTransfer,Bank Transfer,-66.95128701
23237,720314583,4-23-24 16:28,409.7,OutgoingTransfer,Bank Transfer,-476.651287
23238,720314583,05-03-24 21:28,6700,IncomingTransfer,Salary,6223.348713
23239,720314583,05-04-24 10:28,732.11,Purchase,Clothing,5491.238713
23240,720314583,05-06-24 20:28,408.25,OutgoingTransfer,Bank Transfer,5082.988713
23241,720314583,05-08-24 21:28,1900,Payment,Credit Card Payment,3182.988713
23242,720314583,05-11-24 10:28,326.96,Withdrawal,Branch Withdrawal,2856.028713
23243,720314583,5-15-24 21:28,2800,Payment,Insurance Payment,56.02871299
23244,720314583,5-18-24 22:28,190.07,Return,Best Buy Return,246.098713
23245,720314583,5-20-24 23:28,413.98,OutgoingTransfer,Peer-to-Peer Transfer,-167.881287
23246,720314583,5-30-24 18:28,228.5,IncomingTransfer,Freelance Payment,60.61871299
23247,720314583,06-03-24 21:28,6700,IncomingTransfer,Salary,6760.618713
23248,720314583,06-07-24 12:28,104.74,Purchase,Furniture,6655.878713
23249,720314583,06-08-24 21:28,2400,Payment,Credit Card Payment,4255.878713
23250,720314583,06-12-24 10:28,266.5,Deposit,Mobile Deposit,4522.378713
23251,720314583,06-12-24 21:28,2100,Payment,Subscription Payment,2422.378713
23252,720314583,6-19-24 10:28,405.29,Return,AliExpress Return,2827.668713
23253,720314583,6-20-24 11:28,440.62,Withdrawal,ATM Withdrawal,2387.048713
23254,720314583,6-22-24 11:28,177.84,IncomingTransfer,Freelance Payment,2564.888713
23255,720314583,6-30-24 12:28,690.2,Purchase,Pharmacy,1874.688713
23256,720314583,07-04-24 21:28,6700,IncomingTransfer,Salary,8574.688713
23257,720314583,07-09-24 21:28,1900,Payment,Credit Card Payment,6674.688713
23258,720314583,7-13-24 20:28,200.92,Withdrawal,Branch Withdrawal,6473.768713
23259,720314583,7-13-24 21:28,2000,Payment,Insurance Payment,4473.768713
23260,720314583,7-16-24 22:28,418.76,OnlineShopping,Amazon,4055.008713
23261,720356133,1-20-24 21:28,23.53,OutgoingTransfer,Bank Transfer,784.8831782
23262,720356133,1-21-24 18:28,105.37,Deposit,Direct Deposit,890.2531782
23263,720356133,1-22-24 10:28,325.36,IncomingTransfer,Freelance Payment,1215.613178
23264,720356133,1-22-24 10:28,217.46,Deposit,Direct Deposit,1433.073178
23265,720356133,1-24-24 14:28,460.08,OutgoingTransfer,Peer-to-Peer Transfer,972.9931782
23266,720356133,1-25-24 21:28,277.93,Payment,Loan Payment,695.0631782
23267,720356133,1-30-24 10:28,267.67,Withdrawal,ATM Withdrawal,427.3931782
23268,720356133,1-31-24 22:28,86.65,Purchase,Travel,340.7431782
23269,720356133,02-01-24 20:28,106.1,Payment,Mortgage Payment,234.6431782
23270,720356133,02-03-24 11:28,111.57,OutgoingTransfer,Peer-to-Peer Transfer,123.0731782
23271,720356133,02-04-24 21:28,7600,IncomingTransfer,Salary,7723.073178
23272,720356133,02-06-24 15:28,379.32,Purchase,Home Improvement,7343.753178
23273,720356133,02-09-24 12:28,403.96,Purchase,Pharmacy,6939.793178
23274,720356133,02-09-24 21:28,2100,Payment,Credit Card Payment,4839.793178
23275,720356133,2-14-24 9:28,245.34,OutgoingTransfer,International Transfer,4594.453178
23276,720356133,2-15-24 22:28,354.04,Deposit,Cash Deposit,4948.493178
23277,720356133,2-16-24 21:28,3400,Payment,Subscription Payment,1548.493178
23278,720356133,2-20-24 16:28,225.4,Deposit,Direct Deposit,1773.893178
23279,720356133,2-21-24 13:28,422.16,OnlineShopping,Best Buy,1351.733178
23280,720356133,2-22-24 20:28,321.61,Return,Store Return,1673.343178
23281,720356133,2-22-24 21:28,129.79,Deposit,Cash Deposit,1803.133178
23282,720356133,2-22-24 23:28,329.27,Return,AliExpress Return,2132.403178
23283,720356133,2-23-24 15:28,48.75,Return,Etsy Return,2181.153178
23284,720356133,2-23-24 19:28,96.49,IncomingTransfer,Freelance Payment,2277.643178
23285,720356133,2-25-24 20:28,197.51,Purchase,Entertainment,2080.133178
23286,720356133,2-28-24 22:28,444.89,OutgoingTransfer,International Transfer,1635.243178
23287,720356133,03-02-24 20:28,302.85,Deposit,Cash Deposit,1938.093178
23288,720356133,03-03-24 21:28,7600,IncomingTransfer,Salary,9538.093178
23289,720356133,03-04-24 17:28,182.63,Withdrawal,Branch Withdrawal,9355.463178
23290,720356133,03-05-24 16:28,24.49,OutgoingTransfer,Peer-to-Peer Transfer,9330.973178
23291,720356133,03-05-24 20:28,83.53,Return,Best Buy Return,9414.503178
23292,720356133,03-08-24 21:28,1500,Payment,Credit Card Payment,7914.503178
23293,720356133,03-09-24 16:28,163.62,Withdrawal,ATM Withdrawal,7750.883178
23294,720356133,03-09-24 19:28,88.34,IncomingTransfer,Freelance Payment,7839.223178
23295,720356133,03-11-24 22:28,173.05,OnlineShopping,Etsy,7666.173178
23296,720356133,3-13-24 17:28,299.01,Deposit,Check Deposit,7965.183178
23297,720356133,3-14-24 19:28,237.34,Purchase,Travel,7727.843178
23298,720356133,3-15-24 21:28,2200,Payment,Installment Payment,5527.843178
23299,720356133,3-16-24 22:28,115.65,Deposit,Cash Deposit,5643.493178
23300,720356133,3-17-24 20:28,295.17,OnlineShopping,Best Buy,5348.323178
23301,720356133,3-22-24 17:28,138.79,IncomingTransfer,Freelance Payment,5487.113178
23302,720356133,3-26-24 23:28,185.48,Deposit,Mobile Deposit,5672.593178
23303,720356133,3-29-24 21:28,81.06,Purchase,Electronics,5591.533178
23304,720356133,3-30-24 12:28,221.5,OnlineShopping,Etsy,5370.033178
23305,720356133,3-30-24 16:28,393.7,OutgoingTransfer,International Transfer,4976.333178
23306,720356133,3-31-24 21:28,332.41,Deposit,Mobile Deposit,5308.743178
23307,720356133,04-01-24 18:28,487.36,Purchase,Pharmacy,4821.383178
23308,720356133,04-01-24 23:28,372.1,Withdrawal,Mobile App Withdrawal,4449.283178
23309,720356133,04-02-24 10:28,42.16,Purchase,Electronics,4407.123178
23310,720356133,04-03-24 13:28,266.22,Withdrawal,Mobile App Withdrawal,4140.903178
23311,720356133,04-04-24 11:28,258.32,Purchase,Clothing,3882.583178
23312,720356133,04-04-24 18:28,82.43,Purchase,Grocery,3800.153178
23313,720356133,04-05-24 21:28,7600,IncomingTransfer,Salary,11400.15318
23314,720356133,04-06-24 12:28,119.54,Payment,Loan Payment,11280.61318
23315,720356133,04-08-24 20:28,238.21,Purchase,Home Improvement,11042.40318
23316,720356133,04-10-24 15:28,215.7,Purchase,Furniture,10826.70318
23317,720356133,04-10-24 17:28,114.33,Payment,Mortgage Payment,10712.37318
23318,720356133,04-10-24 21:28,2000,Payment,Credit Card Payment,8712.373178
23319,720356133,04-10-24 22:28,188,IncomingTransfer,Freelance Payment,8900.373178
23320,720356133,04-12-24 13:28,13.34,Return,Etsy Return,8913.713178
23321,720356133,04-12-24 21:28,490.51,Deposit,Check Deposit,9404.223178
23322,720356133,4-13-24 16:28,401,Deposit,Direct Deposit,9805.223178
23323,720356133,4-15-24 20:28,105.47,OnlineShopping,Amazon,9699.753178
23324,720356133,4-16-24 22:28,134.65,Deposit,Check Deposit,9834.403178
23325,720356133,4-18-24 21:28,2900,Payment,Insurance Payment,6934.403178
23326,720356133,4-19-24 9:28,359.24,OnlineShopping,Target,6575.163178
23327,720356133,4-19-24 9:28,490.51,Return,Etsy Return,7065.673178
23328,720356133,4-19-24 15:28,368.03,Purchase,Grocery,6697.643178
23329,720356133,4-20-24 19:28,452.6,Deposit,Mobile Deposit,7150.243178
23330,720356133,4-20-24 22:28,181.19,Deposit,Check Deposit,7331.433178
23331,720356133,4-23-24 15:28,263.67,Deposit,Direct Deposit,7595.103178
23332,720356133,4-24-24 18:28,74.43,Purchase,Electronics,7520.673178
23333,720356133,4-25-24 10:28,310.02,Deposit,Cash Deposit,7830.693178
23334,720356133,4-28-24 11:28,373.53,Purchase,Gas,7457.163178
23335,720356133,05-03-24 20:28,62.79,Withdrawal,Mobile App Withdrawal,7394.373178
23336,720356133,05-03-24 21:28,7600,IncomingTransfer,Salary,14994.37318
23337,720356133,05-03-24 23:28,350.92,Return,Walmart Return,15345.29318
23338,720356133,05-04-24 18:28,43.34,Deposit,Mobile Deposit,15388.63318
23339,720356133,05-08-24 21:28,1500,Payment,Credit Card Payment,13888.63318
23340,720356133,05-09-24 16:28,443.96,Return,eBay Return,14332.59318
23341,720356133,05-10-24 19:28,76.14,Purchase,Pharmacy,14256.45318
23342,720356133,5-15-24 21:28,2300,Payment,Insurance Payment,11956.45318
23343,720356133,5-17-24 13:28,195.27,Deposit,Check Deposit,12151.72318
23344,720356133,5-17-24 19:28,133.78,Purchase,Grocery,12017.94318
23345,720356133,5-19-24 21:28,176.88,Purchase,Furniture,11841.06318
23346,720356133,5-20-24 14:28,346.83,Purchase,Pharmacy,11494.23318
23347,720356133,5-21-24 16:28,200.44,Purchase,Grocery,11293.79318
23348,720356133,5-22-24 10:28,335.49,Return,eBay Return,11629.28318
23349,720356133,5-24-24 9:28,352.75,Purchase,Electronics,11276.53318
23350,720356133,5-28-24 17:28,400.84,OutgoingTransfer,International Transfer,10875.69318
23351,720356133,5-29-24 12:28,409.57,Return,Best Buy Return,11285.26318
23352,720356133,5-30-24 13:28,429.1,Withdrawal,Mobile App Withdrawal,10856.16318
23353,720356133,06-01-24 21:28,7600,IncomingTransfer,Salary,18456.16318
23354,720356133,06-03-24 16:28,404.17,OutgoingTransfer,International Transfer,18051.99318
23355,720356133,06-04-24 15:28,291.03,Payment,Loan Payment,17760.96318
23356,720356133,06-06-24 21:28,1600,Payment,Credit Card Payment,16160.96318
23357,720356133,06-08-24 11:28,289.33,OnlineShopping,eBay,15871.63318
23358,720356133,06-08-24 16:28,266.65,Deposit,Mobile Deposit,16138.28318
23359,720356133,06-08-24 18:28,382.8,Purchase,Travel,15755.48318
23360,720356133,06-08-24 22:28,37.84,Deposit,Check Deposit,15793.32318
23361,720356133,06-09-24 11:28,117.64,Withdrawal,Branch Withdrawal,15675.68318
23362,720356133,06-09-24 19:28,305.18,Deposit,Mobile Deposit,15980.86318
23363,720356133,06-11-24 17:28,45.43,Withdrawal,Branch Withdrawal,15935.43318
23364,720356133,6-13-24 23:28,408.24,Withdrawal,ATM Withdrawal,15527.19318
23365,720356133,6-14-24 22:28,272.26,Payment,Bill Payment,15254.93318
23366,720356133,6-15-24 14:28,76.87,OnlineShopping,Etsy,15178.06318
23367,720356133,6-18-24 21:28,2100,Payment,Subscription Payment,13078.06318
23368,720356133,6-25-24 12:28,101.14,Payment,Bill Payment,12976.92318
23369,720356133,6-26-24 13:28,242.88,Withdrawal,ATM Withdrawal,12734.04318
23370,720356133,6-27-24 21:28,244.92,Withdrawal,Branch Withdrawal,12489.12318
23371,720356133,6-27-24 21:28,198.67,Withdrawal,Mobile App Withdrawal,12290.45318
23372,720356133,07-04-24 11:28,482.54,Purchase,Furniture,11807.91318
23373,720356133,07-04-24 21:28,7600,IncomingTransfer,Salary,19407.91318
23374,720356133,07-07-24 21:28,94.71,OutgoingTransfer,Bank Transfer,19313.20318
23375,720356133,07-09-24 21:28,1700,Payment,Credit Card Payment,17613.20318
23376,720356133,07-11-24 17:28,490.16,Withdrawal,Mobile App Withdrawal,17123.04318
23377,720356133,07-12-24 16:28,351.51,Deposit,Check Deposit,17474.55318
23378,720356133,7-15-24 21:28,2200,Payment,Subscription Payment,15274.55318
23379,720356133,7-16-24 14:28,142.8,Purchase,Entertainment,15131.75318
23380,720370533,1-21-24 11:28,461.16,Return,eBay Return,461.16
23381,720370533,1-22-24 14:28,493.69,OutgoingTransfer,Bank Transfer,-32.53
23382,720370533,1-23-24 9:28,54.19,Deposit,Mobile Deposit,21.66
23383,720370533,1-30-24 19:28,190.47,OutgoingTransfer,Peer-to-Peer Transfer,-168.81
23384,720370533,02-01-24 21:28,6550,IncomingTransfer,Salary,6381.19
23385,720370533,02-07-24 16:28,435.44,OutgoingTransfer,Peer-to-Peer Transfer,5945.75
23386,720370533,02-10-24 21:28,4000,Payment,Rent Payment,1945.75
23387,720370533,2-21-24 19:28,74.1,Payment,Mortgage Payment,1871.65
23388,720370533,03-05-24 21:28,6550,IncomingTransfer,Salary,8421.65
23389,720370533,03-12-24 21:28,1900,Payment,Rent Payment,6521.65
23390,720370533,3-13-24 23:28,395.86,Purchase,Electronics,6125.79
23391,720370533,04-05-24 21:28,6550,IncomingTransfer,Salary,12675.79
23392,720370533,04-06-24 22:28,385.56,Return,Walmart Return,13061.35
23393,720370533,04-09-24 11:28,476.24,Payment,Bill Payment,12585.11
23394,720370533,04-10-24 21:28,3600,Payment,Rent Payment,8985.11
23395,720370533,05-05-24 21:28,6550,IncomingTransfer,Salary,15535.11
23396,720370533,05-06-24 16:28,142.3,Deposit,Cash Deposit,15677.41
23397,720370533,5-13-24 21:28,3800,Payment,Rent Payment,11877.41
23398,720370533,5-20-24 20:28,218.72,Purchase,Home Improvement,11658.69
23399,720370533,5-24-24 17:28,79.77,Purchase,Grocery,11578.92
23400,720370533,5-28-24 16:28,536.83,Purchase,Grocery,11042.09
23401,720370533,06-04-24 21:28,6550,IncomingTransfer,Salary,17592.09
23402,720370533,06-07-24 12:28,90.38,Return,Best Buy Return,17682.47
23403,720370533,06-10-24 21:28,3800,Payment,Rent Payment,13882.47
23404,720370533,07-03-24 13:28,340.42,Purchase,Electronics,13542.05
23405,720370533,07-04-24 21:28,6550,IncomingTransfer,Salary,20092.05
23406,720370533,7-16-24 21:28,2100,Payment,Rent Payment,17992.05
23407,720427683,1-20-24 12:28,648.6,OnlineShopping,Etsy,-648.6
23408,720427683,1-20-24 20:28,387.96,Purchase,Gas,-1036.56
23409,720427683,1-23-24 17:28,540.97,Return,Store Return,-495.59
23410,720427683,1-25-24 23:28,941,Purchase,Home Improvement,-1436.59
23411,720427683,02-03-24 21:28,12550,IncomingTransfer,Salary,11113.41
23412,720427683,02-05-24 20:28,705.91,Payment,Mortgage Payment,10407.5
23413,720427683,02-06-24 14:28,648.05,OnlineShopping,AliExpress,9759.45
23414,720427683,02-10-24 21:28,3500,Payment,Insurance Payment,6259.45
23415,720427683,02-12-24 13:28,217.45,OutgoingTransfer,International Transfer,6042
23416,720427683,2-19-24 11:28,730.77,OnlineShopping,Walmart,5311.23
23417,720427683,2-25-24 21:28,922.26,Deposit,Mobile Deposit,6233.49
23418,720427683,2-27-24 17:28,373.13,Deposit,Check Deposit,6606.62
23419,720427683,2-29-24 11:28,853.43,Return,Etsy Return,7460.05
23420,720427683,03-02-24 18:28,874.57,Purchase,Restaurant,6585.48
23421,720427683,03-04-24 22:28,663.81,Payment,Mortgage Payment,5921.67
23422,720427683,03-05-24 21:28,12550,IncomingTransfer,Salary,18471.67
23423,720427683,03-06-24 18:28,497,Return,Walmart Return,18968.67
23424,720427683,03-12-24 17:28,457.68,OnlineShopping,Amazon,18510.99
23425,720427683,3-17-24 21:28,4600,Payment,Insurance Payment,13910.99
23426,720427683,3-19-24 19:28,449.54,Withdrawal,Branch Withdrawal,13461.45
23427,720427683,3-21-24 9:28,887.82,Purchase,Restaurant,12573.63
23428,720427683,3-28-24 23:28,707.13,OnlineShopping,Walmart,11866.5
23429,720427683,04-02-24 17:28,269.99,OnlineShopping,Walmart,11596.51
23430,720427683,04-02-24 21:28,12550,IncomingTransfer,Salary,24146.51
23431,720427683,04-11-24 10:28,903.79,OutgoingTransfer,Bank Transfer,23242.72
23432,720427683,04-12-24 21:28,3900,Payment,Installment Payment,19342.72
23433,720427683,4-15-24 14:28,308.04,OnlineShopping,Target,19034.68
23434,720427683,4-19-24 17:28,233.43,Withdrawal,ATM Withdrawal,18801.25
23435,720427683,4-20-24 21:28,532.22,OutgoingTransfer,Bank Transfer,18269.03
23436,720427683,4-22-24 13:28,819.3,OnlineShopping,AliExpress,17449.73
23437,720427683,4-27-24 10:28,471.27,Purchase,Grocery,16978.46
23438,720427683,4-28-24 13:28,830.35,Deposit,Direct Deposit,17808.81
23439,720427683,05-02-24 12:28,651.85,Purchase,Clothing,17156.96
23440,720427683,05-05-24 21:28,12550,IncomingTransfer,Salary,29706.96
23441,720427683,05-11-24 13:28,287.42,Purchase,Restaurant,29419.54
23442,720427683,05-11-24 21:28,915.77,Return,Best Buy Return,30335.31
23443,720427683,05-12-24 16:28,344.32,Return,Walmart Return,30679.63
23444,720427683,05-12-24 16:28,933.84,Payment,Mortgage Payment,29745.79
23445,720427683,5-14-24 12:28,342.87,OutgoingTransfer,International Transfer,29402.92
23446,720427683,5-16-24 21:28,624.7,Deposit,Check Deposit,30027.62
23447,720427683,5-18-24 21:28,3400,Payment,Installment Payment,26627.62
23448,720427683,5-22-24 19:28,337.63,Deposit,Direct Deposit,26965.25
23449,720427683,06-02-24 21:28,12550,IncomingTransfer,Salary,39515.25
23450,720427683,06-06-24 18:28,675.05,Purchase,Electronics,38840.2
23451,720427683,06-07-24 15:28,373.19,IncomingTransfer,Freelance Payment,39213.39
23452,720427683,06-08-24 11:28,280.35,OnlineShopping,Best Buy,38933.04
23453,720427683,06-11-24 21:28,244.24,Deposit,Direct Deposit,39177.28
23454,720427683,06-12-24 21:28,5500,Payment,Installment Payment,33677.28
23455,720427683,6-15-24 19:28,667.21,OutgoingTransfer,International Transfer,33010.07
23456,720427683,6-20-24 11:28,397.09,Deposit,Cash Deposit,33407.16
23457,720427683,6-22-24 18:28,533.19,Return,Amazon Return,33940.35
23458,720427683,6-28-24 22:28,378.27,Return,Amazon Return,34318.62
23459,720427683,6-30-24 12:28,930.58,Payment,Mortgage Payment,33388.04
23460,720427683,07-03-24 19:28,414.99,Purchase,Entertainment,32973.05
23461,720427683,07-05-24 21:28,12550,IncomingTransfer,Salary,45523.05
23462,720427683,07-09-24 13:28,325.06,Withdrawal,ATM Withdrawal,45197.99
23463,720427683,07-11-24 12:28,679.12,Return,Best Buy Return,45877.11
23464,720427683,07-11-24 23:28,395.04,Payment,Loan Payment,45482.07
23465,720427683,07-12-24 15:28,365.7,Withdrawal,Branch Withdrawal,45116.37
23466,720427683,7-13-24 21:28,3600,Payment,Subscription Payment,41516.37
23467,720430083,1-24-24 9:28,189.36,OnlineShopping,eBay,658.1669307
23468,720430083,1-28-24 20:28,175.37,Purchase,Restaurant,482.7969307
23469,720430083,1-29-24 12:28,85.07,Withdrawal,Mobile App Withdrawal,397.7269307
23470,720430083,1-30-24 10:28,174.26,Withdrawal,Mobile App Withdrawal,223.4669307
23471,720430083,1-31-24 15:28,80.71,Return,eBay Return,304.1769307
23472,720430083,02-04-24 21:28,1800,IncomingTransfer,Salary,2104.176931
23473,720430083,02-06-24 11:28,68.25,Purchase,Home Improvement,2035.926931
23474,720430083,02-08-24 15:28,243.61,OnlineShopping,AliExpress,1792.316931
23475,720430083,02-09-24 16:28,233.87,Withdrawal,ATM Withdrawal,1558.446931
23476,720430083,02-09-24 21:28,1100,Payment,Credit Card Payment,458.4469307
23477,720430083,02-12-24 14:28,239.58,Return,Best Buy Return,698.0269307
23478,720430083,2-13-24 21:28,1000,Payment,Rent Payment,-301.9730693
23479,720430083,2-16-24 12:28,201.76,Withdrawal,Mobile App Withdrawal,-503.7330693
23480,720430083,2-19-24 15:28,166.51,OutgoingTransfer,Bank Transfer,-670.2430693
23481,720430083,2-26-24 13:28,154.34,OutgoingTransfer,Wire Transfer,-824.5830693
23482,720430083,2-27-24 12:28,111.3,Payment,Bill Payment,-935.8830693
23483,720430083,2-28-24 11:28,133.02,Payment,Mortgage Payment,-1068.903069
23484,720430083,2-28-24 12:28,249.53,OnlineShopping,Etsy,-1318.433069
23485,720430083,2-29-24 9:28,121.02,Purchase,Travel,-1439.453069
23486,720430083,2-29-24 22:28,144.74,Purchase,Home Improvement,-1584.193069
23487,720430083,03-04-24 23:28,86.67,OnlineShopping,eBay,-1670.863069
23488,720430083,03-05-24 21:28,1800,IncomingTransfer,Salary,129.1369307
23489,720430083,03-08-24 23:28,42.15,Deposit,Direct Deposit,171.2869307
23490,720430083,03-10-24 21:28,1400,Payment,Credit Card Payment,-1228.713069
23491,720430083,03-10-24 21:28,1100,Payment,Rent Payment,-2328.713069
23492,720430083,03-11-24 19:28,55.22,Purchase,Clothing,-2383.933069
23493,720430083,3-16-24 11:28,154.57,Return,Target Return,-2229.363069
23494,720430083,3-19-24 21:28,136.65,Deposit,Mobile Deposit,-2092.713069
23495,720430083,3-23-24 20:28,44.31,OutgoingTransfer,International Transfer,-2137.023069
23496,720430083,3-25-24 20:28,98.63,OutgoingTransfer,International Transfer,-2235.653069
23497,720430083,3-25-24 23:28,71,Deposit,Direct Deposit,-2164.653069
23498,720430083,3-26-24 14:28,49.2,Deposit,Check Deposit,-2115.453069
23499,720430083,3-28-24 21:28,238.64,Purchase,Pharmacy,-2354.093069
23500,720430083,3-30-24 22:28,48.01,Withdrawal,ATM Withdrawal,-2402.103069
23501,720430083,04-02-24 12:28,105.61,OutgoingTransfer,International Transfer,-2507.713069
23502,720430083,04-03-24 21:28,1800,IncomingTransfer,Salary,-707.7130693
23503,720430083,04-06-24 13:28,93.33,Withdrawal,Branch Withdrawal,-801.0430693
23504,720430083,04-08-24 21:28,1300,Payment,Credit Card Payment,-2101.043069
23505,720430083,4-13-24 21:28,29.17,Withdrawal,Branch Withdrawal,-2130.213069
23506,720430083,4-14-24 19:28,245.3,Purchase,Travel,-2375.513069
23507,720430083,4-14-24 21:28,900,Payment,Rent Payment,-3275.513069
23508,720430083,4-19-24 14:28,153.78,Deposit,Check Deposit,-3121.733069
23509,720430083,4-25-24 9:28,224.86,Withdrawal,Branch Withdrawal,-3346.593069
23510,720430083,4-25-24 20:28,19.35,Return,Best Buy Return,-3327.243069
23511,720430083,4-27-24 21:28,12.15,Deposit,Check Deposit,-3315.093069
23512,720430083,4-28-24 15:28,206.81,OutgoingTransfer,International Transfer,-3521.903069
23513,720430083,4-29-24 22:28,146.57,Payment,Bill Payment,-3668.473069
23514,720430083,05-01-24 21:28,1800,IncomingTransfer,Salary,-1868.473069
23515,720430083,05-01-24 23:28,28.94,Deposit,Check Deposit,-1839.533069
23516,720430083,05-02-24 20:28,232.5,Deposit,Mobile Deposit,-1607.033069
23517,720430083,05-03-24 21:28,245.89,Purchase,Gas,-1852.923069
23518,720430083,05-06-24 21:28,1200,Payment,Credit Card Payment,-3052.923069
23519,720430083,05-07-24 16:28,47.08,Return,eBay Return,-3005.843069
23520,720430083,05-10-24 13:28,122.33,Payment,Mortgage Payment,-3128.173069
23521,720430083,05-11-24 15:28,65.01,Payment,Mortgage Payment,-3193.183069
23522,720430083,05-12-24 16:28,12.28,Return,Etsy Return,-3180.903069
23523,720430083,05-12-24 21:28,1000,Payment,Rent Payment,-4180.903069
23524,720430083,5-15-24 19:28,243.85,Withdrawal,Branch Withdrawal,-4424.753069
23525,720430083,5-16-24 11:28,11.98,Deposit,Check Deposit,-4412.773069
23526,720430083,5-16-24 17:28,37.5,OutgoingTransfer,Bank Transfer,-4450.273069
23527,720430083,5-23-24 14:28,69.04,Purchase,Furniture,-4519.313069
23528,720430083,5-23-24 17:28,18.52,Purchase,Electronics,-4537.833069
23529,720430083,5-26-24 15:28,230.35,Withdrawal,Branch Withdrawal,-4768.183069
23530,720430083,5-29-24 11:28,109.44,Purchase,Entertainment,-4877.623069
23531,720430083,5-29-24 17:28,111.65,IncomingTransfer,Freelance Payment,-4765.973069
23532,720430083,06-05-24 21:28,1800,IncomingTransfer,Salary,-2965.973069
23533,720430083,06-07-24 11:28,156.19,OnlineShopping,Amazon,-3122.163069
23534,720430083,06-09-24 13:28,50.01,IncomingTransfer,Freelance Payment,-3072.153069
23535,720430083,06-10-24 9:28,100.97,Deposit,Cash Deposit,-2971.183069
23536,720430083,06-10-24 21:28,1000,Payment,Credit Card Payment,-3971.183069
23537,720430083,06-12-24 12:28,26.72,OutgoingTransfer,Wire Transfer,-3997.903069
23538,720430083,06-12-24 16:28,118.59,Deposit,Mobile Deposit,-3879.313069
23539,720430083,6-17-24 21:28,1000,Payment,Rent Payment,-4879.313069
23540,720430083,6-19-24 13:28,26.8,Payment,Loan Payment,-4906.113069
23541,720430083,6-23-24 13:28,248.5,Deposit,Cash Deposit,-4657.613069
23542,720430083,6-23-24 21:28,136.94,Deposit,Check Deposit,-4520.673069
23543,720430083,6-30-24 19:28,214.96,OutgoingTransfer,International Transfer,-4735.633069
23544,720430083,07-05-24 14:28,234.11,Deposit,Mobile Deposit,-4501.523069
23545,720430083,07-05-24 16:28,52.84,Deposit,Check Deposit,-4448.683069
23546,720430083,07-05-24 21:28,1800,IncomingTransfer,Salary,-2648.683069
23547,720430083,07-09-24 16:28,214.35,Purchase,Home Improvement,-2863.033069
23548,720430083,07-10-24 21:28,1000,Payment,Credit Card Payment,-3863.033069
23549,720430083,07-11-24 12:28,46.35,Deposit,Mobile Deposit,-3816.683069
23550,720430083,7-13-24 21:28,1100,Payment,Rent Payment,-4916.683069
23551,720430083,7-17-24 21:28,28.72,Return,AliExpress Return,-4887.963069
23552,720482583,1-22-24 9:28,468.34,Return,AliExpress Return,1598.307255
23553,720482583,1-22-24 12:28,339.98,OutgoingTransfer,Peer-to-Peer Transfer,1258.327255
23554,720482583,1-27-24 20:28,404.46,Deposit,Mobile Deposit,1662.787255
23555,720482583,1-28-24 16:28,147.55,Return,eBay Return,1810.337255
23556,720482583,1-29-24 18:28,318.67,OnlineShopping,Best Buy,1491.667255
23557,720482583,1-30-24 20:28,352.23,Withdrawal,ATM Withdrawal,1139.437255
23558,720482583,02-01-24 20:28,474.65,Purchase,Clothing,664.787255
23559,720482583,02-01-24 21:28,5200,IncomingTransfer,Salary,5864.787255
23560,720482583,02-02-24 14:28,199.35,Purchase,Gas,5665.437255
23561,720482583,02-02-24 23:28,26,OutgoingTransfer,Peer-to-Peer Transfer,5639.437255
23562,720482583,02-06-24 13:28,41.82,IncomingTransfer,Freelance Payment,5681.257255
23563,720482583,02-06-24 21:28,2300,Payment,Credit Card Payment,3381.257255
23564,720482583,02-10-24 19:28,427.21,OutgoingTransfer,Wire Transfer,2954.047255
23565,720482583,2-14-24 13:28,119.4,Return,Walmart Return,3073.447255
23566,720482583,2-14-24 21:28,2900,Payment,Rent Payment,173.447255
23567,720482583,2-17-24 11:28,200.25,Deposit,Cash Deposit,373.697255
23568,720482583,2-18-24 14:28,430.27,OnlineShopping,Target,-56.572745
23569,720482583,2-18-24 17:28,375.32,OutgoingTransfer,International Transfer,-431.892745
23570,720482583,2-29-24 19:28,19.28,OutgoingTransfer,Bank Transfer,-451.172745
23571,720482583,2-29-24 22:28,454.97,OnlineShopping,Amazon,-906.142745
23572,720482583,03-04-24 10:28,160.42,IncomingTransfer,Freelance Payment,-745.722745
23573,720482583,03-04-24 23:28,117.99,Withdrawal,Mobile App Withdrawal,-863.712745
23574,720482583,03-05-24 21:28,5200,IncomingTransfer,Salary,4336.287255
23575,720482583,03-08-24 20:28,190.84,Deposit,Direct Deposit,4527.127255
23576,720482583,03-09-24 17:28,483.9,Deposit,Check Deposit,5011.027255
23577,720482583,03-10-24 12:28,240.6,Payment,Bill Payment,4770.427255
23578,720482583,03-10-24 21:28,2900,Payment,Credit Card Payment,1870.427255
23579,720482583,03-11-24 23:28,45.25,Return,Walmart Return,1915.677255
23580,720482583,3-14-24 15:28,363.21,Purchase,Home Improvement,1552.467255
23581,720482583,3-14-24 21:28,1700,Payment,Rent Payment,-147.532745
23582,720482583,3-16-24 14:28,334.57,Payment,Bill Payment,-482.102745
23583,720482583,3-17-24 21:28,259.28,Deposit,Mobile Deposit,-222.822745
23584,720482583,3-20-24 21:28,164.02,Payment,Bill Payment,-386.842745
23585,720482583,3-25-24 22:28,441.56,Withdrawal,ATM Withdrawal,-828.402745
23586,720482583,3-26-24 15:28,494.68,Deposit,Cash Deposit,-333.722745
23587,720482583,3-27-24 12:28,377.02,Deposit,Direct Deposit,43.297255
23588,720482583,3-30-24 14:28,321.69,Withdrawal,Mobile App Withdrawal,-278.392745
23589,720482583,04-01-24 21:28,5200,IncomingTransfer,Salary,4921.607255
23590,720482583,04-05-24 19:28,499.71,Withdrawal,ATM Withdrawal,4421.897255
23591,720482583,04-06-24 21:28,3200,Payment,Credit Card Payment,1221.897255
23592,720482583,04-06-24 21:28,449.76,Deposit,Cash Deposit,1671.657255
23593,720482583,04-06-24 22:28,441.15,Deposit,Cash Deposit,2112.807255
23594,720482583,04-09-24 14:28,280.14,Return,Store Return,2392.947255
23595,720482583,4-13-24 21:28,2500,Payment,Rent Payment,-107.052745
23596,720482583,4-17-24 10:28,323,Payment,Mortgage Payment,-430.052745
23597,720482583,4-26-24 11:28,121.74,Purchase,Gas,-551.792745
23598,720482583,4-29-24 11:28,81.97,Payment,Loan Payment,-633.762745
23599,720482583,05-02-24 18:28,380.89,Deposit,Check Deposit,-252.872745
23600,720482583,05-02-24 21:28,5200,IncomingTransfer,Salary,4947.127255
23601,720482583,05-03-24 17:28,370.64,Deposit,Cash Deposit,5317.767255
23602,720482583,05-04-24 12:28,318.65,Deposit,Check Deposit,5636.417255
23603,720482583,05-06-24 15:28,349.39,Return,eBay Return,5985.807255
23604,720482583,05-07-24 14:28,283.28,OutgoingTransfer,Peer-to-Peer Transfer,5702.527255
23605,720482583,05-07-24 21:28,3200,Payment,Credit Card Payment,2502.527255
23606,720482583,05-10-24 17:28,416.44,Payment,Mortgage Payment,2086.087255
23607,720482583,05-11-24 21:28,1600,Payment,Rent Payment,486.087255
23608,720482583,5-19-24 16:28,148.71,Purchase,Clothing,337.377255
23609,720482583,5-20-24 9:28,266.15,Deposit,Cash Deposit,603.527255
23610,720482583,5-23-24 19:28,118.74,Payment,Mortgage Payment,484.787255
23611,720482583,5-26-24 21:28,274.47,Purchase,Electronics,210.317255
23612,720482583,5-28-24 13:28,27.21,Withdrawal,Branch Withdrawal,183.107255
23613,720482583,5-28-24 21:28,406.18,Purchase,Gas,-223.072745
23614,720482583,06-01-24 11:28,357.46,Deposit,Cash Deposit,134.387255
23615,720482583,06-01-24 16:28,296.78,OutgoingTransfer,Bank Transfer,-162.392745
23616,720482583,06-02-24 11:28,312.13,Deposit,Check Deposit,149.737255
23617,720482583,06-03-24 21:28,5200,IncomingTransfer,Salary,5349.737255
23618,720482583,06-06-24 21:28,365.39,Payment,Bill Payment,4984.347255
23619,720482583,06-07-24 13:28,455.49,Purchase,Clothing,4528.857255
23620,720482583,06-08-24 11:28,286.22,Purchase,Travel,4242.637255
23621,720482583,06-08-24 11:28,136.07,OnlineShopping,Target,4106.567255
23622,720482583,06-08-24 21:28,2400,Payment,Credit Card Payment,1706.567255
23623,720482583,06-09-24 21:28,279.17,Return,Target Return,1985.737255
23624,720482583,06-10-24 9:28,308.06,Deposit,Direct Deposit,2293.797255
23625,720482583,06-11-24 21:28,3200,Payment,Rent Payment,-906.202745
23626,720482583,6-13-24 10:28,278.42,Deposit,Cash Deposit,-627.782745
23627,720482583,6-15-24 15:28,306.16,Return,Store Return,-321.622745
23628,720482583,6-15-24 18:28,206.96,Deposit,Direct Deposit,-114.662745
23629,720482583,6-19-24 16:28,261.54,Withdrawal,Mobile App Withdrawal,-376.202745
23630,720482583,6-21-24 17:28,33.29,Deposit,Check Deposit,-342.912745
23631,720482583,6-30-24 13:28,362.04,Return,Best Buy Return,19.127255
23632,720482583,6-30-24 18:28,259.42,Purchase,Travel,-240.292745
23633,720482583,07-04-24 21:28,5200,IncomingTransfer,Salary,4959.707255
23634,720482583,07-05-24 11:28,459.37,Purchase,Grocery,4500.337255
23635,720482583,07-09-24 13:28,177.9,Purchase,Travel,4322.437255
23636,720482583,07-09-24 21:28,2700,Payment,Credit Card Payment,1622.437255
23637,720482583,07-10-24 13:28,20.87,Deposit,Cash Deposit,1643.307255
23638,720482583,7-13-24 21:28,2000,Payment,Rent Payment,-356.692745
23639,720610008,1-22-24 20:28,433.48,Withdrawal,Branch Withdrawal,86.40832111
23640,720610008,1-28-24 10:28,925.9,Return,Best Buy Return,1012.308321
23641,720610008,02-01-24 21:28,13000,IncomingTransfer,Salary,14012.30832
23642,720610008,02-04-24 15:28,871.9,OnlineShopping,Amazon,13140.40832
23643,720610008,02-06-24 21:28,1200,Payment,Credit Card Payment,11940.40832
23644,720610008,02-12-24 17:28,846.56,Deposit,Mobile Deposit,12786.96832
23645,720610008,02-12-24 21:28,4300,Payment,Installment Payment,8486.968321
23646,720610008,2-17-24 19:28,549.71,Deposit,Mobile Deposit,9036.678321
23647,720610008,03-04-24 21:28,13000,IncomingTransfer,Salary,22036.67832
23648,720610008,03-06-24 20:28,861.09,Purchase,Travel,21175.58832
23649,720610008,03-09-24 21:28,800,Payment,Credit Card Payment,20375.58832
23650,720610008,3-13-24 21:28,5000,Payment,Insurance Payment,15375.58832
23651,720610008,3-22-24 21:28,338.55,Payment,Loan Payment,15037.03832
23652,720610008,3-31-24 18:28,706.28,Withdrawal,Mobile App Withdrawal,14330.75832
23653,720610008,04-05-24 21:28,13000,IncomingTransfer,Salary,27330.75832
23654,720610008,04-08-24 9:28,539.36,Return,AliExpress Return,27870.11832
23655,720610008,04-10-24 21:28,1200,Payment,Credit Card Payment,26670.11832
23656,720610008,04-11-24 21:28,5400,Payment,Installment Payment,21270.11832
23657,720610008,04-11-24 21:28,209.22,OnlineShopping,Best Buy,21060.89832
23658,720610008,4-20-24 10:28,476.17,OutgoingTransfer,Peer-to-Peer Transfer,20584.72832
23659,720610008,4-21-24 22:28,611.91,OnlineShopping,Etsy,19972.81832
23660,720610008,4-28-24 10:28,268.6,Withdrawal,ATM Withdrawal,19704.21832
23661,720610008,4-30-24 20:28,943.85,Purchase,Electronics,18760.36832
23662,720610008,05-01-24 21:28,13000,IncomingTransfer,Salary,31760.36832
23663,720610008,05-06-24 21:28,900,Payment,Credit Card Payment,30860.36832
23664,720610008,05-12-24 21:28,4100,Payment,Installment Payment,26760.36832
23665,720610008,5-31-24 19:28,260.9,OutgoingTransfer,Bank Transfer,26499.46832
23666,720610008,06-02-24 10:28,330.37,Purchase,Clothing,26169.09832
23667,720610008,06-02-24 21:28,13000,IncomingTransfer,Salary,39169.09832
23668,720610008,06-04-24 22:28,461.35,Deposit,Mobile Deposit,39630.44832
23669,720610008,06-07-24 21:28,1200,Payment,Credit Card Payment,38430.44832
23670,720610008,06-07-24 21:28,949.29,Purchase,Entertainment,37481.15832
23671,720610008,06-10-24 12:28,740.67,Deposit,Mobile Deposit,38221.82832
23672,720610008,6-13-24 21:28,3400,Payment,Installment Payment,34821.82832
23673,720610008,6-17-24 10:28,725.56,Return,eBay Return,35547.38832
23674,720610008,6-20-24 12:28,657.72,OnlineShopping,Amazon,34889.66832
23675,720610008,07-02-24 21:28,13000,IncomingTransfer,Salary,47889.66832
23676,720610008,07-07-24 21:28,900,Payment,Credit Card Payment,46989.66832
23677,720610008,07-10-24 21:28,4700,Payment,Installment Payment,42289.66832
23678,720610008,7-13-24 14:28,628.04,Payment,Bill Payment,41661.62832
23679,720610008,7-13-24 19:28,407.28,Withdrawal,Branch Withdrawal,41254.34832
23680,720614658,1-20-24 17:28,290.71,Deposit,Direct Deposit,290.71
23681,720614658,1-26-24 9:28,441.88,Deposit,Cash Deposit,732.59
23682,720614658,1-27-24 19:28,268.29,Withdrawal,Branch Withdrawal,464.3
23683,720614658,1-29-24 21:28,281.43,Deposit,Direct Deposit,745.73
23684,720614658,1-30-24 14:28,252.36,Purchase,Grocery,493.37
23685,720614658,02-02-24 20:28,315.31,Withdrawal,Branch Withdrawal,178.06
23686,720614658,02-03-24 21:28,6150,IncomingTransfer,Salary,6328.06
23687,720614658,02-03-24 22:28,293.1,Purchase,Electronics,6034.96
23688,720614658,02-06-24 20:28,446.6,Purchase,Gas,5588.36
23689,720614658,02-08-24 13:28,484.6,Purchase,Restaurant,5103.76
23690,720614658,02-10-24 19:28,152.6,OutgoingTransfer,Peer-to-Peer Transfer,4951.16
23691,720614658,02-11-24 15:28,475.7,Deposit,Check Deposit,5426.86
23692,720614658,02-12-24 17:28,487.82,Deposit,Mobile Deposit,5914.68
23693,720614658,2-13-24 14:28,105.65,Return,AliExpress Return,6020.33
23694,720614658,2-13-24 17:28,359.92,Deposit,Mobile Deposit,6380.25
23695,720614658,2-14-24 21:28,1900,Payment,Rent Payment,4480.25
23696,720614658,2-17-24 12:28,82.56,Purchase,Restaurant,4397.69
23697,720614658,2-27-24 15:28,549.63,OnlineShopping,AliExpress,3848.06
23698,720614658,03-05-24 17:28,511.81,OutgoingTransfer,Bank Transfer,3336.25
23699,720614658,03-05-24 18:28,165.33,OnlineShopping,Target,3170.92
23700,720614658,03-05-24 21:28,6150,IncomingTransfer,Salary,9320.92
23701,720614658,03-06-24 16:28,369.46,Withdrawal,Branch Withdrawal,8951.46
23702,720614658,03-10-24 21:28,266.74,Withdrawal,ATM Withdrawal,8684.72
23703,720614658,03-11-24 20:28,55.68,OutgoingTransfer,Peer-to-Peer Transfer,8629.04
23704,720614658,03-11-24 21:28,3000,Payment,Rent Payment,5629.04
23705,720614658,3-16-24 18:28,528.4,OutgoingTransfer,Bank Transfer,5100.64
23706,720614658,3-16-24 19:28,487.11,Purchase,Grocery,4613.53
23707,720614658,3-17-24 19:28,295.91,OutgoingTransfer,International Transfer,4317.62
23708,720614658,3-18-24 16:28,251.61,Return,AliExpress Return,4569.23
23709,720614658,3-19-24 19:28,350.98,Deposit,Cash Deposit,4920.21
23710,720614658,3-20-24 12:28,523.11,Return,Amazon Return,5443.32
23711,720614658,3-20-24 14:28,97.32,Return,Amazon Return,5540.64
23712,720614658,3-21-24 18:28,549.53,Deposit,Direct Deposit,6090.17
23713,720614658,3-22-24 20:28,456.79,Return,eBay Return,6546.96
23714,720614658,3-25-24 15:28,490.51,OutgoingTransfer,Peer-to-Peer Transfer,6056.45
23715,720614658,3-26-24 9:28,181.61,Deposit,Mobile Deposit,6238.06
23716,720614658,3-27-24 10:28,157.22,Withdrawal,Branch Withdrawal,6080.84
23717,720614658,3-28-24 9:28,170.3,Purchase,Home Improvement,5910.54
23718,720614658,3-31-24 15:28,201.46,Deposit,Cash Deposit,6112
23719,720614658,3-31-24 22:28,75.1,Deposit,Check Deposit,6187.1
23720,720614658,04-01-24 16:28,236.13,Purchase,Gas,5950.97
23721,720614658,04-02-24 20:28,391,Purchase,Entertainment,5559.97
23722,720614658,04-02-24 21:28,6150,IncomingTransfer,Salary,11709.97
23723,720614658,04-05-24 17:28,438.94,Purchase,Home Improvement,11271.03
23724,720614658,04-06-24 15:28,203.98,OutgoingTransfer,International Transfer,11067.05
23725,720614658,04-08-24 17:28,414.35,Payment,Mortgage Payment,10652.7
23726,720614658,04-11-24 13:28,448.35,OutgoingTransfer,International Transfer,10204.35
23727,720614658,4-14-24 21:28,3900,Payment,Rent Payment,6304.35
23728,720614658,4-15-24 18:28,67.2,OnlineShopping,eBay,6237.15
23729,720614658,4-18-24 12:28,85.77,Purchase,Travel,6151.38
23730,720614658,4-20-24 14:28,470.92,Return,eBay Return,6622.3
23731,720614658,4-23-24 21:28,461.15,Payment,Mortgage Payment,6161.15
23732,720614658,4-27-24 17:28,153.03,Payment,Bill Payment,6008.12
23733,720614658,4-28-24 10:28,85.14,Payment,Bill Payment,5922.98
23734,720614658,4-29-24 9:28,106.99,Deposit,Mobile Deposit,6029.97
23735,720614658,4-29-24 15:28,259.19,IncomingTransfer,Freelance Payment,6289.16
23736,720614658,4-30-24 20:28,381.91,Deposit,Check Deposit,6671.07
23737,720614658,4-30-24 21:28,185.15,Return,Etsy Return,6856.22
23738,720614658,05-01-24 15:28,316.17,OnlineShopping,Amazon,6540.05
23739,720614658,05-03-24 12:28,489.9,OnlineShopping,AliExpress,6050.15
23740,720614658,05-04-24 13:28,244.52,Payment,Loan Payment,5805.63
23741,720614658,05-05-24 21:28,6150,IncomingTransfer,Salary,11955.63
23742,720614658,05-09-24 21:28,278.45,Payment,Loan Payment,11677.18
23743,720614658,05-09-24 23:28,399.14,IncomingTransfer,Freelance Payment,12076.32
23744,720614658,05-10-24 11:28,464.95,Purchase,Grocery,11611.37
23745,720614658,05-11-24 11:28,112.66,OutgoingTransfer,International Transfer,11498.71
23746,720614658,05-12-24 13:28,367.71,Payment,Bill Payment,11131
23747,720614658,05-12-24 14:28,241.69,Withdrawal,ATM Withdrawal,10889.31
23748,720614658,5-13-24 11:28,350.71,Deposit,Check Deposit,11240.02
23749,720614658,5-13-24 20:28,546.04,Purchase,Home Improvement,10693.98
23750,720614658,5-13-24 23:28,342.35,OnlineShopping,Target,10351.63
23751,720614658,5-14-24 23:28,456.83,Purchase,Gas,9894.8
23752,720614658,5-15-24 19:28,410.58,OnlineShopping,Etsy,9484.22
23753,720614658,5-18-24 21:28,2800,Payment,Rent Payment,6684.22
23754,720614658,5-23-24 11:28,166.65,Payment,Bill Payment,6517.57
23755,720614658,5-23-24 19:28,51.94,IncomingTransfer,Freelance Payment,6569.51
23756,720614658,5-25-24 14:28,275.14,Purchase,Travel,6294.37
23757,720614658,5-28-24 17:28,454.91,OnlineShopping,AliExpress,5839.46
23758,720614658,5-29-24 21:28,102.72,Return,Store Return,5942.18
23759,720614658,5-30-24 20:28,206.87,Withdrawal,ATM Withdrawal,5735.31
23760,720614658,5-31-24 12:28,157.29,Return,Etsy Return,5892.6
23761,720614658,06-02-24 13:28,239.34,Return,Best Buy Return,6131.94
23762,720614658,06-02-24 21:28,6150,IncomingTransfer,Salary,12281.94
23763,720614658,06-03-24 19:28,159.73,OnlineShopping,Target,12122.21
23764,720614658,06-04-24 14:28,480.52,Withdrawal,Branch Withdrawal,11641.69
23765,720614658,06-07-24 22:28,175.34,Purchase,Restaurant,11466.35
23766,720614658,06-08-24 14:28,242.86,Deposit,Mobile Deposit,11709.21
23767,720614658,06-09-24 19:28,182.73,Purchase,Home Improvement,11526.48
23768,720614658,06-11-24 18:28,460.95,Withdrawal,Branch Withdrawal,11065.53
23769,720614658,06-11-24 20:28,108.05,Deposit,Mobile Deposit,11173.58
23770,720614658,06-12-24 15:28,512.9,Deposit,Check Deposit,11686.48
23771,720614658,06-12-24 18:28,78.65,Return,AliExpress Return,11765.13
23772,720614658,06-12-24 21:28,3200,Payment,Rent Payment,8565.13
23773,720614658,6-18-24 21:28,59.22,Deposit,Mobile Deposit,8624.35
23774,720614658,6-21-24 15:28,210.97,Purchase,Clothing,8413.38
23775,720614658,6-24-24 23:28,433.49,OutgoingTransfer,Wire Transfer,7979.89
23776,720614658,6-26-24 12:28,228.35,Purchase,Pharmacy,7751.54
23777,720614658,6-30-24 11:28,95.58,OnlineShopping,Best Buy,7655.96
23778,720614658,07-01-24 21:28,6150,IncomingTransfer,Salary,13805.96
23779,720614658,07-02-24 10:28,68.35,OnlineShopping,Walmart,13737.61
23780,720614658,07-06-24 10:28,265.01,Purchase,Home Improvement,13472.6
23781,720614658,07-10-24 21:28,340.48,Deposit,Check Deposit,13813.08
23782,720614658,7-13-24 12:28,136.28,Purchase,Restaurant,13676.8
23783,720614658,7-13-24 21:28,3500,Payment,Rent Payment,10176.8
23784,720614658,7-14-24 20:28,294.23,Purchase,Electronics,9882.57
23785,720614658,7-15-24 11:28,292.91,OnlineShopping,Walmart,9589.66
23786,720614658,7-16-24 19:28,426,Withdrawal,Branch Withdrawal,9163.66
23787,720695583,1-21-24 22:28,81.75,Withdrawal,Mobile App Withdrawal,1370.14199
23788,720695583,1-25-24 18:28,277.04,Purchase,Home Improvement,1093.10199
23789,720695583,1-28-24 14:28,410.9,Purchase,Electronics,682.2019898
23790,720695583,02-02-24 18:28,382.65,OnlineShopping,eBay,299.5519898
23791,720695583,02-03-24 18:28,375.1,OutgoingTransfer,Bank Transfer,-75.54801019
23792,720695583,02-03-24 21:28,5150,IncomingTransfer,Salary,5074.45199
23793,720695583,02-04-24 10:28,328.2,Deposit,Check Deposit,5402.65199
23794,720695583,02-07-24 10:28,248.5,Return,Etsy Return,5651.15199
23795,720695583,02-08-24 21:28,2000,Payment,Credit Card Payment,3651.15199
23796,720695583,02-09-24 23:28,214.08,OnlineShopping,Best Buy,3437.07199
23797,720695583,02-10-24 12:28,485.27,Withdrawal,ATM Withdrawal,2951.80199
23798,720695583,02-10-24 22:28,423.68,Purchase,Clothing,2528.12199
23799,720695583,02-11-24 19:28,450.66,Withdrawal,Mobile App Withdrawal,2077.46199
23800,720695583,2-15-24 17:28,93.09,Withdrawal,Mobile App Withdrawal,1984.37199
23801,720695583,2-15-24 21:28,2600,Payment,Rent Payment,-615.6280102
23802,720695583,2-17-24 14:28,105.72,Return,AliExpress Return,-509.9080102
23803,720695583,2-20-24 15:28,453.04,Deposit,Cash Deposit,-56.86801019
23804,720695583,2-20-24 23:28,205.59,Return,Walmart Return,148.7219898
23805,720695583,2-24-24 13:28,260.48,OnlineShopping,Best Buy,-111.7580102
23806,720695583,2-28-24 11:28,200.77,Deposit,Cash Deposit,89.01198981
23807,720695583,03-02-24 21:28,5150,IncomingTransfer,Salary,5239.01199
23808,720695583,03-03-24 16:28,207.34,OutgoingTransfer,International Transfer,5031.67199
23809,720695583,03-07-24 21:28,2400,Payment,Credit Card Payment,2631.67199
23810,720695583,3-13-24 21:28,2700,Payment,Rent Payment,-68.32801019
23811,720695583,3-17-24 19:28,154.96,Withdrawal,Mobile App Withdrawal,-223.2880102
23812,720695583,3-19-24 12:28,239.78,Deposit,Cash Deposit,16.49198981
23813,720695583,3-20-24 14:28,228.55,Payment,Mortgage Payment,-212.0580102
23814,720695583,3-22-24 10:28,441.15,Deposit,Cash Deposit,229.0919898
23815,720695583,3-22-24 16:28,455.37,Deposit,Mobile Deposit,684.4619898
23816,720695583,3-26-24 13:28,414.03,Return,Store Return,1098.49199
23817,720695583,3-26-24 22:28,134.69,Withdrawal,Mobile App Withdrawal,963.8019898
23818,720695583,3-27-24 13:28,162.34,Withdrawal,ATM Withdrawal,801.4619898
23819,720695583,3-27-24 22:28,334.87,Deposit,Mobile Deposit,1136.33199
23820,720695583,3-28-24 20:28,187.27,Purchase,Clothing,949.0619898
23821,720695583,04-05-24 21:28,5150,IncomingTransfer,Salary,6099.06199
23822,720695583,04-08-24 10:28,137.16,Payment,Loan Payment,5961.90199
23823,720695583,04-09-24 12:28,449.26,Deposit,Cash Deposit,6411.16199
23824,720695583,04-10-24 21:28,2500,Payment,Credit Card Payment,3911.16199
23825,720695583,04-11-24 11:28,70.17,Withdrawal,ATM Withdrawal,3840.99199
23826,720695583,4-13-24 19:28,480.9,OnlineShopping,Walmart,3360.09199
23827,720695583,4-16-24 23:28,285.47,Purchase,Furniture,3074.62199
23828,720695583,4-17-24 21:28,3300,Payment,Rent Payment,-225.3780102
23829,720695583,4-18-24 23:28,224.5,Deposit,Direct Deposit,-0.878010191
23830,720695583,4-23-24 18:28,446.02,OutgoingTransfer,International Transfer,-446.8980102
23831,720695583,4-27-24 16:28,385.4,Deposit,Mobile Deposit,-61.49801019
23832,720695583,05-01-24 13:28,75.02,OutgoingTransfer,International Transfer,-136.5180102
23833,720695583,05-03-24 10:28,258.48,OnlineShopping,Target,-394.9980102
23834,720695583,05-04-24 16:28,231.01,Deposit,Check Deposit,-163.9880102
23835,720695583,05-04-24 20:28,392.45,Deposit,Direct Deposit,228.4619898
23836,720695583,05-04-24 21:28,5150,IncomingTransfer,Salary,5378.46199
23837,720695583,05-09-24 21:28,2700,Payment,Credit Card Payment,2678.46199
23838,720695583,5-13-24 21:28,1700,Payment,Rent Payment,978.4619898
23839,720695583,5-14-24 19:28,283.93,OnlineShopping,Amazon,694.5319898
23840,720695583,5-20-24 12:28,47.65,OutgoingTransfer,International Transfer,646.8819898
23841,720695583,5-20-24 16:28,281.35,IncomingTransfer,Freelance Payment,928.2319898
23842,720695583,5-21-24 10:28,148.94,OnlineShopping,Best Buy,779.2919898
23843,720695583,5-21-24 12:28,362.75,Withdrawal,ATM Withdrawal,416.5419898
23844,720695583,5-21-24 17:28,120.07,Withdrawal,Mobile App Withdrawal,296.4719898
23845,720695583,5-22-24 23:28,285.67,Purchase,Grocery,10.80198981
23846,720695583,5-25-24 18:28,492.32,Payment,Bill Payment,-481.5180102
23847,720695583,5-28-24 12:28,303.44,Return,Target Return,-178.0780102
23848,720695583,5-29-24 12:28,310.61,Withdrawal,ATM Withdrawal,-488.6880102
23849,720695583,5-29-24 21:28,343.59,Deposit,Cash Deposit,-145.0980102
23850,720695583,5-31-24 11:28,309.1,Withdrawal,Mobile App Withdrawal,-454.1980102
23851,720695583,06-01-24 13:28,95.04,Deposit,Mobile Deposit,-359.1580102
23852,720695583,06-02-24 12:28,95.71,OnlineShopping,Target,-454.8680102
23853,720695583,06-05-24 21:28,5150,IncomingTransfer,Salary,4695.13199
23854,720695583,06-06-24 13:28,108.66,Purchase,Gas,4586.47199
23855,720695583,06-06-24 22:28,56.15,Deposit,Check Deposit,4642.62199
23856,720695583,06-07-24 20:28,398.1,Deposit,Mobile Deposit,5040.72199
23857,720695583,06-07-24 22:28,235.03,OnlineShopping,eBay,4805.69199
23858,720695583,06-07-24 22:28,460.25,IncomingTransfer,Freelance Payment,5265.94199
23859,720695583,06-09-24 21:28,179.01,Withdrawal,ATM Withdrawal,5086.93199
23860,720695583,06-10-24 21:28,2600,Payment,Credit Card Payment,2486.93199
23861,720695583,6-17-24 21:28,1500,Payment,Rent Payment,986.9319898
23862,720695583,6-18-24 16:28,447.08,Purchase,Travel,539.8519898
23863,720695583,6-20-24 13:28,399.61,Purchase,Grocery,140.2419898
23864,720695583,6-24-24 16:28,420.08,OnlineShopping,Amazon,-279.8380102
23865,720695583,07-01-24 9:28,479.8,Payment,Mortgage Payment,-759.6380102
23866,720695583,07-02-24 21:28,5150,IncomingTransfer,Salary,4390.36199
23867,720695583,07-04-24 10:28,192.35,OutgoingTransfer,Wire Transfer,4198.01199
23868,720695583,07-06-24 15:28,111.42,Deposit,Mobile Deposit,4309.43199
23869,720695583,07-07-24 21:28,1900,Payment,Credit Card Payment,2409.43199
23870,720695583,07-09-24 9:28,70.21,Deposit,Mobile Deposit,2479.64199
23871,720695583,07-11-24 20:28,138.7,Deposit,Mobile Deposit,2618.34199
23872,720695583,7-13-24 21:28,2800,Payment,Rent Payment,-181.6580102
23873,720695583,7-16-24 16:28,76.02,Withdrawal,ATM Withdrawal,-257.6780102
23874,720695583,7-17-24 12:28,217.97,IncomingTransfer,Freelance Payment,-39.70801019
23875,720747633,1-29-24 23:28,232.06,Deposit,Cash Deposit,971.512448
23876,720747633,02-01-24 11:28,166.01,Purchase,Travel,805.502448
23877,720747633,02-03-24 21:28,4850,IncomingTransfer,Salary,5655.502448
23878,720747633,02-05-24 12:28,59.3,OnlineShopping,Etsy,5596.202448
23879,720747633,02-08-24 21:28,1700,Payment,Credit Card Payment,3896.202448
23880,720747633,02-09-24 11:28,301.2,OnlineShopping,Walmart,3595.002448
23881,720747633,02-12-24 14:28,184.09,OutgoingTransfer,Bank Transfer,3410.912448
23882,720747633,02-12-24 21:28,2100,Payment,Rent Payment,1310.912448
23883,720747633,2-13-24 13:28,372.96,Return,Etsy Return,1683.872448
23884,720747633,2-14-24 15:28,149.1,Deposit,Mobile Deposit,1832.972448
23885,720747633,2-21-24 18:28,162.95,OutgoingTransfer,Peer-to-Peer Transfer,1670.022448
23886,720747633,2-24-24 15:28,282.52,Deposit,Check Deposit,1952.542448
23887,720747633,2-26-24 16:28,134.49,Purchase,Entertainment,1818.052448
23888,720747633,03-02-24 10:28,114.85,Purchase,Entertainment,1703.202448
23889,720747633,03-05-24 21:28,4850,IncomingTransfer,Salary,6553.202448
23890,720747633,03-06-24 10:28,101.42,Withdrawal,Branch Withdrawal,6451.782448
23891,720747633,03-08-24 18:28,25.03,Return,Best Buy Return,6476.812448
23892,720747633,03-10-24 21:28,2000,Payment,Credit Card Payment,4476.812448
23893,720747633,03-11-24 21:28,1900,Payment,Rent Payment,2576.812448
23894,720747633,3-26-24 13:28,229.5,Deposit,Cash Deposit,2806.312448
23895,720747633,3-27-24 21:28,220.75,OutgoingTransfer,Wire Transfer,2585.562448
23896,720747633,3-29-24 16:28,103.34,Deposit,Mobile Deposit,2688.902448
23897,720747633,04-01-24 19:28,383.35,Purchase,Restaurant,2305.552448
23898,720747633,04-01-24 20:28,316.55,Deposit,Check Deposit,2622.102448
23899,720747633,04-02-24 21:28,4850,IncomingTransfer,Salary,7472.102448
23900,720747633,04-04-24 22:28,369.56,OnlineShopping,eBay,7102.542448
23901,720747633,04-05-24 23:28,248.99,Payment,Bill Payment,6853.552448
23902,720747633,04-07-24 21:28,1900,Payment,Credit Card Payment,4953.552448
23903,720747633,4-14-24 18:28,173.9,Purchase,Gas,4779.652448
23904,720747633,4-17-24 21:28,2600,Payment,Rent Payment,2179.652448
23905,720747633,4-19-24 15:28,108.93,Withdrawal,Branch Withdrawal,2070.722448
23906,720747633,4-19-24 19:28,316.35,OnlineShopping,Walmart,1754.372448
23907,720747633,4-27-24 16:28,139.47,Withdrawal,ATM Withdrawal,1614.902448
23908,720747633,05-05-24 21:28,4850,IncomingTransfer,Salary,6464.902448
23909,720747633,05-10-24 16:28,332.36,Purchase,Entertainment,6132.542448
23910,720747633,05-10-24 21:28,1900,Payment,Credit Card Payment,4232.542448
23911,720747633,05-12-24 13:28,312.6,Return,Etsy Return,4545.142448
23912,720747633,5-13-24 19:28,57.04,Withdrawal,Mobile App Withdrawal,4488.102448
23913,720747633,5-15-24 21:28,1600,Payment,Rent Payment,2888.102448
23914,720747633,5-17-24 17:28,192.39,Deposit,Mobile Deposit,3080.492448
23915,720747633,5-19-24 13:28,126.54,OnlineShopping,AliExpress,2953.952448
23916,720747633,5-20-24 23:28,203.89,Return,Store Return,3157.842448
23917,720747633,5-23-24 11:28,163.76,Withdrawal,Mobile App Withdrawal,2994.082448
23918,720747633,5-23-24 12:28,34.66,Return,eBay Return,3028.742448
23919,720747633,5-24-24 16:28,53.84,OutgoingTransfer,Peer-to-Peer Transfer,2974.902448
23920,720747633,5-28-24 13:28,137.02,Return,Target Return,3111.922448
23921,720747633,5-30-24 10:28,44.5,OnlineShopping,Walmart,3067.422448
23922,720747633,5-31-24 11:28,118.26,Payment,Bill Payment,2949.162448
23923,720747633,06-01-24 21:28,4850,IncomingTransfer,Salary,7799.162448
23924,720747633,06-01-24 21:28,239.94,Purchase,Pharmacy,7559.222448
23925,720747633,06-03-24 19:28,275.17,OutgoingTransfer,International Transfer,7284.052448
23926,720747633,06-06-24 21:28,1800,Payment,Credit Card Payment,5484.052448
23927,720747633,06-08-24 15:28,58.55,IncomingTransfer,Freelance Payment,5542.602448
23928,720747633,6-14-24 9:28,254.92,Withdrawal,Branch Withdrawal,5287.682448
23929,720747633,6-15-24 21:28,1400,Payment,Rent Payment,3887.682448
23930,720747633,6-17-24 19:28,188.97,OnlineShopping,eBay,3698.712448
23931,720747633,6-25-24 23:28,105.47,Purchase,Travel,3593.242448
23932,720747633,6-26-24 20:28,287.65,Purchase,Entertainment,3305.592448
23933,720747633,07-01-24 15:28,195.72,Purchase,Furniture,3109.872448
23934,720747633,07-02-24 21:28,4850,IncomingTransfer,Salary,7959.872448
23935,720747633,07-05-24 15:28,147.3,IncomingTransfer,Freelance Payment,8107.172448
23936,720747633,07-07-24 21:28,2100,Payment,Credit Card Payment,6007.172448
23937,720747633,07-08-24 18:28,280.6,Deposit,Mobile Deposit,6287.772448
23938,720747633,07-10-24 12:28,302.76,OnlineShopping,eBay,5985.012448
23939,720747633,7-16-24 14:28,135.77,Payment,Mortgage Payment,5849.242448
23940,720747633,7-16-24 21:28,2600,Payment,Rent Payment,3249.242448
23941,720807183,1-21-24 19:28,460.71,Return,AliExpress Return,1250.764771
23942,720807183,1-22-24 10:28,640.78,Purchase,Furniture,609.9847714
23943,720807183,1-23-24 14:28,657.48,OnlineShopping,eBay,-47.49522859
23944,720807183,1-26-24 10:28,149.21,Purchase,Pharmacy,-196.7052286
23945,720807183,1-26-24 11:28,135.79,Payment,Mortgage Payment,-332.4952286
23946,720807183,1-27-24 19:28,458.94,Payment,Mortgage Payment,-791.4352286
23947,720807183,1-29-24 12:28,262.61,Purchase,Grocery,-1054.045229
23948,720807183,1-29-24 23:28,734.48,OnlineShopping,Target,-1788.525229
23949,720807183,02-02-24 16:28,522.43,IncomingTransfer,Freelance Payment,-1266.095229
23950,720807183,02-04-24 20:28,429.03,Purchase,Gas,-1695.125229
23951,720807183,02-04-24 21:28,7000,IncomingTransfer,Salary,5304.874771
23952,720807183,02-09-24 13:28,470.14,OnlineShopping,AliExpress,4834.734771
23953,720807183,02-09-24 21:28,1300,Payment,Credit Card Payment,3534.734771
23954,720807183,02-10-24 14:28,307.27,Purchase,Electronics,3227.464771
23955,720807183,02-10-24 21:28,369.75,Deposit,Mobile Deposit,3597.214771
23956,720807183,2-16-24 11:28,387.9,Deposit,Mobile Deposit,3985.114771
23957,720807183,2-16-24 21:28,3300,Payment,Rent Payment,685.1147714
23958,720807183,2-17-24 11:28,343.22,Return,Store Return,1028.334771
23959,720807183,2-20-24 17:28,650.12,IncomingTransfer,Freelance Payment,1678.454771
23960,720807183,2-21-24 15:28,537.98,Return,Amazon Return,2216.434771
23961,720807183,2-28-24 23:28,587.97,Purchase,Furniture,1628.464771
23962,720807183,2-29-24 23:28,733.03,Deposit,Cash Deposit,2361.494771
23963,720807183,03-04-24 21:28,7000,IncomingTransfer,Salary,9361.494771
23964,720807183,03-09-24 21:28,1200,Payment,Credit Card Payment,8161.494771
23965,720807183,03-11-24 14:28,475.63,Payment,Loan Payment,7685.864771
23966,720807183,3-13-24 15:28,483.92,OnlineShopping,AliExpress,7201.944771
23967,720807183,3-13-24 21:28,2500,Payment,Rent Payment,4701.944771
23968,720807183,3-22-24 23:28,316.86,Return,Best Buy Return,5018.804771
23969,720807183,3-29-24 10:28,665.43,Payment,Loan Payment,4353.374771
23970,720807183,04-04-24 21:28,7000,IncomingTransfer,Salary,11353.37477
23971,720807183,04-09-24 20:28,555.77,Purchase,Grocery,10797.60477
23972,720807183,04-09-24 21:28,1100,Payment,Credit Card Payment,9697.604771
23973,720807183,04-11-24 21:28,1800,Payment,Rent Payment,7897.604771
23974,720807183,04-12-24 18:28,111.76,OnlineShopping,Etsy,7785.844771
23975,720807183,04-12-24 19:28,321.21,OutgoingTransfer,Wire Transfer,7464.634771
23976,720807183,4-13-24 19:28,714.55,OutgoingTransfer,Peer-to-Peer Transfer,6750.084771
23977,720807183,4-18-24 13:28,618.95,OutgoingTransfer,Wire Transfer,6131.134771
23978,720807183,4-18-24 15:28,252.29,Deposit,Check Deposit,6383.424771
23979,720807183,4-19-24 13:28,404.85,Purchase,Gas,5978.574771
23980,720807183,4-20-24 13:28,567.11,Withdrawal,Mobile App Withdrawal,5411.464771
23981,720807183,4-24-24 13:28,462.88,Purchase,Travel,4948.584771
23982,720807183,4-28-24 13:28,107.01,OnlineShopping,Walmart,4841.574771
23983,720807183,4-28-24 22:28,288.67,Return,Walmart Return,5130.244771
23984,720807183,05-01-24 11:28,227.85,Payment,Bill Payment,4902.394771
23985,720807183,05-01-24 21:28,7000,IncomingTransfer,Salary,11902.39477
23986,720807183,05-02-24 13:28,422.27,Payment,Bill Payment,11480.12477
23987,720807183,05-05-24 12:28,515.6,OutgoingTransfer,International Transfer,10964.52477
23988,720807183,05-06-24 21:28,1000,Payment,Credit Card Payment,9964.524771
23989,720807183,05-07-24 11:28,689.44,Return,Store Return,10653.96477
23990,720807183,05-09-24 19:28,130.95,Purchase,Pharmacy,10523.01477
23991,720807183,05-10-24 21:28,2800,Payment,Rent Payment,7723.014771
23992,720807183,05-12-24 13:28,282.94,Deposit,Direct Deposit,8005.954771
23993,720807183,5-14-24 9:28,488.78,Purchase,Pharmacy,7517.174771
23994,720807183,5-22-24 17:28,345.59,Purchase,Entertainment,7171.584771
23995,720807183,5-28-24 10:28,542.8,Purchase,Home Improvement,6628.784771
23996,720807183,06-01-24 21:28,7000,IncomingTransfer,Salary,13628.78477
23997,720807183,06-06-24 21:28,1100,Payment,Credit Card Payment,12528.78477
23998,720807183,06-08-24 11:28,555.19,Purchase,Furniture,11973.59477
23999,720807183,06-08-24 16:28,158.68,OutgoingTransfer,Peer-to-Peer Transfer,11814.91477
24000,720807183,06-10-24 17:28,549.98,Return,AliExpress Return,12364.89477
24001,720807183,06-10-24 22:28,381.88,Purchase,Restaurant,11983.01477
24002,720807183,6-13-24 21:28,3400,Payment,Rent Payment,8583.014771
24003,720807183,6-14-24 17:28,411.06,Deposit,Check Deposit,8994.074771
24004,720807183,6-15-24 11:28,396.99,Return,Etsy Return,9391.064771
24005,720807183,6-17-24 13:28,403.56,Withdrawal,ATM Withdrawal,8987.504771
24006,720807183,6-21-24 9:28,427.24,Deposit,Direct Deposit,9414.744771
24007,720807183,6-22-24 15:28,456.33,Purchase,Restaurant,8958.414771
24008,720807183,6-23-24 18:28,679.37,OnlineShopping,Etsy,8279.044771
24009,720807183,6-26-24 15:28,581.24,OnlineShopping,Amazon,7697.804771
24010,720807183,6-27-24 20:28,707.31,Payment,Bill Payment,6990.494771
24011,720807183,6-27-24 20:28,321.35,Withdrawal,ATM Withdrawal,6669.144771
24012,720807183,6-30-24 12:28,221.45,Purchase,Electronics,6447.694771
24013,720807183,07-01-24 22:28,653.57,Deposit,Cash Deposit,7101.264771
24014,720807183,07-02-24 17:28,586.59,OutgoingTransfer,Wire Transfer,6514.674771
24015,720807183,07-03-24 17:28,296.46,Deposit,Direct Deposit,6811.134771
24016,720807183,07-04-24 21:28,7000,IncomingTransfer,Salary,13811.13477
24017,720807183,07-06-24 19:28,394.41,Deposit,Mobile Deposit,14205.54477
24018,720807183,07-07-24 15:28,511.53,Withdrawal,Mobile App Withdrawal,13694.01477
24019,720807183,07-09-24 21:28,1100,Payment,Credit Card Payment,12594.01477
24020,720807183,7-14-24 21:28,2200,Payment,Rent Payment,10394.01477
24021,720807183,7-17-24 9:28,653.97,OutgoingTransfer,Wire Transfer,9740.044771
24022,720809358,1-20-24 16:28,49.09,Deposit,Mobile Deposit,2089.084007
24023,720809358,1-24-24 19:28,96.82,IncomingTransfer,Freelance Payment,2185.904007
24024,720809358,1-25-24 12:28,369.01,OutgoingTransfer,Wire Transfer,1816.894007
24025,720809358,1-25-24 17:28,318.64,Deposit,Check Deposit,2135.534007
24026,720809358,1-25-24 20:28,229.79,Purchase,Gas,1905.744007
24027,720809358,1-28-24 10:28,256.3,Purchase,Furniture,1649.444007
24028,720809358,02-03-24 13:28,231.54,Withdrawal,Mobile App Withdrawal,1417.904007
24029,720809358,02-04-24 13:28,141.53,OutgoingTransfer,Bank Transfer,1276.374007
24030,720809358,02-04-24 13:28,232.93,OnlineShopping,Amazon,1043.444007
24031,720809358,02-05-24 21:28,3950,IncomingTransfer,Salary,4993.444007
24032,720809358,02-07-24 18:28,238.59,Payment,Bill Payment,4754.854007
24033,720809358,02-10-24 18:28,165.83,OutgoingTransfer,Bank Transfer,4589.024007
24034,720809358,02-10-24 21:28,2700,Payment,Credit Card Payment,1889.024007
24035,720809358,02-11-24 11:28,335.05,IncomingTransfer,Freelance Payment,2224.074007
24036,720809358,02-11-24 17:28,152,OutgoingTransfer,Bank Transfer,2072.074007
24037,720809358,2-14-24 19:28,314.67,Deposit,Mobile Deposit,2386.744007
24038,720809358,2-15-24 15:28,176.91,Deposit,Check Deposit,2563.654007
24039,720809358,2-15-24 19:28,223.65,Purchase,Restaurant,2340.004007
24040,720809358,2-17-24 21:28,2100,Payment,Rent Payment,240.0040068
24041,720809358,2-21-24 11:28,150.35,Purchase,Grocery,89.65400682
24042,720809358,2-23-24 21:28,355.65,OnlineShopping,Amazon,-265.9959932
24043,720809358,2-26-24 11:28,219.66,Payment,Loan Payment,-485.6559932
24044,720809358,2-29-24 9:28,211.37,Purchase,Restaurant,-697.0259932
24045,720809358,03-03-24 16:28,314.16,Payment,Mortgage Payment,-1011.185993
24046,720809358,03-04-24 17:28,167.52,Deposit,Mobile Deposit,-843.6659932
24047,720809358,03-04-24 21:28,3950,IncomingTransfer,Salary,3106.334007
24048,720809358,03-05-24 9:28,374.27,OnlineShopping,eBay,2732.064007
24049,720809358,03-05-24 11:28,378.46,Purchase,Electronics,2353.604007
24050,720809358,03-05-24 18:28,223.14,Withdrawal,Mobile App Withdrawal,2130.464007
24051,720809358,03-06-24 17:28,298.14,Purchase,Electronics,1832.324007
24052,720809358,03-07-24 20:28,339.13,IncomingTransfer,Freelance Payment,2171.454007
24053,720809358,03-08-24 15:28,20.31,Withdrawal,Branch Withdrawal,2151.144007
24054,720809358,03-09-24 21:28,2400,Payment,Credit Card Payment,-248.8559932
24055,720809358,03-11-24 13:28,46.15,Withdrawal,Branch Withdrawal,-295.0059932
24056,720809358,3-13-24 13:28,102.61,OutgoingTransfer,International Transfer,-397.6159932
24057,720809358,3-13-24 21:28,372.18,IncomingTransfer,Freelance Payment,-25.43599318
24058,720809358,3-14-24 15:28,356.21,Withdrawal,Mobile App Withdrawal,-381.6459932
24059,720809358,3-16-24 12:28,198.12,Withdrawal,Branch Withdrawal,-579.7659932
24060,720809358,3-16-24 13:28,87.97,Deposit,Direct Deposit,-491.7959932
24061,720809358,3-17-24 19:28,243.71,Withdrawal,Mobile App Withdrawal,-735.5059932
24062,720809358,3-18-24 21:28,1900,Payment,Rent Payment,-2635.505993
24063,720809358,3-21-24 12:28,207.67,Purchase,Clothing,-2843.175993
24064,720809358,3-22-24 17:28,100.76,Withdrawal,Branch Withdrawal,-2943.935993
24065,720809358,3-23-24 13:28,299.21,Withdrawal,Branch Withdrawal,-3243.145993
24066,720809358,3-25-24 9:28,252.25,Purchase,Electronics,-3495.395993
24067,720809358,3-26-24 9:28,31.1,Deposit,Mobile Deposit,-3464.295993
24068,720809358,3-28-24 9:28,188.18,IncomingTransfer,Freelance Payment,-3276.115993
24069,720809358,04-01-24 12:28,269.34,Purchase,Electronics,-3545.455993
24070,720809358,04-02-24 11:28,267.37,Purchase,Restaurant,-3812.825993
24071,720809358,04-03-24 21:28,3950,IncomingTransfer,Salary,137.1740068
24072,720809358,04-07-24 17:28,347.66,Return,Best Buy Return,484.8340068
24073,720809358,04-08-24 11:28,105.5,Deposit,Direct Deposit,590.3340068
24074,720809358,04-08-24 16:28,261.75,OnlineShopping,Walmart,328.5840068
24075,720809358,04-08-24 21:28,2400,Payment,Credit Card Payment,-2071.415993
24076,720809358,04-08-24 22:28,21.17,Purchase,Clothing,-2092.585993
24077,720809358,04-09-24 10:28,113.7,Deposit,Direct Deposit,-1978.885993
24078,720809358,04-09-24 13:28,112.06,Purchase,Clothing,-2090.945993
24079,720809358,04-12-24 18:28,215.32,Deposit,Mobile Deposit,-1875.625993
24080,720809358,4-13-24 15:28,26.53,Purchase,Electronics,-1902.155993
24081,720809358,4-14-24 22:28,68.84,Purchase,Grocery,-1970.995993
24082,720809358,4-16-24 12:28,323.53,Purchase,Grocery,-2294.525993
24083,720809358,4-16-24 20:28,196.13,OnlineShopping,Etsy,-2490.655993
24084,720809358,4-17-24 21:28,1900,Payment,Rent Payment,-4390.655993
24085,720809358,4-23-24 18:28,24.6,OutgoingTransfer,Bank Transfer,-4415.255993
24086,720809358,4-24-24 22:28,146.14,OnlineShopping,AliExpress,-4561.395993
24087,720809358,05-03-24 21:28,3950,IncomingTransfer,Salary,-611.3959932
24088,720809358,05-03-24 21:28,277.16,Deposit,Cash Deposit,-334.2359932
24089,720809358,05-05-24 11:28,261.48,Purchase,Home Improvement,-595.7159932
24090,720809358,05-05-24 13:28,370.28,Purchase,Home Improvement,-965.9959932
24091,720809358,05-05-24 18:28,299.51,OnlineShopping,Target,-1265.505993
24092,720809358,05-06-24 22:28,263.71,Return,Target Return,-1001.795993
24093,720809358,05-08-24 21:28,2400,Payment,Credit Card Payment,-3401.795993
24094,720809358,05-09-24 21:28,258.3,OnlineShopping,Walmart,-3660.095993
24095,720809358,05-12-24 20:28,77.19,Purchase,Restaurant,-3737.285993
24096,720809358,5-15-24 15:28,386.76,OutgoingTransfer,Peer-to-Peer Transfer,-4124.045993
24097,720809358,5-15-24 21:28,1600,Payment,Rent Payment,-5724.045993
24098,720809358,5-18-24 17:28,207.6,Withdrawal,Mobile App Withdrawal,-5931.645993
24099,720809358,5-19-24 16:28,357.4,Purchase,Travel,-6289.045993
24100,720809358,5-20-24 9:28,113.21,OutgoingTransfer,International Transfer,-6402.255993
24101,720809358,5-20-24 23:28,252.83,OutgoingTransfer,Peer-to-Peer Transfer,-6655.085993
24102,720809358,5-24-24 16:28,252.99,Payment,Loan Payment,-6908.075993
24103,720809358,5-24-24 21:28,112.18,Withdrawal,ATM Withdrawal,-7020.255993
24104,720809358,5-24-24 22:28,83.98,OnlineShopping,Target,-7104.235993
24105,720809358,5-27-24 9:28,239.96,Payment,Bill Payment,-7344.195993
24106,720809358,5-28-24 19:28,100.33,Purchase,Electronics,-7444.525993
24107,720809358,5-29-24 16:28,271.84,Withdrawal,ATM Withdrawal,-7716.365993
24108,720809358,5-31-24 22:28,276.63,Withdrawal,ATM Withdrawal,-7992.995993
24109,720809358,06-01-24 16:28,179.57,Deposit,Check Deposit,-7813.425993
24110,720809358,06-01-24 21:28,3950,IncomingTransfer,Salary,-3863.425993
24111,720809358,06-02-24 12:28,331.24,Withdrawal,Mobile App Withdrawal,-4194.665993
24112,720809358,06-05-24 13:28,300.76,Return,AliExpress Return,-3893.905993
24113,720809358,06-05-24 20:28,360.33,Deposit,Mobile Deposit,-3533.575993
24114,720809358,06-06-24 21:28,2800,Payment,Credit Card Payment,-6333.575993
24115,720809358,06-11-24 13:28,196.05,Withdrawal,Branch Withdrawal,-6529.625993
24116,720809358,06-12-24 15:28,178.05,Withdrawal,ATM Withdrawal,-6707.675993
24117,720809358,06-12-24 21:28,227.48,Purchase,Restaurant,-6935.155993
24118,720809358,6-13-24 12:28,182.96,IncomingTransfer,Freelance Payment,-6752.195993
24119,720809358,6-13-24 21:28,1800,Payment,Rent Payment,-8552.195993
24120,720809358,6-14-24 23:28,338.09,Deposit,Cash Deposit,-8214.105993
24121,720809358,6-15-24 21:28,194,Purchase,Clothing,-8408.105993
24122,720809358,6-15-24 22:28,391.17,Withdrawal,Mobile App Withdrawal,-8799.275993
24123,720809358,6-21-24 13:28,366.08,Withdrawal,Mobile App Withdrawal,-9165.355993
24124,720809358,6-21-24 20:28,233.85,Withdrawal,Mobile App Withdrawal,-9399.205993
24125,720809358,6-22-24 12:28,267.47,Purchase,Pharmacy,-9666.675993
24126,720809358,6-22-24 22:28,147.84,OutgoingTransfer,Peer-to-Peer Transfer,-9814.515993
24127,720809358,6-25-24 13:28,252.61,Deposit,Cash Deposit,-9561.905993
24128,720809358,6-26-24 16:28,294.4,Purchase,Home Improvement,-9856.305993
24129,720809358,6-29-24 10:28,226.59,Purchase,Grocery,-10082.89599
24130,720809358,07-01-24 20:28,131.23,Deposit,Check Deposit,-9951.665993
24131,720809358,07-03-24 21:28,3950,IncomingTransfer,Salary,-6001.665993
24132,720809358,07-08-24 21:28,2700,Payment,Credit Card Payment,-8701.665993
24133,720809358,7-13-24 13:28,300.74,Withdrawal,Mobile App Withdrawal,-9002.405993
24134,720809358,7-14-24 21:28,1300,Payment,Rent Payment,-10302.40599
24135,720809358,7-15-24 22:28,210.46,OnlineShopping,Best Buy,-10512.86599
24136,720809358,7-16-24 19:28,391.16,Deposit,Direct Deposit,-10121.70599
24137,720809358,7-17-24 15:28,47.68,OutgoingTransfer,Peer-to-Peer Transfer,-10169.38599
24138,720815208,1-21-24 21:28,551.73,IncomingTransfer,Freelance Payment,706.2834345
24139,720815208,1-23-24 17:28,621.85,Deposit,Check Deposit,1328.133435
24140,720815208,1-25-24 10:28,474.1,Deposit,Cash Deposit,1802.233435
24141,720815208,1-27-24 21:28,674.49,Purchase,Clothing,1127.743435
24142,720815208,1-29-24 14:28,869.89,Purchase,Home Improvement,257.8534345
24143,720815208,1-31-24 11:28,904.39,Purchase,Pharmacy,-646.5365655
24144,720815208,1-31-24 13:28,909.7,Withdrawal,Branch Withdrawal,-1556.236565
24145,720815208,02-02-24 21:28,13150,IncomingTransfer,Salary,11593.76343
24146,720815208,02-03-24 17:28,786,Withdrawal,ATM Withdrawal,10807.76343
24147,720815208,02-04-24 16:28,662.76,Purchase,Travel,10145.00343
24148,720815208,02-06-24 12:28,487.69,OutgoingTransfer,Peer-to-Peer Transfer,9657.313435
24149,720815208,02-07-24 21:28,300,Payment,Credit Card Payment,9357.313435
24150,720815208,02-10-24 13:28,461.56,Withdrawal,ATM Withdrawal,8895.753435
24151,720815208,02-10-24 21:28,5300,Payment,Rent Payment,3595.753435
24152,720815208,02-12-24 22:28,601.4,Withdrawal,Mobile App Withdrawal,2994.353435
24153,720815208,2-14-24 19:28,448.33,Deposit,Cash Deposit,3442.683435
24154,720815208,2-14-24 23:28,368.31,OnlineShopping,Target,3074.373435
24155,720815208,2-16-24 22:28,891.4,Payment,Loan Payment,2182.973435
24156,720815208,2-19-24 12:28,859.88,Return,AliExpress Return,3042.853435
24157,720815208,2-27-24 18:28,825.29,Payment,Bill Payment,2217.563435
24158,720815208,03-01-24 21:28,13150,IncomingTransfer,Salary,15367.56343
24159,720815208,03-03-24 13:28,776.53,Payment,Bill Payment,14591.03343
24160,720815208,03-04-24 13:28,710.78,Purchase,Restaurant,13880.25343
24161,720815208,03-06-24 21:28,200,Payment,Credit Card Payment,13680.25343
24162,720815208,03-12-24 13:28,876.63,Deposit,Direct Deposit,14556.88343
24163,720815208,03-12-24 21:28,7700,Payment,Rent Payment,6856.883435
24164,720815208,3-13-24 18:28,619.4,Return,Target Return,7476.283435
24165,720815208,3-17-24 14:28,818.72,OutgoingTransfer,Peer-to-Peer Transfer,6657.563435
24166,720815208,3-20-24 15:28,847.68,Withdrawal,ATM Withdrawal,5809.883435
24167,720815208,3-23-24 10:28,248.6,OnlineShopping,eBay,5561.283435
24168,720815208,3-23-24 12:28,234.96,Purchase,Furniture,5326.323435
24169,720815208,3-27-24 23:28,685.51,Deposit,Mobile Deposit,6011.833435
24170,720815208,3-29-24 12:28,771.64,OutgoingTransfer,International Transfer,5240.193435
24171,720815208,04-01-24 21:28,13150,IncomingTransfer,Salary,18390.19343
24172,720815208,04-05-24 18:28,351.92,Purchase,Travel,18038.27343
24173,720815208,04-06-24 21:28,300,Payment,Credit Card Payment,17738.27343
24174,720815208,04-12-24 12:28,529.22,IncomingTransfer,Freelance Payment,18267.49343
24175,720815208,4-13-24 10:28,909.43,Deposit,Mobile Deposit,19176.92343
24176,720815208,4-14-24 21:28,8500,Payment,Rent Payment,10676.92343
24177,720815208,4-16-24 22:28,603.03,Withdrawal,Branch Withdrawal,10073.89343
24178,720815208,4-18-24 14:28,448.37,Withdrawal,ATM Withdrawal,9625.523435
24179,720815208,4-29-24 20:28,304.46,Purchase,Travel,9321.063435
24180,720815208,05-03-24 16:28,895.89,Deposit,Check Deposit,10216.95343
24181,720815208,05-04-24 21:28,13150,IncomingTransfer,Salary,23366.95343
24182,720815208,05-07-24 10:28,398.75,OnlineShopping,Etsy,22968.20343
24183,720815208,05-09-24 21:28,300,Payment,Credit Card Payment,22668.20343
24184,720815208,5-18-24 10:28,513.61,Purchase,Furniture,22154.59343
24185,720815208,5-18-24 21:28,7200,Payment,Rent Payment,14954.59343
24186,720815208,06-02-24 11:28,802.3,Deposit,Mobile Deposit,15756.89343
24187,720815208,06-02-24 15:28,356.31,Return,Walmart Return,16113.20343
24188,720815208,06-04-24 21:28,13150,IncomingTransfer,Salary,29263.20343
24189,720815208,06-07-24 12:28,766.29,Purchase,Entertainment,28496.91343
24190,720815208,06-09-24 18:28,346.41,Withdrawal,ATM Withdrawal,28150.50343
24191,720815208,06-09-24 21:28,300,Payment,Credit Card Payment,27850.50343
24192,720815208,06-11-24 14:28,849.63,OnlineShopping,eBay,27000.87343
24193,720815208,6-18-24 21:28,7900,Payment,Rent Payment,19100.87343
24194,720815208,6-24-24 23:28,258.35,OutgoingTransfer,International Transfer,18842.52343
24195,720815208,07-03-24 14:28,363.22,Deposit,Direct Deposit,19205.74343
24196,720815208,07-03-24 21:28,13150,IncomingTransfer,Salary,32355.74343
24197,720815208,07-04-24 22:28,621.12,Withdrawal,ATM Withdrawal,31734.62343
24198,720815208,07-08-24 9:28,454.78,IncomingTransfer,Freelance Payment,32189.40343
24199,720815208,07-08-24 21:28,300,Payment,Credit Card Payment,31889.40343
24200,720815208,7-13-24 16:28,348.45,Withdrawal,Branch Withdrawal,31540.95343
24201,720815208,7-16-24 21:28,8200,Payment,Rent Payment,23340.95343
24202,720815208,7-17-24 13:28,203.42,OnlineShopping,Etsy,23137.53343
24203,720817533,1-24-24 14:28,452.08,Payment,Loan Payment,640.7428615
24204,720817533,1-25-24 11:28,854.41,OnlineShopping,Best Buy,-213.6671385
24205,720817533,1-25-24 16:28,744.83,Withdrawal,ATM Withdrawal,-958.4971385
24206,720817533,1-25-24 23:28,694.91,Return,AliExpress Return,-263.5871385
24207,720817533,1-27-24 22:28,622.47,Deposit,Check Deposit,358.8828615
24208,720817533,1-28-24 19:28,423.17,Withdrawal,ATM Withdrawal,-64.28713851
24209,720817533,1-30-24 21:28,727.53,Withdrawal,ATM Withdrawal,-791.8171385
24210,720817533,02-03-24 21:28,14700,IncomingTransfer,Salary,13908.18286
24211,720817533,02-04-24 19:28,382.19,OnlineShopping,Amazon,13525.99286
24212,720817533,02-05-24 16:28,727.51,Deposit,Mobile Deposit,14253.50286
24213,720817533,02-08-24 21:28,1400,Payment,Credit Card Payment,12853.50286
24214,720817533,02-11-24 21:28,877.9,OutgoingTransfer,Wire Transfer,11975.60286
24215,720817533,2-16-24 21:28,5800,Payment,Insurance Payment,6175.602861
24216,720817533,2-18-24 21:28,538.81,Purchase,Home Improvement,5636.792861
24217,720817533,2-19-24 12:28,895.33,Return,Best Buy Return,6532.122861
24218,720817533,2-21-24 14:28,845.32,Purchase,Gas,5686.802861
24219,720817533,2-26-24 13:28,283.1,Purchase,Clothing,5403.702861
24220,720817533,2-27-24 11:28,685.29,Purchase,Home Improvement,4718.412861
24221,720817533,2-29-24 23:28,660.87,Deposit,Cash Deposit,5379.282861
24222,720817533,03-01-24 21:28,14700,IncomingTransfer,Salary,20079.28286
24223,720817533,03-04-24 12:28,804.1,Purchase,Gas,19275.18286
24224,720817533,03-05-24 12:28,448.54,Withdrawal,ATM Withdrawal,18826.64286
24225,720817533,03-05-24 14:28,401.81,Deposit,Mobile Deposit,19228.45286
24226,720817533,03-06-24 11:28,863.78,Withdrawal,ATM Withdrawal,18364.67286
24227,720817533,03-06-24 21:28,1800,Payment,Credit Card Payment,16564.67286
24228,720817533,03-08-24 17:28,776.05,Purchase,Pharmacy,15788.62286
24229,720817533,03-12-24 21:28,5100,Payment,Installment Payment,10688.62286
24230,720817533,3-13-24 11:28,814.14,OutgoingTransfer,International Transfer,9874.482861
24231,720817533,3-14-24 12:28,682.8,OnlineShopping,Target,9191.682861
24232,720817533,3-17-24 19:28,217.2,Deposit,Cash Deposit,9408.882861
24233,720817533,3-20-24 9:28,837.53,Deposit,Check Deposit,10246.41286
24234,720817533,3-20-24 23:28,451.85,Withdrawal,Mobile App Withdrawal,9794.562861
24235,720817533,3-23-24 16:28,730.07,Payment,Mortgage Payment,9064.492861
24236,720817533,3-23-24 21:28,382.37,OnlineShopping,Best Buy,8682.122861
24237,720817533,3-27-24 13:28,776.72,Return,Amazon Return,9458.842861
24238,720817533,3-28-24 20:28,607.89,OutgoingTransfer,Peer-to-Peer Transfer,8850.952861
24239,720817533,3-31-24 14:28,710.81,Return,Target Return,9561.762861
24240,720817533,04-01-24 16:28,604.1,Return,AliExpress Return,10165.86286
24241,720817533,04-03-24 21:28,14700,IncomingTransfer,Salary,24865.86286
24242,720817533,04-04-24 11:28,845.83,OutgoingTransfer,Wire Transfer,24020.03286
24243,720817533,04-06-24 17:28,544.75,Withdrawal,Mobile App Withdrawal,23475.28286
24244,720817533,04-08-24 21:28,1700,Payment,Credit Card Payment,21775.28286
24245,720817533,4-14-24 11:28,875.53,Deposit,Check Deposit,22650.81286
24246,720817533,4-15-24 12:28,907.28,Deposit,Cash Deposit,23558.09286
24247,720817533,4-16-24 16:28,286.8,Withdrawal,Mobile App Withdrawal,23271.29286
24248,720817533,4-16-24 16:28,818.84,IncomingTransfer,Freelance Payment,24090.13286
24249,720817533,4-16-24 21:28,576.59,Withdrawal,Mobile App Withdrawal,23513.54286
24250,720817533,4-17-24 20:28,314.37,Payment,Loan Payment,23199.17286
24251,720817533,4-17-24 23:28,357.84,Purchase,Electronics,22841.33286
24252,720817533,4-18-24 12:28,304.32,OutgoingTransfer,International Transfer,22537.01286
24253,720817533,4-18-24 21:28,4400,Payment,Subscription Payment,18137.01286
24254,720817533,4-19-24 15:28,413.68,OnlineShopping,Amazon,17723.33286
24255,720817533,4-21-24 10:28,863.35,Withdrawal,Branch Withdrawal,16859.98286
24256,720817533,4-22-24 14:28,726.14,Return,Etsy Return,17586.12286
24257,720817533,4-23-24 22:28,775.39,Deposit,Direct Deposit,18361.51286
24258,720817533,4-25-24 14:28,384.32,OnlineShopping,Amazon,17977.19286
24259,720817533,05-01-24 18:28,723.62,OutgoingTransfer,Peer-to-Peer Transfer,17253.57286
24260,720817533,05-02-24 14:28,903.75,Deposit,Direct Deposit,18157.32286
24261,720817533,05-02-24 18:28,387.44,OnlineShopping,Target,17769.88286
24262,720817533,05-03-24 13:28,433.93,Payment,Mortgage Payment,17335.95286
24263,720817533,05-03-24 17:28,542.15,IncomingTransfer,Freelance Payment,17878.10286
24264,720817533,05-04-24 22:28,745.86,Withdrawal,ATM Withdrawal,17132.24286
24265,720817533,05-05-24 21:28,14700,IncomingTransfer,Salary,31832.24286
24266,720817533,05-10-24 21:28,1400,Payment,Credit Card Payment,30432.24286
24267,720817533,05-11-24 21:28,3800,Payment,Insurance Payment,26632.24286
24268,720817533,05-11-24 21:28,925.66,OutgoingTransfer,International Transfer,25706.58286
24269,720817533,05-12-24 20:28,693.85,Withdrawal,ATM Withdrawal,25012.73286
24270,720817533,5-15-24 23:28,779.55,OnlineShopping,AliExpress,24233.18286
24271,720817533,5-19-24 13:28,203.3,Withdrawal,Branch Withdrawal,24029.88286
24272,720817533,5-20-24 19:28,291.93,Withdrawal,ATM Withdrawal,23737.95286
24273,720817533,5-21-24 18:28,869.53,Deposit,Cash Deposit,24607.48286
24274,720817533,5-21-24 19:28,286.69,Deposit,Check Deposit,24894.17286
24275,720817533,5-22-24 15:28,579.31,OnlineShopping,Etsy,24314.86286
24276,720817533,5-24-24 14:28,516.32,OutgoingTransfer,Wire Transfer,23798.54286
24277,720817533,5-24-24 15:28,650.11,Purchase,Travel,23148.43286
24278,720817533,5-25-24 10:28,592.38,Purchase,Grocery,22556.05286
24279,720817533,5-25-24 20:28,913.24,Deposit,Mobile Deposit,23469.29286
24280,720817533,5-31-24 20:28,881.63,Withdrawal,Mobile App Withdrawal,22587.66286
24281,720817533,06-01-24 12:28,598.72,OnlineShopping,Target,21988.94286
24282,720817533,06-02-24 15:28,804.08,Return,Best Buy Return,22793.02286
24283,720817533,06-03-24 21:28,14700,IncomingTransfer,Salary,37493.02286
24284,720817533,06-04-24 22:28,904.33,Deposit,Cash Deposit,38397.35286
24285,720817533,06-05-24 17:28,845.96,Return,Target Return,39243.31286
24286,720817533,06-08-24 21:28,1600,Payment,Credit Card Payment,37643.31286
24287,720817533,06-09-24 15:28,568.05,Purchase,Furniture,37075.26286
24288,720817533,06-10-24 17:28,468.44,Purchase,Pharmacy,36606.82286
24289,720817533,06-10-24 19:28,694.69,Withdrawal,ATM Withdrawal,35912.13286
24290,720817533,06-11-24 19:28,934.76,Payment,Loan Payment,34977.37286
24291,720817533,06-12-24 16:28,742.85,Return,Best Buy Return,35720.22286
24292,720817533,06-12-24 23:28,229.24,OutgoingTransfer,Wire Transfer,35490.98286
24293,720817533,6-14-24 21:28,4600,Payment,Subscription Payment,30890.98286
24294,720817533,6-15-24 11:28,583.95,Return,eBay Return,31474.93286
24295,720817533,6-18-24 17:28,629.24,Purchase,Gas,30845.69286
24296,720817533,6-21-24 14:28,452.72,Purchase,Home Improvement,30392.97286
24297,720817533,6-23-24 17:28,390.31,Deposit,Check Deposit,30783.28286
24298,720817533,6-23-24 22:28,781.61,OnlineShopping,Target,30001.67286
24299,720817533,6-26-24 18:28,393.19,Withdrawal,Mobile App Withdrawal,29608.48286
24300,720817533,6-27-24 11:28,244.81,OnlineShopping,eBay,29363.67286
24301,720817533,6-30-24 16:28,904.83,Return,Walmart Return,30268.50286
24302,720817533,07-01-24 21:28,14700,IncomingTransfer,Salary,44968.50286
24303,720817533,07-02-24 22:28,932.84,Payment,Mortgage Payment,44035.66286
24304,720817533,07-04-24 19:28,828.32,IncomingTransfer,Freelance Payment,44863.98286
24305,720817533,07-05-24 13:28,660.2,Return,Best Buy Return,45524.18286
24306,720817533,07-05-24 23:28,332.85,IncomingTransfer,Freelance Payment,45857.03286
24307,720817533,07-06-24 21:28,1700,Payment,Credit Card Payment,44157.03286
24308,720817533,07-07-24 22:28,452.94,OutgoingTransfer,International Transfer,43704.09286
24309,720817533,07-09-24 11:28,464.21,OnlineShopping,AliExpress,43239.88286
24310,720817533,7-14-24 16:28,321.81,OutgoingTransfer,Wire Transfer,42918.07286
24311,720817533,7-17-24 21:28,4400,Payment,Installment Payment,38518.07286
24312,720848733,1-23-24 10:28,542.57,Deposit,Cash Deposit,1375.591255
24313,720848733,1-24-24 10:28,215.54,Deposit,Cash Deposit,1591.131255
24314,720848733,1-24-24 17:28,563.68,IncomingTransfer,Freelance Payment,2154.811255
24315,720848733,1-27-24 20:28,572.11,Purchase,Travel,1582.701255
24316,720848733,02-02-24 21:28,7650,IncomingTransfer,Salary,9232.701255
24317,720848733,02-04-24 13:28,523.18,Withdrawal,Mobile App Withdrawal,8709.521255
24318,720848733,02-07-24 21:28,1700,Payment,Credit Card Payment,7009.521255
24319,720848733,02-08-24 9:28,383.04,Return,Etsy Return,7392.561255
24320,720848733,2-14-24 21:28,202.42,OnlineShopping,eBay,7190.141255
24321,720848733,2-17-24 21:28,2400,Payment,Rent Payment,4790.141255
24322,720848733,2-29-24 21:28,195.88,Payment,Mortgage Payment,4594.261255
24323,720848733,03-01-24 21:28,7650,IncomingTransfer,Salary,12244.26125
24324,720848733,03-06-24 21:28,1500,Payment,Credit Card Payment,10744.26125
24325,720848733,03-11-24 21:28,3900,Payment,Rent Payment,6844.261255
24326,720848733,3-21-24 11:28,148.12,OutgoingTransfer,Wire Transfer,6696.141255
24327,720848733,3-21-24 18:28,170.77,Payment,Loan Payment,6525.371255
24328,720848733,3-22-24 11:28,651.61,Withdrawal,Mobile App Withdrawal,5873.761255
24329,720848733,3-23-24 14:28,533.9,Withdrawal,ATM Withdrawal,5339.861255
24330,720848733,3-26-24 19:28,243.53,Purchase,Grocery,5096.331255
24331,720848733,04-02-24 13:28,188.98,Purchase,Clothing,4907.351255
24332,720848733,04-03-24 21:28,7650,IncomingTransfer,Salary,12557.35125
24333,720848733,04-08-24 21:28,1700,Payment,Credit Card Payment,10857.35125
24334,720848733,04-12-24 19:28,669.82,Return,Target Return,11527.17125
24335,720848733,04-12-24 21:28,3900,Payment,Rent Payment,7627.171255
24336,720848733,4-26-24 17:28,334.01,IncomingTransfer,Freelance Payment,7961.181255
24337,720848733,4-27-24 16:28,298.93,Return,Etsy Return,8260.111255
24338,720848733,4-28-24 19:28,184.07,Withdrawal,Branch Withdrawal,8076.041255
24339,720848733,05-02-24 11:28,348.11,OnlineShopping,Target,7727.931255
24340,720848733,05-05-24 21:28,7650,IncomingTransfer,Salary,15377.93125
24341,720848733,05-09-24 9:28,254.98,Purchase,Gas,15122.95125
24342,720848733,05-10-24 21:28,1800,Payment,Credit Card Payment,13322.95125
24343,720848733,5-13-24 17:28,579.09,Payment,Loan Payment,12743.86125
24344,720848733,5-14-24 21:28,3600,Payment,Rent Payment,9143.861255
24345,720848733,5-14-24 22:28,174.5,OnlineShopping,Target,8969.361255
24346,720848733,5-20-24 14:28,185.74,Deposit,Direct Deposit,9155.101255
24347,720848733,5-21-24 22:28,623.55,Deposit,Check Deposit,9778.651255
24348,720848733,06-03-24 14:28,426.63,Deposit,Cash Deposit,10205.28125
24349,720848733,06-03-24 21:28,7650,IncomingTransfer,Salary,17855.28125
24350,720848733,06-04-24 13:28,187.5,Payment,Loan Payment,17667.78125
24351,720848733,06-08-24 21:28,1500,Payment,Credit Card Payment,16167.78125
24352,720848733,6-13-24 12:28,527.36,OnlineShopping,AliExpress,15640.42125
24353,720848733,6-14-24 21:28,3700,Payment,Rent Payment,11940.42125
24354,720848733,6-17-24 15:28,394.25,Purchase,Home Improvement,11546.17125
24355,720848733,6-20-24 21:28,583.4,Purchase,Grocery,10962.77125
24356,720848733,6-22-24 18:28,574.12,Purchase,Grocery,10388.65125
24357,720848733,6-27-24 18:28,507.68,Payment,Mortgage Payment,9880.971255
24358,720848733,07-04-24 20:28,462.34,Return,Best Buy Return,10343.31125
24359,720848733,07-05-24 21:28,7650,IncomingTransfer,Salary,17993.31125
24360,720848733,07-06-24 15:28,383.94,IncomingTransfer,Freelance Payment,18377.25125
24361,720848733,07-10-24 21:28,1300,Payment,Credit Card Payment,17077.25125
24362,720848733,7-18-24 21:28,2800,Payment,Rent Payment,14277.25125
24363,720899058,1-20-24 21:28,255.25,Return,Best Buy Return,2273.314176
24364,720899058,1-23-24 12:28,347.63,Payment,Loan Payment,1925.684176
24365,720899058,1-26-24 22:28,253.37,OnlineShopping,Best Buy,1672.314176
24366,720899058,02-01-24 14:28,383.4,OutgoingTransfer,Peer-to-Peer Transfer,1288.914176
24367,720899058,02-01-24 18:28,616.54,Deposit,Mobile Deposit,1905.454176
24368,720899058,02-02-24 11:28,729.48,OutgoingTransfer,Peer-to-Peer Transfer,1175.974176
24369,720899058,02-02-24 17:28,546.11,Deposit,Direct Deposit,1722.084176
24370,720899058,02-03-24 16:28,537.43,OnlineShopping,Amazon,1184.654176
24371,720899058,02-03-24 18:28,381.52,OnlineShopping,Best Buy,803.134176
24372,720899058,02-03-24 21:28,9250,IncomingTransfer,Salary,10053.13418
24373,720899058,02-08-24 18:28,530.01,OutgoingTransfer,Wire Transfer,9523.124176
24374,720899058,02-08-24 21:28,2900,Payment,Credit Card Payment,6623.124176
24375,720899058,02-09-24 16:28,135.54,Withdrawal,Branch Withdrawal,6487.584176
24376,720899058,02-10-24 17:28,197.12,Withdrawal,ATM Withdrawal,6290.464176
24377,720899058,02-10-24 22:28,606.05,Return,eBay Return,6896.514176
24378,720899058,02-11-24 11:28,241.27,Withdrawal,ATM Withdrawal,6655.244176
24379,720899058,02-12-24 14:28,348.39,Purchase,Clothing,6306.854176
24380,720899058,2-14-24 13:28,510.7,Withdrawal,Branch Withdrawal,5796.154176
24381,720899058,2-14-24 16:28,438.26,Withdrawal,Mobile App Withdrawal,5357.894176
24382,720899058,2-15-24 10:28,127.29,Withdrawal,Branch Withdrawal,5230.604176
24383,720899058,2-15-24 18:28,516.94,OutgoingTransfer,International Transfer,4713.664176
24384,720899058,2-15-24 21:28,2800,Payment,Insurance Payment,1913.664176
24385,720899058,2-16-24 12:28,145.1,OutgoingTransfer,Peer-to-Peer Transfer,1768.564176
24386,720899058,2-18-24 18:28,218.48,Return,Walmart Return,1987.044176
24387,720899058,2-19-24 12:28,416.37,Deposit,Direct Deposit,2403.414176
24388,720899058,2-21-24 13:28,466.96,Deposit,Cash Deposit,2870.374176
24389,720899058,2-21-24 14:28,446.23,Withdrawal,Mobile App Withdrawal,2424.144176
24390,720899058,2-21-24 15:28,453.22,Deposit,Mobile Deposit,2877.364176
24391,720899058,2-21-24 16:28,483.26,Withdrawal,Branch Withdrawal,2394.104176
24392,720899058,2-22-24 12:28,606.23,Withdrawal,Mobile App Withdrawal,1787.874176
24393,720899058,2-23-24 13:28,111.29,Payment,Loan Payment,1676.584176
24394,720899058,2-23-24 18:28,485.78,OutgoingTransfer,Wire Transfer,1190.804176
24395,720899058,2-24-24 15:28,620.18,Withdrawal,Branch Withdrawal,570.624176
24396,720899058,2-26-24 9:28,450.2,Purchase,Furniture,120.424176
24397,720899058,2-27-24 9:28,508.17,Purchase,Furniture,-387.745824
24398,720899058,2-27-24 22:28,552.48,OutgoingTransfer,International Transfer,-940.225824
24399,720899058,2-28-24 20:28,122.22,OnlineShopping,Etsy,-1062.445824
24400,720899058,2-28-24 20:28,729.3,Withdrawal,ATM Withdrawal,-1791.745824
24401,720899058,2-29-24 20:28,640.02,Withdrawal,Mobile App Withdrawal,-2431.765824
24402,720899058,03-03-24 17:28,236.67,Purchase,Pharmacy,-2668.435824
24403,720899058,03-04-24 21:28,9250,IncomingTransfer,Salary,6581.564176
24404,720899058,03-07-24 13:28,445.6,Return,Target Return,7027.164176
24405,720899058,03-07-24 13:28,225.95,Deposit,Cash Deposit,7253.114176
24406,720899058,03-08-24 19:28,572.13,OutgoingTransfer,International Transfer,6680.984176
24407,720899058,03-08-24 21:28,607.19,Deposit,Direct Deposit,7288.174176
24408,720899058,03-09-24 21:28,3200,Payment,Credit Card Payment,4088.174176
24409,720899058,03-10-24 12:28,672.31,Deposit,Check Deposit,4760.484176
24410,720899058,03-10-24 12:28,634.23,Purchase,Travel,4126.254176
24411,720899058,03-12-24 13:28,687.99,Deposit,Direct Deposit,4814.244176
24412,720899058,3-13-24 9:28,613.87,Deposit,Mobile Deposit,5428.114176
24413,720899058,3-13-24 18:28,148.5,Deposit,Check Deposit,5576.614176
24414,720899058,3-13-24 23:28,410.89,Withdrawal,Branch Withdrawal,5165.724176
24415,720899058,3-14-24 15:28,351.72,IncomingTransfer,Freelance Payment,5517.444176
24416,720899058,3-17-24 13:28,265.67,Deposit,Check Deposit,5783.114176
24417,720899058,3-18-24 21:28,2500,Payment,Insurance Payment,3283.114176
24418,720899058,3-24-24 13:28,319.82,Payment,Bill Payment,2963.294176
24419,720899058,3-25-24 23:28,589.72,Withdrawal,ATM Withdrawal,2373.574176
24420,720899058,3-26-24 23:28,604.9,Purchase,Home Improvement,1768.674176
24421,720899058,3-27-24 15:28,317.84,IncomingTransfer,Freelance Payment,2086.514176
24422,720899058,3-29-24 17:28,150.85,Deposit,Cash Deposit,2237.364176
24423,720899058,3-31-24 21:28,735.7,Withdrawal,Mobile App Withdrawal,1501.664176
24424,720899058,04-01-24 16:28,497.36,OnlineShopping,Target,1004.304176
24425,720899058,04-01-24 16:28,524.48,OutgoingTransfer,Peer-to-Peer Transfer,479.824176
24426,720899058,04-04-24 21:28,9250,IncomingTransfer,Salary,9729.824176
24427,720899058,04-08-24 10:28,749.2,Withdrawal,Mobile App Withdrawal,8980.624176
24428,720899058,04-09-24 21:28,3000,Payment,Credit Card Payment,5980.624176
24429,720899058,04-10-24 9:28,716.16,OnlineShopping,Target,5264.464176
24430,720899058,04-11-24 16:28,190.1,Return,Walmart Return,5454.564176
24431,720899058,04-11-24 22:28,685.78,OnlineShopping,Amazon,4768.784176
24432,720899058,4-14-24 11:28,392.07,Purchase,Home Improvement,4376.714176
24433,720899058,4-14-24 21:28,2700,Payment,Insurance Payment,1676.714176
24434,720899058,4-16-24 10:28,121.63,Purchase,Clothing,1555.084176
24435,720899058,4-18-24 14:28,447.27,Deposit,Cash Deposit,2002.354176
24436,720899058,4-18-24 22:28,309.99,Payment,Bill Payment,1692.364176
24437,720899058,4-19-24 15:28,680.1,Deposit,Direct Deposit,2372.464176
24438,720899058,4-19-24 16:28,438.56,OutgoingTransfer,International Transfer,1933.904176
24439,720899058,4-21-24 12:28,692.86,Deposit,Direct Deposit,2626.764176
24440,720899058,4-22-24 21:28,241.21,Return,Store Return,2867.974176
24441,720899058,4-22-24 23:28,692.78,Withdrawal,ATM Withdrawal,2175.194176
24442,720899058,4-23-24 19:28,669.65,Payment,Loan Payment,1505.544176
24443,720899058,4-24-24 19:28,653.45,Deposit,Check Deposit,2158.994176
24444,720899058,4-25-24 11:28,151.89,Payment,Mortgage Payment,2007.104176
24445,720899058,4-29-24 18:28,453.76,Deposit,Check Deposit,2460.864176
24446,720899058,05-04-24 21:28,9250,IncomingTransfer,Salary,11710.86418
24447,720899058,05-06-24 22:28,352.23,Deposit,Direct Deposit,12063.09418
24448,720899058,05-08-24 13:28,630.74,Withdrawal,Branch Withdrawal,11432.35418
24449,720899058,05-08-24 20:28,739.18,Payment,Loan Payment,10693.17418
24450,720899058,05-09-24 21:28,3500,Payment,Credit Card Payment,7193.174176
24451,720899058,05-10-24 16:28,301.22,Payment,Mortgage Payment,6891.954176
24452,720899058,05-12-24 18:28,363.27,IncomingTransfer,Freelance Payment,7255.224176
24453,720899058,5-14-24 20:28,151.74,Withdrawal,Mobile App Withdrawal,7103.484176
24454,720899058,5-16-24 15:28,558.3,Payment,Mortgage Payment,6545.184176
24455,720899058,5-16-24 17:28,541.14,Deposit,Mobile Deposit,7086.324176
24456,720899058,5-18-24 21:28,3600,Payment,Insurance Payment,3486.324176
24457,720899058,5-20-24 19:28,577.8,OutgoingTransfer,Bank Transfer,2908.524176
24458,720899058,5-20-24 22:28,171.56,IncomingTransfer,Freelance Payment,3080.084176
24459,720899058,5-22-24 13:28,611.68,Purchase,Electronics,2468.404176
24460,720899058,5-24-24 10:28,481.44,Payment,Bill Payment,1986.964176
24461,720899058,5-26-24 19:28,450.25,Deposit,Cash Deposit,2437.214176
24462,720899058,5-27-24 12:28,237.99,Purchase,Clothing,2199.224176
24463,720899058,5-27-24 15:28,707.22,Withdrawal,ATM Withdrawal,1492.004176
24464,720899058,5-27-24 23:28,480.72,Deposit,Direct Deposit,1972.724176
24465,720899058,5-28-24 17:28,266.79,OnlineShopping,eBay,1705.934176
24466,720899058,5-30-24 19:28,311.21,Purchase,Pharmacy,1394.724176
24467,720899058,5-30-24 20:28,447.64,OutgoingTransfer,Bank Transfer,947.084176
24468,720899058,06-01-24 15:28,100.46,Purchase,Grocery,846.624176
24469,720899058,06-01-24 19:28,413.07,Purchase,Furniture,433.554176
24470,720899058,06-02-24 21:28,9250,IncomingTransfer,Salary,9683.554176
24471,720899058,06-06-24 11:28,456.07,Purchase,Pharmacy,9227.484176
24472,720899058,06-07-24 10:28,739.39,OutgoingTransfer,Peer-to-Peer Transfer,8488.094176
24473,720899058,06-07-24 21:28,3500,Payment,Credit Card Payment,4988.094176
24474,720899058,06-08-24 10:28,269.67,Deposit,Mobile Deposit,5257.764176
24475,720899058,06-08-24 22:28,506.99,Purchase,Entertainment,4750.774176
24476,720899058,06-09-24 10:28,709.08,Deposit,Mobile Deposit,5459.854176
24477,720899058,06-10-24 12:28,422.54,Payment,Loan Payment,5037.314176
24478,720899058,6-15-24 20:28,693.7,OutgoingTransfer,International Transfer,4343.614176
24479,720899058,6-17-24 21:28,3000,Payment,Insurance Payment,1343.614176
24480,720899058,6-18-24 21:28,407.98,Deposit,Check Deposit,1751.594176
24481,720899058,6-19-24 11:28,450.21,Purchase,Home Improvement,1301.384176
24482,720899058,6-20-24 14:28,734.63,Payment,Bill Payment,566.754176
24483,720899058,6-21-24 10:28,180.81,OutgoingTransfer,International Transfer,385.944176
24484,720899058,6-28-24 10:28,618.35,Return,eBay Return,1004.294176
24485,720899058,07-02-24 16:28,239.84,Purchase,Gas,764.454176
24486,720899058,07-02-24 21:28,357.46,Withdrawal,Mobile App Withdrawal,406.994176
24487,720899058,07-04-24 21:28,9250,IncomingTransfer,Salary,9656.994176
24488,720899058,07-05-24 19:28,360.42,Return,AliExpress Return,10017.41418
24489,720899058,07-06-24 18:28,264.99,OutgoingTransfer,Bank Transfer,9752.424176
24490,720899058,07-08-24 14:28,512.91,OutgoingTransfer,Wire Transfer,9239.514176
24491,720899058,07-09-24 16:28,284.9,Payment,Mortgage Payment,8954.614176
24492,720899058,07-09-24 21:28,2800,Payment,Credit Card Payment,6154.614176
24493,720899058,07-11-24 9:28,670.97,Deposit,Cash Deposit,6825.584176
24494,720899058,07-11-24 21:28,170.51,OnlineShopping,Etsy,6655.074176
24495,720899058,07-12-24 21:28,3800,Payment,Installment Payment,2855.074176
24496,720899058,7-16-24 20:28,296.44,Withdrawal,Mobile App Withdrawal,2558.634176
24497,720920058,1-27-24 10:28,208.17,Deposit,Mobile Deposit,1081.678314
24498,720920058,1-30-24 23:28,189.04,Withdrawal,Branch Withdrawal,892.6383141
24499,720920058,1-31-24 14:28,519.18,Purchase,Travel,373.4583141
24500,720920058,02-04-24 10:28,530.04,Deposit,Cash Deposit,903.4983141
24501,720920058,02-04-24 20:28,122.26,Return,Target Return,1025.758314
24502,720920058,02-05-24 21:28,6000,IncomingTransfer,Salary,7025.758314
24503,720920058,02-09-24 19:28,345.8,Deposit,Check Deposit,7371.558314
24504,720920058,02-10-24 21:28,1300,Payment,Credit Card Payment,6071.558314
24505,720920058,02-11-24 21:28,2000,Payment,Rent Payment,4071.558314
24506,720920058,02-12-24 12:28,167.32,Purchase,Furniture,3904.238314
24507,720920058,2-13-24 16:28,78.01,Purchase,Clothing,3826.228314
24508,720920058,2-28-24 15:28,88.22,Purchase,Grocery,3738.008314
24509,720920058,03-01-24 15:28,295.25,Return,Amazon Return,4033.258314
24510,720920058,03-04-24 21:28,6000,IncomingTransfer,Salary,10033.25831
24511,720920058,03-07-24 14:28,542.84,Deposit,Cash Deposit,10576.09831
24512,720920058,03-09-24 21:28,1800,Payment,Credit Card Payment,8776.098314
24513,720920058,3-17-24 16:28,340.76,Payment,Loan Payment,8435.338314
24514,720920058,3-17-24 21:28,3200,Payment,Rent Payment,5235.338314
24515,720920058,3-18-24 13:28,231.24,Purchase,Gas,5004.098314
24516,720920058,3-24-24 21:28,466.36,Deposit,Check Deposit,5470.458314
24517,720920058,3-25-24 15:28,278.23,Purchase,Furniture,5192.228314
24518,720920058,3-25-24 17:28,466.62,Withdrawal,Mobile App Withdrawal,4725.608314
24519,720920058,3-25-24 18:28,197.02,IncomingTransfer,Freelance Payment,4922.628314
24520,720920058,3-29-24 19:28,398.92,Deposit,Check Deposit,5321.548314
24521,720920058,3-30-24 18:28,203.63,Return,Best Buy Return,5525.178314
24522,720920058,04-05-24 21:28,6000,IncomingTransfer,Salary,11525.17831
24523,720920058,04-06-24 11:28,52.58,Deposit,Cash Deposit,11577.75831
24524,720920058,04-09-24 15:28,280.35,Deposit,Check Deposit,11858.10831
24525,720920058,04-10-24 21:28,1400,Payment,Credit Card Payment,10458.10831
24526,720920058,04-10-24 21:28,1900,Payment,Rent Payment,8558.108314
24527,720920058,04-11-24 13:28,499.66,Purchase,Clothing,8058.448314
24528,720920058,04-11-24 15:28,547.12,OutgoingTransfer,Wire Transfer,7511.328314
24529,720920058,04-12-24 18:28,229.01,OutgoingTransfer,International Transfer,7282.318314
24530,720920058,4-13-24 13:28,275.62,Purchase,Pharmacy,7006.698314
24531,720920058,4-21-24 10:28,342,Deposit,Cash Deposit,7348.698314
24532,720920058,4-23-24 11:28,140.2,OutgoingTransfer,Wire Transfer,7208.498314
24533,720920058,4-24-24 12:28,302.41,Purchase,Restaurant,6906.088314
24534,720920058,4-28-24 19:28,545.28,Deposit,Mobile Deposit,7451.368314
24535,720920058,4-30-24 19:28,164.12,Deposit,Check Deposit,7615.488314
24536,720920058,05-01-24 18:28,515.7,Deposit,Mobile Deposit,8131.188314
24537,720920058,05-01-24 20:28,166.91,Withdrawal,ATM Withdrawal,7964.278314
24538,720920058,05-01-24 21:28,6000,IncomingTransfer,Salary,13964.27831
24539,720920058,05-06-24 14:28,139.48,Withdrawal,Branch Withdrawal,13824.79831
24540,720920058,05-06-24 21:28,1300,Payment,Credit Card Payment,12524.79831
24541,720920058,05-07-24 21:28,420.77,OnlineShopping,Target,12104.02831
24542,720920058,05-10-24 21:28,2100,Payment,Rent Payment,10004.02831
24543,720920058,05-11-24 16:28,389.62,Deposit,Cash Deposit,10393.64831
24544,720920058,5-15-24 20:28,528.19,Payment,Loan Payment,9865.458314
24545,720920058,5-20-24 15:28,115.72,Deposit,Mobile Deposit,9981.178314
24546,720920058,5-21-24 23:28,195.66,Withdrawal,Branch Withdrawal,9785.518314
24547,720920058,5-29-24 15:28,247.26,Withdrawal,ATM Withdrawal,9538.258314
24548,720920058,5-29-24 16:28,70.81,Deposit,Cash Deposit,9609.068314
24549,720920058,5-30-24 13:28,387.1,Purchase,Furniture,9221.968314
24550,720920058,06-04-24 10:28,157.26,IncomingTransfer,Freelance Payment,9379.228314
24551,720920058,06-04-24 16:28,229.14,Return,Store Return,9608.368314
24552,720920058,06-05-24 21:28,6000,IncomingTransfer,Salary,15608.36831
24553,720920058,06-09-24 20:28,321.11,Purchase,Entertainment,15287.25831
24554,720920058,06-10-24 21:28,1500,Payment,Credit Card Payment,13787.25831
24555,720920058,6-15-24 19:28,74.19,Return,Target Return,13861.44831
24556,720920058,6-18-24 21:28,2400,Payment,Rent Payment,11461.44831
24557,720920058,6-19-24 17:28,86.8,Purchase,Pharmacy,11374.64831
24558,720920058,6-20-24 18:28,72.45,OnlineShopping,Target,11302.19831
24559,720920058,6-25-24 9:28,473.62,Return,Etsy Return,11775.81831
24560,720920058,6-26-24 9:28,137.22,IncomingTransfer,Freelance Payment,11913.03831
24561,720920058,6-29-24 12:28,488.88,Deposit,Check Deposit,12401.91831
24562,720920058,07-01-24 10:28,312.12,Purchase,Entertainment,12089.79831
24563,720920058,07-01-24 14:28,300.19,Deposit,Cash Deposit,12389.98831
24564,720920058,07-02-24 10:28,347.96,Payment,Bill Payment,12042.02831
24565,720920058,07-02-24 15:28,432.99,Purchase,Grocery,11609.03831
24566,720920058,07-03-24 21:28,510.89,Purchase,Entertainment,11098.14831
24567,720920058,07-04-24 12:28,76.14,IncomingTransfer,Freelance Payment,11174.28831
24568,720920058,07-04-24 18:28,377.7,Purchase,Grocery,10796.58831
24569,720920058,07-04-24 21:28,6000,IncomingTransfer,Salary,16796.58831
24570,720920058,07-09-24 13:28,210.74,Return,Store Return,17007.32831
24571,720920058,07-09-24 21:28,1400,Payment,Credit Card Payment,15607.32831
24572,720920058,07-10-24 21:28,2600,Payment,Rent Payment,13007.32831
24573,720920058,07-12-24 9:28,277.65,Payment,Loan Payment,12729.67831
24574,720920058,7-13-24 21:28,55.09,Purchase,Entertainment,12674.58831
24575,720920058,7-14-24 15:28,286.32,OnlineShopping,Target,12388.26831
24576,720920058,7-16-24 23:28,148.8,Purchase,Pharmacy,12239.46831
24577,720941433,1-21-24 15:28,91.11,Payment,Loan Payment,-91.11
24578,720941433,1-24-24 18:28,132.5,Payment,Mortgage Payment,-223.61
24579,720941433,1-29-24 22:28,175.51,Purchase,Travel,-399.12
24580,720941433,1-30-24 10:28,150.19,Payment,Mortgage Payment,-549.31
24581,720941433,02-01-24 21:28,3300,IncomingTransfer,Salary,2750.69
24582,720941433,02-08-24 19:28,129.52,Return,eBay Return,2880.21
24583,720941433,02-12-24 21:28,1900,Payment,Rent Payment,980.21
24584,720941433,2-15-24 16:28,17.6,Purchase,Electronics,962.61
24585,720941433,2-16-24 12:28,167.32,OutgoingTransfer,International Transfer,795.29
24586,720941433,2-18-24 13:28,72.14,Withdrawal,Branch Withdrawal,723.15
24587,720941433,2-29-24 16:28,108.74,Withdrawal,Mobile App Withdrawal,614.41
24588,720941433,03-02-24 22:28,51.8,Purchase,Home Improvement,562.61
24589,720941433,03-04-24 14:28,240.45,Deposit,Mobile Deposit,803.06
24590,720941433,03-05-24 21:28,3300,IncomingTransfer,Salary,4103.06
24591,720941433,03-09-24 13:28,221.77,Purchase,Pharmacy,3881.29
24592,720941433,03-10-24 11:28,102.63,OnlineShopping,Target,3778.66
24593,720941433,03-10-24 21:28,1800,Payment,Rent Payment,1978.66
24594,720941433,03-11-24 20:28,219.24,Payment,Loan Payment,1759.42
24595,720941433,03-12-24 12:28,60.84,Return,eBay Return,1820.26
24596,720941433,3-14-24 9:28,107.1,Deposit,Cash Deposit,1927.36
24597,720941433,3-19-24 10:28,141.69,OutgoingTransfer,Peer-to-Peer Transfer,1785.67
24598,720941433,3-19-24 21:28,29.92,Return,eBay Return,1815.59
24599,720941433,3-22-24 10:28,48.02,Purchase,Home Improvement,1767.57
24600,720941433,3-27-24 16:28,216.35,Purchase,Electronics,1551.22
24601,720941433,3-30-24 18:28,137.46,Purchase,Pharmacy,1413.76
24602,720941433,3-31-24 21:28,131.25,Purchase,Electronics,1282.51
24603,720941433,04-04-24 22:28,41.98,OutgoingTransfer,Wire Transfer,1240.53
24604,720941433,04-05-24 21:28,3300,IncomingTransfer,Salary,4540.53
24605,720941433,04-08-24 10:28,239.72,OutgoingTransfer,Bank Transfer,4300.81
24606,720941433,4-13-24 21:28,1100,Payment,Rent Payment,3200.81
24607,720941433,4-19-24 18:28,239.87,Purchase,Electronics,2960.94
24608,720941433,05-01-24 21:28,3300,IncomingTransfer,Salary,6260.94
24609,720941433,05-09-24 18:28,219.83,Return,Amazon Return,6480.77
24610,720941433,5-16-24 15:28,170.79,Purchase,Furniture,6309.98
24611,720941433,5-16-24 21:28,1100,Payment,Rent Payment,5209.98
24612,720941433,5-29-24 20:28,27.3,OnlineShopping,Etsy,5182.68
24613,720941433,5-31-24 14:28,29.12,Payment,Mortgage Payment,5153.56
24614,720941433,06-02-24 16:28,243.78,Return,eBay Return,5397.34
24615,720941433,06-02-24 21:28,3300,IncomingTransfer,Salary,8697.34
24616,720941433,06-03-24 13:28,102.59,Purchase,Pharmacy,8594.75
24617,720941433,06-05-24 9:28,199.08,Purchase,Gas,8395.67
24618,720941433,06-08-24 14:28,15.41,OutgoingTransfer,Wire Transfer,8380.26
24619,720941433,06-10-24 10:28,103.86,Purchase,Clothing,8276.4
24620,720941433,06-11-24 23:28,12.88,Purchase,Electronics,8263.52
24621,720941433,6-13-24 21:28,1500,Payment,Rent Payment,6763.52
24622,720941433,6-14-24 14:28,140.87,Purchase,Grocery,6622.65
24623,720941433,6-14-24 22:28,141.32,Deposit,Mobile Deposit,6763.97
24624,720941433,6-18-24 18:28,32.85,OutgoingTransfer,International Transfer,6731.12
24625,720941433,6-19-24 11:28,75.79,Purchase,Grocery,6655.33
24626,720941433,6-20-24 14:28,223.27,OnlineShopping,Amazon,6432.06
24627,720941433,6-29-24 13:28,94.94,Deposit,Check Deposit,6527
24628,720941433,07-02-24 17:28,207.46,Deposit,Cash Deposit,6734.46
24629,720941433,07-02-24 21:28,3300,IncomingTransfer,Salary,10034.46
24630,720941433,07-09-24 23:28,248.68,Payment,Mortgage Payment,9785.78
24631,720941433,07-11-24 21:28,800,Payment,Rent Payment,8985.78
24632,720963258,1-22-24 19:28,79.28,Withdrawal,ATM Withdrawal,-79.28
24633,720963258,1-23-24 14:28,204.81,OutgoingTransfer,Bank Transfer,-284.09
24634,720963258,1-29-24 14:28,57.09,Payment,Bill Payment,-341.18
24635,720963258,02-01-24 21:28,2200,IncomingTransfer,Salary,1858.82
24636,720963258,02-11-24 13:28,43.43,OnlineShopping,Etsy,1815.39
24637,720963258,2-15-24 13:28,118.62,Return,Etsy Return,1934.01
24638,720963258,2-18-24 11:28,245.96,Return,Store Return,2179.97
24639,720963258,2-18-24 21:28,900,Payment,Rent Payment,1279.97
24640,720963258,2-18-24 22:28,87.89,Purchase,Restaurant,1192.08
24641,720963258,2-19-24 10:28,36.4,Deposit,Direct Deposit,1228.48
24642,720963258,2-20-24 16:28,202.02,Withdrawal,Branch Withdrawal,1026.46
24643,720963258,2-20-24 22:28,133.89,Deposit,Direct Deposit,1160.35
24644,720963258,2-28-24 13:28,98.98,OnlineShopping,AliExpress,1061.37
24645,720963258,03-01-24 10:28,75.67,Deposit,Cash Deposit,1137.04
24646,720963258,03-02-24 21:28,2200,IncomingTransfer,Salary,3337.04
24647,720963258,03-05-24 15:28,82.31,Deposit,Mobile Deposit,3419.35
24648,720963258,03-10-24 11:28,18.2,Withdrawal,ATM Withdrawal,3401.15
24649,720963258,03-12-24 14:28,47.02,Deposit,Cash Deposit,3448.17
24650,720963258,3-13-24 16:28,195.35,Return,Walmart Return,3643.52
24651,720963258,3-13-24 18:28,141.15,Deposit,Mobile Deposit,3784.67
24652,720963258,3-13-24 21:28,800,Payment,Rent Payment,2984.67
24653,720963258,3-25-24 17:28,115.63,Purchase,Travel,2869.04
24654,720963258,3-27-24 10:28,229.15,Return,Best Buy Return,3098.19
24655,720963258,3-27-24 18:28,203.69,Purchase,Entertainment,2894.5
24656,720963258,04-02-24 14:28,56.3,Purchase,Grocery,2838.2
24657,720963258,04-03-24 21:28,2200,IncomingTransfer,Salary,5038.2
24658,720963258,04-03-24 23:28,14.29,Deposit,Direct Deposit,5052.49
24659,720963258,4-14-24 14:28,22.79,OutgoingTransfer,Wire Transfer,5029.7
24660,720963258,4-16-24 21:28,600,Payment,Rent Payment,4429.7
24661,720963258,05-02-24 17:28,17.21,Withdrawal,Branch Withdrawal,4412.49
24662,720963258,05-03-24 21:28,2200,IncomingTransfer,Salary,6612.49
24663,720963258,05-07-24 23:28,239.08,Deposit,Check Deposit,6851.57
24664,720963258,05-10-24 18:28,117.18,Purchase,Clothing,6734.39
24665,720963258,05-10-24 21:28,1400,Payment,Rent Payment,5334.39
24666,720963258,5-27-24 11:28,155.69,OutgoingTransfer,Bank Transfer,5178.7
24667,720963258,5-30-24 15:28,227.05,Withdrawal,Mobile App Withdrawal,4951.65
24668,720963258,06-02-24 13:28,66.97,Deposit,Cash Deposit,5018.62
24669,720963258,06-03-24 21:28,2200,IncomingTransfer,Salary,7218.62
24670,720963258,06-10-24 11:28,64.66,Deposit,Cash Deposit,7283.28
24671,720963258,06-11-24 21:28,800,Payment,Rent Payment,6483.28
24672,720963258,6-21-24 17:28,128.58,Purchase,Pharmacy,6354.7
24673,720963258,6-21-24 22:28,222.11,Payment,Bill Payment,6132.59
24674,720963258,6-27-24 12:28,110.55,Payment,Loan Payment,6022.04
24675,720963258,07-01-24 21:28,2200,IncomingTransfer,Salary,8222.04
24676,720963258,07-02-24 23:28,78.41,Payment,Mortgage Payment,8143.63
24677,720963258,7-14-24 13:28,82.74,Purchase,Furniture,8060.89
24678,720963258,7-15-24 22:28,234.74,Deposit,Check Deposit,8295.63
24679,720963258,7-16-24 11:28,201.95,Return,Amazon Return,8497.58
24680,720963258,7-16-24 21:28,1100,Payment,Rent Payment,7397.58
24681,720964683,1-22-24 20:28,114.42,Deposit,Cash Deposit,114.42
24682,720964683,1-27-24 12:28,188.98,Purchase,Home Improvement,-74.56
24683,720964683,1-31-24 10:28,23.27,Purchase,Grocery,-97.83
24684,720964683,02-05-24 21:28,5000,IncomingTransfer,Salary,4902.17
24685,720964683,02-07-24 9:28,178.05,IncomingTransfer,Freelance Payment,5080.22
24686,720964683,02-10-24 19:28,292,Deposit,Direct Deposit,5372.22
24687,720964683,02-11-24 10:28,353.51,Deposit,Mobile Deposit,5725.73
24688,720964683,2-13-24 21:28,2600,Payment,Rent Payment,3125.73
24689,720964683,2-17-24 21:28,295.79,Deposit,Check Deposit,3421.52
24690,720964683,2-23-24 9:28,157.89,Deposit,Mobile Deposit,3579.41
24691,720964683,2-25-24 14:28,248.47,OnlineShopping,Best Buy,3330.94
24692,720964683,2-29-24 11:28,120.29,Withdrawal,ATM Withdrawal,3210.65
24693,720964683,2-29-24 11:28,172.57,IncomingTransfer,Freelance Payment,3383.22
24694,720964683,2-29-24 18:28,235.49,OnlineShopping,Target,3147.73
24695,720964683,03-01-24 18:28,136.19,Return,Store Return,3283.92
24696,720964683,03-03-24 19:28,205.74,Payment,Bill Payment,3078.18
24697,720964683,03-04-24 21:28,5000,IncomingTransfer,Salary,8078.18
24698,720964683,03-09-24 16:28,227.25,Deposit,Cash Deposit,8305.43
24699,720964683,03-10-24 18:28,245.87,Deposit,Check Deposit,8551.3
24700,720964683,3-14-24 21:28,2500,Payment,Rent Payment,6051.3
24701,720964683,3-14-24 21:28,368.36,Deposit,Cash Deposit,6419.66
24702,720964683,3-16-24 19:28,88.74,Payment,Bill Payment,6330.92
24703,720964683,3-24-24 13:28,34.2,IncomingTransfer,Freelance Payment,6365.12
24704,720964683,3-31-24 14:28,364.69,OutgoingTransfer,Bank Transfer,6000.43
24705,720964683,3-31-24 19:28,42.15,Purchase,Travel,5958.28
24706,720964683,04-01-24 17:28,103.57,Withdrawal,Mobile App Withdrawal,5854.71
24707,720964683,04-04-24 21:28,5000,IncomingTransfer,Salary,10854.71
24708,720964683,04-07-24 22:28,146.04,Return,Etsy Return,11000.75
24709,720964683,04-09-24 14:28,82.85,Purchase,Gas,10917.9
24710,720964683,04-10-24 21:28,3100,Payment,Rent Payment,7817.9
24711,720964683,04-12-24 11:28,335.35,Deposit,Mobile Deposit,8153.25
24712,720964683,4-14-24 11:28,333.27,Deposit,Cash Deposit,8486.52
24713,720964683,4-21-24 18:28,370.07,Withdrawal,Branch Withdrawal,8116.45
24714,720964683,4-29-24 12:28,110.14,Purchase,Entertainment,8006.31
24715,720964683,05-02-24 21:28,5000,IncomingTransfer,Salary,13006.31
24716,720964683,05-06-24 13:28,350.04,Purchase,Gas,12656.27
24717,720964683,05-10-24 17:28,316,IncomingTransfer,Freelance Payment,12972.27
24718,720964683,05-10-24 21:28,1400,Payment,Rent Payment,11572.27
24719,720964683,05-11-24 13:28,213.31,Payment,Bill Payment,11358.96
24720,720964683,5-13-24 9:28,99.93,Deposit,Direct Deposit,11458.89
24721,720964683,5-13-24 19:28,106.02,Purchase,Grocery,11352.87
24722,720964683,5-14-24 18:28,199.3,OutgoingTransfer,International Transfer,11153.57
24723,720964683,5-18-24 19:28,205.58,IncomingTransfer,Freelance Payment,11359.15
24724,720964683,5-18-24 22:28,299.96,Return,eBay Return,11659.11
24725,720964683,5-23-24 13:28,295.44,Withdrawal,Mobile App Withdrawal,11363.67
24726,720964683,06-02-24 14:28,152.1,Deposit,Cash Deposit,11515.77
24727,720964683,06-03-24 21:28,276.12,Payment,Loan Payment,11239.65
24728,720964683,06-05-24 21:28,5000,IncomingTransfer,Salary,16239.65
24729,720964683,06-07-24 12:28,273.42,Deposit,Direct Deposit,16513.07
24730,720964683,06-08-24 17:28,206.61,Withdrawal,ATM Withdrawal,16306.46
24731,720964683,06-10-24 19:28,262.71,Deposit,Mobile Deposit,16569.17
24732,720964683,06-11-24 21:28,1500,Payment,Rent Payment,15069.17
24733,720964683,06-12-24 11:28,261.72,Deposit,Mobile Deposit,15330.89
24734,720964683,6-16-24 19:28,193.26,Withdrawal,Branch Withdrawal,15137.63
24735,720964683,6-18-24 22:28,304.21,Return,Best Buy Return,15441.84
24736,720964683,6-19-24 19:28,179.98,Deposit,Cash Deposit,15621.82
24737,720964683,6-21-24 17:28,59.15,IncomingTransfer,Freelance Payment,15680.97
24738,720964683,6-22-24 20:28,103.85,OnlineShopping,Best Buy,15577.12
24739,720964683,6-26-24 11:28,123.15,Deposit,Cash Deposit,15700.27
24740,720964683,6-26-24 14:28,257.41,Withdrawal,ATM Withdrawal,15442.86
24741,720964683,6-29-24 10:28,125.32,Deposit,Check Deposit,15568.18
24742,720964683,6-29-24 13:28,50.34,Purchase,Clothing,15517.84
24743,720964683,07-05-24 21:28,5000,IncomingTransfer,Salary,20517.84
24744,720964683,07-07-24 13:28,35.06,Return,Store Return,20552.9
24745,720964683,07-07-24 16:28,154.39,Deposit,Mobile Deposit,20707.29
24746,720964683,07-07-24 20:28,212.15,Purchase,Restaurant,20495.14
24747,720964683,07-08-24 14:28,322.68,Purchase,Grocery,20172.46
24748,720964683,07-10-24 17:28,181.55,Withdrawal,ATM Withdrawal,19990.91
24749,720964683,7-13-24 18:28,265.6,Payment,Mortgage Payment,19725.31
24750,720964683,7-14-24 13:28,312.22,Withdrawal,ATM Withdrawal,19413.09
24751,720964683,7-17-24 17:28,274.4,Payment,Loan Payment,19138.69
24752,720964683,7-18-24 21:28,2400,Payment,Rent Payment,16738.69
24753,720983733,1-20-24 15:28,164.12,Payment,Mortgage Payment,353.2380155
24754,720983733,1-23-24 14:28,422.59,Deposit,Cash Deposit,775.8280155
24755,720983733,1-25-24 20:28,281.88,Return,Etsy Return,1057.708015
24756,720983733,1-26-24 19:28,288.76,OnlineShopping,Etsy,768.9480155
24757,720983733,1-30-24 20:28,382.82,Deposit,Direct Deposit,1151.768015
24758,720983733,02-02-24 21:28,5900,IncomingTransfer,Salary,7051.768015
24759,720983733,02-07-24 9:28,321.56,Deposit,Mobile Deposit,7373.328015
24760,720983733,02-07-24 16:28,264.86,OnlineShopping,Walmart,7108.468015
24761,720983733,02-07-24 21:28,1200,Payment,Credit Card Payment,5908.468015
24762,720983733,02-08-24 23:28,329.86,OnlineShopping,AliExpress,5578.608015
24763,720983733,02-12-24 10:28,305.67,Purchase,Pharmacy,5272.938015
24764,720983733,2-14-24 21:28,2200,Payment,Rent Payment,3072.938015
24765,720983733,2-15-24 23:28,134.13,OnlineShopping,Target,2938.808015
24766,720983733,2-18-24 21:28,382.63,Deposit,Cash Deposit,3321.438015
24767,720983733,2-25-24 22:28,123.97,Return,Etsy Return,3445.408015
24768,720983733,2-26-24 11:28,475.46,OnlineShopping,Walmart,2969.948015
24769,720983733,03-01-24 21:28,5900,IncomingTransfer,Salary,8869.948015
24770,720983733,03-03-24 15:28,89.81,Return,Target Return,8959.758015
24771,720983733,03-04-24 16:28,342.26,Payment,Bill Payment,8617.498015
24772,720983733,03-06-24 21:28,900,Payment,Credit Card Payment,7717.498015
24773,720983733,03-07-24 11:28,403.54,Withdrawal,Mobile App Withdrawal,7313.958015
24774,720983733,03-09-24 11:28,324.79,OnlineShopping,AliExpress,6989.168015
24775,720983733,3-18-24 21:28,2000,Payment,Rent Payment,4989.168015
24776,720983733,3-19-24 12:28,405.58,Deposit,Direct Deposit,5394.748015
24777,720983733,3-21-24 22:28,183.95,OutgoingTransfer,International Transfer,5210.798015
24778,720983733,3-24-24 14:28,384.26,Payment,Loan Payment,4826.538015
24779,720983733,3-26-24 19:28,486.04,Purchase,Clothing,4340.498015
24780,720983733,3-29-24 22:28,291.87,Purchase,Grocery,4048.628015
24781,720983733,04-02-24 21:28,5900,IncomingTransfer,Salary,9948.628015
24782,720983733,04-06-24 17:28,50.7,Purchase,Home Improvement,9897.928015
24783,720983733,04-07-24 21:28,1100,Payment,Credit Card Payment,8797.928015
24784,720983733,04-10-24 21:28,1800,Payment,Rent Payment,6997.928015
24785,720983733,4-17-24 19:28,487.35,Withdrawal,Mobile App Withdrawal,6510.578015
24786,720983733,4-19-24 19:28,502.57,IncomingTransfer,Freelance Payment,7013.148015
24787,720983733,4-20-24 22:28,127.24,Payment,Bill Payment,6885.908015
24788,720983733,4-26-24 12:28,193.81,OnlineShopping,Amazon,6692.098015
24789,720983733,4-26-24 12:28,359.69,Purchase,Electronics,6332.408015
24790,720983733,4-27-24 18:28,148.85,Purchase,Pharmacy,6183.558015
24791,720983733,05-02-24 21:28,5900,IncomingTransfer,Salary,12083.55802
24792,720983733,05-06-24 20:28,298.22,OutgoingTransfer,International Transfer,11785.33802
24793,720983733,05-07-24 21:28,1100,Payment,Credit Card Payment,10685.33802
24794,720983733,05-08-24 16:28,232.93,Withdrawal,ATM Withdrawal,10452.40802
24795,720983733,05-10-24 12:28,379.33,Payment,Mortgage Payment,10073.07802
24796,720983733,5-13-24 13:28,414.44,Return,AliExpress Return,10487.51802
24797,720983733,5-14-24 23:28,280.82,Withdrawal,Branch Withdrawal,10206.69802
24798,720983733,5-15-24 21:28,1800,Payment,Rent Payment,8406.698015
24799,720983733,5-19-24 16:28,341.42,Deposit,Cash Deposit,8748.118015
24800,720983733,5-22-24 9:28,344.09,Deposit,Direct Deposit,9092.208015
24801,720983733,5-22-24 12:28,294.35,Payment,Loan Payment,8797.858015
24802,720983733,5-24-24 16:28,222.55,Purchase,Travel,8575.308015
24803,720983733,5-26-24 18:28,313.37,Withdrawal,Branch Withdrawal,8261.938015
24804,720983733,06-02-24 18:28,388.21,Purchase,Grocery,7873.728015
24805,720983733,06-04-24 21:28,5900,IncomingTransfer,Salary,13773.72802
24806,720983733,06-08-24 13:28,279.51,Return,Etsy Return,14053.23802
24807,720983733,06-09-24 18:28,314.83,Purchase,Furniture,13738.40802
24808,720983733,06-09-24 21:28,1000,Payment,Credit Card Payment,12738.40802
24809,720983733,6-17-24 21:28,3100,Payment,Rent Payment,9638.408015
24810,720983733,6-18-24 15:28,375.07,OnlineShopping,AliExpress,9263.338015
24811,720983733,6-22-24 16:28,478.77,Payment,Loan Payment,8784.568015
24812,720983733,6-22-24 22:28,143.78,Purchase,Clothing,8640.788015
24813,720983733,6-25-24 16:28,295.52,Deposit,Direct Deposit,8936.308015
24814,720983733,6-26-24 16:28,153.85,Purchase,Electronics,8782.458015
24815,720983733,6-30-24 11:28,63.34,Return,Store Return,8845.798015
24816,720983733,07-02-24 14:28,120.67,OnlineShopping,Etsy,8725.128015
24817,720983733,07-02-24 21:28,5900,IncomingTransfer,Salary,14625.12802
24818,720983733,07-07-24 21:28,1100,Payment,Credit Card Payment,13525.12802
24819,720983733,07-10-24 17:28,146.94,Purchase,Gas,13378.18802
24820,720983733,07-11-24 15:28,370.37,Deposit,Direct Deposit,13748.55802
24821,720983733,7-13-24 21:28,2100,Payment,Rent Payment,11648.55802
24822,720983733,7-14-24 14:28,135.79,Deposit,Cash Deposit,11784.34802
24823,720983733,7-14-24 22:28,346.15,Deposit,Direct Deposit,12130.49802
24824,720983733,7-16-24 17:28,437.9,IncomingTransfer,Freelance Payment,12568.39802
24825,721023708,1-25-24 22:28,442.84,Purchase,Furniture,-442.84
24826,721023708,1-29-24 21:28,196.55,Payment,Bill Payment,-639.39
24827,721023708,02-02-24 21:28,5350,IncomingTransfer,Salary,4710.61
24828,721023708,02-03-24 10:28,79.28,Return,Store Return,4789.89
24829,721023708,02-03-24 19:28,198.76,IncomingTransfer,Freelance Payment,4988.65
24830,721023708,02-05-24 12:28,533.12,Return,Store Return,5521.77
24831,721023708,02-05-24 20:28,71.81,Deposit,Check Deposit,5593.58
24832,721023708,02-10-24 21:28,1800,Payment,Rent Payment,3793.58
24833,721023708,2-14-24 10:28,505.64,IncomingTransfer,Freelance Payment,4299.22
24834,721023708,2-17-24 13:28,487.05,OnlineShopping,Best Buy,3812.17
24835,721023708,2-17-24 15:28,345.1,Purchase,Clothing,3467.07
24836,721023708,2-19-24 22:28,390.39,Deposit,Mobile Deposit,3857.46
24837,721023708,2-21-24 19:28,87.53,OnlineShopping,Walmart,3769.93
24838,721023708,2-25-24 13:28,256.76,OutgoingTransfer,Bank Transfer,3513.17
24839,721023708,2-26-24 22:28,366.25,OnlineShopping,eBay,3146.92
24840,721023708,2-27-24 9:28,397.66,Purchase,Restaurant,2749.26
24841,721023708,2-27-24 15:28,493.55,Deposit,Mobile Deposit,3242.81
24842,721023708,03-02-24 21:28,5350,IncomingTransfer,Salary,8592.81
24843,721023708,03-05-24 20:28,107.89,Payment,Loan Payment,8484.92
24844,721023708,03-06-24 23:28,273.95,IncomingTransfer,Freelance Payment,8758.87
24845,721023708,03-09-24 13:28,218.62,Purchase,Pharmacy,8540.25
24846,721023708,03-09-24 17:28,89.42,Purchase,Restaurant,8450.83
24847,721023708,03-11-24 19:28,275.84,Withdrawal,ATM Withdrawal,8174.99
24848,721023708,3-13-24 19:28,505.24,Purchase,Travel,7669.75
24849,721023708,3-14-24 11:28,359.59,OutgoingTransfer,Bank Transfer,7310.16
24850,721023708,3-14-24 21:28,1700,Payment,Rent Payment,5610.16
24851,721023708,3-17-24 18:28,421.59,Payment,Mortgage Payment,5188.57
24852,721023708,3-21-24 22:28,467.67,Withdrawal,Mobile App Withdrawal,4720.9
24853,721023708,3-23-24 16:28,85.96,Return,Target Return,4806.86
24854,721023708,3-27-24 19:28,211.07,Deposit,Direct Deposit,5017.93
24855,721023708,3-28-24 10:28,476.85,Payment,Mortgage Payment,4541.08
24856,721023708,3-30-24 12:28,449.66,OnlineShopping,Walmart,4091.42
24857,721023708,3-31-24 14:28,219.22,Withdrawal,ATM Withdrawal,3872.2
24858,721023708,04-01-24 17:28,420.62,OutgoingTransfer,Wire Transfer,3451.58
24859,721023708,04-05-24 21:28,5350,IncomingTransfer,Salary,8801.58
24860,721023708,04-08-24 22:28,429.34,Return,Store Return,9230.92
24861,721023708,4-14-24 10:28,486.8,Purchase,Home Improvement,8744.12
24862,721023708,4-14-24 21:28,369.79,Deposit,Mobile Deposit,9113.91
24863,721023708,4-16-24 21:28,2600,Payment,Rent Payment,6513.91
24864,721023708,4-20-24 21:28,55.04,Deposit,Cash Deposit,6568.95
24865,721023708,4-30-24 14:28,78.17,Withdrawal,Branch Withdrawal,6490.78
24866,721023708,4-30-24 17:28,415.62,Deposit,Check Deposit,6906.4
24867,721023708,05-01-24 20:28,216.85,Purchase,Furniture,6689.55
24868,721023708,05-02-24 21:28,5350,IncomingTransfer,Salary,12039.55
24869,721023708,05-05-24 13:28,495.86,Withdrawal,Mobile App Withdrawal,11543.69
24870,721023708,05-07-24 19:28,193,Purchase,Restaurant,11350.69
24871,721023708,5-15-24 12:28,491.34,IncomingTransfer,Freelance Payment,11842.03
24872,721023708,5-15-24 19:28,205.19,OnlineShopping,Walmart,11636.84
24873,721023708,5-15-24 21:28,3000,Payment,Rent Payment,8636.84
24874,721023708,5-15-24 22:28,84.47,Return,Target Return,8721.31
24875,721023708,5-22-24 19:28,108.43,Purchase,Electronics,8612.88
24876,721023708,5-22-24 20:28,486.62,OutgoingTransfer,Bank Transfer,8126.26
24877,721023708,5-26-24 13:28,378.52,Purchase,Gas,7747.74
24878,721023708,06-01-24 14:28,258.24,Deposit,Direct Deposit,8005.98
24879,721023708,06-02-24 17:28,187.93,Deposit,Direct Deposit,8193.91
24880,721023708,06-05-24 11:28,124.39,OnlineShopping,AliExpress,8069.52
24881,721023708,06-05-24 21:28,5350,IncomingTransfer,Salary,13419.52
24882,721023708,06-10-24 21:28,286.52,Purchase,Gas,13133
24883,721023708,06-12-24 21:28,2800,Payment,Rent Payment,10333
24884,721023708,6-14-24 14:28,430.14,Deposit,Check Deposit,10763.14
24885,721023708,6-24-24 18:28,310.69,Purchase,Entertainment,10452.45
24886,721023708,6-24-24 19:28,422.75,Return,Best Buy Return,10875.2
24887,721023708,6-24-24 22:28,362.33,OnlineShopping,Walmart,10512.87
24888,721023708,6-27-24 22:28,211.93,Purchase,Pharmacy,10300.94
24889,721023708,6-29-24 13:28,439.97,Withdrawal,Mobile App Withdrawal,9860.97
24890,721023708,6-30-24 21:28,244.18,OnlineShopping,Etsy,9616.79
24891,721023708,07-01-24 21:28,5350,IncomingTransfer,Salary,14966.79
24892,721023708,07-04-24 22:28,344.04,Withdrawal,Branch Withdrawal,14622.75
24893,721023708,07-06-24 15:28,103.97,Deposit,Cash Deposit,14726.72
24894,721023708,07-07-24 11:28,241.63,Purchase,Gas,14485.09
24895,721023708,07-07-24 19:28,317.53,Payment,Mortgage Payment,14167.56
24896,721023708,07-09-24 13:28,206.15,Purchase,Clothing,13961.41
24897,721023708,07-09-24 18:28,421.4,Deposit,Direct Deposit,14382.81
24898,721023708,7-14-24 21:28,3400,Payment,Rent Payment,10982.81
24899,721055058,1-21-24 13:28,312.31,Purchase,Furniture,1045.548589
24900,721055058,1-24-24 18:28,546.34,Deposit,Cash Deposit,1591.888589
24901,721055058,1-27-24 15:28,103.45,Deposit,Direct Deposit,1695.338589
24902,721055058,02-03-24 21:28,5400,IncomingTransfer,Salary,7095.338589
24903,721055058,02-04-24 13:28,390.69,Purchase,Grocery,6704.648589
24904,721055058,02-07-24 16:28,530.64,Deposit,Cash Deposit,7235.288589
24905,721055058,02-07-24 21:28,186.12,Purchase,Gas,7049.168589
24906,721055058,02-08-24 21:28,3000,Payment,Credit Card Payment,4049.168589
24907,721055058,02-09-24 10:28,216.77,OnlineShopping,Amazon,3832.398589
24908,721055058,02-10-24 17:28,115.11,Purchase,Pharmacy,3717.288589
24909,721055058,02-10-24 21:28,1700,Payment,Rent Payment,2017.288589
24910,721055058,2-19-24 15:28,93.46,OnlineShopping,eBay,1923.828589
24911,721055058,03-01-24 21:28,5400,IncomingTransfer,Salary,7323.828589
24912,721055058,03-01-24 23:28,358.96,Withdrawal,Mobile App Withdrawal,6964.868589
24913,721055058,03-02-24 19:28,371.97,OutgoingTransfer,International Transfer,6592.898589
24914,721055058,03-06-24 21:28,3800,Payment,Credit Card Payment,2792.898589
24915,721055058,03-10-24 21:28,1400,Payment,Rent Payment,1392.898589
24916,721055058,3-24-24 14:28,122.49,Withdrawal,Branch Withdrawal,1270.408589
24917,721055058,04-02-24 21:28,5400,IncomingTransfer,Salary,6670.408589
24918,721055058,04-07-24 19:28,426.99,Deposit,Direct Deposit,7097.398589
24919,721055058,04-07-24 21:28,3000,Payment,Credit Card Payment,4097.398589
24920,721055058,04-09-24 10:28,367.9,OutgoingTransfer,Peer-to-Peer Transfer,3729.498589
24921,721055058,04-10-24 21:28,123.75,Deposit,Check Deposit,3853.248589
24922,721055058,04-12-24 20:28,157.55,Purchase,Electronics,3695.698589
24923,721055058,4-16-24 21:28,1500,Payment,Rent Payment,2195.698589
24924,721055058,4-17-24 18:28,168.23,Purchase,Pharmacy,2027.468589
24925,721055058,4-25-24 13:28,151.36,OnlineShopping,Etsy,1876.108589
24926,721055058,4-27-24 22:28,507.19,OnlineShopping,eBay,1368.918589
24927,721055058,05-01-24 9:28,280.93,Withdrawal,Branch Withdrawal,1087.988589
24928,721055058,05-01-24 22:28,426.23,Purchase,Electronics,661.7585894
24929,721055058,05-02-24 23:28,143.33,OutgoingTransfer,International Transfer,518.4285894
24930,721055058,05-03-24 11:28,242.14,Deposit,Cash Deposit,760.5685894
24931,721055058,05-05-24 21:28,5400,IncomingTransfer,Salary,6160.568589
24932,721055058,05-10-24 21:28,3600,Payment,Credit Card Payment,2560.568589
24933,721055058,5-13-24 23:28,211.7,Deposit,Cash Deposit,2772.268589
24934,721055058,5-15-24 9:28,388.66,Withdrawal,Branch Withdrawal,2383.608589
24935,721055058,5-15-24 21:28,2100,Payment,Rent Payment,283.6085894
24936,721055058,5-15-24 23:28,113.54,Withdrawal,ATM Withdrawal,170.0685894
24937,721055058,5-16-24 12:28,541.03,Payment,Bill Payment,-370.9614106
24938,721055058,5-20-24 20:28,391.87,Deposit,Direct Deposit,20.90858938
24939,721055058,5-26-24 12:28,421.91,OutgoingTransfer,Bank Transfer,-401.0014106
24940,721055058,5-26-24 21:28,420.4,Purchase,Restaurant,-821.4014106
24941,721055058,5-29-24 19:28,362.66,Withdrawal,Branch Withdrawal,-1184.061411
24942,721055058,5-30-24 14:28,512.4,Withdrawal,ATM Withdrawal,-1696.461411
24943,721055058,5-31-24 15:28,200.92,Return,Amazon Return,-1495.541411
24944,721055058,06-01-24 10:28,55.38,Deposit,Direct Deposit,-1440.161411
24945,721055058,06-01-24 21:28,5400,IncomingTransfer,Salary,3959.838589
24946,721055058,06-03-24 18:28,52.72,OutgoingTransfer,Bank Transfer,3907.118589
24947,721055058,06-06-24 21:28,3000,Payment,Credit Card Payment,907.1185894
24948,721055058,06-07-24 12:28,78.01,Deposit,Mobile Deposit,985.1285894
24949,721055058,06-08-24 15:28,387.62,Return,Target Return,1372.748589
24950,721055058,06-08-24 21:28,477.81,Purchase,Clothing,894.9385894
24951,721055058,06-12-24 13:28,254.74,Purchase,Electronics,640.1985894
24952,721055058,6-14-24 21:28,1900,Payment,Rent Payment,-1259.801411
24953,721055058,6-26-24 13:28,210.55,OnlineShopping,Walmart,-1470.351411
24954,721055058,6-30-24 14:28,227.79,Deposit,Mobile Deposit,-1242.561411
24955,721055058,6-30-24 18:28,228.18,Deposit,Check Deposit,-1014.381411
24956,721055058,07-04-24 21:28,5400,IncomingTransfer,Salary,4385.618589
24957,721055058,07-09-24 21:28,2600,Payment,Credit Card Payment,1785.618589
24958,721055058,07-10-24 17:28,92.85,IncomingTransfer,Freelance Payment,1878.468589
24959,721055058,07-11-24 12:28,331,OutgoingTransfer,Wire Transfer,1547.468589
24960,721055058,07-12-24 12:28,183.85,OutgoingTransfer,Peer-to-Peer Transfer,1363.618589
24961,721055058,07-12-24 16:28,367.24,IncomingTransfer,Freelance Payment,1730.858589
24962,721055058,7-13-24 21:28,2400,Payment,Rent Payment,-669.1414106
24963,721057758,1-28-24 18:28,310.66,OutgoingTransfer,International Transfer,-310.66
24964,721057758,1-31-24 19:28,204.63,Return,Walmart Return,-106.03
24965,721057758,1-31-24 23:28,261.95,OutgoingTransfer,Bank Transfer,-367.98
24966,721057758,02-01-24 20:28,411.64,Withdrawal,Branch Withdrawal,-779.62
24967,721057758,02-02-24 10:28,283.32,Withdrawal,ATM Withdrawal,-1062.94
24968,721057758,02-04-24 21:28,1900,IncomingTransfer,Salary,837.06
24969,721057758,02-06-24 9:28,22.33,Withdrawal,Mobile App Withdrawal,814.73
24970,721057758,02-07-24 15:28,489.69,Deposit,Direct Deposit,1304.42
24971,721057758,2-15-24 21:28,600,Payment,Rent Payment,704.42
24972,721057758,2-28-24 10:28,152.23,OutgoingTransfer,Wire Transfer,552.19
24973,721057758,03-02-24 21:28,1900,IncomingTransfer,Salary,2452.19
24974,721057758,03-06-24 11:28,87.06,Return,Store Return,2539.25
24975,721057758,3-18-24 21:28,700,Payment,Rent Payment,1839.25
24976,721057758,3-25-24 19:28,161.86,Deposit,Cash Deposit,2001.11
24977,721057758,04-02-24 21:28,1900,IncomingTransfer,Salary,3901.11
24978,721057758,04-07-24 19:28,202.57,OutgoingTransfer,International Transfer,3698.54
24979,721057758,4-15-24 13:28,198.81,Withdrawal,Branch Withdrawal,3499.73
24980,721057758,4-16-24 21:28,1100,Payment,Rent Payment,2399.73
24981,721057758,4-23-24 15:28,348.84,IncomingTransfer,Freelance Payment,2748.57
24982,721057758,05-02-24 21:28,1900,IncomingTransfer,Salary,4648.57
24983,721057758,05-10-24 21:28,900,Payment,Rent Payment,3748.57
24984,721057758,5-15-24 21:28,94.9,Deposit,Direct Deposit,3843.47
24985,721057758,5-19-24 20:28,359.53,Purchase,Travel,3483.94
24986,721057758,5-24-24 12:28,433.13,Purchase,Travel,3050.81
24987,721057758,5-27-24 17:28,393.26,OnlineShopping,AliExpress,2657.55
24988,721057758,5-27-24 17:28,275.51,Return,Target Return,2933.06
24989,721057758,06-01-24 21:28,1900,IncomingTransfer,Salary,4833.06
24990,721057758,06-02-24 19:28,481.56,OutgoingTransfer,Peer-to-Peer Transfer,4351.5
24991,721057758,06-10-24 20:28,264.27,Purchase,Restaurant,4087.23
24992,721057758,6-13-24 21:28,1000,Payment,Rent Payment,3087.23
24993,721057758,6-13-24 21:28,123.72,Purchase,Entertainment,2963.51
24994,721057758,6-17-24 18:28,77.58,Withdrawal,Branch Withdrawal,2885.93
24995,721057758,6-23-24 18:28,174.1,OnlineShopping,Target,2711.83
24996,721057758,07-03-24 21:28,1900,IncomingTransfer,Salary,4611.83
24997,721057758,07-07-24 21:28,399.48,Purchase,Gas,4212.35
24998,721057758,07-11-24 15:28,388.41,Deposit,Cash Deposit,4600.76
24999,721057758,07-11-24 21:28,900,Payment,Rent Payment,3700.76
25000,721057758,7-13-24 13:28,367.79,Purchase,Travel,3332.97
25001,721057758,7-14-24 20:28,49.02,Deposit,Cash Deposit,3381.99
25002,721106133,1-20-24 19:28,192.39,Purchase,Home Improvement,1257.596816
25003,721106133,1-21-24 18:28,34.68,Purchase,Clothing,1222.916816
25004,721106133,1-23-24 19:28,392.48,Withdrawal,ATM Withdrawal,830.4368157
25005,721106133,1-25-24 15:28,180.29,OutgoingTransfer,Wire Transfer,650.1468157
25006,721106133,1-27-24 15:28,464.31,Payment,Loan Payment,185.8368157
25007,721106133,1-30-24 17:28,278.29,Purchase,Grocery,-92.4531843
25008,721106133,02-04-24 21:28,2450,IncomingTransfer,Salary,2357.546816
25009,721106133,02-05-24 23:28,212.4,Purchase,Restaurant,2145.146816
25010,721106133,02-06-24 13:28,423.41,OnlineShopping,Walmart,1721.736816
25011,721106133,02-09-24 21:28,2600,Payment,Credit Card Payment,-878.2631843
25012,721106133,02-10-24 18:28,85.86,OutgoingTransfer,Peer-to-Peer Transfer,-964.1231843
25013,721106133,02-10-24 21:28,1500,Payment,Rent Payment,-2464.123184
25014,721106133,02-11-24 21:28,103.4,Purchase,Furniture,-2567.523184
25015,721106133,2-14-24 22:28,161.59,Withdrawal,Mobile App Withdrawal,-2729.113184
25016,721106133,2-14-24 22:28,307.19,Withdrawal,ATM Withdrawal,-3036.303184
25017,721106133,2-15-24 17:28,355.33,Return,Amazon Return,-2680.973184
25018,721106133,2-16-24 17:28,49.09,Return,Store Return,-2631.883184
25019,721106133,2-16-24 19:28,429.26,OnlineShopping,Best Buy,-3061.143184
25020,721106133,2-18-24 14:28,241.33,Deposit,Direct Deposit,-2819.813184
25021,721106133,2-20-24 17:28,360.7,Deposit,Cash Deposit,-2459.113184
25022,721106133,2-22-24 12:28,301.37,OutgoingTransfer,Wire Transfer,-2760.483184
25023,721106133,2-25-24 10:28,309.51,OnlineShopping,Walmart,-3069.993184
25024,721106133,2-26-24 17:28,99.56,Withdrawal,Mobile App Withdrawal,-3169.553184
25025,721106133,03-01-24 21:28,2450,IncomingTransfer,Salary,-719.5531843
25026,721106133,03-02-24 21:28,250.29,Purchase,Grocery,-969.8431843
25027,721106133,03-03-24 11:28,327.42,Purchase,Gas,-1297.263184
25028,721106133,03-06-24 21:28,2000,Payment,Credit Card Payment,-3297.263184
25029,721106133,03-11-24 10:28,166.93,Purchase,Pharmacy,-3464.193184
25030,721106133,03-12-24 17:28,58.45,Return,Best Buy Return,-3405.743184
25031,721106133,03-12-24 20:28,135.64,Deposit,Mobile Deposit,-3270.103184
25032,721106133,03-12-24 21:28,1000,Payment,Rent Payment,-4270.103184
25033,721106133,3-17-24 12:28,303.88,Deposit,Mobile Deposit,-3966.223184
25034,721106133,3-17-24 18:28,371.48,Payment,Loan Payment,-4337.703184
25035,721106133,3-29-24 22:28,392.96,Purchase,Grocery,-4730.663184
25036,721106133,3-30-24 10:28,339.41,Withdrawal,Branch Withdrawal,-5070.073184
25037,721106133,04-01-24 11:28,97.03,OutgoingTransfer,Wire Transfer,-5167.103184
25038,721106133,04-01-24 15:28,244.58,Payment,Mortgage Payment,-5411.683184
25039,721106133,04-03-24 15:28,350.6,Payment,Bill Payment,-5762.283184
25040,721106133,04-03-24 21:28,2450,IncomingTransfer,Salary,-3312.283184
25041,721106133,04-03-24 23:28,444.16,Purchase,Furniture,-3756.443184
25042,721106133,04-04-24 21:28,442.74,OutgoingTransfer,Bank Transfer,-4199.183184
25043,721106133,04-08-24 10:28,478.01,OutgoingTransfer,Bank Transfer,-4677.193184
25044,721106133,04-08-24 21:28,2200,Payment,Credit Card Payment,-6877.193184
25045,721106133,04-09-24 16:28,309.65,Purchase,Clothing,-7186.843184
25046,721106133,04-09-24 17:28,16.73,Withdrawal,Mobile App Withdrawal,-7203.573184
25047,721106133,04-10-24 21:28,1500,Payment,Rent Payment,-8703.573184
25048,721106133,04-12-24 16:28,217.42,IncomingTransfer,Freelance Payment,-8486.153184
25049,721106133,4-14-24 19:28,463.94,Withdrawal,Mobile App Withdrawal,-8950.093184
25050,721106133,4-16-24 16:28,146.92,OnlineShopping,Walmart,-9097.013184
25051,721106133,4-18-24 19:28,463.05,Deposit,Check Deposit,-8633.963184
25052,721106133,4-20-24 10:28,420.54,IncomingTransfer,Freelance Payment,-8213.423184
25053,721106133,4-24-24 14:28,458.11,Withdrawal,ATM Withdrawal,-8671.533184
25054,721106133,4-26-24 19:28,205.81,Withdrawal,ATM Withdrawal,-8877.343184
25055,721106133,4-30-24 23:28,162.72,Return,eBay Return,-8714.623184
25056,721106133,05-01-24 10:28,351.09,IncomingTransfer,Freelance Payment,-8363.533184
25057,721106133,05-01-24 21:28,2450,IncomingTransfer,Salary,-5913.533184
25058,721106133,05-02-24 17:28,374.57,Payment,Bill Payment,-6288.103184
25059,721106133,05-06-24 21:28,1900,Payment,Credit Card Payment,-8188.103184
25060,721106133,05-07-24 14:28,104.71,Payment,Mortgage Payment,-8292.813184
25061,721106133,05-08-24 15:28,136.04,Purchase,Furniture,-8428.853184
25062,721106133,05-11-24 11:28,446.87,Purchase,Travel,-8875.723184
25063,721106133,05-11-24 21:28,21.83,Payment,Mortgage Payment,-8897.553184
25064,721106133,05-11-24 21:28,88.03,OnlineShopping,Walmart,-8985.583184
25065,721106133,05-12-24 10:28,144.44,Purchase,Grocery,-9130.023184
25066,721106133,5-13-24 11:28,278.58,Withdrawal,Mobile App Withdrawal,-9408.603184
25067,721106133,5-14-24 17:28,196.92,Purchase,Electronics,-9605.523184
25068,721106133,5-15-24 14:28,489.77,IncomingTransfer,Freelance Payment,-9115.753184
25069,721106133,5-16-24 21:28,1300,Payment,Rent Payment,-10415.75318
25070,721106133,5-20-24 20:28,166,Purchase,Home Improvement,-10581.75318
25071,721106133,5-22-24 9:28,363.18,OnlineShopping,Best Buy,-10944.93318
25072,721106133,5-23-24 16:28,434.98,Return,Amazon Return,-10509.95318
25073,721106133,5-23-24 20:28,46.87,Deposit,Check Deposit,-10463.08318
25074,721106133,5-24-24 17:28,455.99,Return,Etsy Return,-10007.09318
25075,721106133,5-25-24 12:28,236.58,Purchase,Grocery,-10243.67318
25076,721106133,06-02-24 10:28,294.05,Payment,Bill Payment,-10537.72318
25077,721106133,06-02-24 18:28,83.1,OutgoingTransfer,Bank Transfer,-10620.82318
25078,721106133,06-02-24 21:28,2450,IncomingTransfer,Salary,-8170.823184
25079,721106133,06-05-24 12:28,36.16,Purchase,Furniture,-8206.983184
25080,721106133,06-07-24 21:28,2100,Payment,Credit Card Payment,-10306.98318
25081,721106133,06-10-24 23:28,398.08,Payment,Mortgage Payment,-10705.06318
25082,721106133,06-11-24 21:28,900,Payment,Rent Payment,-11605.06318
25083,721106133,6-14-24 14:28,281.26,OutgoingTransfer,Peer-to-Peer Transfer,-11886.32318
25084,721106133,6-17-24 12:28,258.03,Deposit,Cash Deposit,-11628.29318
25085,721106133,6-17-24 15:28,365.34,Payment,Mortgage Payment,-11993.63318
25086,721106133,6-20-24 17:28,399.96,Purchase,Clothing,-12393.59318
25087,721106133,6-22-24 15:28,222.81,Purchase,Pharmacy,-12616.40318
25088,721106133,6-24-24 20:28,166.66,Deposit,Cash Deposit,-12449.74318
25089,721106133,6-25-24 21:28,73.93,Deposit,Direct Deposit,-12375.81318
25090,721106133,6-27-24 13:28,76.86,Deposit,Mobile Deposit,-12298.95318
25091,721106133,6-30-24 13:28,136.49,Return,Store Return,-12162.46318
25092,721106133,07-01-24 21:28,2450,IncomingTransfer,Salary,-9712.463184
25093,721106133,07-03-24 14:28,397.14,Deposit,Cash Deposit,-9315.323184
25094,721106133,07-03-24 17:28,378.63,Purchase,Clothing,-9693.953184
25095,721106133,07-06-24 14:28,469.21,Purchase,Home Improvement,-10163.16318
25096,721106133,07-06-24 21:28,2600,Payment,Credit Card Payment,-12763.16318
25097,721106133,07-07-24 18:28,380.21,Deposit,Mobile Deposit,-12382.95318
25098,721106133,07-11-24 21:28,1300,Payment,Rent Payment,-13682.95318
25099,721106133,7-13-24 15:28,231.35,Return,Target Return,-13451.60318
25100,721106133,7-17-24 18:28,102.48,Return,AliExpress Return,-13349.12318
25101,721106133,7-17-24 20:28,264.76,Payment,Bill Payment,-13613.88318
25102,721109358,1-20-24 22:28,369.47,Purchase,Restaurant,-369.47
25103,721109358,1-22-24 9:28,303.49,Payment,Loan Payment,-672.96
25104,721109358,1-24-24 12:28,68.66,Payment,Bill Payment,-741.62
25105,721109358,1-25-24 22:28,214.72,IncomingTransfer,Freelance Payment,-526.9
25106,721109358,1-27-24 15:28,280.52,Purchase,Pharmacy,-807.42
25107,721109358,1-31-24 18:28,492.09,OnlineShopping,AliExpress,-1299.51
25108,721109358,02-02-24 20:28,249.12,OutgoingTransfer,Bank Transfer,-1548.63
25109,721109358,02-04-24 12:28,174.04,Purchase,Electronics,-1722.67
25110,721109358,02-04-24 13:28,481.11,Deposit,Direct Deposit,-1241.56
25111,721109358,02-04-24 21:28,5750,IncomingTransfer,Salary,4508.44
25112,721109358,02-11-24 21:28,2500,Payment,Insurance Payment,2008.44
25113,721109358,02-12-24 16:28,397.98,Withdrawal,ATM Withdrawal,1610.46
25114,721109358,2-13-24 18:28,130.03,OnlineShopping,Etsy,1480.43
25115,721109358,2-14-24 12:28,177.5,OutgoingTransfer,Bank Transfer,1302.93
25116,721109358,2-14-24 20:28,393.71,Withdrawal,ATM Withdrawal,909.22
25117,721109358,2-14-24 20:28,240.69,Purchase,Entertainment,668.53
25118,721109358,2-19-24 12:28,320.67,Withdrawal,Mobile App Withdrawal,347.86
25119,721109358,2-19-24 14:28,106.11,OnlineShopping,Etsy,241.75
25120,721109358,2-20-24 18:28,220.68,Deposit,Direct Deposit,462.43
25121,721109358,2-23-24 15:28,134.46,Purchase,Electronics,327.97
25122,721109358,2-23-24 18:28,310.26,Purchase,Grocery,17.71
25123,721109358,2-25-24 14:28,437.12,Withdrawal,ATM Withdrawal,-419.41
25124,721109358,2-27-24 12:28,456.07,Return,Etsy Return,36.66
25125,721109358,03-03-24 20:28,143.66,OnlineShopping,eBay,-107
25126,721109358,03-04-24 17:28,401.95,Purchase,Pharmacy,-508.95
25127,721109358,03-04-24 21:28,5750,IncomingTransfer,Salary,5241.05
25128,721109358,03-05-24 20:28,242.27,Deposit,Mobile Deposit,5483.32
25129,721109358,03-11-24 19:28,291.62,Payment,Loan Payment,5191.7
25130,721109358,3-13-24 21:28,1500,Payment,Installment Payment,3691.7
25131,721109358,3-19-24 12:28,492.23,Return,Walmart Return,4183.93
25132,721109358,3-23-24 18:28,316.17,Withdrawal,ATM Withdrawal,3867.76
25133,721109358,3-24-24 16:28,77.92,Payment,Bill Payment,3789.84
25134,721109358,3-26-24 11:28,229.4,Deposit,Check Deposit,4019.24
25135,721109358,3-29-24 11:28,241.64,Purchase,Home Improvement,3777.6
25136,721109358,3-31-24 13:28,171.01,Withdrawal,Mobile App Withdrawal,3606.59
25137,721109358,04-02-24 18:28,319.85,Withdrawal,Mobile App Withdrawal,3286.74
25138,721109358,04-04-24 21:28,5750,IncomingTransfer,Salary,9036.74
25139,721109358,04-06-24 17:28,151.22,OutgoingTransfer,Bank Transfer,8885.52
25140,721109358,04-06-24 20:28,335.81,Return,Walmart Return,9221.33
25141,721109358,04-09-24 10:28,77.27,Purchase,Home Improvement,9144.06
25142,721109358,04-10-24 23:28,318.89,OnlineShopping,Etsy,8825.17
25143,721109358,4-13-24 18:28,516.88,OutgoingTransfer,International Transfer,8308.29
25144,721109358,4-13-24 20:28,399.24,Purchase,Clothing,7909.05
25145,721109358,4-14-24 11:28,216.71,Withdrawal,ATM Withdrawal,7692.34
25146,721109358,4-14-24 17:28,312.29,OutgoingTransfer,Bank Transfer,7380.05
25147,721109358,4-17-24 21:28,1900,Payment,Subscription Payment,5480.05
25148,721109358,4-20-24 19:28,479.58,Withdrawal,Branch Withdrawal,5000.47
25149,721109358,4-22-24 21:28,328.9,Deposit,Direct Deposit,5329.37
25150,721109358,4-25-24 22:28,312.11,Purchase,Grocery,5017.26
25151,721109358,4-26-24 18:28,475.26,Withdrawal,Mobile App Withdrawal,4542
25152,721109358,4-27-24 12:28,468.95,Deposit,Mobile Deposit,5010.95
25153,721109358,4-27-24 18:28,326.29,Payment,Mortgage Payment,4684.66
25154,721109358,4-28-24 18:28,358.5,Purchase,Furniture,4326.16
25155,721109358,4-28-24 19:28,185.79,Payment,Bill Payment,4140.37
25156,721109358,4-28-24 21:28,323.88,OutgoingTransfer,Bank Transfer,3816.49
25157,721109358,4-29-24 20:28,444.83,OutgoingTransfer,International Transfer,3371.66
25158,721109358,4-30-24 12:28,274.1,Payment,Mortgage Payment,3097.56
25159,721109358,05-03-24 21:28,5750,IncomingTransfer,Salary,8847.56
25160,721109358,05-05-24 20:28,193.28,OnlineShopping,Target,8654.28
25161,721109358,05-08-24 16:28,528.39,Purchase,Restaurant,8125.89
25162,721109358,5-13-24 12:28,483.59,Withdrawal,Branch Withdrawal,7642.3
25163,721109358,5-16-24 13:28,339.41,OutgoingTransfer,International Transfer,7302.89
25164,721109358,5-16-24 14:28,512.08,Deposit,Mobile Deposit,7814.97
25165,721109358,5-16-24 16:28,59.17,Return,Walmart Return,7874.14
25166,721109358,5-18-24 21:28,1900,Payment,Installment Payment,5974.14
25167,721109358,5-19-24 22:28,65.3,Withdrawal,Mobile App Withdrawal,5908.84
25168,721109358,5-23-24 10:28,342.84,Payment,Bill Payment,5566
25169,721109358,5-23-24 21:28,393.61,OutgoingTransfer,Peer-to-Peer Transfer,5172.39
25170,721109358,5-24-24 10:28,372.87,Deposit,Direct Deposit,5545.26
25171,721109358,5-24-24 11:28,244.95,Withdrawal,Branch Withdrawal,5300.31
25172,721109358,5-29-24 11:28,65.53,Deposit,Direct Deposit,5365.84
25173,721109358,5-31-24 9:28,170.65,Return,Etsy Return,5536.49
25174,721109358,06-01-24 22:28,477.53,Purchase,Home Improvement,5058.96
25175,721109358,06-02-24 13:28,52.86,IncomingTransfer,Freelance Payment,5111.82
25176,721109358,06-03-24 15:28,269.29,Purchase,Clothing,4842.53
25177,721109358,06-04-24 22:28,478.14,Deposit,Mobile Deposit,5320.67
25178,721109358,06-05-24 21:28,5750,IncomingTransfer,Salary,11070.67
25179,721109358,06-06-24 11:28,372.42,Deposit,Mobile Deposit,11443.09
25180,721109358,06-09-24 18:28,152.29,Return,Best Buy Return,11595.38
25181,721109358,06-11-24 15:28,445.19,OutgoingTransfer,Bank Transfer,11150.19
25182,721109358,06-11-24 21:28,2100,Payment,Installment Payment,9050.19
25183,721109358,06-12-24 20:28,214.04,OnlineShopping,Best Buy,8836.15
25184,721109358,6-17-24 12:28,180.6,Withdrawal,Mobile App Withdrawal,8655.55
25185,721109358,6-24-24 22:28,155.14,Deposit,Direct Deposit,8810.69
25186,721109358,6-25-24 13:28,510.33,Withdrawal,Mobile App Withdrawal,8300.36
25187,721109358,6-27-24 18:28,356.2,IncomingTransfer,Freelance Payment,8656.56
25188,721109358,6-27-24 21:28,429.85,OnlineShopping,Best Buy,8226.71
25189,721109358,6-29-24 15:28,292.68,Return,Target Return,8519.39
25190,721109358,07-02-24 16:28,265.77,OnlineShopping,Amazon,8253.62
25191,721109358,07-04-24 21:28,5750,IncomingTransfer,Salary,14003.62
25192,721109358,07-05-24 9:28,216.59,Purchase,Home Improvement,13787.03
25193,721109358,07-06-24 18:28,408.7,Withdrawal,Branch Withdrawal,13378.33
25194,721109358,07-08-24 21:28,258.56,Deposit,Cash Deposit,13636.89
25195,721109358,07-09-24 10:28,456.57,Deposit,Cash Deposit,14093.46
25196,721109358,07-12-24 23:28,373.45,IncomingTransfer,Freelance Payment,14466.91
25197,721109358,7-14-24 19:28,507.88,Deposit,Check Deposit,14974.79
25198,721109358,7-15-24 12:28,276.17,Withdrawal,ATM Withdrawal,14698.62
25199,721109358,7-17-24 18:28,310.12,OnlineShopping,Walmart,14388.5
25200,721109358,7-17-24 21:28,1700,Payment,Subscription Payment,12688.5
25201,721115733,1-22-24 14:28,380.57,Withdrawal,ATM Withdrawal,336.0769432
25202,721115733,1-23-24 14:28,300.25,Deposit,Direct Deposit,636.3269432
25203,721115733,1-23-24 20:28,291.98,Return,Target Return,928.3069432
25204,721115733,1-24-24 20:28,367.21,Withdrawal,Mobile App Withdrawal,561.0969432
25205,721115733,1-29-24 20:28,450.46,Deposit,Cash Deposit,1011.556943
25206,721115733,1-29-24 23:28,179.58,Purchase,Furniture,831.9769432
25207,721115733,1-31-24 22:28,526.81,Deposit,Check Deposit,1358.786943
25208,721115733,02-05-24 21:28,5450,IncomingTransfer,Salary,6808.786943
25209,721115733,02-10-24 16:28,546.77,Deposit,Direct Deposit,7355.556943
25210,721115733,02-10-24 21:28,1200,Payment,Credit Card Payment,6155.556943
25211,721115733,2-13-24 21:28,2300,Payment,Installment Payment,3855.556943
25212,721115733,2-14-24 11:28,303.88,Payment,Loan Payment,3551.676943
25213,721115733,2-17-24 12:28,96.06,OnlineShopping,AliExpress,3455.616943
25214,721115733,2-23-24 20:28,228.66,Deposit,Mobile Deposit,3684.276943
25215,721115733,2-28-24 10:28,71.45,Purchase,Furniture,3612.826943
25216,721115733,2-28-24 19:28,483.23,Payment,Loan Payment,3129.596943
25217,721115733,2-29-24 12:28,514,Purchase,Pharmacy,2615.596943
25218,721115733,2-29-24 21:28,244.01,Withdrawal,ATM Withdrawal,2371.586943
25219,721115733,03-01-24 21:28,5450,IncomingTransfer,Salary,7821.586943
25220,721115733,03-01-24 22:28,400.64,OutgoingTransfer,Wire Transfer,7420.946943
25221,721115733,03-03-24 10:28,520.3,Payment,Loan Payment,6900.646943
25222,721115733,03-05-24 20:28,81.45,Return,Walmart Return,6982.096943
25223,721115733,03-06-24 16:28,459.3,Deposit,Cash Deposit,7441.396943
25224,721115733,03-06-24 17:28,542.39,Withdrawal,Branch Withdrawal,6899.006943
25225,721115733,03-06-24 21:28,900,Payment,Credit Card Payment,5999.006943
25226,721115733,03-07-24 22:28,367.33,Withdrawal,Branch Withdrawal,5631.676943
25227,721115733,03-08-24 11:28,120.17,OnlineShopping,Amazon,5511.506943
25228,721115733,03-11-24 9:28,211.1,Purchase,Entertainment,5300.406943
25229,721115733,03-11-24 13:28,428.82,Deposit,Mobile Deposit,5729.226943
25230,721115733,03-11-24 15:28,98.61,OnlineShopping,Best Buy,5630.616943
25231,721115733,3-14-24 21:28,1400,Payment,Installment Payment,4230.616943
25232,721115733,3-14-24 21:28,149.43,Deposit,Cash Deposit,4380.046943
25233,721115733,3-18-24 21:28,390.67,Withdrawal,ATM Withdrawal,3989.376943
25234,721115733,3-21-24 15:28,153.98,Purchase,Grocery,3835.396943
25235,721115733,3-23-24 14:28,504.3,Deposit,Cash Deposit,4339.696943
25236,721115733,3-26-24 19:28,399.53,Payment,Bill Payment,3940.166943
25237,721115733,3-28-24 9:28,395.39,OutgoingTransfer,Bank Transfer,3544.776943
25238,721115733,3-31-24 10:28,490.86,OnlineShopping,Target,3053.916943
25239,721115733,04-01-24 13:28,127.33,Deposit,Direct Deposit,3181.246943
25240,721115733,04-03-24 20:28,362.34,Deposit,Direct Deposit,3543.586943
25241,721115733,04-04-24 19:28,146.36,Withdrawal,Branch Withdrawal,3397.226943
25242,721115733,04-04-24 21:28,5450,IncomingTransfer,Salary,8847.226943
25243,721115733,04-05-24 12:28,143.08,Payment,Bill Payment,8704.146943
25244,721115733,04-05-24 19:28,443.44,Purchase,Pharmacy,8260.706943
25245,721115733,04-06-24 20:28,388.52,Payment,Bill Payment,7872.186943
25246,721115733,04-09-24 10:28,531.2,Purchase,Entertainment,7340.986943
25247,721115733,04-09-24 21:28,1200,Payment,Credit Card Payment,6140.986943
25248,721115733,4-14-24 21:28,1800,Payment,Insurance Payment,4340.986943
25249,721115733,4-18-24 12:28,317.29,Purchase,Clothing,4023.696943
25250,721115733,4-18-24 17:28,403.89,Deposit,Mobile Deposit,4427.586943
25251,721115733,4-22-24 10:28,235.7,Purchase,Electronics,4191.886943
25252,721115733,4-23-24 12:28,367.69,OnlineShopping,eBay,3824.196943
25253,721115733,4-23-24 14:28,353.22,Withdrawal,ATM Withdrawal,3470.976943
25254,721115733,4-23-24 18:28,224.94,OutgoingTransfer,Peer-to-Peer Transfer,3246.036943
25255,721115733,4-25-24 15:28,52.82,Payment,Bill Payment,3193.216943
25256,721115733,4-27-24 10:28,373.29,Payment,Mortgage Payment,2819.926943
25257,721115733,4-29-24 22:28,245.08,OutgoingTransfer,International Transfer,2574.846943
25258,721115733,05-01-24 12:28,479.65,Deposit,Cash Deposit,3054.496943
25259,721115733,05-01-24 20:28,508.46,Withdrawal,Branch Withdrawal,2546.036943
25260,721115733,05-02-24 21:28,5450,IncomingTransfer,Salary,7996.036943
25261,721115733,05-07-24 12:28,358.76,Deposit,Direct Deposit,8354.796943
25262,721115733,05-07-24 21:28,1000,Payment,Credit Card Payment,7354.796943
25263,721115733,5-13-24 21:28,2400,Payment,Subscription Payment,4954.796943
25264,721115733,5-17-24 9:28,390.64,Payment,Loan Payment,4564.156943
25265,721115733,5-18-24 13:28,113.81,Purchase,Gas,4450.346943
25266,721115733,5-25-24 13:28,95.49,OutgoingTransfer,Wire Transfer,4354.856943
25267,721115733,5-27-24 13:28,79.76,Withdrawal,ATM Withdrawal,4275.096943
25268,721115733,5-27-24 14:28,343.72,Deposit,Mobile Deposit,4618.816943
25269,721115733,5-27-24 16:28,192.64,Return,Etsy Return,4811.456943
25270,721115733,5-28-24 18:28,457.17,Purchase,Home Improvement,4354.286943
25271,721115733,06-01-24 12:28,514.54,OnlineShopping,eBay,3839.746943
25272,721115733,06-01-24 17:28,138,Payment,Bill Payment,3701.746943
25273,721115733,06-02-24 16:28,213.65,Deposit,Cash Deposit,3915.396943
25274,721115733,06-02-24 19:28,504.22,Withdrawal,Mobile App Withdrawal,3411.176943
25275,721115733,06-03-24 21:28,5450,IncomingTransfer,Salary,8861.176943
25276,721115733,06-08-24 21:28,1000,Payment,Credit Card Payment,7861.176943
25277,721115733,06-11-24 21:28,293.14,Return,Etsy Return,8154.316943
25278,721115733,06-11-24 22:28,341.12,Withdrawal,Mobile App Withdrawal,7813.196943
25279,721115733,06-12-24 14:28,315.39,Deposit,Cash Deposit,8128.586943
25280,721115733,6-13-24 22:28,449.98,OnlineShopping,Best Buy,7678.606943
25281,721115733,6-14-24 21:28,2000,Payment,Insurance Payment,5678.606943
25282,721115733,6-18-24 13:28,342.48,OutgoingTransfer,Peer-to-Peer Transfer,5336.126943
25283,721115733,6-23-24 12:28,480.16,OutgoingTransfer,Wire Transfer,4855.966943
25284,721115733,6-24-24 13:28,172.42,Deposit,Check Deposit,5028.386943
25285,721115733,6-25-24 16:28,215.59,Payment,Bill Payment,4812.796943
25286,721115733,6-27-24 21:28,396.41,OutgoingTransfer,Bank Transfer,4416.386943
25287,721115733,6-28-24 16:28,254.33,Withdrawal,Mobile App Withdrawal,4162.056943
25288,721115733,6-28-24 19:28,303.59,OutgoingTransfer,International Transfer,3858.466943
25289,721115733,6-29-24 19:28,368.42,Withdrawal,Mobile App Withdrawal,3490.046943
25290,721115733,07-02-24 20:28,492.66,Purchase,Electronics,2997.386943
25291,721115733,07-04-24 21:28,5450,IncomingTransfer,Salary,8447.386943
25292,721115733,07-06-24 14:28,512.38,Return,Store Return,8959.766943
25293,721115733,07-08-24 14:28,291.63,OutgoingTransfer,Wire Transfer,8668.136943
25294,721115733,07-09-24 21:28,1100,Payment,Credit Card Payment,7568.136943
25295,721115733,07-11-24 19:28,320.26,Deposit,Mobile Deposit,7888.396943
25296,721115733,7-13-24 21:28,2300,Payment,Subscription Payment,5588.396943
25297,721115733,7-17-24 23:28,448.5,OutgoingTransfer,Wire Transfer,5139.896943
25298,721144383,1-26-24 15:28,279.31,Deposit,Direct Deposit,851.8801939
25299,721144383,1-30-24 23:28,219.41,OutgoingTransfer,Bank Transfer,632.4701939
25300,721144383,1-31-24 18:28,290.73,Payment,Bill Payment,341.7401939
25301,721144383,1-31-24 19:28,62.9,Deposit,Mobile Deposit,404.6401939
25302,721144383,02-01-24 17:28,416.63,Deposit,Cash Deposit,821.2701939
25303,721144383,02-02-24 21:28,5550,IncomingTransfer,Salary,6371.270194
25304,721144383,02-03-24 19:28,393.54,OnlineShopping,Target,5977.730194
25305,721144383,02-04-24 14:28,355.98,Deposit,Mobile Deposit,6333.710194
25306,721144383,02-07-24 21:28,1200,Payment,Credit Card Payment,5133.710194
25307,721144383,02-10-24 19:28,258.23,Deposit,Cash Deposit,5391.940194
25308,721144383,2-13-24 10:28,269.71,Return,AliExpress Return,5661.650194
25309,721144383,2-13-24 19:28,350.11,Withdrawal,ATM Withdrawal,5311.540194
25310,721144383,2-14-24 21:28,1600,Payment,Insurance Payment,3711.540194
25311,721144383,2-18-24 14:28,73.74,Deposit,Check Deposit,3785.280194
25312,721144383,2-26-24 11:28,198.04,Deposit,Mobile Deposit,3983.320194
25313,721144383,03-01-24 10:28,463.64,Return,Walmart Return,4446.960194
25314,721144383,03-03-24 18:28,419.45,Purchase,Furniture,4027.510194
25315,721144383,03-03-24 21:28,5550,IncomingTransfer,Salary,9577.510194
25316,721144383,03-04-24 11:28,100.43,Deposit,Check Deposit,9677.940194
25317,721144383,03-08-24 21:28,1200,Payment,Credit Card Payment,8477.940194
25318,721144383,03-11-24 21:28,2500,Payment,Subscription Payment,5977.940194
25319,721144383,3-13-24 18:28,365.11,Withdrawal,ATM Withdrawal,5612.830194
25320,721144383,3-26-24 20:28,389.78,Deposit,Mobile Deposit,6002.610194
25321,721144383,3-28-24 20:28,250.4,Purchase,Electronics,5752.210194
25322,721144383,04-03-24 21:28,5550,IncomingTransfer,Salary,11302.21019
25323,721144383,04-05-24 10:28,355.62,Deposit,Check Deposit,11657.83019
25324,721144383,04-08-24 21:28,1200,Payment,Credit Card Payment,10457.83019
25325,721144383,04-09-24 15:28,98.6,OutgoingTransfer,Wire Transfer,10359.23019
25326,721144383,04-11-24 21:28,390.24,Return,eBay Return,10749.47019
25327,721144383,4-18-24 21:28,1500,Payment,Subscription Payment,9249.470194
25328,721144383,4-24-24 19:28,285.37,Withdrawal,ATM Withdrawal,8964.100194
25329,721144383,4-26-24 9:28,96.87,Return,Store Return,9060.970194
25330,721144383,05-02-24 21:28,5550,IncomingTransfer,Salary,14610.97019
25331,721144383,05-07-24 13:28,459.87,IncomingTransfer,Freelance Payment,15070.84019
25332,721144383,05-07-24 21:28,1200,Payment,Credit Card Payment,13870.84019
25333,721144383,05-10-24 14:28,526.59,Purchase,Travel,13344.25019
25334,721144383,05-10-24 19:28,295.36,Return,Walmart Return,13639.61019
25335,721144383,05-12-24 21:28,2100,Payment,Installment Payment,11539.61019
25336,721144383,5-13-24 19:28,77.43,Withdrawal,Mobile App Withdrawal,11462.18019
25337,721144383,5-13-24 23:28,108.41,Deposit,Check Deposit,11570.59019
25338,721144383,5-17-24 23:28,281.74,Payment,Loan Payment,11288.85019
25339,721144383,5-21-24 13:28,376.22,Withdrawal,Branch Withdrawal,10912.63019
25340,721144383,06-01-24 11:28,457.54,Payment,Bill Payment,10455.09019
25341,721144383,06-02-24 21:28,5550,IncomingTransfer,Salary,16005.09019
25342,721144383,06-03-24 13:28,122.44,Deposit,Cash Deposit,16127.53019
25343,721144383,06-05-24 22:28,138.48,Return,Etsy Return,16266.01019
25344,721144383,06-07-24 21:28,1100,Payment,Credit Card Payment,15166.01019
25345,721144383,06-11-24 19:28,130.09,Deposit,Direct Deposit,15296.10019
25346,721144383,6-18-24 21:28,1900,Payment,Subscription Payment,13396.10019
25347,721144383,6-26-24 10:28,146.72,Withdrawal,Branch Withdrawal,13249.38019
25348,721144383,07-01-24 21:28,5550,IncomingTransfer,Salary,18799.38019
25349,721144383,07-06-24 21:28,1000,Payment,Credit Card Payment,17799.38019
25350,721144383,07-08-24 12:28,180.63,Return,Amazon Return,17980.01019
25351,721144383,07-08-24 23:28,460.49,Return,eBay Return,18440.50019
25352,721144383,7-15-24 14:28,376.57,OnlineShopping,Amazon,18063.93019
25353,721144383,7-16-24 21:28,2400,Payment,Subscription Payment,15663.93019
25354,721188033,1-21-24 21:28,176.07,Purchase,Restaurant,1621.087358
25355,721188033,1-22-24 9:28,86.92,OutgoingTransfer,Peer-to-Peer Transfer,1534.167358
25356,721188033,1-22-24 18:28,27.28,Withdrawal,Branch Withdrawal,1506.887358
25357,721188033,1-22-24 19:28,204.35,OutgoingTransfer,Wire Transfer,1302.537358
25358,721188033,1-23-24 13:28,180.06,OnlineShopping,AliExpress,1122.477358
25359,721188033,1-27-24 21:28,155.07,Return,Store Return,1277.547358
25360,721188033,1-28-24 14:28,191.61,OnlineShopping,Target,1085.937358
25361,721188033,1-28-24 15:28,243.04,Purchase,Travel,842.8973582
25362,721188033,1-31-24 10:28,38.55,Withdrawal,ATM Withdrawal,804.3473582
25363,721188033,02-04-24 12:28,158.61,Withdrawal,Branch Withdrawal,645.7373582
25364,721188033,02-04-24 13:28,248.06,OutgoingTransfer,International Transfer,397.6773582
25365,721188033,02-04-24 21:28,2800,IncomingTransfer,Salary,3197.677358
25366,721188033,02-05-24 14:28,127.02,Purchase,Travel,3070.657358
25367,721188033,02-07-24 12:28,225.8,Return,Walmart Return,3296.457358
25368,721188033,02-09-24 21:28,2800,Payment,Credit Card Payment,496.4573582
25369,721188033,02-10-24 12:28,54.51,Deposit,Cash Deposit,550.9673582
25370,721188033,2-15-24 12:28,198.2,Return,Amazon Return,749.1673582
25371,721188033,2-15-24 21:28,1500,Payment,Rent Payment,-750.8326418
25372,721188033,2-20-24 10:28,26.52,Withdrawal,ATM Withdrawal,-777.3526418
25373,721188033,2-22-24 16:28,190.59,Withdrawal,Branch Withdrawal,-967.9426418
25374,721188033,2-24-24 21:28,88.98,Withdrawal,Mobile App Withdrawal,-1056.922642
25375,721188033,2-26-24 22:28,151.27,Deposit,Cash Deposit,-905.6526418
25376,721188033,2-28-24 19:28,80.98,Return,Walmart Return,-824.6726418
25377,721188033,03-03-24 13:28,149.59,OutgoingTransfer,Bank Transfer,-974.2626418
25378,721188033,03-03-24 15:28,137.16,OutgoingTransfer,International Transfer,-1111.422642
25379,721188033,03-05-24 21:28,2800,IncomingTransfer,Salary,1688.577358
25380,721188033,03-07-24 11:28,102.67,OutgoingTransfer,Peer-to-Peer Transfer,1585.907358
25381,721188033,03-08-24 20:28,236.88,Purchase,Pharmacy,1349.027358
25382,721188033,03-09-24 18:28,47.56,Withdrawal,ATM Withdrawal,1301.467358
25383,721188033,03-10-24 12:28,138.28,IncomingTransfer,Freelance Payment,1439.747358
25384,721188033,03-10-24 15:28,18.42,Deposit,Mobile Deposit,1458.167358
25385,721188033,03-10-24 21:28,2700,Payment,Credit Card Payment,-1241.832642
25386,721188033,03-11-24 16:28,214.21,Withdrawal,Mobile App Withdrawal,-1456.042642
25387,721188033,03-11-24 16:28,165.97,Purchase,Travel,-1622.012642
25388,721188033,3-13-24 21:28,1000,Payment,Rent Payment,-2622.012642
25389,721188033,3-13-24 22:28,233.67,Purchase,Grocery,-2855.682642
25390,721188033,3-14-24 11:28,48.47,OutgoingTransfer,Wire Transfer,-2904.152642
25391,721188033,3-14-24 14:28,128.48,Deposit,Mobile Deposit,-2775.672642
25392,721188033,3-15-24 10:28,124.31,Purchase,Home Improvement,-2899.982642
25393,721188033,3-16-24 11:28,210.04,Deposit,Cash Deposit,-2689.942642
25394,721188033,3-16-24 12:28,141.47,OnlineShopping,Best Buy,-2831.412642
25395,721188033,3-20-24 14:28,162.49,IncomingTransfer,Freelance Payment,-2668.922642
25396,721188033,3-20-24 17:28,246.01,Return,AliExpress Return,-2422.912642
25397,721188033,3-21-24 12:28,114.51,Deposit,Direct Deposit,-2308.402642
25398,721188033,3-21-24 14:28,61.6,Purchase,Clothing,-2370.002642
25399,721188033,3-23-24 22:28,193.1,Deposit,Check Deposit,-2176.902642
25400,721188033,3-30-24 22:28,248.38,Purchase,Home Improvement,-2425.282642
25401,721188033,04-03-24 21:28,2800,IncomingTransfer,Salary,374.7173582
25402,721188033,04-04-24 14:28,61.74,OnlineShopping,Best Buy,312.9773582
25403,721188033,04-04-24 21:28,208.81,Purchase,Furniture,104.1673582
25404,721188033,04-05-24 23:28,10.15,Deposit,Direct Deposit,114.3173582
25405,721188033,04-06-24 18:28,35.49,OutgoingTransfer,Wire Transfer,78.82735818
25406,721188033,04-06-24 18:28,140.94,Deposit,Mobile Deposit,219.7673582
25407,721188033,04-06-24 21:28,156.09,Withdrawal,Mobile App Withdrawal,63.67735818
25408,721188033,04-06-24 22:28,21,Deposit,Direct Deposit,84.67735818
25409,721188033,04-08-24 21:28,2600,Payment,Credit Card Payment,-2515.322642
25410,721188033,04-08-24 21:28,67.2,OutgoingTransfer,Peer-to-Peer Transfer,-2582.522642
25411,721188033,04-11-24 16:28,219.52,Withdrawal,Branch Withdrawal,-2802.042642
25412,721188033,04-12-24 11:28,98.84,Deposit,Check Deposit,-2703.202642
25413,721188033,04-12-24 16:28,105.32,Return,eBay Return,-2597.882642
25414,721188033,04-12-24 18:28,98.39,Payment,Loan Payment,-2696.272642
25415,721188033,04-12-24 23:28,137.06,Purchase,Travel,-2833.332642
25416,721188033,4-13-24 13:28,175.82,OnlineShopping,Best Buy,-3009.152642
25417,721188033,4-13-24 22:28,79.93,Payment,Loan Payment,-3089.082642
25418,721188033,4-14-24 21:28,1100,Payment,Rent Payment,-4189.082642
25419,721188033,4-14-24 22:28,69.51,IncomingTransfer,Freelance Payment,-4119.572642
25420,721188033,4-15-24 13:28,155.81,Purchase,Grocery,-4275.382642
25421,721188033,4-20-24 14:28,241.95,Withdrawal,ATM Withdrawal,-4517.332642
25422,721188033,4-22-24 16:28,210.48,IncomingTransfer,Freelance Payment,-4306.852642
25423,721188033,4-26-24 16:28,168.19,OnlineShopping,Amazon,-4475.042642
25424,721188033,4-26-24 17:28,162.93,IncomingTransfer,Freelance Payment,-4312.112642
25425,721188033,05-01-24 21:28,2800,IncomingTransfer,Salary,-1512.112642
25426,721188033,05-02-24 11:28,213.23,Purchase,Electronics,-1725.342642
25427,721188033,05-04-24 14:28,203.42,Payment,Loan Payment,-1928.762642
25428,721188033,05-06-24 15:28,249.15,Return,Walmart Return,-1679.612642
25429,721188033,05-06-24 21:28,3300,Payment,Credit Card Payment,-4979.612642
25430,721188033,05-11-24 15:28,184.77,OnlineShopping,Amazon,-5164.382642
25431,721188033,05-12-24 16:28,90.33,OnlineShopping,Amazon,-5254.712642
25432,721188033,05-12-24 21:28,1700,Payment,Rent Payment,-6954.712642
25433,721188033,5-14-24 16:28,125.49,Deposit,Direct Deposit,-6829.222642
25434,721188033,5-15-24 10:28,245.85,Purchase,Electronics,-7075.072642
25435,721188033,5-15-24 10:28,113.33,OutgoingTransfer,Bank Transfer,-7188.402642
25436,721188033,5-16-24 11:28,60.82,Withdrawal,Mobile App Withdrawal,-7249.222642
25437,721188033,5-18-24 11:28,196.63,Return,Target Return,-7052.592642
25438,721188033,5-21-24 14:28,192.73,Return,Target Return,-6859.862642
25439,721188033,5-22-24 9:28,27.93,Withdrawal,ATM Withdrawal,-6887.792642
25440,721188033,5-22-24 18:28,69.36,Deposit,Cash Deposit,-6818.432642
25441,721188033,5-22-24 23:28,149.28,IncomingTransfer,Freelance Payment,-6669.152642
25442,721188033,5-24-24 10:28,63.42,Deposit,Mobile Deposit,-6605.732642
25443,721188033,5-25-24 22:28,146.36,Return,eBay Return,-6459.372642
25444,721188033,5-27-24 11:28,151.22,Withdrawal,ATM Withdrawal,-6610.592642
25445,721188033,5-28-24 9:28,48.9,OutgoingTransfer,International Transfer,-6659.492642
25446,721188033,5-28-24 13:28,133.15,Return,Store Return,-6526.342642
25447,721188033,5-28-24 21:28,90.76,Deposit,Check Deposit,-6435.582642
25448,721188033,5-30-24 13:28,157.89,OutgoingTransfer,Bank Transfer,-6593.472642
25449,721188033,5-31-24 20:28,165.65,OnlineShopping,Etsy,-6759.122642
25450,721188033,06-02-24 18:28,221.57,Purchase,Grocery,-6980.692642
25451,721188033,06-02-24 21:28,2800,IncomingTransfer,Salary,-4180.692642
25452,721188033,06-03-24 9:28,53.31,Payment,Mortgage Payment,-4234.002642
25453,721188033,06-05-24 23:28,48.64,Purchase,Clothing,-4282.642642
25454,721188033,06-07-24 21:28,2400,Payment,Credit Card Payment,-6682.642642
25455,721188033,06-07-24 23:28,205.54,Deposit,Check Deposit,-6477.102642
25456,721188033,06-11-24 11:28,121.53,Withdrawal,Mobile App Withdrawal,-6598.632642
25457,721188033,6-13-24 19:28,145.19,Purchase,Furniture,-6743.822642
25458,721188033,6-15-24 12:28,76.36,Purchase,Travel,-6820.182642
25459,721188033,6-16-24 14:28,50.87,Purchase,Clothing,-6871.052642
25460,721188033,6-16-24 18:28,69.97,Deposit,Mobile Deposit,-6801.082642
25461,721188033,6-18-24 14:28,182.19,Return,Target Return,-6618.892642
25462,721188033,6-18-24 21:28,1700,Payment,Rent Payment,-8318.892642
25463,721188033,6-22-24 12:28,76.99,Withdrawal,ATM Withdrawal,-8395.882642
25464,721188033,6-23-24 21:28,240.82,Deposit,Mobile Deposit,-8155.062642
25465,721188033,6-24-24 13:28,219.92,Purchase,Clothing,-8374.982642
25466,721188033,6-26-24 17:28,139.8,Purchase,Pharmacy,-8514.782642
25467,721188033,6-26-24 19:28,160.69,OnlineShopping,eBay,-8675.472642
25468,721188033,6-28-24 9:28,161.73,Payment,Bill Payment,-8837.202642
25469,721188033,6-28-24 11:28,180.07,Purchase,Travel,-9017.272642
25470,721188033,6-29-24 13:28,65.8,Payment,Bill Payment,-9083.072642
25471,721188033,07-01-24 17:28,134.84,Return,Best Buy Return,-8948.232642
25472,721188033,07-04-24 13:28,233.4,OnlineShopping,eBay,-9181.632642
25473,721188033,07-04-24 21:28,2800,IncomingTransfer,Salary,-6381.632642
25474,721188033,07-06-24 15:28,183.06,Return,Walmart Return,-6198.572642
25475,721188033,07-08-24 22:28,47.42,Purchase,Home Improvement,-6245.992642
25476,721188033,07-09-24 21:28,3100,Payment,Credit Card Payment,-9345.992642
25477,721188033,7-14-24 10:28,238.03,Payment,Bill Payment,-9584.022642
25478,721188033,7-15-24 9:28,219.79,Return,Best Buy Return,-9364.232642
25479,721188033,7-15-24 15:28,205.54,Deposit,Mobile Deposit,-9158.692642
25480,721188033,7-16-24 15:28,179.5,Deposit,Direct Deposit,-8979.192642
25481,721188033,7-16-24 19:28,75.19,Withdrawal,Mobile App Withdrawal,-9054.382642
25482,721188033,7-17-24 20:28,173.57,Payment,Bill Payment,-9227.952642
25483,721188033,7-18-24 21:28,900,Payment,Rent Payment,-10127.95264
25484,721202058,1-20-24 10:28,65.03,Deposit,Check Deposit,735.8179033
25485,721202058,1-21-24 20:28,114.2,OnlineShopping,Etsy,621.6179033
25486,721202058,1-30-24 23:28,52.23,Payment,Bill Payment,569.3879033
25487,721202058,1-31-24 16:28,395.25,Purchase,Grocery,174.1379033
25488,721202058,02-01-24 11:28,35.62,OnlineShopping,AliExpress,138.5179033
25489,721202058,02-01-24 21:28,4350,IncomingTransfer,Salary,4488.517903
25490,721202058,02-01-24 22:28,373.5,Withdrawal,Mobile App Withdrawal,4115.017903
25491,721202058,02-02-24 12:28,77.85,Purchase,Grocery,4037.167903
25492,721202058,02-04-24 12:28,101.05,Purchase,Home Improvement,3936.117903
25493,721202058,02-06-24 21:28,1100,Payment,Credit Card Payment,2836.117903
25494,721202058,02-06-24 22:28,340.89,Deposit,Direct Deposit,3177.007903
25495,721202058,02-07-24 21:28,199,Withdrawal,Mobile App Withdrawal,2978.007903
25496,721202058,02-12-24 21:28,2700,Payment,Rent Payment,278.0079033
25497,721202058,2-13-24 12:28,183.81,OnlineShopping,Etsy,94.19790332
25498,721202058,2-15-24 15:28,87.27,Purchase,Pharmacy,6.927903317
25499,721202058,2-20-24 9:28,339.42,OnlineShopping,Walmart,-332.4920967
25500,721202058,2-23-24 16:28,41.71,Deposit,Mobile Deposit,-290.7820967
25501,721202058,2-28-24 18:28,162.75,OnlineShopping,Etsy,-453.5320967
25502,721202058,03-02-24 16:28,158.78,OnlineShopping,Walmart,-612.3120967
25503,721202058,03-02-24 21:28,4350,IncomingTransfer,Salary,3737.687903
25504,721202058,03-06-24 19:28,178.39,Purchase,Pharmacy,3559.297903
25505,721202058,03-07-24 21:28,900,Payment,Credit Card Payment,2659.297903
25506,721202058,03-08-24 15:28,131.28,OnlineShopping,Walmart,2528.017903
25507,721202058,03-09-24 21:28,395.47,Purchase,Restaurant,2132.547903
25508,721202058,03-10-24 18:28,53.29,Withdrawal,Branch Withdrawal,2079.257903
25509,721202058,03-10-24 21:28,1600,Payment,Rent Payment,479.2579033
25510,721202058,03-12-24 16:28,141.09,Deposit,Cash Deposit,620.3479033
25511,721202058,3-13-24 21:28,119.4,Purchase,Gas,500.9479033
25512,721202058,3-14-24 15:28,114.41,Return,Etsy Return,615.3579033
25513,721202058,3-19-24 11:28,269.46,Payment,Mortgage Payment,345.8979033
25514,721202058,3-20-24 23:28,26.16,OnlineShopping,Walmart,319.7379033
25515,721202058,3-25-24 18:28,90.26,Payment,Mortgage Payment,229.4779033
25516,721202058,3-27-24 11:28,395.58,Payment,Bill Payment,-166.1020967
25517,721202058,3-27-24 20:28,73.98,Purchase,Home Improvement,-240.0820967
25518,721202058,3-28-24 11:28,293.37,OutgoingTransfer,Peer-to-Peer Transfer,-533.4520967
25519,721202058,3-28-24 11:28,211.65,OutgoingTransfer,International Transfer,-745.1020967
25520,721202058,3-29-24 14:28,128.46,Withdrawal,Mobile App Withdrawal,-873.5620967
25521,721202058,3-30-24 18:28,43.8,OnlineShopping,Amazon,-917.3620967
25522,721202058,04-02-24 13:28,240.49,Withdrawal,Mobile App Withdrawal,-1157.852097
25523,721202058,04-03-24 21:28,4350,IncomingTransfer,Salary,3192.147903
25524,721202058,04-05-24 11:28,77.38,Withdrawal,ATM Withdrawal,3114.767903
25525,721202058,04-05-24 17:28,313.15,Return,Store Return,3427.917903
25526,721202058,04-06-24 10:28,160.83,Withdrawal,ATM Withdrawal,3267.087903
25527,721202058,04-06-24 17:28,82.54,Payment,Bill Payment,3184.547903
25528,721202058,04-08-24 21:28,800,Payment,Credit Card Payment,2384.547903
25529,721202058,04-10-24 22:28,248.01,Payment,Loan Payment,2136.537903
25530,721202058,04-12-24 10:28,128.49,Purchase,Furniture,2008.047903
25531,721202058,04-12-24 21:28,1300,Payment,Rent Payment,708.0479033
25532,721202058,4-15-24 19:28,149.35,Withdrawal,Branch Withdrawal,558.6979033
25533,721202058,4-24-24 11:28,102.93,Deposit,Cash Deposit,661.6279033
25534,721202058,4-29-24 21:28,164.27,OutgoingTransfer,Peer-to-Peer Transfer,497.3579033
25535,721202058,05-02-24 21:28,4350,IncomingTransfer,Salary,4847.357903
25536,721202058,05-04-24 21:28,395.5,OnlineShopping,AliExpress,4451.857903
25537,721202058,05-07-24 21:28,800,Payment,Credit Card Payment,3651.857903
25538,721202058,05-12-24 21:28,137.38,Withdrawal,ATM Withdrawal,3514.477903
25539,721202058,5-16-24 11:28,135.61,Withdrawal,ATM Withdrawal,3378.867903
25540,721202058,5-17-24 21:28,1600,Payment,Rent Payment,1778.867903
25541,721202058,5-21-24 12:28,204.61,Payment,Loan Payment,1574.257903
25542,721202058,5-26-24 17:28,130.07,OnlineShopping,Best Buy,1444.187903
25543,721202058,5-29-24 21:28,21.03,Payment,Bill Payment,1423.157903
25544,721202058,06-03-24 11:28,273.37,Purchase,Travel,1149.787903
25545,721202058,06-03-24 21:28,4350,IncomingTransfer,Salary,5499.787903
25546,721202058,06-06-24 21:28,148.29,Deposit,Check Deposit,5648.077903
25547,721202058,06-06-24 22:28,177.79,Deposit,Check Deposit,5825.867903
25548,721202058,06-07-24 16:28,71.12,OnlineShopping,AliExpress,5754.747903
25549,721202058,06-08-24 21:28,1200,Payment,Credit Card Payment,4554.747903
25550,721202058,06-10-24 21:28,1600,Payment,Rent Payment,2954.747903
25551,721202058,06-12-24 20:28,162.84,Return,Target Return,3117.587903
25552,721202058,6-23-24 12:28,247.15,Purchase,Grocery,2870.437903
25553,721202058,6-28-24 20:28,281.06,Withdrawal,ATM Withdrawal,2589.377903
25554,721202058,07-01-24 10:28,315.56,Withdrawal,Branch Withdrawal,2273.817903
25555,721202058,07-01-24 20:28,261.44,Purchase,Furniture,2012.377903
25556,721202058,07-01-24 21:28,4350,IncomingTransfer,Salary,6362.377903
25557,721202058,07-05-24 11:28,30.69,OnlineShopping,Etsy,6331.687903
25558,721202058,07-05-24 20:28,297.13,Return,eBay Return,6628.817903
25559,721202058,07-06-24 21:28,1100,Payment,Credit Card Payment,5528.817903
25560,721202058,07-07-24 20:28,244.04,Return,Walmart Return,5772.857903
25561,721202058,7-14-24 18:28,320.75,Deposit,Check Deposit,6093.607903
25562,721202058,7-17-24 21:28,2300,Payment,Rent Payment,3793.607903
25563,721252683,1-21-24 14:28,156.86,Withdrawal,Mobile App Withdrawal,957.3709401
25564,721252683,1-27-24 13:28,292.15,OutgoingTransfer,Wire Transfer,665.2209401
25565,721252683,02-02-24 21:28,574.87,Payment,Loan Payment,90.35094013
25566,721252683,02-03-24 21:28,6700,IncomingTransfer,Salary,6790.35094
25567,721252683,02-05-24 9:28,551.11,OnlineShopping,Best Buy,6239.24094
25568,721252683,02-05-24 13:28,568.72,Payment,Loan Payment,5670.52094
25569,721252683,02-06-24 14:28,678.25,OutgoingTransfer,International Transfer,4992.27094
25570,721252683,02-08-24 16:28,304.23,Deposit,Direct Deposit,5296.50094
25571,721252683,02-08-24 21:28,1900,Payment,Credit Card Payment,3396.50094
25572,721252683,02-12-24 21:28,4000,Payment,Rent Payment,-603.4990599
25573,721252683,2-13-24 22:28,408.87,IncomingTransfer,Freelance Payment,-194.6290599
25574,721252683,2-16-24 9:28,746.15,IncomingTransfer,Freelance Payment,551.5209401
25575,721252683,2-18-24 18:28,481.11,Return,Walmart Return,1032.63094
25576,721252683,2-19-24 18:28,432.74,Purchase,Furniture,599.8909401
25577,721252683,2-20-24 18:28,118.27,Deposit,Direct Deposit,718.1609401
25578,721252683,2-26-24 16:28,353.61,Withdrawal,Branch Withdrawal,364.5509401
25579,721252683,2-28-24 22:28,606.88,IncomingTransfer,Freelance Payment,971.4309401
25580,721252683,03-02-24 21:28,6700,IncomingTransfer,Salary,7671.43094
25581,721252683,03-02-24 22:28,281.84,Deposit,Mobile Deposit,7953.27094
25582,721252683,03-04-24 11:28,439.13,Payment,Loan Payment,7514.14094
25583,721252683,03-04-24 20:28,591.66,Withdrawal,Mobile App Withdrawal,6922.48094
25584,721252683,03-07-24 9:28,739.08,IncomingTransfer,Freelance Payment,7661.56094
25585,721252683,03-07-24 21:28,1800,Payment,Credit Card Payment,5861.56094
25586,721252683,03-09-24 13:28,311.04,Deposit,Cash Deposit,6172.60094
25587,721252683,3-13-24 21:28,2500,Payment,Rent Payment,3672.60094
25588,721252683,3-15-24 15:28,582.22,Withdrawal,Mobile App Withdrawal,3090.38094
25589,721252683,3-15-24 15:28,216.61,Deposit,Mobile Deposit,3306.99094
25590,721252683,3-19-24 9:28,363.68,OnlineShopping,Walmart,2943.31094
25591,721252683,3-22-24 15:28,226.82,Withdrawal,Mobile App Withdrawal,2716.49094
25592,721252683,3-25-24 9:28,192.71,OutgoingTransfer,Wire Transfer,2523.78094
25593,721252683,3-25-24 22:28,598.11,OutgoingTransfer,Peer-to-Peer Transfer,1925.67094
25594,721252683,04-02-24 21:28,6700,IncomingTransfer,Salary,8625.67094
25595,721252683,04-04-24 16:28,694.72,Return,AliExpress Return,9320.39094
25596,721252683,04-07-24 21:28,1600,Payment,Credit Card Payment,7720.39094
25597,721252683,4-13-24 20:28,179.07,OutgoingTransfer,Peer-to-Peer Transfer,7541.32094
25598,721252683,4-14-24 14:28,582.36,Payment,Mortgage Payment,6958.96094
25599,721252683,4-16-24 22:28,422.02,Deposit,Check Deposit,7380.98094
25600,721252683,4-17-24 21:28,1800,Payment,Rent Payment,5580.98094
25601,721252683,4-19-24 13:28,520.24,Withdrawal,Mobile App Withdrawal,5060.74094
25602,721252683,4-23-24 16:28,706.52,Purchase,Restaurant,4354.22094
25603,721252683,4-26-24 23:28,488.91,Withdrawal,Mobile App Withdrawal,3865.31094
25604,721252683,4-28-24 13:28,132.51,Deposit,Direct Deposit,3997.82094
25605,721252683,05-01-24 22:28,414.52,Purchase,Home Improvement,3583.30094
25606,721252683,05-03-24 19:28,346.29,Return,Etsy Return,3929.59094
25607,721252683,05-03-24 21:28,6700,IncomingTransfer,Salary,10629.59094
25608,721252683,05-04-24 11:28,128.53,Deposit,Direct Deposit,10758.12094
25609,721252683,05-04-24 18:28,167.43,Purchase,Grocery,10590.69094
25610,721252683,05-05-24 20:28,347.14,Withdrawal,Branch Withdrawal,10243.55094
25611,721252683,05-07-24 21:28,521.58,Withdrawal,Mobile App Withdrawal,9721.97094
25612,721252683,05-08-24 21:28,1500,Payment,Credit Card Payment,8221.97094
25613,721252683,05-11-24 12:28,324.32,OutgoingTransfer,Peer-to-Peer Transfer,7897.65094
25614,721252683,05-11-24 12:28,730.17,Purchase,Electronics,7167.48094
25615,721252683,05-11-24 21:28,2500,Payment,Rent Payment,4667.48094
25616,721252683,5-19-24 14:28,631.62,Deposit,Direct Deposit,5299.10094
25617,721252683,5-19-24 22:28,362.05,OnlineShopping,eBay,4937.05094
25618,721252683,5-20-24 18:28,218.61,Return,AliExpress Return,5155.66094
25619,721252683,5-25-24 11:28,469.53,Purchase,Restaurant,4686.13094
25620,721252683,5-31-24 22:28,364.62,Payment,Mortgage Payment,4321.51094
25621,721252683,06-04-24 21:28,6700,IncomingTransfer,Salary,11021.51094
25622,721252683,06-09-24 21:28,1600,Payment,Credit Card Payment,9421.51094
25623,721252683,06-11-24 22:28,643.88,Payment,Bill Payment,8777.63094
25624,721252683,6-13-24 13:28,609.44,Deposit,Mobile Deposit,9387.07094
25625,721252683,6-14-24 10:28,336.35,Purchase,Furniture,9050.72094
25626,721252683,6-14-24 21:28,3300,Payment,Rent Payment,5750.72094
25627,721252683,6-16-24 20:28,336.12,Payment,Bill Payment,5414.60094
25628,721252683,6-22-24 21:28,573.02,Return,Walmart Return,5987.62094
25629,721252683,6-24-24 21:28,198.21,IncomingTransfer,Freelance Payment,6185.83094
25630,721252683,6-26-24 9:28,451.61,IncomingTransfer,Freelance Payment,6637.44094
25631,721252683,6-27-24 15:28,492.32,OnlineShopping,AliExpress,6145.12094
25632,721252683,6-29-24 12:28,744.14,OnlineShopping,Amazon,5400.98094
25633,721252683,07-03-24 14:28,441.36,Purchase,Pharmacy,4959.62094
25634,721252683,07-03-24 17:28,287.36,Purchase,Gas,4672.26094
25635,721252683,07-03-24 17:28,523.56,Purchase,Gas,4148.70094
25636,721252683,07-04-24 21:28,6700,IncomingTransfer,Salary,10848.70094
25637,721252683,07-05-24 20:28,436.78,Purchase,Electronics,10411.92094
25638,721252683,07-09-24 21:28,1900,Payment,Credit Card Payment,8511.92094
25639,721252683,07-11-24 19:28,297.16,Payment,Bill Payment,8214.76094
25640,721252683,7-13-24 20:28,137.39,Payment,Bill Payment,8077.37094
25641,721252683,7-14-24 15:28,234.43,Payment,Loan Payment,7842.94094
25642,721252683,7-14-24 21:28,3700,Payment,Rent Payment,4142.94094
25643,721252683,7-15-24 15:28,179.11,Deposit,Cash Deposit,4322.05094
25644,721252683,7-16-24 14:28,540.91,Purchase,Home Improvement,3781.14094
25645,721273008,02-03-24 21:28,2150,IncomingTransfer,Salary,3096.469951
25646,721273008,02-04-24 11:28,14.24,Deposit,Mobile Deposit,3110.709951
25647,721273008,02-08-24 11:28,165.07,Deposit,Direct Deposit,3275.779951
25648,721273008,02-08-24 21:28,1500,Payment,Credit Card Payment,1775.779951
25649,721273008,2-15-24 21:28,500,Payment,Rent Payment,1275.779951
25650,721273008,2-17-24 13:28,127,Deposit,Direct Deposit,1402.779951
25651,721273008,2-19-24 9:28,19.84,Deposit,Cash Deposit,1422.619951
25652,721273008,2-24-24 15:28,124.31,Purchase,Grocery,1298.309951
25653,721273008,2-24-24 16:28,125.5,Payment,Mortgage Payment,1172.809951
25654,721273008,2-25-24 19:28,206.07,OutgoingTransfer,Wire Transfer,966.739951
25655,721273008,2-28-24 21:28,227.45,IncomingTransfer,Freelance Payment,1194.189951
25656,721273008,03-05-24 21:28,2150,IncomingTransfer,Salary,3344.189951
25657,721273008,03-06-24 17:28,173.67,OutgoingTransfer,Wire Transfer,3170.519951
25658,721273008,03-10-24 21:28,1300,Payment,Credit Card Payment,1870.519951
25659,721273008,03-11-24 11:28,88.36,Return,Target Return,1958.879951
25660,721273008,03-12-24 10:28,123.44,Deposit,Check Deposit,2082.319951
25661,721273008,3-13-24 21:28,800,Payment,Rent Payment,1282.319951
25662,721273008,3-17-24 10:28,77.94,Return,Store Return,1360.259951
25663,721273008,3-25-24 22:28,182.46,Purchase,Grocery,1177.799951
25664,721273008,04-03-24 21:28,2150,IncomingTransfer,Salary,3327.799951
25665,721273008,04-05-24 18:28,58.69,Deposit,Check Deposit,3386.489951
25666,721273008,04-08-24 21:28,1700,Payment,Credit Card Payment,1686.489951
25667,721273008,04-12-24 10:28,166.63,Return,eBay Return,1853.119951
25668,721273008,4-13-24 12:28,93.14,OutgoingTransfer,Peer-to-Peer Transfer,1759.979951
25669,721273008,4-15-24 21:28,600,Payment,Rent Payment,1159.979951
25670,721273008,4-19-24 22:28,21.04,OnlineShopping,eBay,1138.939951
25671,721273008,4-26-24 23:28,22.91,Withdrawal,ATM Withdrawal,1116.029951
25672,721273008,05-01-24 21:28,2150,IncomingTransfer,Salary,3266.029951
25673,721273008,05-02-24 11:28,209.72,Deposit,Cash Deposit,3475.749951
25674,721273008,05-06-24 21:28,1500,Payment,Credit Card Payment,1975.749951
25675,721273008,05-07-24 15:28,225.61,Deposit,Check Deposit,2201.359951
25676,721273008,05-08-24 12:28,159.39,OnlineShopping,Walmart,2041.969951
25677,721273008,05-09-24 19:28,122.19,OnlineShopping,Etsy,1919.779951
25678,721273008,05-10-24 21:28,900,Payment,Rent Payment,1019.779951
25679,721273008,05-12-24 11:28,167.8,Return,Walmart Return,1187.579951
25680,721273008,5-17-24 23:28,122.71,Withdrawal,ATM Withdrawal,1064.869951
25681,721273008,5-20-24 16:28,208.59,Deposit,Cash Deposit,1273.459951
25682,721273008,5-20-24 21:28,173.46,Purchase,Travel,1099.999951
25683,721273008,5-21-24 12:28,12.66,Withdrawal,Mobile App Withdrawal,1087.339951
25684,721273008,5-29-24 12:28,137.15,Payment,Mortgage Payment,950.189951
25685,721273008,5-29-24 16:28,36.3,Deposit,Check Deposit,986.489951
25686,721273008,5-31-24 12:28,43.25,Return,AliExpress Return,1029.739951
25687,721273008,06-01-24 21:28,2150,IncomingTransfer,Salary,3179.739951
25688,721273008,06-02-24 14:28,169.75,Purchase,Pharmacy,3009.989951
25689,721273008,06-02-24 20:28,50.39,IncomingTransfer,Freelance Payment,3060.379951
25690,721273008,06-06-24 14:28,146.34,Payment,Mortgage Payment,2914.039951
25691,721273008,06-06-24 21:28,1500,Payment,Credit Card Payment,1414.039951
25692,721273008,06-11-24 21:28,1100,Payment,Rent Payment,314.039951
25693,721273008,6-15-24 22:28,69.32,Withdrawal,Mobile App Withdrawal,244.719951
25694,721273008,6-29-24 11:28,127.16,OnlineShopping,Target,117.559951
25695,721273008,07-02-24 21:28,2150,IncomingTransfer,Salary,2267.559951
25696,721273008,07-05-24 10:28,219.83,OutgoingTransfer,Peer-to-Peer Transfer,2047.729951
25697,721273008,07-05-24 19:28,76.13,Deposit,Direct Deposit,2123.859951
25698,721273008,07-07-24 21:28,1600,Payment,Credit Card Payment,523.859951
25699,721273008,07-10-24 21:28,700,Payment,Rent Payment,-176.140049
25700,721273008,7-14-24 16:28,42.69,Deposit,Cash Deposit,-133.450049
25701,721301733,1-20-24 10:28,470.11,IncomingTransfer,Freelance Payment,1119.159363
25702,721301733,1-21-24 12:28,280.88,Return,Best Buy Return,1400.039363
25703,721301733,1-21-24 20:28,715.79,IncomingTransfer,Freelance Payment,2115.829363
25704,721301733,1-25-24 20:28,230.95,Deposit,Direct Deposit,2346.779363
25705,721301733,02-01-24 9:28,513.44,Withdrawal,Mobile App Withdrawal,1833.339363
25706,721301733,02-01-24 15:28,326.48,Purchase,Pharmacy,1506.859363
25707,721301733,02-05-24 21:28,6850,IncomingTransfer,Salary,8356.859363
25708,721301733,02-06-24 18:28,432.11,Purchase,Clothing,7924.749363
25709,721301733,02-09-24 9:28,613.29,Withdrawal,ATM Withdrawal,7311.459363
25710,721301733,02-10-24 16:28,268.42,IncomingTransfer,Freelance Payment,7579.879363
25711,721301733,02-10-24 21:28,800,Payment,Credit Card Payment,6779.879363
25712,721301733,02-12-24 23:28,171.42,OnlineShopping,Amazon,6608.459363
25713,721301733,2-18-24 21:28,2500,Payment,Insurance Payment,4108.459363
25714,721301733,2-19-24 13:28,367.4,Withdrawal,ATM Withdrawal,3741.059363
25715,721301733,2-24-24 15:28,547.24,Withdrawal,Mobile App Withdrawal,3193.819363
25716,721301733,2-24-24 15:28,173.57,Withdrawal,ATM Withdrawal,3020.249363
25717,721301733,03-05-24 16:28,287.15,Withdrawal,Branch Withdrawal,2733.099363
25718,721301733,03-05-24 20:28,111.39,IncomingTransfer,Freelance Payment,2844.489363
25719,721301733,03-05-24 21:28,6850,IncomingTransfer,Salary,9694.489363
25720,721301733,03-10-24 21:28,1000,Payment,Credit Card Payment,8694.489363
25721,721301733,3-13-24 20:28,585.82,Return,Amazon Return,9280.309363
25722,721301733,3-14-24 21:28,2800,Payment,Installment Payment,6480.309363
25723,721301733,3-17-24 21:28,647.16,Payment,Bill Payment,5833.149363
25724,721301733,3-19-24 20:28,477.86,OnlineShopping,Best Buy,5355.289363
25725,721301733,3-22-24 15:28,127.64,OutgoingTransfer,Bank Transfer,5227.649363
25726,721301733,3-22-24 20:28,254.74,Withdrawal,ATM Withdrawal,4972.909363
25727,721301733,3-31-24 11:28,466.24,IncomingTransfer,Freelance Payment,5439.149363
25728,721301733,04-03-24 10:28,243.29,Purchase,Furniture,5195.859363
25729,721301733,04-04-24 21:28,6850,IncomingTransfer,Salary,12045.85936
25730,721301733,04-07-24 14:28,131.13,Purchase,Pharmacy,11914.72936
25731,721301733,04-09-24 16:28,478.82,Return,AliExpress Return,12393.54936
25732,721301733,04-09-24 21:28,800,Payment,Credit Card Payment,11593.54936
25733,721301733,4-13-24 20:28,737.85,Purchase,Gas,10855.69936
25734,721301733,4-16-24 17:28,102.75,Purchase,Clothing,10752.94936
25735,721301733,4-17-24 10:28,357.02,OutgoingTransfer,Bank Transfer,10395.92936
25736,721301733,4-18-24 21:28,2700,Payment,Installment Payment,7695.929363
25737,721301733,4-24-24 13:28,500.73,OnlineShopping,Amazon,7195.199363
25738,721301733,4-27-24 17:28,131.3,Withdrawal,Mobile App Withdrawal,7063.899363
25739,721301733,05-01-24 10:28,237.54,Payment,Bill Payment,6826.359363
25740,721301733,05-02-24 21:28,6850,IncomingTransfer,Salary,13676.35936
25741,721301733,05-06-24 18:28,526.48,OnlineShopping,Target,13149.87936
25742,721301733,05-07-24 21:28,900,Payment,Credit Card Payment,12249.87936
25743,721301733,05-11-24 21:28,3000,Payment,Installment Payment,9249.879363
25744,721301733,5-17-24 22:28,178.91,Deposit,Cash Deposit,9428.789363
25745,721301733,5-18-24 12:28,185.4,Deposit,Check Deposit,9614.189363
25746,721301733,5-19-24 15:28,433.73,Purchase,Electronics,9180.459363
25747,721301733,5-20-24 11:28,280.33,Purchase,Electronics,8900.129363
25748,721301733,5-20-24 22:28,717.82,Deposit,Check Deposit,9617.949363
25749,721301733,5-22-24 13:28,476.62,Withdrawal,ATM Withdrawal,9141.329363
25750,721301733,06-02-24 21:28,6850,IncomingTransfer,Salary,15991.32936
25751,721301733,06-06-24 13:28,585.27,Purchase,Clothing,15406.05936
25752,721301733,06-07-24 21:28,900,Payment,Credit Card Payment,14506.05936
25753,721301733,6-13-24 18:28,324.61,IncomingTransfer,Freelance Payment,14830.66936
25754,721301733,6-16-24 21:28,2400,Payment,Insurance Payment,12430.66936
25755,721301733,6-22-24 10:28,261.13,Purchase,Entertainment,12169.53936
25756,721301733,6-26-24 13:28,358.52,OutgoingTransfer,International Transfer,11811.01936
25757,721301733,07-02-24 21:28,6850,IncomingTransfer,Salary,18661.01936
25758,721301733,07-07-24 15:28,324.62,Withdrawal,ATM Withdrawal,18336.39936
25759,721301733,07-07-24 21:28,1100,Payment,Credit Card Payment,17236.39936
25760,721301733,07-10-24 15:28,157.87,Deposit,Check Deposit,17394.26936
25761,721301733,07-12-24 12:28,533.98,Return,Walmart Return,17928.24936
25762,721301733,7-14-24 21:28,2700,Payment,Insurance Payment,15228.24936
25763,721301733,7-17-24 17:28,102.15,Withdrawal,Mobile App Withdrawal,15126.09936
25764,721317333,1-20-24 10:28,228.44,Purchase,Gas,1057.002698
25765,721317333,1-21-24 13:28,95.52,Purchase,Clothing,961.482698
25766,721317333,1-21-24 18:28,398.78,OutgoingTransfer,Peer-to-Peer Transfer,562.702698
25767,721317333,1-23-24 11:28,162.33,OutgoingTransfer,International Transfer,400.372698
25768,721317333,02-04-24 21:28,3850,IncomingTransfer,Salary,4250.372698
25769,721317333,02-05-24 13:28,329.39,Purchase,Restaurant,3920.982698
25770,721317333,02-05-24 14:28,23.37,Deposit,Direct Deposit,3944.352698
25771,721317333,02-05-24 17:28,98.03,Withdrawal,Mobile App Withdrawal,3846.322698
25772,721317333,02-09-24 21:28,2700,Payment,Credit Card Payment,1146.322698
25773,721317333,02-12-24 18:28,114.41,OutgoingTransfer,Peer-to-Peer Transfer,1031.912698
25774,721317333,2-14-24 14:28,91.83,OutgoingTransfer,Bank Transfer,940.082698
25775,721317333,2-15-24 22:28,390.22,Purchase,Travel,549.862698
25776,721317333,2-17-24 13:28,193.4,OnlineShopping,Amazon,356.462698
25777,721317333,2-17-24 21:28,1200,Payment,Rent Payment,-843.537302
25778,721317333,2-18-24 20:28,225.27,Deposit,Direct Deposit,-618.267302
25779,721317333,2-20-24 15:28,69.83,Withdrawal,Branch Withdrawal,-688.097302
25780,721317333,2-20-24 18:28,40.37,Purchase,Gas,-728.467302
25781,721317333,2-23-24 15:28,133.97,Return,Target Return,-594.497302
25782,721317333,2-27-24 18:28,328.27,OutgoingTransfer,Bank Transfer,-922.767302
25783,721317333,2-29-24 18:28,218.07,OnlineShopping,AliExpress,-1140.837302
25784,721317333,2-29-24 23:28,172.95,Purchase,Pharmacy,-1313.787302
25785,721317333,03-02-24 15:28,237.34,Purchase,Gas,-1551.127302
25786,721317333,03-05-24 21:28,3850,IncomingTransfer,Salary,2298.872698
25787,721317333,03-10-24 18:28,218.14,Deposit,Direct Deposit,2517.012698
25788,721317333,03-10-24 21:28,2500,Payment,Credit Card Payment,17.01269798
25789,721317333,03-10-24 21:28,292.96,Payment,Loan Payment,-275.947302
25790,721317333,03-10-24 22:28,151.28,Withdrawal,Branch Withdrawal,-427.227302
25791,721317333,03-11-24 19:28,44.84,Purchase,Electronics,-472.067302
25792,721317333,03-12-24 19:28,169.14,Withdrawal,Branch Withdrawal,-641.207302
25793,721317333,3-15-24 23:28,315.81,Deposit,Check Deposit,-325.397302
25794,721317333,3-16-24 12:28,231.68,OutgoingTransfer,International Transfer,-557.077302
25795,721317333,3-17-24 21:28,1500,Payment,Rent Payment,-2057.077302
25796,721317333,3-18-24 11:28,260.69,Purchase,Restaurant,-2317.767302
25797,721317333,3-20-24 12:28,333.2,Payment,Mortgage Payment,-2650.967302
25798,721317333,3-22-24 20:28,338.62,Purchase,Home Improvement,-2989.587302
25799,721317333,3-27-24 14:28,321.05,Withdrawal,Branch Withdrawal,-3310.637302
25800,721317333,3-30-24 10:28,90.32,Payment,Bill Payment,-3400.957302
25801,721317333,04-03-24 12:28,345.29,Payment,Loan Payment,-3746.247302
25802,721317333,04-04-24 13:28,130.39,Payment,Bill Payment,-3876.637302
25803,721317333,04-04-24 21:28,3850,IncomingTransfer,Salary,-26.63730202
25804,721317333,04-06-24 16:28,110.47,OnlineShopping,Target,-137.107302
25805,721317333,04-07-24 16:28,307.93,Deposit,Mobile Deposit,170.822698
25806,721317333,04-07-24 17:28,335.57,IncomingTransfer,Freelance Payment,506.392698
25807,721317333,04-07-24 17:28,48.37,Purchase,Entertainment,458.022698
25808,721317333,04-07-24 18:28,150.32,Deposit,Direct Deposit,608.342698
25809,721317333,04-09-24 21:28,2600,Payment,Credit Card Payment,-1991.657302
25810,721317333,04-11-24 11:28,305.79,Payment,Mortgage Payment,-2297.447302
25811,721317333,04-11-24 11:28,112.39,Purchase,Pharmacy,-2409.837302
25812,721317333,04-12-24 21:28,1300,Payment,Rent Payment,-3709.837302
25813,721317333,4-13-24 13:28,265.87,Deposit,Direct Deposit,-3443.967302
25814,721317333,4-17-24 11:28,199.47,Withdrawal,Mobile App Withdrawal,-3643.437302
25815,721317333,4-19-24 16:28,198.2,IncomingTransfer,Freelance Payment,-3445.237302
25816,721317333,4-23-24 9:28,91.16,IncomingTransfer,Freelance Payment,-3354.077302
25817,721317333,05-05-24 19:28,303.51,Withdrawal,Branch Withdrawal,-3657.587302
25818,721317333,05-05-24 21:28,3850,IncomingTransfer,Salary,192.412698
25819,721317333,05-09-24 12:28,383.97,Withdrawal,Branch Withdrawal,-191.557302
25820,721317333,05-10-24 21:28,2600,Payment,Credit Card Payment,-2791.557302
25821,721317333,5-14-24 13:28,274.24,OutgoingTransfer,Wire Transfer,-3065.797302
25822,721317333,5-15-24 19:28,333.07,Deposit,Mobile Deposit,-2732.727302
25823,721317333,5-15-24 21:28,273.06,OutgoingTransfer,Bank Transfer,-3005.787302
25824,721317333,5-15-24 21:28,310.53,Payment,Loan Payment,-3316.317302
25825,721317333,5-16-24 21:28,2500,Payment,Rent Payment,-5816.317302
25826,721317333,5-16-24 23:28,273.41,OutgoingTransfer,Bank Transfer,-6089.727302
25827,721317333,5-18-24 17:28,156.79,OnlineShopping,Amazon,-6246.517302
25828,721317333,5-18-24 17:28,50.04,OnlineShopping,Best Buy,-6296.557302
25829,721317333,5-23-24 10:28,161.98,Purchase,Travel,-6458.537302
25830,721317333,5-24-24 23:28,203.67,Payment,Loan Payment,-6662.207302
25831,721317333,5-28-24 22:28,202.77,OnlineShopping,Walmart,-6864.977302
25832,721317333,5-30-24 10:28,351.66,Purchase,Gas,-7216.637302
25833,721317333,5-31-24 20:28,83.56,IncomingTransfer,Freelance Payment,-7133.077302
25834,721317333,06-01-24 14:28,291.21,OnlineShopping,Walmart,-7424.287302
25835,721317333,06-04-24 21:28,3850,IncomingTransfer,Salary,-3574.287302
25836,721317333,06-04-24 22:28,301.67,Deposit,Direct Deposit,-3272.617302
25837,721317333,06-07-24 23:28,218.51,IncomingTransfer,Freelance Payment,-3054.107302
25838,721317333,06-09-24 21:28,2600,Payment,Credit Card Payment,-5654.107302
25839,721317333,06-10-24 21:28,2000,Payment,Rent Payment,-7654.107302
25840,721317333,06-12-24 15:28,294.87,Withdrawal,Mobile App Withdrawal,-7948.977302
25841,721317333,6-17-24 13:28,331.58,Return,Walmart Return,-7617.397302
25842,721317333,6-25-24 14:28,369.31,Withdrawal,Mobile App Withdrawal,-7986.707302
25843,721317333,6-26-24 10:28,195.19,Purchase,Gas,-8181.897302
25844,721317333,6-30-24 17:28,232.88,Withdrawal,Mobile App Withdrawal,-8414.777302
25845,721317333,07-01-24 20:28,60.05,OutgoingTransfer,Bank Transfer,-8474.827302
25846,721317333,07-02-24 16:28,345.61,Withdrawal,ATM Withdrawal,-8820.437302
25847,721317333,07-04-24 10:28,245.82,Return,Etsy Return,-8574.617302
25848,721317333,07-04-24 10:28,242.24,Return,eBay Return,-8332.377302
25849,721317333,07-04-24 21:28,3850,IncomingTransfer,Salary,-4482.377302
25850,721317333,07-09-24 21:28,2500,Payment,Credit Card Payment,-6982.377302
25851,721317333,07-10-24 16:28,51.19,Deposit,Check Deposit,-6931.187302
25852,721317333,07-10-24 19:28,390.54,Withdrawal,Branch Withdrawal,-7321.727302
25853,721317333,07-11-24 15:28,38.2,OutgoingTransfer,Peer-to-Peer Transfer,-7359.927302
25854,721317333,7-15-24 11:28,151.81,Purchase,Restaurant,-7511.737302
25855,721317333,7-15-24 21:28,1800,Payment,Rent Payment,-9311.737302
25856,721317333,7-17-24 11:28,325.78,Payment,Mortgage Payment,-9637.517302
25857,721402233,1-21-24 19:28,912.07,Return,Walmart Return,1931.310343
25858,721402233,1-21-24 22:28,349.55,OutgoingTransfer,Peer-to-Peer Transfer,1581.760343
25859,721402233,1-24-24 19:28,936.08,Deposit,Check Deposit,2517.840343
25860,721402233,1-26-24 16:28,748.38,Payment,Mortgage Payment,1769.460343
25861,721402233,1-27-24 19:28,595.45,Purchase,Gas,1174.010343
25862,721402233,1-28-24 16:28,878.94,Deposit,Cash Deposit,2052.950343
25863,721402233,1-28-24 21:28,687.65,Deposit,Cash Deposit,2740.600343
25864,721402233,1-31-24 14:28,834.56,Deposit,Check Deposit,3575.160343
25865,721402233,1-31-24 23:28,645.22,Deposit,Mobile Deposit,4220.380343
25866,721402233,02-01-24 21:28,16000,IncomingTransfer,Salary,20220.38034
25867,721402233,02-03-24 15:28,529.63,Withdrawal,Mobile App Withdrawal,19690.75034
25868,721402233,02-05-24 15:28,339.39,Deposit,Check Deposit,20030.14034
25869,721402233,02-06-24 21:28,1800,Payment,Credit Card Payment,18230.14034
25870,721402233,02-07-24 21:28,483.99,Purchase,Travel,17746.15034
25871,721402233,02-08-24 11:28,848.88,OnlineShopping,eBay,16897.27034
25872,721402233,02-08-24 13:28,676.71,IncomingTransfer,Freelance Payment,17573.98034
25873,721402233,02-11-24 10:28,398.59,Deposit,Mobile Deposit,17972.57034
25874,721402233,2-13-24 10:28,908.57,Return,AliExpress Return,18881.14034
25875,721402233,2-14-24 18:28,590.37,Payment,Bill Payment,18290.77034
25876,721402233,2-15-24 11:28,676.54,Purchase,Clothing,17614.23034
25877,721402233,2-17-24 11:28,383.41,Purchase,Electronics,17230.82034
25878,721402233,2-17-24 14:28,483.79,Purchase,Clothing,16747.03034
25879,721402233,2-17-24 16:28,333.32,Withdrawal,ATM Withdrawal,16413.71034
25880,721402233,2-17-24 17:28,657.7,Payment,Loan Payment,15756.01034
25881,721402233,2-18-24 15:28,380.3,Purchase,Furniture,15375.71034
25882,721402233,2-18-24 21:28,4900,Payment,Installment Payment,10475.71034
25883,721402233,2-21-24 20:28,714.12,Purchase,Home Improvement,9761.590343
25884,721402233,2-23-24 21:28,625.37,Return,Store Return,10386.96034
25885,721402233,2-24-24 11:28,396.82,Purchase,Home Improvement,9990.140343
25886,721402233,2-24-24 21:28,855.83,Deposit,Check Deposit,10845.97034
25887,721402233,2-26-24 14:28,892.01,OutgoingTransfer,Bank Transfer,9953.960343
25888,721402233,2-27-24 16:28,450.84,Deposit,Mobile Deposit,10404.80034
25889,721402233,2-27-24 17:28,686.65,Return,Target Return,11091.45034
25890,721402233,2-28-24 13:28,900.01,Withdrawal,ATM Withdrawal,10191.44034
25891,721402233,2-29-24 18:28,679.3,Deposit,Direct Deposit,10870.74034
25892,721402233,03-01-24 21:28,16000,IncomingTransfer,Salary,26870.74034
25893,721402233,03-03-24 19:28,249.37,Payment,Bill Payment,26621.37034
25894,721402233,03-04-24 20:28,787.65,Deposit,Mobile Deposit,27409.02034
25895,721402233,03-06-24 13:28,806.17,Return,Target Return,28215.19034
25896,721402233,03-06-24 21:28,1700,Payment,Credit Card Payment,26515.19034
25897,721402233,03-09-24 10:28,921.86,Withdrawal,Mobile App Withdrawal,25593.33034
25898,721402233,03-09-24 16:28,728.53,Deposit,Check Deposit,26321.86034
25899,721402233,03-10-24 22:28,470.11,Purchase,Electronics,25851.75034
25900,721402233,03-11-24 14:28,532.38,OnlineShopping,Etsy,25319.37034
25901,721402233,03-12-24 15:28,831.11,Purchase,Grocery,24488.26034
25902,721402233,03-12-24 21:28,4800,Payment,Installment Payment,19688.26034
25903,721402233,3-13-24 9:28,569.58,Purchase,Entertainment,19118.68034
25904,721402233,3-14-24 10:28,846.52,Purchase,Electronics,18272.16034
25905,721402233,3-20-24 13:28,657.18,OutgoingTransfer,International Transfer,17614.98034
25906,721402233,3-23-24 16:28,894.89,Payment,Loan Payment,16720.09034
25907,721402233,3-23-24 20:28,748.94,Withdrawal,Mobile App Withdrawal,15971.15034
25908,721402233,3-24-24 16:28,263.88,OnlineShopping,Target,15707.27034
25909,721402233,3-28-24 22:28,880.66,Purchase,Furniture,14826.61034
25910,721402233,3-29-24 20:28,931.56,Return,Etsy Return,15758.17034
25911,721402233,3-30-24 19:28,278.38,Withdrawal,Branch Withdrawal,15479.79034
25912,721402233,3-31-24 13:28,244.6,Purchase,Clothing,15235.19034
25913,721402233,04-02-24 21:28,16000,IncomingTransfer,Salary,31235.19034
25914,721402233,04-04-24 12:28,536.01,OnlineShopping,Walmart,30699.18034
25915,721402233,04-04-24 14:28,521.53,Purchase,Electronics,30177.65034
25916,721402233,04-05-24 21:28,648.99,Return,Amazon Return,30826.64034
25917,721402233,04-07-24 12:28,580.99,Deposit,Cash Deposit,31407.63034
25918,721402233,04-07-24 21:28,1500,Payment,Credit Card Payment,29907.63034
25919,721402233,04-07-24 22:28,614.33,Payment,Bill Payment,29293.30034
25920,721402233,04-08-24 9:28,283.57,Purchase,Clothing,29009.73034
25921,721402233,04-08-24 16:28,498.04,Payment,Loan Payment,28511.69034
25922,721402233,04-10-24 17:28,683.91,OutgoingTransfer,Peer-to-Peer Transfer,27827.78034
25923,721402233,04-11-24 20:28,692.12,Purchase,Grocery,27135.66034
25924,721402233,4-13-24 20:28,894.69,OutgoingTransfer,Bank Transfer,26240.97034
25925,721402233,4-14-24 18:28,440.88,Withdrawal,Branch Withdrawal,25800.09034
25926,721402233,4-15-24 21:28,7100,Payment,Insurance Payment,18700.09034
25927,721402233,4-17-24 10:28,491.91,Purchase,Grocery,18208.18034
25928,721402233,4-19-24 11:28,214.2,Purchase,Gas,17993.98034
25929,721402233,4-19-24 22:28,770.26,Return,eBay Return,18764.24034
25930,721402233,4-21-24 14:28,555.96,Purchase,Pharmacy,18208.28034
25931,721402233,4-21-24 18:28,722.61,Payment,Loan Payment,17485.67034
25932,721402233,4-22-24 20:28,650.34,Deposit,Cash Deposit,18136.01034
25933,721402233,4-23-24 14:28,474.86,OnlineShopping,eBay,17661.15034
25934,721402233,4-23-24 18:28,414.27,Return,Store Return,18075.42034
25935,721402233,4-23-24 19:28,942.06,Withdrawal,Branch Withdrawal,17133.36034
25936,721402233,4-25-24 22:28,778.23,Deposit,Mobile Deposit,17911.59034
25937,721402233,4-26-24 21:28,470.64,Withdrawal,Branch Withdrawal,17440.95034
25938,721402233,4-27-24 11:28,793.33,Return,AliExpress Return,18234.28034
25939,721402233,05-01-24 11:28,569.48,OutgoingTransfer,International Transfer,17664.80034
25940,721402233,05-01-24 20:28,665.59,Deposit,Cash Deposit,18330.39034
25941,721402233,05-01-24 21:28,16000,IncomingTransfer,Salary,34330.39034
25942,721402233,05-02-24 20:28,223.66,Return,Best Buy Return,34554.05034
25943,721402233,05-03-24 15:28,666.95,Purchase,Restaurant,33887.10034
25944,721402233,05-06-24 21:28,1500,Payment,Credit Card Payment,32387.10034
25945,721402233,05-08-24 15:28,759.55,Purchase,Clothing,31627.55034
25946,721402233,05-09-24 23:28,943.7,Withdrawal,Branch Withdrawal,30683.85034
25947,721402233,05-11-24 18:28,906.64,Deposit,Cash Deposit,31590.49034
25948,721402233,05-12-24 10:28,231.42,Withdrawal,Mobile App Withdrawal,31359.07034
25949,721402233,5-13-24 15:28,494.5,OnlineShopping,Etsy,30864.57034
25950,721402233,5-14-24 21:28,6200,Payment,Installment Payment,24664.57034
25951,721402233,5-15-24 10:28,267.09,Deposit,Cash Deposit,24931.66034
25952,721402233,5-15-24 12:28,686.22,Deposit,Mobile Deposit,25617.88034
25953,721402233,5-16-24 23:28,683.79,OnlineShopping,Etsy,24934.09034
25954,721402233,5-21-24 21:28,881.12,Deposit,Direct Deposit,25815.21034
25955,721402233,5-22-24 19:28,913.53,OutgoingTransfer,Wire Transfer,24901.68034
25956,721402233,5-23-24 23:28,688.1,Return,Target Return,25589.78034
25957,721402233,5-24-24 12:28,381.66,Deposit,Mobile Deposit,25971.44034
25958,721402233,5-25-24 18:28,333.22,OutgoingTransfer,Peer-to-Peer Transfer,25638.22034
25959,721402233,5-27-24 10:28,755.18,OnlineShopping,eBay,24883.04034
25960,721402233,5-28-24 12:28,809.73,Deposit,Mobile Deposit,25692.77034
25961,721402233,5-29-24 9:28,217.05,Purchase,Pharmacy,25475.72034
25962,721402233,5-29-24 13:28,609.01,Purchase,Gas,24866.71034
25963,721402233,06-02-24 14:28,632.67,Deposit,Check Deposit,25499.38034
25964,721402233,06-04-24 11:28,220.87,Deposit,Direct Deposit,25720.25034
25965,721402233,06-04-24 19:28,230.01,Purchase,Electronics,25490.24034
25966,721402233,06-05-24 21:28,16000,IncomingTransfer,Salary,41490.24034
25967,721402233,06-07-24 13:28,839.79,Deposit,Cash Deposit,42330.03034
25968,721402233,06-10-24 21:28,1700,Payment,Credit Card Payment,40630.03034
25969,721402233,06-11-24 20:28,268.97,OutgoingTransfer,Bank Transfer,40361.06034
25970,721402233,6-14-24 17:28,679.44,IncomingTransfer,Freelance Payment,41040.50034
25971,721402233,6-14-24 21:28,5200,Payment,Subscription Payment,35840.50034
25972,721402233,6-15-24 12:28,733.54,Purchase,Home Improvement,35106.96034
25973,721402233,6-16-24 15:28,900.93,OnlineShopping,Etsy,34206.03034
25974,721402233,6-16-24 19:28,700.96,Return,AliExpress Return,34906.99034
25975,721402233,6-18-24 23:28,269.64,OnlineShopping,Walmart,34637.35034
25976,721402233,6-21-24 23:28,396.19,OnlineShopping,Target,34241.16034
25977,721402233,6-24-24 16:28,670.09,Return,Walmart Return,34911.25034
25978,721402233,6-24-24 23:28,348.59,Purchase,Gas,34562.66034
25979,721402233,6-25-24 13:28,709.02,OnlineShopping,Amazon,33853.64034
25980,721402233,6-25-24 16:28,816.51,OnlineShopping,Walmart,33037.13034
25981,721402233,6-26-24 18:28,425.35,OutgoingTransfer,Bank Transfer,32611.78034
25982,721402233,6-26-24 21:28,353.64,Deposit,Check Deposit,32965.42034
25983,721402233,6-28-24 16:28,349.36,Withdrawal,Mobile App Withdrawal,32616.06034
25984,721402233,6-28-24 22:28,541.16,Purchase,Electronics,32074.90034
25985,721402233,6-30-24 10:28,264.22,Return,Target Return,32339.12034
25986,721402233,07-01-24 17:28,479.54,OnlineShopping,Etsy,31859.58034
25987,721402233,07-02-24 11:28,949.48,Purchase,Grocery,30910.10034
25988,721402233,07-02-24 16:28,575.74,OutgoingTransfer,Wire Transfer,30334.36034
25989,721402233,07-02-24 21:28,16000,IncomingTransfer,Salary,46334.36034
25990,721402233,07-03-24 23:28,677.19,Deposit,Mobile Deposit,47011.55034
25991,721402233,07-07-24 21:28,2100,Payment,Credit Card Payment,44911.55034
25992,721402233,07-10-24 21:28,4800,Payment,Subscription Payment,40111.55034
25993,721402233,7-13-24 12:28,601.12,Withdrawal,ATM Withdrawal,39510.43034
25994,721402233,7-13-24 13:28,630.29,Withdrawal,ATM Withdrawal,38880.14034
25995,721402233,7-15-24 21:28,382.33,Purchase,Home Improvement,38497.81034
25996,721402233,7-15-24 21:28,708.54,Deposit,Mobile Deposit,39206.35034
25997,721402233,7-16-24 11:28,724.97,Purchase,Grocery,38481.38034
25998,721402233,7-17-24 15:28,826.17,Payment,Bill Payment,37655.21034
25999,721402233,7-17-24 18:28,747.48,OutgoingTransfer,Bank Transfer,36907.73034
26000,721434483,1-20-24 13:28,359.4,Purchase,Entertainment,674.856969
26001,721434483,1-25-24 13:28,211.52,Deposit,Check Deposit,886.376969
26002,721434483,1-28-24 10:28,400.74,Payment,Loan Payment,485.636969
26003,721434483,1-28-24 14:28,304.39,Payment,Loan Payment,181.246969
26004,721434483,1-28-24 22:28,392.19,Payment,Bill Payment,-210.943031
26005,721434483,02-02-24 19:28,636,Return,eBay Return,425.056969
26006,721434483,02-03-24 19:28,518.26,Withdrawal,Mobile App Withdrawal,-93.20303097
26007,721434483,02-03-24 21:28,699.44,Purchase,Gas,-792.643031
26008,721434483,02-05-24 21:28,9600,IncomingTransfer,Salary,8807.356969
26009,721434483,02-10-24 21:28,1800,Payment,Credit Card Payment,7007.356969
26010,721434483,02-11-24 19:28,295.93,Purchase,Grocery,6711.426969
26011,721434483,2-14-24 21:28,5900,Payment,Rent Payment,811.426969
26012,721434483,2-15-24 9:28,300.42,OutgoingTransfer,International Transfer,511.006969
26013,721434483,2-17-24 21:28,705.39,Return,Target Return,1216.396969
26014,721434483,2-18-24 15:28,609.43,Payment,Loan Payment,606.966969
26015,721434483,2-21-24 21:28,369.22,Return,eBay Return,976.186969
26016,721434483,2-22-24 9:28,258.5,Deposit,Check Deposit,1234.686969
26017,721434483,03-01-24 22:28,398.43,OutgoingTransfer,International Transfer,836.256969
26018,721434483,03-02-24 19:28,234.55,Purchase,Grocery,601.706969
26019,721434483,03-04-24 15:28,646.35,Deposit,Mobile Deposit,1248.056969
26020,721434483,03-04-24 21:28,9600,IncomingTransfer,Salary,10848.05697
26021,721434483,03-06-24 11:28,719.38,Deposit,Mobile Deposit,11567.43697
26022,721434483,03-08-24 15:28,494.51,Purchase,Travel,11072.92697
26023,721434483,03-09-24 21:28,1500,Payment,Credit Card Payment,9572.926969
26024,721434483,03-10-24 12:28,575.16,Withdrawal,Mobile App Withdrawal,8997.766969
26025,721434483,03-11-24 21:28,310.24,Purchase,Restaurant,8687.526969
26026,721434483,3-16-24 14:28,420.67,OutgoingTransfer,Bank Transfer,8266.856969
26027,721434483,3-16-24 21:28,3700,Payment,Rent Payment,4566.856969
26028,721434483,3-22-24 10:28,249.42,Return,eBay Return,4816.276969
26029,721434483,3-22-24 11:28,738.76,Deposit,Check Deposit,5555.036969
26030,721434483,3-22-24 18:28,543.48,OnlineShopping,Best Buy,5011.556969
26031,721434483,3-23-24 15:28,435.95,Withdrawal,Branch Withdrawal,4575.606969
26032,721434483,3-29-24 23:28,290.06,OnlineShopping,Target,4285.546969
26033,721434483,04-01-24 21:28,9600,IncomingTransfer,Salary,13885.54697
26034,721434483,04-04-24 10:28,692.63,OutgoingTransfer,International Transfer,13192.91697
26035,721434483,04-04-24 11:28,583.44,Purchase,Electronics,12609.47697
26036,721434483,04-04-24 15:28,676.6,Withdrawal,Mobile App Withdrawal,11932.87697
26037,721434483,04-06-24 21:28,1800,Payment,Credit Card Payment,10132.87697
26038,721434483,4-18-24 21:28,4100,Payment,Rent Payment,6032.876969
26039,721434483,4-22-24 15:28,258.75,OutgoingTransfer,Bank Transfer,5774.126969
26040,721434483,4-24-24 21:28,203.47,Payment,Loan Payment,5570.656969
26041,721434483,4-25-24 13:28,534.86,Withdrawal,Mobile App Withdrawal,5035.796969
26042,721434483,4-26-24 16:28,368.62,Return,AliExpress Return,5404.416969
26043,721434483,4-29-24 22:28,277.98,Deposit,Cash Deposit,5682.396969
26044,721434483,4-30-24 17:28,419.67,OnlineShopping,eBay,5262.726969
26045,721434483,05-01-24 21:28,9600,IncomingTransfer,Salary,14862.72697
26046,721434483,05-06-24 21:28,1700,Payment,Credit Card Payment,13162.72697
26047,721434483,05-12-24 21:28,2700,Payment,Rent Payment,10462.72697
26048,721434483,5-15-24 10:28,588.04,OutgoingTransfer,Bank Transfer,9874.686969
26049,721434483,5-15-24 22:28,622.49,Deposit,Mobile Deposit,10497.17697
26050,721434483,5-18-24 12:28,617.77,Purchase,Pharmacy,9879.406969
26051,721434483,5-20-24 11:28,341.38,Deposit,Cash Deposit,10220.78697
26052,721434483,5-22-24 22:28,687.7,OnlineShopping,Amazon,9533.086969
26053,721434483,5-28-24 14:28,363.12,Purchase,Travel,9169.966969
26054,721434483,5-28-24 17:28,678.9,Deposit,Cash Deposit,9848.866969
26055,721434483,06-01-24 21:28,9600,IncomingTransfer,Salary,19448.86697
26056,721434483,06-05-24 16:28,298.77,OutgoingTransfer,Wire Transfer,19150.09697
26057,721434483,06-06-24 21:28,1800,Payment,Credit Card Payment,17350.09697
26058,721434483,06-07-24 21:28,447.56,Payment,Bill Payment,16902.53697
26059,721434483,06-10-24 12:28,614.18,Return,eBay Return,17516.71697
26060,721434483,06-10-24 21:28,5900,Payment,Rent Payment,11616.71697
26061,721434483,6-17-24 9:28,289.34,IncomingTransfer,Freelance Payment,11906.05697
26062,721434483,6-18-24 11:28,624.02,Payment,Loan Payment,11282.03697
26063,721434483,6-18-24 11:28,436.02,Purchase,Pharmacy,10846.01697
26064,721434483,6-21-24 19:28,144.06,Purchase,Home Improvement,10701.95697
26065,721434483,6-22-24 16:28,209.52,Deposit,Direct Deposit,10911.47697
26066,721434483,6-23-24 18:28,374.98,Withdrawal,Branch Withdrawal,10536.49697
26067,721434483,6-29-24 12:28,728.06,Payment,Loan Payment,9808.436969
26068,721434483,07-02-24 21:28,9600,IncomingTransfer,Salary,19408.43697
26069,721434483,07-03-24 16:28,646.49,Deposit,Check Deposit,20054.92697
26070,721434483,07-07-24 21:28,1800,Payment,Credit Card Payment,18254.92697
26071,721434483,07-12-24 21:28,3900,Payment,Rent Payment,14354.92697
26072,721434483,7-17-24 18:28,509.64,OutgoingTransfer,Wire Transfer,13845.28697
26073,721437333,1-23-24 19:28,725.73,IncomingTransfer,Freelance Payment,2141.949681
26074,721437333,1-28-24 11:28,386.86,Purchase,Home Improvement,1755.089681
26075,721437333,1-30-24 10:28,256.03,OutgoingTransfer,International Transfer,1499.059681
26076,721437333,1-30-24 16:28,523.12,Purchase,Entertainment,975.9396807
26077,721437333,02-02-24 21:28,8550,IncomingTransfer,Salary,9525.939681
26078,721437333,02-06-24 15:28,184.97,Deposit,Cash Deposit,9710.909681
26079,721437333,02-07-24 21:28,3300,Payment,Credit Card Payment,6410.909681
26080,721437333,02-09-24 9:28,725.83,OutgoingTransfer,Bank Transfer,5685.079681
26081,721437333,02-12-24 21:28,5200,Payment,Rent Payment,485.0796807
26082,721437333,2-14-24 15:28,586.23,Withdrawal,Branch Withdrawal,-101.1503193
26083,721437333,2-16-24 10:28,543.08,Deposit,Check Deposit,441.9296807
26084,721437333,2-18-24 21:28,176.84,Deposit,Cash Deposit,618.7696807
26085,721437333,2-21-24 9:28,524.5,Purchase,Pharmacy,94.26968066
26086,721437333,2-29-24 12:28,143.21,Purchase,Gas,-48.94031934
26087,721437333,03-01-24 9:28,298.31,Return,Store Return,249.3696807
26088,721437333,03-02-24 21:28,8550,IncomingTransfer,Salary,8799.369681
26089,721437333,03-07-24 21:28,3000,Payment,Credit Card Payment,5799.369681
26090,721437333,3-14-24 21:28,2500,Payment,Rent Payment,3299.369681
26091,721437333,3-31-24 15:28,655.44,Payment,Loan Payment,2643.929681
26092,721437333,04-04-24 21:28,8550,IncomingTransfer,Salary,11193.92968
26093,721437333,04-07-24 14:28,483.21,OutgoingTransfer,International Transfer,10710.71968
26094,721437333,04-09-24 21:28,3400,Payment,Credit Card Payment,7310.719681
26095,721437333,04-11-24 19:28,266.21,OutgoingTransfer,Bank Transfer,7044.509681
26096,721437333,04-12-24 18:28,649.82,Withdrawal,ATM Withdrawal,6394.689681
26097,721437333,4-14-24 21:28,4600,Payment,Rent Payment,1794.689681
26098,721437333,4-15-24 16:28,495.29,OnlineShopping,Best Buy,1299.399681
26099,721437333,4-18-24 13:28,694.4,Withdrawal,Mobile App Withdrawal,604.9996807
26100,721437333,4-19-24 13:28,119.8,Payment,Bill Payment,485.1996807
26101,721437333,4-27-24 15:28,262.15,Deposit,Direct Deposit,747.3496807
26102,721437333,05-01-24 20:28,182.99,Return,Walmart Return,930.3396807
26103,721437333,05-02-24 11:28,656.62,Deposit,Cash Deposit,1586.959681
26104,721437333,05-04-24 14:28,467.04,Return,Etsy Return,2053.999681
26105,721437333,05-04-24 21:28,8550,IncomingTransfer,Salary,10603.99968
26106,721437333,05-09-24 20:28,347.33,OutgoingTransfer,International Transfer,10256.66968
26107,721437333,05-09-24 21:28,3100,Payment,Credit Card Payment,7156.669681
26108,721437333,5-16-24 21:28,5100,Payment,Rent Payment,2056.669681
26109,721437333,5-18-24 14:28,373.8,Payment,Bill Payment,1682.869681
26110,721437333,5-18-24 15:28,680.6,Deposit,Direct Deposit,2363.469681
26111,721437333,5-21-24 12:28,705.48,Purchase,Home Improvement,1657.989681
26112,721437333,5-29-24 15:28,721.23,Purchase,Furniture,936.7596807
26113,721437333,5-30-24 15:28,149.08,OutgoingTransfer,Peer-to-Peer Transfer,787.6796807
26114,721437333,5-31-24 13:28,736.62,IncomingTransfer,Freelance Payment,1524.299681
26115,721437333,06-03-24 21:28,8550,IncomingTransfer,Salary,10074.29968
26116,721437333,06-03-24 22:28,292.43,Purchase,Gas,9781.869681
26117,721437333,06-08-24 21:28,2900,Payment,Credit Card Payment,6881.869681
26118,721437333,06-10-24 21:28,3900,Payment,Rent Payment,2981.869681
26119,721437333,6-15-24 22:28,218.29,Deposit,Mobile Deposit,3200.159681
26120,721437333,6-27-24 19:28,353.36,Purchase,Grocery,2846.799681
26121,721437333,07-02-24 21:28,8550,IncomingTransfer,Salary,11396.79968
26122,721437333,07-05-24 19:28,443.4,Return,Amazon Return,11840.19968
26123,721437333,07-07-24 21:28,3100,Payment,Credit Card Payment,8740.199681
26124,721437333,07-07-24 22:28,176.54,OutgoingTransfer,Bank Transfer,8563.659681
26125,721437333,7-13-24 21:28,107.2,Deposit,Check Deposit,8670.859681
26126,721437333,7-14-24 13:28,713.31,OnlineShopping,Target,7957.549681
26127,721437333,7-15-24 16:28,455.24,Payment,Bill Payment,7502.309681
26128,721437333,7-16-24 21:28,2800,Payment,Rent Payment,4702.309681
26129,721437333,7-17-24 23:28,322.55,IncomingTransfer,Freelance Payment,5024.859681
26130,721440633,1-22-24 10:28,19.26,Payment,Bill Payment,759.7880858
26131,721440633,1-24-24 15:28,105.58,Deposit,Direct Deposit,865.3680858
26132,721440633,1-26-24 9:28,66.32,Deposit,Check Deposit,931.6880858
26133,721440633,1-29-24 17:28,240.8,Deposit,Mobile Deposit,1172.488086
26134,721440633,02-01-24 21:28,3050,IncomingTransfer,Salary,4222.488086
26135,721440633,02-02-24 11:28,101.03,Purchase,Home Improvement,4121.458086
26136,721440633,02-03-24 21:28,176.67,OutgoingTransfer,International Transfer,3944.788086
26137,721440633,02-04-24 22:28,126.15,Withdrawal,Mobile App Withdrawal,3818.638086
26138,721440633,02-05-24 16:28,27.96,OutgoingTransfer,Bank Transfer,3790.678086
26139,721440633,02-06-24 21:28,1000,Payment,Credit Card Payment,2790.678086
26140,721440633,02-08-24 14:28,220.74,Purchase,Travel,2569.938086
26141,721440633,02-12-24 13:28,65.56,Deposit,Mobile Deposit,2635.498086
26142,721440633,2-13-24 21:28,1300,Payment,Installment Payment,1335.498086
26143,721440633,2-22-24 15:28,232.56,Payment,Bill Payment,1102.938086
26144,721440633,2-22-24 23:28,10.99,OutgoingTransfer,Wire Transfer,1091.948086
26145,721440633,03-01-24 12:28,172.05,Return,eBay Return,1263.998086
26146,721440633,03-02-24 10:28,82.05,Deposit,Mobile Deposit,1346.048086
26147,721440633,03-03-24 15:28,33.73,OnlineShopping,Best Buy,1312.318086
26148,721440633,03-03-24 16:28,117.88,Deposit,Check Deposit,1430.198086
26149,721440633,03-04-24 21:28,3050,IncomingTransfer,Salary,4480.198086
26150,721440633,03-09-24 21:28,1100,Payment,Credit Card Payment,3380.198086
26151,721440633,03-10-24 11:28,199.38,Withdrawal,ATM Withdrawal,3180.818086
26152,721440633,03-10-24 21:28,1000,Payment,Insurance Payment,2180.818086
26153,721440633,03-11-24 17:28,112.94,Purchase,Electronics,2067.878086
26154,721440633,03-11-24 18:28,58.07,Return,AliExpress Return,2125.948086
26155,721440633,3-15-24 14:28,83.92,Payment,Bill Payment,2042.028086
26156,721440633,3-20-24 23:28,168.43,OutgoingTransfer,Wire Transfer,1873.598086
26157,721440633,3-26-24 10:28,188.48,Purchase,Gas,1685.118086
26158,721440633,04-01-24 14:28,208.31,Withdrawal,ATM Withdrawal,1476.808086
26159,721440633,04-01-24 21:28,3050,IncomingTransfer,Salary,4526.808086
26160,721440633,04-06-24 21:28,1000,Payment,Credit Card Payment,3526.808086
26161,721440633,04-08-24 21:28,47.92,Purchase,Travel,3478.888086
26162,721440633,04-10-24 21:28,87.04,OutgoingTransfer,Bank Transfer,3391.848086
26163,721440633,04-10-24 23:28,109.5,Withdrawal,Branch Withdrawal,3282.348086
26164,721440633,04-12-24 21:28,1200,Payment,Installment Payment,2082.348086
26165,721440633,4-13-24 12:28,100.34,Deposit,Check Deposit,2182.688086
26166,721440633,4-15-24 10:28,203.27,Deposit,Check Deposit,2385.958086
26167,721440633,4-19-24 22:28,205.09,OutgoingTransfer,Wire Transfer,2180.868086
26168,721440633,4-23-24 20:28,95.63,Return,Store Return,2276.498086
26169,721440633,4-26-24 23:28,156.11,Purchase,Travel,2120.388086
26170,721440633,4-27-24 17:28,132.62,Withdrawal,Branch Withdrawal,1987.768086
26171,721440633,4-27-24 20:28,121.05,Withdrawal,Mobile App Withdrawal,1866.718086
26172,721440633,4-30-24 9:28,208.36,Return,Target Return,2075.078086
26173,721440633,05-01-24 9:28,244.77,Purchase,Restaurant,1830.308086
26174,721440633,05-02-24 19:28,157.68,Deposit,Cash Deposit,1987.988086
26175,721440633,05-04-24 21:28,3050,IncomingTransfer,Salary,5037.988086
26176,721440633,05-07-24 9:28,180.28,Deposit,Mobile Deposit,5218.268086
26177,721440633,05-09-24 21:28,1200,Payment,Credit Card Payment,4018.268086
26178,721440633,5-13-24 22:28,186.47,OnlineShopping,Etsy,3831.798086
26179,721440633,5-14-24 21:28,164.6,OnlineShopping,Target,3667.198086
26180,721440633,5-15-24 11:28,159.13,OutgoingTransfer,International Transfer,3508.068086
26181,721440633,5-16-24 16:28,57.57,Return,Walmart Return,3565.638086
26182,721440633,5-17-24 22:28,46.19,Deposit,Mobile Deposit,3611.828086
26183,721440633,5-18-24 21:28,900,Payment,Subscription Payment,2711.828086
26184,721440633,5-19-24 20:28,200.62,Purchase,Gas,2511.208086
26185,721440633,5-21-24 22:28,113.12,Deposit,Direct Deposit,2624.328086
26186,721440633,5-24-24 17:28,43.35,Purchase,Pharmacy,2580.978086
26187,721440633,5-25-24 20:28,61.23,Purchase,Grocery,2519.748086
26188,721440633,5-25-24 20:28,202.6,Withdrawal,ATM Withdrawal,2317.148086
26189,721440633,5-26-24 17:28,209.74,Withdrawal,ATM Withdrawal,2107.408086
26190,721440633,5-29-24 21:28,167.73,OnlineShopping,Amazon,1939.678086
26191,721440633,5-31-24 11:28,107.96,Deposit,Check Deposit,2047.638086
26192,721440633,06-04-24 19:28,21.23,Purchase,Restaurant,2026.408086
26193,721440633,06-04-24 21:28,3050,IncomingTransfer,Salary,5076.408086
26194,721440633,06-06-24 20:28,227.73,Deposit,Mobile Deposit,5304.138086
26195,721440633,06-07-24 18:28,110.53,Return,Best Buy Return,5414.668086
26196,721440633,06-09-24 21:28,1200,Payment,Credit Card Payment,4214.668086
26197,721440633,06-10-24 21:28,147.32,Return,Store Return,4361.988086
26198,721440633,06-11-24 21:28,1400,Payment,Insurance Payment,2961.988086
26199,721440633,06-12-24 15:28,33.49,Deposit,Check Deposit,2995.478086
26200,721440633,6-14-24 9:28,149.91,Withdrawal,ATM Withdrawal,2845.568086
26201,721440633,6-16-24 20:28,118.65,Withdrawal,Branch Withdrawal,2726.918086
26202,721440633,6-17-24 17:28,180.26,Return,AliExpress Return,2907.178086
26203,721440633,6-18-24 15:28,214.13,Withdrawal,ATM Withdrawal,2693.048086
26204,721440633,6-18-24 18:28,115.68,Purchase,Grocery,2577.368086
26205,721440633,6-22-24 21:28,130.85,Withdrawal,Mobile App Withdrawal,2446.518086
26206,721440633,6-23-24 17:28,100.75,OnlineShopping,eBay,2345.768086
26207,721440633,6-24-24 22:28,230.6,Deposit,Direct Deposit,2576.368086
26208,721440633,6-30-24 13:28,43.13,OnlineShopping,Target,2533.238086
26209,721440633,6-30-24 15:28,220.02,OutgoingTransfer,Wire Transfer,2313.218086
26210,721440633,07-01-24 14:28,153.88,Payment,Loan Payment,2159.338086
26211,721440633,07-04-24 14:28,38.62,Payment,Mortgage Payment,2120.718086
26212,721440633,07-05-24 21:28,3050,IncomingTransfer,Salary,5170.718086
26213,721440633,07-08-24 19:28,30.23,Withdrawal,Mobile App Withdrawal,5140.488086
26214,721440633,07-09-24 21:28,151.27,Payment,Mortgage Payment,4989.218086
26215,721440633,07-10-24 21:28,1200,Payment,Credit Card Payment,3789.218086
26216,721440633,7-13-24 21:28,900,Payment,Installment Payment,2889.218086
26217,721440633,7-16-24 18:28,189.55,IncomingTransfer,Freelance Payment,3078.768086
26218,721440633,7-17-24 10:28,109.71,Withdrawal,Branch Withdrawal,2969.058086
26219,721460283,1-23-24 9:28,240.27,OnlineShopping,Etsy,282.8608854
26220,721460283,1-23-24 22:28,99.23,Deposit,Cash Deposit,382.0908854
26221,721460283,1-27-24 18:28,188.02,Purchase,Clothing,194.0708854
26222,721460283,1-31-24 9:28,189.93,OutgoingTransfer,Wire Transfer,4.140885352
26223,721460283,02-04-24 15:28,63.52,Purchase,Home Improvement,-59.37911465
26224,721460283,02-09-24 23:28,68.87,OutgoingTransfer,Peer-to-Peer Transfer,-128.2491146
26225,721460283,2-15-24 11:28,122.92,Payment,Bill Payment,-251.1691146
26226,721460283,2-17-24 14:28,97.1,OnlineShopping,Walmart,-348.2691146
26227,721460283,2-18-24 10:28,190.27,Purchase,Clothing,-538.5391146
26228,721460283,2-18-24 22:28,62.47,Purchase,Entertainment,-601.0091146
26229,721460283,2-23-24 10:28,48.22,Return,eBay Return,-552.7891146
26230,721460283,2-24-24 14:28,146.4,Purchase,Travel,-699.1891146
26231,721460283,03-02-24 20:28,101.19,OutgoingTransfer,Wire Transfer,-800.3791146
26232,721460283,03-04-24 16:28,144.51,Withdrawal,Branch Withdrawal,-944.8891146
26233,721460283,03-05-24 21:28,169.54,Purchase,Home Improvement,-1114.429115
26234,721460283,3-14-24 12:28,192.8,Payment,Loan Payment,-1307.229115
26235,721460283,3-15-24 18:28,59.57,Withdrawal,Mobile App Withdrawal,-1366.799115
26236,721460283,3-20-24 13:28,109.4,Deposit,Mobile Deposit,-1257.399115
26237,721460283,3-26-24 22:28,41.72,Deposit,Direct Deposit,-1215.679115
26238,721460283,3-29-24 12:28,168.53,Payment,Bill Payment,-1384.209115
26239,721460283,3-31-24 20:28,81.83,Deposit,Cash Deposit,-1302.379115
26240,721460283,04-02-24 16:28,159.77,OnlineShopping,Walmart,-1462.149115
26241,721460283,04-10-24 9:28,136.47,Return,Store Return,-1325.679115
26242,721460283,4-14-24 15:28,96.03,Purchase,Furniture,-1421.709115
26243,721460283,4-15-24 13:28,76.64,Purchase,Electronics,-1498.349115
26244,721460283,4-17-24 21:28,102.34,Withdrawal,Mobile App Withdrawal,-1600.689115
26245,721460283,4-17-24 23:28,162.47,Purchase,Travel,-1763.159115
26246,721460283,4-20-24 17:28,55.94,IncomingTransfer,Freelance Payment,-1707.219115
26247,721460283,4-21-24 17:28,56.71,OutgoingTransfer,Peer-to-Peer Transfer,-1763.929115
26248,721460283,4-24-24 12:28,95.43,Return,AliExpress Return,-1668.499115
26249,721460283,4-26-24 14:28,181.87,Deposit,Mobile Deposit,-1486.629115
26250,721460283,4-27-24 19:28,173.25,IncomingTransfer,Freelance Payment,-1313.379115
26251,721460283,05-02-24 13:28,92.6,Payment,Bill Payment,-1405.979115
26252,721460283,05-03-24 15:28,38.69,Payment,Bill Payment,-1444.669115
26253,721460283,5-16-24 17:28,122.37,IncomingTransfer,Freelance Payment,-1322.299115
26254,721460283,5-19-24 13:28,180.35,Purchase,Pharmacy,-1502.649115
26255,721460283,5-20-24 11:28,30.21,Return,Etsy Return,-1472.439115
26256,721460283,5-24-24 14:28,51.05,Purchase,Home Improvement,-1523.489115
26257,721460283,5-24-24 20:28,131.83,Deposit,Direct Deposit,-1391.659115
26258,721460283,5-26-24 21:28,63.41,Purchase,Travel,-1455.069115
26259,721460283,06-06-24 18:28,210.09,Withdrawal,ATM Withdrawal,-1665.159115
26260,721460283,06-10-24 15:28,42.66,Payment,Bill Payment,-1707.819115
26261,721460283,6-21-24 23:28,168.92,Withdrawal,Branch Withdrawal,-1876.739115
26262,721460283,6-25-24 20:28,117.93,Return,Store Return,-1758.809115
26263,721460283,6-26-24 18:28,69.09,Deposit,Mobile Deposit,-1689.719115
26264,721460283,6-30-24 22:28,55.96,Deposit,Cash Deposit,-1633.759115
26265,721460283,07-02-24 16:28,184.99,Purchase,Gas,-1818.749115
26266,721460283,07-03-24 9:28,35.38,Payment,Mortgage Payment,-1854.129115
26267,721460283,7-13-24 13:28,196.21,OnlineShopping,Etsy,-2050.339115
26268,721460283,7-16-24 16:28,120.07,Deposit,Mobile Deposit,-1930.269115
26269,721460283,7-16-24 18:28,240.03,Purchase,Home Improvement,-2170.299115
26270,721486908,1-21-24 11:28,37.11,Deposit,Check Deposit,1896.285634
26271,721486908,1-22-24 19:28,37.69,Payment,Mortgage Payment,1858.595634
26272,721486908,1-27-24 20:28,229.97,OnlineShopping,eBay,1628.625634
26273,721486908,1-28-24 22:28,13.23,Purchase,Furniture,1615.395634
26274,721486908,02-01-24 22:28,72.42,Purchase,Pharmacy,1542.975634
26275,721486908,02-03-24 15:28,66.22,OutgoingTransfer,Bank Transfer,1476.755634
26276,721486908,02-05-24 21:28,2200,IncomingTransfer,Salary,3676.755634
26277,721486908,02-09-24 13:28,109.64,Purchase,Furniture,3567.115634
26278,721486908,02-10-24 11:28,182.77,IncomingTransfer,Freelance Payment,3749.885634
26279,721486908,02-10-24 21:28,2600,Payment,Credit Card Payment,1149.885634
26280,721486908,02-11-24 18:28,101.97,Deposit,Mobile Deposit,1251.855634
26281,721486908,02-11-24 18:28,55.63,Purchase,Entertainment,1196.225634
26282,721486908,02-12-24 21:28,1100,Payment,Rent Payment,96.22563393
26283,721486908,2-16-24 9:28,142.72,Purchase,Electronics,-46.49436607
26284,721486908,2-16-24 18:28,63.39,IncomingTransfer,Freelance Payment,16.89563393
26285,721486908,2-18-24 10:28,68.71,Return,AliExpress Return,85.60563393
26286,721486908,2-22-24 18:28,61.52,Return,Walmart Return,147.1256339
26287,721486908,2-22-24 19:28,51.21,Purchase,Furniture,95.91563393
26288,721486908,2-29-24 9:28,86.56,Payment,Loan Payment,9.355633927
26289,721486908,03-01-24 21:28,2200,IncomingTransfer,Salary,2209.355634
26290,721486908,03-05-24 16:28,129.77,OnlineShopping,Etsy,2079.585634
26291,721486908,03-05-24 18:28,136.94,Payment,Bill Payment,1942.645634
26292,721486908,03-06-24 18:28,21.25,Purchase,Grocery,1921.395634
26293,721486908,03-06-24 21:28,2100,Payment,Credit Card Payment,-178.6043661
26294,721486908,03-08-24 9:28,225.93,Payment,Loan Payment,-404.5343661
26295,721486908,3-14-24 13:28,74.73,Payment,Bill Payment,-479.2643661
26296,721486908,3-15-24 21:28,600,Payment,Rent Payment,-1079.264366
26297,721486908,3-16-24 10:28,187.45,Return,AliExpress Return,-891.8143661
26298,721486908,3-18-24 22:28,189.29,Purchase,Travel,-1081.104366
26299,721486908,3-20-24 16:28,242.09,Return,Best Buy Return,-839.0143661
26300,721486908,3-24-24 10:28,50.31,Deposit,Direct Deposit,-788.7043661
26301,721486908,3-24-24 13:28,98.72,IncomingTransfer,Freelance Payment,-689.9843661
26302,721486908,3-24-24 20:28,150.33,Payment,Mortgage Payment,-840.3143661
26303,721486908,3-29-24 11:28,184.42,Purchase,Travel,-1024.734366
26304,721486908,3-30-24 13:28,247.47,Payment,Mortgage Payment,-1272.204366
26305,721486908,3-30-24 18:28,163.27,OnlineShopping,Etsy,-1435.474366
26306,721486908,3-31-24 14:28,146.87,Withdrawal,Branch Withdrawal,-1582.344366
26307,721486908,04-02-24 21:28,2200,IncomingTransfer,Salary,617.6556339
26308,721486908,04-03-24 14:28,97.64,Purchase,Restaurant,520.0156339
26309,721486908,04-05-24 11:28,137.56,Purchase,Restaurant,382.4556339
26310,721486908,04-05-24 19:28,70.34,OnlineShopping,Target,312.1156339
26311,721486908,04-07-24 21:28,2300,Payment,Credit Card Payment,-1987.884366
26312,721486908,04-10-24 12:28,247.25,Deposit,Mobile Deposit,-1740.634366
26313,721486908,04-12-24 20:28,89.03,Purchase,Restaurant,-1829.664366
26314,721486908,4-13-24 16:28,33.24,Return,Target Return,-1796.424366
26315,721486908,4-16-24 21:28,700,Payment,Rent Payment,-2496.424366
26316,721486908,4-18-24 22:28,188.14,OnlineShopping,Best Buy,-2684.564366
26317,721486908,4-19-24 10:28,36.03,OutgoingTransfer,Wire Transfer,-2720.594366
26318,721486908,4-25-24 12:28,108.51,OnlineShopping,Amazon,-2829.104366
26319,721486908,4-26-24 22:28,44.77,Withdrawal,ATM Withdrawal,-2873.874366
26320,721486908,4-27-24 14:28,52.77,Purchase,Furniture,-2926.644366
26321,721486908,05-03-24 21:28,2200,IncomingTransfer,Salary,-726.6443661
26322,721486908,05-04-24 13:28,145.77,Withdrawal,Mobile App Withdrawal,-872.4143661
26323,721486908,05-07-24 19:28,149.59,Purchase,Clothing,-1022.004366
26324,721486908,05-08-24 16:28,229,Deposit,Mobile Deposit,-793.0043661
26325,721486908,05-08-24 21:28,2200,Payment,Credit Card Payment,-2993.004366
26326,721486908,05-10-24 18:28,147.43,Withdrawal,Branch Withdrawal,-3140.434366
26327,721486908,05-11-24 19:28,168.53,Purchase,Gas,-3308.964366
26328,721486908,5-13-24 22:28,228.89,Withdrawal,Mobile App Withdrawal,-3537.854366
26329,721486908,5-14-24 14:28,54.81,Purchase,Travel,-3592.664366
26330,721486908,5-14-24 21:28,700,Payment,Rent Payment,-4292.664366
26331,721486908,5-16-24 11:28,164.91,OutgoingTransfer,International Transfer,-4457.574366
26332,721486908,06-01-24 10:28,191.6,Payment,Mortgage Payment,-4649.174366
26333,721486908,06-01-24 21:28,2200,IncomingTransfer,Salary,-2449.174366
26334,721486908,06-03-24 23:28,177.62,OnlineShopping,AliExpress,-2626.794366
26335,721486908,06-04-24 21:28,116.51,OnlineShopping,Target,-2743.304366
26336,721486908,06-05-24 12:28,47.2,Return,AliExpress Return,-2696.104366
26337,721486908,06-06-24 21:28,2400,Payment,Credit Card Payment,-5096.104366
26338,721486908,06-07-24 23:28,64.43,Return,Amazon Return,-5031.674366
26339,721486908,06-08-24 19:28,185.41,OutgoingTransfer,Peer-to-Peer Transfer,-5217.084366
26340,721486908,06-10-24 11:28,219.68,Payment,Bill Payment,-5436.764366
26341,721486908,06-12-24 17:28,146.24,IncomingTransfer,Freelance Payment,-5290.524366
26342,721486908,6-14-24 21:28,220.67,Deposit,Mobile Deposit,-5069.854366
26343,721486908,6-17-24 21:28,1400,Payment,Rent Payment,-6469.854366
26344,721486908,6-17-24 22:28,34.68,OnlineShopping,Best Buy,-6504.534366
26345,721486908,6-20-24 22:28,130.28,IncomingTransfer,Freelance Payment,-6374.254366
26346,721486908,6-21-24 15:28,111.92,OutgoingTransfer,Wire Transfer,-6486.174366
26347,721486908,6-23-24 12:28,130.14,Deposit,Check Deposit,-6356.034366
26348,721486908,6-25-24 23:28,57.87,Purchase,Furniture,-6413.904366
26349,721486908,6-28-24 18:28,171.76,OnlineShopping,Amazon,-6585.664366
26350,721486908,07-01-24 20:28,79.07,Payment,Mortgage Payment,-6664.734366
26351,721486908,07-01-24 21:28,2200,IncomingTransfer,Salary,-4464.734366
26352,721486908,07-02-24 17:28,157.6,Purchase,Home Improvement,-4622.334366
26353,721486908,07-03-24 17:28,184.82,Payment,Mortgage Payment,-4807.154366
26354,721486908,07-04-24 16:28,187.14,Purchase,Clothing,-4994.294366
26355,721486908,07-04-24 22:28,213.74,Return,eBay Return,-4780.554366
26356,721486908,07-06-24 21:28,2400,Payment,Credit Card Payment,-7180.554366
26357,721486908,07-09-24 16:28,16.9,OutgoingTransfer,Wire Transfer,-7197.454366
26358,721486908,07-09-24 20:28,74.32,OnlineShopping,AliExpress,-7271.774366
26359,721486908,07-12-24 20:28,234.25,Return,Amazon Return,-7037.524366
26360,721486908,07-12-24 23:28,106.38,Purchase,Travel,-7143.904366
26361,721486908,7-16-24 11:28,205.29,Return,Amazon Return,-6938.614366
26362,721486908,7-16-24 21:28,1000,Payment,Rent Payment,-7938.614366
26363,735825258,1-22-24 19:28,90.88,OnlineShopping,AliExpress,806.3562637
26364,735825258,1-23-24 18:28,237.33,Withdrawal,ATM Withdrawal,569.0262637
26365,735825258,1-24-24 14:28,175.27,Purchase,Clothing,393.7562637
26366,735825258,1-26-24 9:28,195.05,OutgoingTransfer,International Transfer,198.7062637
26367,735825258,1-29-24 9:28,50.56,Withdrawal,ATM Withdrawal,148.1462637
26368,735825258,1-30-24 10:28,61.68,OnlineShopping,Etsy,86.46626373
26369,735825258,1-31-24 21:28,113.84,Withdrawal,Branch Withdrawal,-27.37373627
26370,735825258,02-02-24 21:28,12.21,Withdrawal,Mobile App Withdrawal,-39.58373627
26371,735825258,02-03-24 18:28,66.35,Payment,Loan Payment,-105.9337363
26372,735825258,02-03-24 21:28,2000,IncomingTransfer,Salary,1894.066264
26373,735825258,02-04-24 21:28,133.13,Withdrawal,Mobile App Withdrawal,1760.936264
26374,735825258,02-05-24 20:28,29.31,Purchase,Travel,1731.626264
26375,735825258,02-05-24 22:28,44.03,OnlineShopping,AliExpress,1687.596264
26376,735825258,02-07-24 15:28,80.31,Withdrawal,ATM Withdrawal,1607.286264
26377,735825258,02-07-24 21:28,54.14,Payment,Loan Payment,1553.146264
26378,735825258,02-08-24 16:28,70.13,Deposit,Direct Deposit,1623.276264
26379,735825258,02-08-24 21:28,2400,Payment,Credit Card Payment,-776.7237363
26380,735825258,02-11-24 21:28,700,Payment,Rent Payment,-1476.723736
26381,735825258,02-12-24 12:28,170.72,Deposit,Check Deposit,-1306.003736
26382,735825258,2-14-24 12:28,177.48,Deposit,Direct Deposit,-1128.523736
26383,735825258,2-16-24 16:28,91.37,Deposit,Cash Deposit,-1037.153736
26384,735825258,2-19-24 14:28,225.69,Return,AliExpress Return,-811.4637363
26385,735825258,2-19-24 19:28,143.2,Withdrawal,Branch Withdrawal,-954.6637363
26386,735825258,2-20-24 20:28,206.86,OutgoingTransfer,Bank Transfer,-1161.523736
26387,735825258,2-21-24 14:28,154.45,Withdrawal,ATM Withdrawal,-1315.973736
26388,735825258,2-21-24 18:28,212.51,Return,Target Return,-1103.463736
26389,735825258,2-23-24 22:28,36.13,Withdrawal,ATM Withdrawal,-1139.593736
26390,735825258,2-24-24 11:28,158,OnlineShopping,Target,-1297.593736
26391,735825258,2-29-24 10:28,90.15,Withdrawal,ATM Withdrawal,-1387.743736
26392,735825258,2-29-24 15:28,146.25,OutgoingTransfer,Bank Transfer,-1533.993736
26393,735825258,03-03-24 15:28,218.69,Withdrawal,Branch Withdrawal,-1752.683736
26394,735825258,03-03-24 20:28,210.39,Payment,Loan Payment,-1963.073736
26395,735825258,03-04-24 16:28,131.75,Withdrawal,Branch Withdrawal,-2094.823736
26396,735825258,03-04-24 22:28,20.45,Purchase,Clothing,-2115.273736
26397,735825258,03-05-24 21:28,2000,IncomingTransfer,Salary,-115.2737363
26398,735825258,03-06-24 11:28,158.38,Purchase,Furniture,-273.6537363
26399,735825258,03-07-24 22:28,13.02,Deposit,Mobile Deposit,-260.6337363
26400,735825258,03-08-24 18:28,52.48,Deposit,Direct Deposit,-208.1537363
26401,735825258,03-09-24 13:28,96.83,Deposit,Check Deposit,-111.3237363
26402,735825258,03-10-24 10:28,85.23,OutgoingTransfer,Peer-to-Peer Transfer,-196.5537363
26403,735825258,03-10-24 21:28,2200,Payment,Credit Card Payment,-2396.553736
26404,735825258,03-10-24 21:28,700,Payment,Rent Payment,-3096.553736
26405,735825258,03-12-24 9:28,24.76,Purchase,Gas,-3121.313736
26406,735825258,03-12-24 11:28,233.08,IncomingTransfer,Freelance Payment,-2888.233736
26407,735825258,3-13-24 12:28,215.52,Return,Target Return,-2672.713736
26408,735825258,3-13-24 21:28,119.27,OutgoingTransfer,International Transfer,-2791.983736
26409,735825258,3-15-24 10:28,228.38,Purchase,Electronics,-3020.363736
26410,735825258,3-16-24 13:28,145.12,Purchase,Entertainment,-3165.483736
26411,735825258,3-16-24 19:28,140.67,Purchase,Grocery,-3306.153736
26412,735825258,3-16-24 21:28,211.2,OnlineShopping,Target,-3517.353736
26413,735825258,3-18-24 20:28,189.67,Withdrawal,ATM Withdrawal,-3707.023736
26414,735825258,3-24-24 12:28,32.83,Withdrawal,Mobile App Withdrawal,-3739.853736
26415,735825258,3-24-24 18:28,167.46,IncomingTransfer,Freelance Payment,-3572.393736
26416,735825258,3-25-24 22:28,56.16,Deposit,Direct Deposit,-3516.233736
26417,735825258,3-27-24 12:28,151.01,Deposit,Mobile Deposit,-3365.223736
26418,735825258,04-03-24 21:28,2000,IncomingTransfer,Salary,-1365.223736
26419,735825258,04-05-24 18:28,54.71,Deposit,Mobile Deposit,-1310.513736
26420,735825258,04-07-24 10:28,159.73,Return,Target Return,-1150.783736
26421,735825258,04-08-24 21:28,1800,Payment,Credit Card Payment,-2950.783736
26422,735825258,04-11-24 12:28,83.01,Deposit,Check Deposit,-2867.773736
26423,735825258,04-12-24 10:28,169.24,Payment,Loan Payment,-3037.013736
26424,735825258,4-13-24 10:28,231.9,Purchase,Grocery,-3268.913736
26425,735825258,4-16-24 14:28,45.96,Purchase,Grocery,-3314.873736
26426,735825258,4-16-24 19:28,200.92,Payment,Bill Payment,-3515.793736
26427,735825258,4-17-24 21:28,1200,Payment,Rent Payment,-4715.793736
26428,735825258,4-18-24 9:28,230.43,Payment,Loan Payment,-4946.223736
26429,735825258,4-18-24 16:28,71.11,Withdrawal,Mobile App Withdrawal,-5017.333736
26430,735825258,4-19-24 21:28,22.76,Purchase,Entertainment,-5040.093736
26431,735825258,4-23-24 23:28,38.56,Purchase,Travel,-5078.653736
26432,735825258,4-25-24 14:28,199.4,Return,Walmart Return,-4879.253736
26433,735825258,4-27-24 11:28,239.22,Payment,Mortgage Payment,-5118.473736
26434,735825258,4-28-24 10:28,96.41,Return,AliExpress Return,-5022.063736
26435,735825258,4-30-24 11:28,194.37,Purchase,Clothing,-5216.433736
26436,735825258,05-02-24 15:28,68.65,Deposit,Cash Deposit,-5147.783736
26437,735825258,05-02-24 21:28,214.81,Deposit,Check Deposit,-4932.973736
26438,735825258,05-03-24 21:28,2000,IncomingTransfer,Salary,-2932.973736
26439,735825258,05-04-24 17:28,223.16,Deposit,Cash Deposit,-2709.813736
26440,735825258,05-04-24 19:28,18.04,Purchase,Clothing,-2727.853736
26441,735825258,05-05-24 16:28,170.29,Payment,Mortgage Payment,-2898.143736
26442,735825258,05-08-24 21:28,2400,Payment,Credit Card Payment,-5298.143736
26443,735825258,05-09-24 15:28,158.96,Deposit,Check Deposit,-5139.183736
26444,735825258,05-10-24 23:28,25.54,Purchase,Home Improvement,-5164.723736
26445,735825258,05-11-24 21:28,1000,Payment,Rent Payment,-6164.723736
26446,735825258,5-13-24 23:28,143.87,Return,Target Return,-6020.853736
26447,735825258,5-16-24 10:28,17.74,Withdrawal,Mobile App Withdrawal,-6038.593736
26448,735825258,5-17-24 16:28,88.53,Purchase,Gas,-6127.123736
26449,735825258,5-19-24 11:28,165.31,OnlineShopping,AliExpress,-6292.433736
26450,735825258,5-21-24 13:28,224.96,Deposit,Cash Deposit,-6067.473736
26451,735825258,5-23-24 12:28,79.23,Deposit,Mobile Deposit,-5988.243736
26452,735825258,5-25-24 15:28,184.58,IncomingTransfer,Freelance Payment,-5803.663736
26453,735825258,5-26-24 15:28,109.56,OutgoingTransfer,Wire Transfer,-5913.223736
26454,735825258,5-26-24 19:28,76.41,OutgoingTransfer,Peer-to-Peer Transfer,-5989.633736
26455,735825258,5-27-24 14:28,59.62,Payment,Loan Payment,-6049.253736
26456,735825258,5-28-24 9:28,187.72,Withdrawal,Mobile App Withdrawal,-6236.973736
26457,735825258,5-30-24 19:28,84.67,Payment,Bill Payment,-6321.643736
26458,735825258,5-30-24 21:28,179.5,Purchase,Furniture,-6501.143736
26459,735825258,5-31-24 13:28,239.74,OnlineShopping,Amazon,-6740.883736
26460,735825258,5-31-24 14:28,32.45,OutgoingTransfer,Bank Transfer,-6773.333736
26461,735825258,06-03-24 13:28,215.88,Withdrawal,ATM Withdrawal,-6989.213736
26462,735825258,06-03-24 21:28,13.9,Return,Etsy Return,-6975.313736
26463,735825258,06-04-24 21:28,2000,IncomingTransfer,Salary,-4975.313736
26464,735825258,06-06-24 19:28,112.49,Payment,Loan Payment,-5087.803736
26465,735825258,06-08-24 13:28,136.72,Withdrawal,Branch Withdrawal,-5224.523736
26466,735825258,06-09-24 21:28,2400,Payment,Credit Card Payment,-7624.523736
26467,735825258,06-10-24 9:28,86.28,Deposit,Direct Deposit,-7538.243736
26468,735825258,6-13-24 13:28,209.91,Deposit,Cash Deposit,-7328.333736
26469,735825258,6-13-24 21:28,600,Payment,Rent Payment,-7928.333736
26470,735825258,6-14-24 18:28,192.12,IncomingTransfer,Freelance Payment,-7736.213736
26471,735825258,6-17-24 18:28,58.57,Purchase,Home Improvement,-7794.783736
26472,735825258,6-18-24 23:28,190.86,Purchase,Electronics,-7985.643736
26473,735825258,6-21-24 22:28,233.67,OnlineShopping,Target,-8219.313736
26474,735825258,6-22-24 12:28,198.05,Purchase,Gas,-8417.363736
26475,735825258,6-24-24 22:28,112.14,OnlineShopping,AliExpress,-8529.503736
26476,735825258,6-25-24 12:28,75.08,Return,Best Buy Return,-8454.423736
26477,735825258,6-25-24 18:28,30.44,Withdrawal,Branch Withdrawal,-8484.863736
26478,735825258,6-26-24 21:28,192.84,IncomingTransfer,Freelance Payment,-8292.023736
26479,735825258,6-28-24 22:28,51.32,OutgoingTransfer,Bank Transfer,-8343.343736
26480,735825258,07-02-24 22:28,93.11,Return,AliExpress Return,-8250.233736
26481,735825258,07-04-24 14:28,236.95,Deposit,Check Deposit,-8013.283736
26482,735825258,07-04-24 15:28,180.96,Purchase,Entertainment,-8194.243736
26483,735825258,07-04-24 21:28,2000,IncomingTransfer,Salary,-6194.243736
26484,735825258,07-04-24 21:28,194.64,Payment,Bill Payment,-6388.883736
26485,735825258,07-09-24 9:28,227.21,OutgoingTransfer,Bank Transfer,-6616.093736
26486,735825258,07-09-24 14:28,134.82,Deposit,Cash Deposit,-6481.273736
26487,735825258,07-09-24 18:28,31.58,OnlineShopping,Best Buy,-6512.853736
26488,735825258,07-09-24 21:28,1800,Payment,Credit Card Payment,-8312.853736
26489,735825258,07-10-24 11:28,195.92,OnlineShopping,Best Buy,-8508.773736
26490,735825258,07-11-24 21:28,900,Payment,Rent Payment,-9408.773736
26491,735825258,07-12-24 9:28,175.3,Payment,Bill Payment,-9584.073736
26492,735825258,7-13-24 16:28,42.49,Deposit,Mobile Deposit,-9541.583736
26493,737933883,1-20-24 11:28,171.64,OnlineShopping,Etsy,1591.488406
26494,737933883,1-23-24 19:28,243.82,Purchase,Entertainment,1347.668406
26495,737933883,1-26-24 11:28,528.79,OnlineShopping,eBay,818.8784063
26496,737933883,1-30-24 20:28,200.11,Withdrawal,Branch Withdrawal,618.7684063
26497,737933883,02-05-24 21:28,5650,IncomingTransfer,Salary,6268.768406
26498,737933883,02-06-24 9:28,521.55,Payment,Loan Payment,5747.218406
26499,737933883,02-06-24 13:28,264.98,Deposit,Direct Deposit,6012.198406
26500,737933883,02-06-24 19:28,284.22,OutgoingTransfer,Wire Transfer,5727.978406
26501,737933883,02-07-24 20:28,144.79,Deposit,Cash Deposit,5872.768406
26502,737933883,02-10-24 16:28,301.9,OutgoingTransfer,Wire Transfer,5570.868406
26503,737933883,02-10-24 21:28,3000,Payment,Credit Card Payment,2570.868406
26504,737933883,02-12-24 17:28,419.59,Deposit,Mobile Deposit,2990.458406
26505,737933883,2-17-24 21:28,2600,Payment,Rent Payment,390.4584063
26506,737933883,2-22-24 15:28,525.77,Withdrawal,ATM Withdrawal,-135.3115937
26507,737933883,2-22-24 20:28,325.56,OutgoingTransfer,Peer-to-Peer Transfer,-460.8715937
26508,737933883,2-26-24 17:28,234.81,Purchase,Electronics,-695.6815937
26509,737933883,03-03-24 12:28,519.09,Purchase,Travel,-1214.771594
26510,737933883,03-04-24 20:28,514.17,Purchase,Clothing,-1728.941594
26511,737933883,03-05-24 17:28,436.64,Deposit,Check Deposit,-1292.301594
26512,737933883,03-05-24 21:28,5650,IncomingTransfer,Salary,4357.698406
26513,737933883,03-10-24 21:28,2500,Payment,Credit Card Payment,1857.698406
26514,737933883,03-12-24 23:28,166.7,OutgoingTransfer,Peer-to-Peer Transfer,1690.998406
26515,737933883,3-15-24 19:28,254.81,Return,eBay Return,1945.808406
26516,737933883,3-15-24 21:28,2600,Payment,Rent Payment,-654.1915937
26517,737933883,3-20-24 16:28,216.53,Purchase,Clothing,-870.7215937
26518,737933883,3-27-24 13:28,434.22,Purchase,Electronics,-1304.941594
26519,737933883,3-29-24 16:28,216.41,Deposit,Check Deposit,-1088.531594
26520,737933883,04-02-24 21:28,5650,IncomingTransfer,Salary,4561.468406
26521,737933883,04-04-24 22:28,116.12,IncomingTransfer,Freelance Payment,4677.588406
26522,737933883,04-07-24 15:28,208.21,Purchase,Pharmacy,4469.378406
26523,737933883,04-07-24 21:28,2500,Payment,Credit Card Payment,1969.378406
26524,737933883,04-09-24 20:28,81.84,Deposit,Cash Deposit,2051.218406
26525,737933883,4-16-24 11:28,226.23,Payment,Loan Payment,1824.988406
26526,737933883,4-16-24 21:28,2800,Payment,Rent Payment,-975.0115937
26527,737933883,4-17-24 13:28,317.71,Purchase,Clothing,-1292.721594
26528,737933883,4-26-24 19:28,63.24,Deposit,Mobile Deposit,-1229.481594
26529,737933883,4-29-24 14:28,411.19,Purchase,Restaurant,-1640.671594
26530,737933883,05-04-24 21:28,5650,IncomingTransfer,Salary,4009.328406
26531,737933883,05-04-24 21:28,507.88,Payment,Bill Payment,3501.448406
26532,737933883,05-06-24 21:28,124.35,Withdrawal,Mobile App Withdrawal,3377.098406
26533,737933883,05-09-24 21:28,2600,Payment,Credit Card Payment,777.0984063
26534,737933883,05-10-24 14:28,197.45,Withdrawal,Branch Withdrawal,579.6484063
26535,737933883,5-13-24 17:28,389.07,Return,Store Return,968.7184063
26536,737933883,5-17-24 14:28,513.88,Return,Store Return,1482.598406
26537,737933883,5-17-24 21:28,1500,Payment,Rent Payment,-17.40159366
26538,737933883,5-19-24 20:28,135.93,Purchase,Grocery,-153.3315937
26539,737933883,5-21-24 17:28,244.12,OnlineShopping,Walmart,-397.4515937
26540,737933883,5-23-24 12:28,100.52,OutgoingTransfer,Bank Transfer,-497.9715937
26541,737933883,5-30-24 12:28,482.83,Withdrawal,Mobile App Withdrawal,-980.8015937
26542,737933883,06-04-24 21:28,5650,IncomingTransfer,Salary,4669.198406
26543,737933883,06-06-24 22:28,145.29,Purchase,Pharmacy,4523.908406
26544,737933883,06-09-24 21:28,2300,Payment,Credit Card Payment,2223.908406
26545,737933883,06-12-24 15:28,283.95,Payment,Mortgage Payment,1939.958406
26546,737933883,6-13-24 21:28,1600,Payment,Rent Payment,339.9584063
26547,737933883,6-20-24 13:28,320.19,Withdrawal,Branch Withdrawal,19.76840634
26548,737933883,6-26-24 18:28,481.07,Return,AliExpress Return,500.8384063
26549,737933883,6-28-24 22:28,479.23,Deposit,Check Deposit,980.0684063
26550,737933883,6-30-24 17:28,481.99,Deposit,Cash Deposit,1462.058406
26551,737933883,07-02-24 21:28,5650,IncomingTransfer,Salary,7112.058406
26552,737933883,07-06-24 21:28,126.83,Deposit,Direct Deposit,7238.888406
26553,737933883,07-07-24 17:28,246.97,Deposit,Direct Deposit,7485.858406
26554,737933883,07-07-24 21:28,2300,Payment,Credit Card Payment,5185.858406
26555,737933883,07-10-24 9:28,219.4,IncomingTransfer,Freelance Payment,5405.258406
26556,737933883,07-11-24 13:28,280.94,Payment,Loan Payment,5124.318406
26557,737933883,07-12-24 10:28,118.58,OnlineShopping,Amazon,5005.738406
26558,737933883,07-12-24 16:28,315.67,OutgoingTransfer,Wire Transfer,4690.068406
26559,737933883,7-16-24 21:28,2900,Payment,Rent Payment,1790.068406
26560,745124658,1-30-24 17:28,138.38,OnlineShopping,Walmart,1130.828938
26561,745124658,1-31-24 15:28,63.33,Withdrawal,Branch Withdrawal,1067.498938
26562,745124658,02-04-24 22:28,37.29,Payment,Mortgage Payment,1030.208938
26563,745124658,02-05-24 21:28,2750,IncomingTransfer,Salary,3780.208938
26564,745124658,02-10-24 21:28,1900,Payment,Credit Card Payment,1880.208938
26565,745124658,2-15-24 19:28,199.57,OutgoingTransfer,Wire Transfer,1680.638938
26566,745124658,2-18-24 15:28,185.93,OutgoingTransfer,International Transfer,1494.708938
26567,745124658,2-18-24 21:28,1200,Payment,Rent Payment,294.7089384
26568,745124658,2-22-24 16:28,142.54,OutgoingTransfer,Wire Transfer,152.1689384
26569,745124658,2-22-24 17:28,193.86,Payment,Loan Payment,-41.69106163
26570,745124658,2-25-24 11:28,212.2,OutgoingTransfer,International Transfer,-253.8910616
26571,745124658,2-25-24 15:28,235.72,Purchase,Grocery,-489.6110616
26572,745124658,2-28-24 12:28,132.53,OnlineShopping,AliExpress,-622.1410616
26573,745124658,2-29-24 23:28,200.98,Payment,Mortgage Payment,-823.1210616
26574,745124658,03-02-24 10:28,114.81,Purchase,Pharmacy,-937.9310616
26575,745124658,03-04-24 10:28,56.27,Return,Best Buy Return,-881.6610616
26576,745124658,03-04-24 16:28,34.66,Deposit,Direct Deposit,-847.0010616
26577,745124658,03-04-24 21:28,2750,IncomingTransfer,Salary,1902.998938
26578,745124658,03-09-24 21:28,2300,Payment,Credit Card Payment,-397.0010616
26579,745124658,03-11-24 11:28,139.71,Withdrawal,Mobile App Withdrawal,-536.7110616
26580,745124658,03-11-24 19:28,173.47,Purchase,Home Improvement,-710.1810616
26581,745124658,3-15-24 19:28,61.04,Return,Amazon Return,-649.1410616
26582,745124658,3-16-24 10:28,38.04,Payment,Bill Payment,-687.1810616
26583,745124658,3-17-24 17:28,226.46,Payment,Bill Payment,-913.6410616
26584,745124658,3-18-24 16:28,240.53,Payment,Mortgage Payment,-1154.171062
26585,745124658,3-18-24 21:28,1500,Payment,Rent Payment,-2654.171062
26586,745124658,3-19-24 17:28,200.97,Payment,Mortgage Payment,-2855.141062
26587,745124658,3-20-24 10:28,37.62,IncomingTransfer,Freelance Payment,-2817.521062
26588,745124658,04-01-24 19:28,155.75,Purchase,Furniture,-2973.271062
26589,745124658,04-03-24 18:28,177.77,Withdrawal,Mobile App Withdrawal,-3151.041062
26590,745124658,04-04-24 10:28,80.61,OnlineShopping,Walmart,-3231.651062
26591,745124658,04-04-24 21:28,2750,IncomingTransfer,Salary,-481.6510616
26592,745124658,04-06-24 13:28,145.61,IncomingTransfer,Freelance Payment,-336.0410616
26593,745124658,04-06-24 19:28,78.73,Return,Target Return,-257.3110616
26594,745124658,04-07-24 17:28,37.31,Withdrawal,ATM Withdrawal,-294.6210616
26595,745124658,04-09-24 21:28,1900,Payment,Credit Card Payment,-2194.621062
26596,745124658,04-11-24 21:28,800,Payment,Rent Payment,-2994.621062
26597,745124658,4-13-24 11:28,122.79,Return,AliExpress Return,-2871.831062
26598,745124658,4-14-24 11:28,216.97,Purchase,Pharmacy,-3088.801062
26599,745124658,4-14-24 22:28,28.39,Purchase,Furniture,-3117.191062
26600,745124658,4-19-24 9:28,19.68,Withdrawal,Branch Withdrawal,-3136.871062
26601,745124658,4-20-24 10:28,117.23,OnlineShopping,Best Buy,-3254.101062
26602,745124658,4-20-24 13:28,231.24,Withdrawal,ATM Withdrawal,-3485.341062
26603,745124658,4-21-24 19:28,164.51,Deposit,Direct Deposit,-3320.831062
26604,745124658,4-22-24 19:28,120.93,Withdrawal,ATM Withdrawal,-3441.761062
26605,745124658,4-28-24 10:28,113.32,Payment,Mortgage Payment,-3555.081062
26606,745124658,05-01-24 21:28,79.75,Deposit,Cash Deposit,-3475.331062
26607,745124658,05-02-24 21:28,2750,IncomingTransfer,Salary,-725.3310616
26608,745124658,05-04-24 20:28,67.11,OnlineShopping,Target,-792.4410616
26609,745124658,05-06-24 11:28,163.4,OutgoingTransfer,International Transfer,-955.8410616
26610,745124658,05-07-24 21:28,1600,Payment,Credit Card Payment,-2555.841062
26611,745124658,05-11-24 16:28,81.45,Purchase,Clothing,-2637.291062
26612,745124658,05-12-24 12:28,225.65,Purchase,Gas,-2862.941062
26613,745124658,05-12-24 21:28,900,Payment,Rent Payment,-3762.941062
26614,745124658,5-16-24 23:28,225.3,Purchase,Grocery,-3988.241062
26615,745124658,5-17-24 20:28,208.29,Purchase,Pharmacy,-4196.531062
26616,745124658,5-18-24 21:28,197.94,Payment,Mortgage Payment,-4394.471062
26617,745124658,5-21-24 13:28,235.17,Purchase,Grocery,-4629.641062
26618,745124658,5-22-24 19:28,197.31,Purchase,Grocery,-4826.951062
26619,745124658,5-26-24 15:28,160.6,Deposit,Cash Deposit,-4666.351062
26620,745124658,5-29-24 12:28,96.28,Purchase,Travel,-4762.631062
26621,745124658,06-04-24 21:28,2750,IncomingTransfer,Salary,-2012.631062
26622,745124658,06-05-24 11:28,161.23,Deposit,Cash Deposit,-1851.401062
26623,745124658,06-05-24 13:28,66.8,Purchase,Travel,-1918.201062
26624,745124658,06-09-24 19:28,185.02,Withdrawal,Mobile App Withdrawal,-2103.221062
26625,745124658,06-09-24 21:28,1600,Payment,Credit Card Payment,-3703.221062
26626,745124658,06-10-24 21:28,199.19,Purchase,Gas,-3902.411062
26627,745124658,6-13-24 16:28,84.55,Purchase,Grocery,-3986.961062
26628,745124658,6-15-24 21:28,1100,Payment,Rent Payment,-5086.961062
26629,745124658,6-17-24 13:28,101.53,OutgoingTransfer,Wire Transfer,-5188.491062
26630,745124658,6-18-24 16:28,80.56,IncomingTransfer,Freelance Payment,-5107.931062
26631,745124658,6-19-24 15:28,75.4,OutgoingTransfer,Bank Transfer,-5183.331062
26632,745124658,6-23-24 17:28,55.94,Return,AliExpress Return,-5127.391062
26633,745124658,6-24-24 23:28,34.85,Purchase,Restaurant,-5162.241062
26634,745124658,6-25-24 13:28,236.54,Purchase,Grocery,-5398.781062
26635,745124658,6-27-24 19:28,142.46,Deposit,Mobile Deposit,-5256.321062
26636,745124658,6-29-24 11:28,176.31,OnlineShopping,Target,-5432.631062
26637,745124658,6-29-24 11:28,21.63,Deposit,Cash Deposit,-5411.001062
26638,745124658,07-04-24 21:28,2750,IncomingTransfer,Salary,-2661.001062
26639,745124658,07-05-24 10:28,92.77,OnlineShopping,Amazon,-2753.771062
26640,745124658,07-05-24 20:28,90.16,Deposit,Mobile Deposit,-2663.611062
26641,745124658,07-08-24 15:28,157.68,Withdrawal,Branch Withdrawal,-2821.291062
26642,745124658,07-09-24 11:28,30.82,Purchase,Entertainment,-2852.111062
26643,745124658,07-09-24 21:28,1800,Payment,Credit Card Payment,-4652.111062
26644,745124658,07-11-24 17:28,185.36,OutgoingTransfer,Wire Transfer,-4837.471062
26645,745124658,7-16-24 21:28,1000,Payment,Rent Payment,-5837.471062
26646,745124658,7-16-24 21:28,98.82,OnlineShopping,AliExpress,-5936.291062
26647,745124658,7-17-24 14:28,127.62,Deposit,Mobile Deposit,-5808.671062
26648,745853283,1-20-24 19:28,163.3,IncomingTransfer,Freelance Payment,163.3
26649,745853283,1-21-24 18:28,302.01,IncomingTransfer,Freelance Payment,465.31
26650,745853283,1-24-24 12:28,96.44,Deposit,Direct Deposit,561.75
26651,745853283,1-25-24 15:28,469.17,IncomingTransfer,Freelance Payment,1030.92
26652,745853283,1-27-24 14:28,133.78,Withdrawal,Mobile App Withdrawal,897.14
26653,745853283,1-31-24 13:28,163.98,Deposit,Cash Deposit,1061.12
26654,745853283,02-03-24 20:28,30.32,OnlineShopping,Walmart,1030.8
26655,745853283,02-03-24 21:28,3800,IncomingTransfer,Salary,4830.8
26656,745853283,02-06-24 15:28,272.93,Withdrawal,Mobile App Withdrawal,4557.87
26657,745853283,02-07-24 20:28,198.42,OnlineShopping,Target,4359.45
26658,745853283,02-08-24 23:28,442.06,Purchase,Clothing,3917.39
26659,745853283,02-10-24 22:28,124.14,Return,Store Return,4041.53
26660,745853283,2-16-24 14:28,417.5,OutgoingTransfer,International Transfer,3624.03
26661,745853283,2-16-24 21:28,1300,Payment,Rent Payment,2324.03
26662,745853283,2-19-24 18:28,245.96,IncomingTransfer,Freelance Payment,2569.99
26663,745853283,2-20-24 23:28,452.73,Deposit,Direct Deposit,3022.72
26664,745853283,2-25-24 15:28,26.95,Payment,Mortgage Payment,2995.77
26665,745853283,2-27-24 16:28,303.99,OnlineShopping,Amazon,2691.78
26666,745853283,03-01-24 21:28,3800,IncomingTransfer,Salary,6491.78
26667,745853283,03-03-24 22:28,73.86,IncomingTransfer,Freelance Payment,6565.64
26668,745853283,03-10-24 13:28,335.4,Deposit,Cash Deposit,6901.04
26669,745853283,03-10-24 13:28,359.3,Purchase,Restaurant,6541.74
26670,745853283,03-11-24 19:28,268.87,Purchase,Gas,6272.87
26671,745853283,03-12-24 16:28,143.94,Purchase,Grocery,6128.93
26672,745853283,03-12-24 21:28,1200,Payment,Rent Payment,4928.93
26673,745853283,3-13-24 18:28,287.87,Withdrawal,Mobile App Withdrawal,4641.06
26674,745853283,3-14-24 13:28,325.08,OnlineShopping,Amazon,4315.98
26675,745853283,3-15-24 11:28,455.8,Return,Walmart Return,4771.78
26676,745853283,3-16-24 18:28,396.28,Payment,Loan Payment,4375.5
26677,745853283,3-18-24 18:28,154.01,OutgoingTransfer,Wire Transfer,4221.49
26678,745853283,3-19-24 22:28,191.17,Deposit,Direct Deposit,4412.66
26679,745853283,3-21-24 20:28,148.47,Payment,Bill Payment,4264.19
26680,745853283,3-21-24 23:28,289.72,Deposit,Cash Deposit,4553.91
26681,745853283,3-25-24 18:28,417,Withdrawal,Branch Withdrawal,4136.91
26682,745853283,3-31-24 11:28,308,IncomingTransfer,Freelance Payment,4444.91
26683,745853283,04-01-24 13:28,475.84,Withdrawal,Mobile App Withdrawal,3969.07
26684,745853283,04-02-24 11:28,378.25,Withdrawal,Mobile App Withdrawal,3590.82
26685,745853283,04-02-24 15:28,380.02,OnlineShopping,Etsy,3210.8
26686,745853283,04-05-24 21:28,3800,IncomingTransfer,Salary,7010.8
26687,745853283,04-06-24 13:28,364.2,Deposit,Check Deposit,7375
26688,745853283,04-06-24 17:28,489.03,Purchase,Clothing,6885.97
26689,745853283,04-07-24 13:28,495.67,Deposit,Cash Deposit,7381.64
26690,745853283,04-07-24 14:28,27.87,Deposit,Check Deposit,7409.51
26691,745853283,04-07-24 19:28,192.14,Purchase,Clothing,7217.37
26692,745853283,04-08-24 15:28,146.59,Withdrawal,Mobile App Withdrawal,7070.78
26693,745853283,4-14-24 16:28,85.13,OutgoingTransfer,Peer-to-Peer Transfer,6985.65
26694,745853283,4-18-24 21:28,1600,Payment,Rent Payment,5385.65
26695,745853283,4-20-24 17:28,409.02,Deposit,Cash Deposit,5794.67
26696,745853283,4-20-24 19:28,416.46,Withdrawal,Mobile App Withdrawal,5378.21
26697,745853283,4-21-24 12:28,271.91,OnlineShopping,Target,5106.3
26698,745853283,4-21-24 21:28,334.57,Deposit,Check Deposit,5440.87
26699,745853283,4-22-24 9:28,203.07,OnlineShopping,Best Buy,5237.8
26700,745853283,4-22-24 23:28,427.49,Payment,Mortgage Payment,4810.31
26701,745853283,4-23-24 10:28,181.95,Deposit,Check Deposit,4992.26
26702,745853283,4-24-24 19:28,425.34,Purchase,Furniture,4566.92
26703,745853283,05-01-24 11:28,78.5,Return,Best Buy Return,4645.42
26704,745853283,05-03-24 15:28,339.64,OutgoingTransfer,Wire Transfer,4305.78
26705,745853283,05-03-24 21:28,3800,IncomingTransfer,Salary,8105.78
26706,745853283,05-06-24 19:28,383.5,Deposit,Mobile Deposit,8489.28
26707,745853283,05-10-24 17:28,192.31,Withdrawal,Branch Withdrawal,8296.97
26708,745853283,05-10-24 21:28,1300,Payment,Rent Payment,6996.97
26709,745853283,05-11-24 11:28,366.17,Payment,Loan Payment,6630.8
26710,745853283,5-13-24 18:28,98.95,Deposit,Cash Deposit,6729.75
26711,745853283,5-13-24 22:28,358.17,Withdrawal,ATM Withdrawal,6371.58
26712,745853283,5-14-24 21:28,260.84,OutgoingTransfer,Bank Transfer,6110.74
26713,745853283,5-20-24 16:28,102.81,Deposit,Cash Deposit,6213.55
26714,745853283,5-20-24 20:28,187.92,Return,Amazon Return,6401.47
26715,745853283,5-21-24 19:28,472.12,Deposit,Mobile Deposit,6873.59
26716,745853283,5-26-24 16:28,381.64,Deposit,Check Deposit,7255.23
26717,745853283,5-27-24 20:28,332.4,OutgoingTransfer,Wire Transfer,6922.83
26718,745853283,5-28-24 13:28,100.64,Withdrawal,ATM Withdrawal,6822.19
26719,745853283,5-31-24 13:28,247.88,Return,AliExpress Return,7070.07
26720,745853283,06-02-24 11:28,482.85,Payment,Loan Payment,6587.22
26721,745853283,06-03-24 21:28,3800,IncomingTransfer,Salary,10387.22
26722,745853283,06-06-24 9:28,118.64,OutgoingTransfer,Peer-to-Peer Transfer,10268.58
26723,745853283,6-14-24 21:28,2300,Payment,Rent Payment,7968.58
26724,745853283,6-15-24 14:28,349.44,Payment,Mortgage Payment,7619.14
26725,745853283,6-20-24 22:28,119.43,OutgoingTransfer,Peer-to-Peer Transfer,7499.71
26726,745853283,6-22-24 10:28,196.53,Payment,Bill Payment,7303.18
26727,745853283,6-22-24 19:28,345.83,Payment,Mortgage Payment,6957.35
26728,745853283,07-02-24 11:28,389.11,Deposit,Mobile Deposit,7346.46
26729,745853283,07-03-24 21:28,3800,IncomingTransfer,Salary,11146.46
26730,745853283,07-06-24 10:28,150.03,Withdrawal,Branch Withdrawal,10996.43
26731,745853283,07-07-24 18:28,80.36,IncomingTransfer,Freelance Payment,11076.79
26732,745853283,07-11-24 21:28,1800,Payment,Rent Payment,9276.79
26733,745853283,07-11-24 21:28,292.66,Purchase,Home Improvement,8984.13
26734,745853283,7-13-24 13:28,281.17,Withdrawal,ATM Withdrawal,8702.96
26735,751518633,1-20-24 12:28,671.39,Deposit,Direct Deposit,2230.602565
26736,751518633,1-27-24 12:28,692.49,Payment,Loan Payment,1538.112565
26737,751518633,1-31-24 13:28,401.58,Purchase,Home Improvement,1136.532565
26738,751518633,1-31-24 15:28,244.32,Purchase,Clothing,892.212565
26739,751518633,02-03-24 11:28,902.45,IncomingTransfer,Freelance Payment,1794.662565
26740,751518633,02-03-24 16:28,926.34,Withdrawal,Branch Withdrawal,868.322565
26741,751518633,02-04-24 21:28,12850,IncomingTransfer,Salary,13718.32257
26742,751518633,02-07-24 19:28,602.53,Return,Amazon Return,14320.85257
26743,751518633,02-08-24 22:28,397.52,Deposit,Check Deposit,14718.37257
26744,751518633,02-09-24 21:28,2600,Payment,Credit Card Payment,12118.37257
26745,751518633,02-11-24 19:28,751.93,OnlineShopping,AliExpress,11366.44257
26746,751518633,2-13-24 21:28,6000,Payment,Rent Payment,5366.442565
26747,751518633,2-14-24 22:28,524.05,OutgoingTransfer,Wire Transfer,4842.392565
26748,751518633,2-19-24 19:28,677.5,IncomingTransfer,Freelance Payment,5519.892565
26749,751518633,2-20-24 12:28,736.38,Withdrawal,Branch Withdrawal,4783.512565
26750,751518633,2-23-24 9:28,240.02,Purchase,Grocery,4543.492565
26751,751518633,2-28-24 10:28,461.45,Payment,Mortgage Payment,4082.042565
26752,751518633,2-28-24 19:28,214.7,OnlineShopping,Target,3867.342565
26753,751518633,03-01-24 9:28,755.9,Withdrawal,Branch Withdrawal,3111.442565
26754,751518633,03-01-24 21:28,12850,IncomingTransfer,Salary,15961.44257
26755,751518633,03-01-24 21:28,799.52,Return,AliExpress Return,16760.96257
26756,751518633,03-06-24 21:28,2800,Payment,Credit Card Payment,13960.96257
26757,751518633,03-08-24 16:28,200.6,Deposit,Check Deposit,14161.56257
26758,751518633,3-14-24 16:28,435.62,Withdrawal,Mobile App Withdrawal,13725.94257
26759,751518633,3-16-24 17:28,823.51,Purchase,Clothing,12902.43257
26760,751518633,3-17-24 21:28,3400,Payment,Rent Payment,9502.432565
26761,751518633,3-21-24 21:28,622.17,OutgoingTransfer,Peer-to-Peer Transfer,8880.262565
26762,751518633,3-24-24 16:28,811.71,Deposit,Check Deposit,9691.972565
26763,751518633,3-25-24 20:28,439.45,Deposit,Cash Deposit,10131.42257
26764,751518633,3-29-24 12:28,852,OutgoingTransfer,Wire Transfer,9279.422565
26765,751518633,3-30-24 15:28,552.52,Return,Etsy Return,9831.942565
26766,751518633,3-30-24 21:28,793.18,Withdrawal,Mobile App Withdrawal,9038.762565
26767,751518633,3-31-24 18:28,201.3,Withdrawal,Branch Withdrawal,8837.462565
26768,751518633,3-31-24 20:28,226.7,Purchase,Pharmacy,8610.762565
26769,751518633,04-05-24 21:28,12850,IncomingTransfer,Salary,21460.76257
26770,751518633,04-10-24 21:28,3000,Payment,Credit Card Payment,18460.76257
26771,751518633,4-15-24 22:28,254.79,Deposit,Check Deposit,18715.55257
26772,751518633,4-16-24 21:28,5000,Payment,Rent Payment,13715.55257
26773,751518633,4-17-24 18:28,387.21,Purchase,Restaurant,13328.34257
26774,751518633,4-18-24 11:28,456.56,OnlineShopping,Walmart,12871.78257
26775,751518633,4-18-24 13:28,741.14,Deposit,Cash Deposit,13612.92257
26776,751518633,4-23-24 16:28,402.38,IncomingTransfer,Freelance Payment,14015.30257
26777,751518633,4-25-24 9:28,937.66,Deposit,Cash Deposit,14952.96257
26778,751518633,4-29-24 11:28,623.41,Deposit,Check Deposit,15576.37257
26779,751518633,4-30-24 23:28,460.12,OutgoingTransfer,International Transfer,15116.25257
26780,751518633,05-03-24 21:28,12850,IncomingTransfer,Salary,27966.25257
26781,751518633,05-08-24 21:28,2700,Payment,Credit Card Payment,25266.25257
26782,751518633,5-14-24 21:28,4400,Payment,Rent Payment,20866.25257
26783,751518633,5-17-24 10:28,907.61,Withdrawal,Mobile App Withdrawal,19958.64257
26784,751518633,5-18-24 21:28,518.31,Deposit,Check Deposit,20476.95257
26785,751518633,5-20-24 19:28,477.34,OnlineShopping,eBay,19999.61257
26786,751518633,5-23-24 23:28,831.44,OnlineShopping,Etsy,19168.17257
26787,751518633,5-29-24 10:28,252.14,Purchase,Grocery,18916.03257
26788,751518633,06-02-24 19:28,738.58,Deposit,Check Deposit,19654.61257
26789,751518633,06-03-24 22:28,539.26,Payment,Bill Payment,19115.35257
26790,751518633,06-04-24 21:28,12850,IncomingTransfer,Salary,31965.35257
26791,751518633,06-05-24 22:28,718.41,Withdrawal,Mobile App Withdrawal,31246.94257
26792,751518633,06-09-24 21:28,2700,Payment,Credit Card Payment,28546.94257
26793,751518633,06-10-24 21:28,5800,Payment,Rent Payment,22746.94257
26794,751518633,6-14-24 17:28,850.63,Deposit,Cash Deposit,23597.57257
26795,751518633,6-23-24 19:28,722.49,Withdrawal,Branch Withdrawal,22875.08257
26796,751518633,07-02-24 21:28,12850,IncomingTransfer,Salary,35725.08257
26797,751518633,07-04-24 18:28,529.22,Purchase,Entertainment,35195.86257
26798,751518633,07-07-24 19:28,776.08,Withdrawal,Branch Withdrawal,34419.78257
26799,751518633,07-07-24 21:28,3100,Payment,Credit Card Payment,31319.78257
26800,751518633,07-08-24 21:28,530.04,OutgoingTransfer,International Transfer,30789.74257
26801,751518633,07-12-24 21:28,937.6,Deposit,Cash Deposit,31727.34257
26802,751518633,7-13-24 21:28,4300,Payment,Rent Payment,27427.34257
26803,751607058,1-25-24 13:28,561.37,Deposit,Check Deposit,561.37
26804,751607058,02-02-24 15:28,814.37,Deposit,Direct Deposit,1375.74
26805,751607058,02-05-24 19:28,275.38,Withdrawal,Branch Withdrawal,1100.36
26806,751607058,02-05-24 21:28,11250,IncomingTransfer,Salary,12350.36
26807,751607058,02-06-24 12:28,572.55,Payment,Loan Payment,11777.81
26808,751607058,02-10-24 16:28,364.31,Withdrawal,Mobile App Withdrawal,11413.5
26809,751607058,02-11-24 12:28,649.03,Payment,Bill Payment,10764.47
26810,751607058,02-11-24 22:28,845.66,OutgoingTransfer,International Transfer,9918.81
26811,751607058,02-12-24 11:28,487.62,Withdrawal,ATM Withdrawal,9431.19
26812,751607058,2-13-24 11:28,773.3,Deposit,Mobile Deposit,10204.49
26813,751607058,2-13-24 15:28,453.64,Purchase,Entertainment,9750.85
26814,751607058,2-13-24 21:28,5000,Payment,Installment Payment,4750.85
26815,751607058,2-18-24 14:28,491.36,OutgoingTransfer,Peer-to-Peer Transfer,4259.49
26816,751607058,2-21-24 19:28,941.78,OnlineShopping,Walmart,3317.71
26817,751607058,2-22-24 20:28,262.26,Payment,Mortgage Payment,3055.45
26818,751607058,2-24-24 22:28,255.67,Withdrawal,ATM Withdrawal,2799.78
26819,751607058,2-25-24 11:28,485.36,Purchase,Grocery,2314.42
26820,751607058,2-29-24 10:28,817.33,OutgoingTransfer,Bank Transfer,1497.09
26821,751607058,03-01-24 22:28,677.8,Withdrawal,ATM Withdrawal,819.29
26822,751607058,03-03-24 17:28,368.62,OnlineShopping,Target,450.67
26823,751607058,03-04-24 20:28,708.69,Deposit,Direct Deposit,1159.36
26824,751607058,03-04-24 21:28,11250,IncomingTransfer,Salary,12409.36
26825,751607058,03-06-24 23:28,364.64,OnlineShopping,Walmart,12044.72
26826,751607058,03-08-24 11:28,258.42,Payment,Mortgage Payment,11786.3
26827,751607058,03-09-24 11:28,417.28,IncomingTransfer,Freelance Payment,12203.58
26828,751607058,03-11-24 21:28,4900,Payment,Subscription Payment,7303.58
26829,751607058,3-16-24 11:28,720.72,Purchase,Pharmacy,6582.86
26830,751607058,3-16-24 16:28,865.01,Payment,Loan Payment,5717.85
26831,751607058,3-16-24 20:28,332.74,Deposit,Direct Deposit,6050.59
26832,751607058,3-17-24 15:28,348.66,Deposit,Cash Deposit,6399.25
26833,751607058,3-22-24 23:28,581.5,Return,Target Return,6980.75
26834,751607058,3-24-24 13:28,341.76,Return,eBay Return,7322.51
26835,751607058,3-26-24 16:28,257.51,Withdrawal,Branch Withdrawal,7065
26836,751607058,3-31-24 19:28,571.71,OnlineShopping,Walmart,6493.29
26837,751607058,04-01-24 16:28,464.81,Deposit,Cash Deposit,6958.1
26838,751607058,04-03-24 21:28,11250,IncomingTransfer,Salary,18208.1
26839,751607058,04-05-24 17:28,444.5,Deposit,Check Deposit,18652.6
26840,751607058,04-08-24 13:28,349.37,Deposit,Direct Deposit,19001.97
26841,751607058,04-08-24 15:28,225.7,Withdrawal,Branch Withdrawal,18776.27
26842,751607058,04-08-24 20:28,416.17,Withdrawal,Branch Withdrawal,18360.1
26843,751607058,04-10-24 13:28,394.01,Withdrawal,ATM Withdrawal,17966.09
26844,751607058,4-14-24 13:28,924.16,OutgoingTransfer,Wire Transfer,17041.93
26845,751607058,4-18-24 14:28,337.3,OutgoingTransfer,Bank Transfer,16704.63
26846,751607058,4-18-24 21:28,4900,Payment,Subscription Payment,11804.63
26847,751607058,4-20-24 15:28,705.78,Deposit,Direct Deposit,12510.41
26848,751607058,4-20-24 22:28,758.5,OnlineShopping,eBay,11751.91
26849,751607058,4-28-24 10:28,442.63,Deposit,Direct Deposit,12194.54
26850,751607058,4-28-24 20:28,600.13,IncomingTransfer,Freelance Payment,12794.67
26851,751607058,05-03-24 11:28,464.15,Payment,Loan Payment,12330.52
26852,751607058,05-03-24 17:28,522.13,Return,Store Return,12852.65
26853,751607058,05-03-24 21:28,11250,IncomingTransfer,Salary,24102.65
26854,751607058,05-04-24 13:28,739.37,Deposit,Cash Deposit,24842.02
26855,751607058,05-10-24 18:28,279.39,Payment,Loan Payment,24562.63
26856,751607058,05-11-24 10:28,448.66,Deposit,Direct Deposit,25011.29
26857,751607058,05-11-24 17:28,716.93,Return,AliExpress Return,25728.22
26858,751607058,05-11-24 20:28,680.74,Deposit,Direct Deposit,26408.96
26859,751607058,5-16-24 21:28,3700,Payment,Insurance Payment,22708.96
26860,751607058,5-18-24 17:28,525.97,Purchase,Restaurant,22182.99
26861,751607058,5-20-24 18:28,500.53,Purchase,Home Improvement,21682.46
26862,751607058,5-21-24 14:28,746.46,IncomingTransfer,Freelance Payment,22428.92
26863,751607058,5-21-24 17:28,530.78,Purchase,Travel,21898.14
26864,751607058,5-25-24 12:28,848.04,Withdrawal,Branch Withdrawal,21050.1
26865,751607058,5-25-24 22:28,244.73,Deposit,Mobile Deposit,21294.83
26866,751607058,5-30-24 11:28,344.13,OnlineShopping,Walmart,20950.7
26867,751607058,5-31-24 23:28,238.1,Deposit,Cash Deposit,21188.8
26868,751607058,06-01-24 11:28,558.95,Payment,Mortgage Payment,20629.85
26869,751607058,06-03-24 21:28,11250,IncomingTransfer,Salary,31879.85
26870,751607058,06-07-24 20:28,455.52,Withdrawal,Branch Withdrawal,31424.33
26871,751607058,06-10-24 21:28,3700,Payment,Installment Payment,27724.33
26872,751607058,6-17-24 10:28,292.65,Deposit,Cash Deposit,28016.98
26873,751607058,6-18-24 18:28,688.42,Purchase,Gas,27328.56
26874,751607058,6-18-24 22:28,476.83,Payment,Bill Payment,26851.73
26875,751607058,6-20-24 19:28,369.52,Deposit,Mobile Deposit,27221.25
26876,751607058,6-24-24 15:28,511.62,OnlineShopping,Walmart,26709.63
26877,751607058,6-24-24 21:28,329.82,Purchase,Restaurant,26379.81
26878,751607058,6-26-24 11:28,912.1,OutgoingTransfer,Peer-to-Peer Transfer,25467.71
26879,751607058,07-01-24 11:28,512.14,Purchase,Entertainment,24955.57
26880,751607058,07-01-24 21:28,11250,IncomingTransfer,Salary,36205.57
26881,751607058,07-05-24 9:28,754.99,Return,Walmart Return,36960.56
26882,751607058,07-09-24 12:28,368.65,OutgoingTransfer,Bank Transfer,36591.91
26883,751607058,07-09-24 16:28,845.04,IncomingTransfer,Freelance Payment,37436.95
26884,751607058,07-09-24 20:28,293.94,OnlineShopping,AliExpress,37143.01
26885,751607058,07-10-24 9:28,352.32,Withdrawal,Mobile App Withdrawal,36790.69
26886,751607058,07-10-24 15:28,790.66,Purchase,Pharmacy,36000.03
26887,751607058,07-11-24 14:28,233.51,IncomingTransfer,Freelance Payment,36233.54
26888,751607058,07-12-24 21:28,779.34,Purchase,Home Improvement,35454.2
26889,751607058,7-14-24 14:28,564.95,Deposit,Mobile Deposit,36019.15
26890,751607058,7-14-24 21:28,4500,Payment,Insurance Payment,31519.15
26891,751607058,7-16-24 21:28,522.55,Deposit,Cash Deposit,32041.7
26892,753443583,1-22-24 12:28,221.92,IncomingTransfer,Freelance Payment,221.92
26893,753443583,1-24-24 15:28,62.67,Deposit,Check Deposit,284.59
26894,753443583,1-28-24 15:28,152.16,Return,Amazon Return,436.75
26895,753443583,1-30-24 18:28,49.37,Purchase,Electronics,387.38
26896,753443583,02-02-24 21:28,335.48,OnlineShopping,Etsy,51.9
26897,753443583,02-03-24 16:28,306.08,Withdrawal,Mobile App Withdrawal,-254.18
26898,753443583,02-05-24 11:28,131.96,OnlineShopping,eBay,-386.14
26899,753443583,02-05-24 21:28,4500,IncomingTransfer,Salary,4113.86
26900,753443583,02-08-24 15:28,263.21,OnlineShopping,Target,3850.65
26901,753443583,2-13-24 11:28,219.79,Withdrawal,Mobile App Withdrawal,3630.86
26902,753443583,2-13-24 12:28,248.44,Withdrawal,Mobile App Withdrawal,3382.42
26903,753443583,2-13-24 21:28,1200,Payment,Rent Payment,2182.42
26904,753443583,2-17-24 10:28,160.79,Deposit,Check Deposit,2343.21
26905,753443583,2-18-24 14:28,270.76,Return,Target Return,2613.97
26906,753443583,2-19-24 13:28,26.32,IncomingTransfer,Freelance Payment,2640.29
26907,753443583,2-19-24 14:28,201.15,Deposit,Mobile Deposit,2841.44
26908,753443583,2-23-24 18:28,35.9,OnlineShopping,eBay,2805.54
26909,753443583,2-24-24 16:28,351.78,Deposit,Mobile Deposit,3157.32
26910,753443583,2-25-24 19:28,288.61,Purchase,Pharmacy,2868.71
26911,753443583,2-26-24 23:28,271.97,Deposit,Mobile Deposit,3140.68
26912,753443583,2-27-24 22:28,141.88,Withdrawal,Mobile App Withdrawal,2998.8
26913,753443583,03-02-24 10:28,35.63,Withdrawal,Mobile App Withdrawal,2963.17
26914,753443583,03-03-24 21:28,4500,IncomingTransfer,Salary,7463.17
26915,753443583,03-04-24 15:28,338.35,Withdrawal,Branch Withdrawal,7124.82
26916,753443583,03-09-24 22:28,20.49,Purchase,Gas,7104.33
26917,753443583,03-10-24 20:28,22.66,Purchase,Pharmacy,7081.67
26918,753443583,03-10-24 21:28,1800,Payment,Rent Payment,5281.67
26919,753443583,03-11-24 19:28,275.49,OnlineShopping,Target,5006.18
26920,753443583,03-11-24 22:28,158.09,Deposit,Direct Deposit,5164.27
26921,753443583,3-13-24 13:28,23.12,Deposit,Direct Deposit,5187.39
26922,753443583,3-14-24 13:28,233.85,Purchase,Clothing,4953.54
26923,753443583,3-19-24 10:28,80.1,IncomingTransfer,Freelance Payment,5033.64
26924,753443583,3-23-24 20:28,232.11,OnlineShopping,Best Buy,4801.53
26925,753443583,3-24-24 13:28,44.58,Purchase,Home Improvement,4756.95
26926,753443583,3-26-24 21:28,232.87,Purchase,Restaurant,4524.08
26927,753443583,3-29-24 20:28,188.77,Purchase,Electronics,4335.31
26928,753443583,04-02-24 21:28,4500,IncomingTransfer,Salary,8835.31
26929,753443583,04-03-24 13:28,162.24,IncomingTransfer,Freelance Payment,8997.55
26930,753443583,04-03-24 15:28,161.4,Withdrawal,Mobile App Withdrawal,8836.15
26931,753443583,04-04-24 15:28,144.56,Purchase,Gas,8691.59
26932,753443583,04-04-24 20:28,185.71,Payment,Loan Payment,8505.88
26933,753443583,04-07-24 22:28,306.07,Purchase,Gas,8199.81
26934,753443583,04-10-24 11:28,373.08,Payment,Mortgage Payment,7826.73
26935,753443583,04-10-24 16:28,277.73,Return,AliExpress Return,8104.46
26936,753443583,04-10-24 18:28,84.55,OnlineShopping,Best Buy,8019.91
26937,753443583,4-13-24 16:28,360.15,Deposit,Mobile Deposit,8380.06
26938,753443583,4-14-24 16:28,63.12,Deposit,Direct Deposit,8443.18
26939,753443583,4-15-24 22:28,303.23,Deposit,Mobile Deposit,8746.41
26940,753443583,4-16-24 21:28,2100,Payment,Rent Payment,6646.41
26941,753443583,4-21-24 14:28,298.22,Return,Etsy Return,6944.63
26942,753443583,4-25-24 10:28,135.26,Purchase,Travel,6809.37
26943,753443583,4-27-24 20:28,60.04,OutgoingTransfer,Bank Transfer,6749.33
26944,753443583,05-01-24 21:28,4500,IncomingTransfer,Salary,11249.33
26945,753443583,05-08-24 16:28,271.85,Deposit,Mobile Deposit,11521.18
26946,753443583,05-10-24 19:28,182.55,Purchase,Pharmacy,11338.63
26947,753443583,5-17-24 11:28,28.44,Deposit,Cash Deposit,11367.07
26948,753443583,5-17-24 21:28,2500,Payment,Rent Payment,8867.07
26949,753443583,5-18-24 14:28,377.32,Return,Walmart Return,9244.39
26950,753443583,5-20-24 21:28,388.7,Return,Walmart Return,9633.09
26951,753443583,5-23-24 16:28,270.45,OutgoingTransfer,Bank Transfer,9362.64
26952,753443583,5-25-24 15:28,290.77,Payment,Bill Payment,9071.87
26953,753443583,5-30-24 19:28,126.03,Withdrawal,Branch Withdrawal,8945.84
26954,753443583,06-01-24 18:28,387.23,OutgoingTransfer,Wire Transfer,8558.61
26955,753443583,06-03-24 21:28,4500,IncomingTransfer,Salary,13058.61
26956,753443583,6-14-24 21:28,1600,Payment,Rent Payment,11458.61
26957,753443583,6-16-24 11:28,314,Withdrawal,ATM Withdrawal,11144.61
26958,753443583,6-24-24 23:28,158.93,Purchase,Furniture,10985.68
26959,753443583,6-24-24 23:28,25.43,OutgoingTransfer,Bank Transfer,10960.25
26960,753443583,6-27-24 23:28,254.92,Deposit,Mobile Deposit,11215.17
26961,753443583,6-28-24 20:28,315.19,OnlineShopping,Walmart,10899.98
26962,753443583,6-29-24 16:28,226.93,IncomingTransfer,Freelance Payment,11126.91
26963,753443583,07-01-24 15:28,122.54,Payment,Bill Payment,11004.37
26964,753443583,07-02-24 18:28,340.63,IncomingTransfer,Freelance Payment,11345
26965,753443583,07-02-24 21:28,4500,IncomingTransfer,Salary,15845
26966,753443583,07-05-24 15:28,189.21,Deposit,Mobile Deposit,16034.21
26967,753443583,07-05-24 19:28,109.4,Return,eBay Return,16143.61
26968,753443583,07-06-24 17:28,29.53,OutgoingTransfer,Wire Transfer,16114.08
26969,753443583,07-09-24 19:28,63.13,Withdrawal,Branch Withdrawal,16050.95
26970,753443583,07-12-24 21:28,1400,Payment,Rent Payment,14650.95
26971,753443583,07-12-24 23:28,318.28,Withdrawal,Branch Withdrawal,14332.67
26972,753443583,7-16-24 13:28,27,Purchase,Home Improvement,14305.67
26973,753443583,7-16-24 20:28,266.09,Payment,Bill Payment,14039.58
26974,753443583,7-17-24 10:28,367.02,Withdrawal,Branch Withdrawal,13672.56
26975,753443583,7-17-24 14:28,120.58,OutgoingTransfer,Wire Transfer,13551.98
26976,753443583,7-17-24 15:28,78.52,Withdrawal,Mobile App Withdrawal,13473.46
26977,755273658,1-21-24 17:28,164.39,Deposit,Cash Deposit,1287.928249
26978,755273658,1-22-24 12:28,138.65,Payment,Bill Payment,1149.278249
26979,755273658,1-27-24 11:28,115.85,Withdrawal,Mobile App Withdrawal,1033.428249
26980,755273658,1-27-24 12:28,174.68,IncomingTransfer,Freelance Payment,1208.108249
26981,755273658,1-29-24 11:28,239.89,Deposit,Check Deposit,1447.998249
26982,755273658,1-29-24 14:28,118.86,IncomingTransfer,Freelance Payment,1566.858249
26983,755273658,02-01-24 14:28,134.37,Purchase,Electronics,1432.488249
26984,755273658,02-02-24 14:28,196.91,Deposit,Mobile Deposit,1629.398249
26985,755273658,02-04-24 13:28,49.55,Deposit,Cash Deposit,1678.948249
26986,755273658,02-04-24 21:28,2900,IncomingTransfer,Salary,4578.948249
26987,755273658,02-09-24 21:28,1900,Payment,Credit Card Payment,2678.948249
26988,755273658,02-11-24 14:28,121.17,Deposit,Cash Deposit,2800.118249
26989,755273658,2-13-24 10:28,166.33,Withdrawal,Branch Withdrawal,2633.788249
26990,755273658,2-15-24 23:28,135.55,Payment,Mortgage Payment,2498.238249
26991,755273658,2-17-24 20:28,222.14,Purchase,Electronics,2276.098249
26992,755273658,2-18-24 17:28,242.62,Withdrawal,Branch Withdrawal,2033.478249
26993,755273658,2-18-24 21:28,800,Payment,Rent Payment,1233.478249
26994,755273658,2-20-24 16:28,90.36,OutgoingTransfer,Peer-to-Peer Transfer,1143.118249
26995,755273658,2-22-24 20:28,36.55,OutgoingTransfer,Peer-to-Peer Transfer,1106.568249
26996,755273658,2-27-24 21:28,68.92,Return,Walmart Return,1175.488249
26997,755273658,03-03-24 19:28,20.22,Withdrawal,Mobile App Withdrawal,1155.268249
26998,755273658,03-04-24 21:28,2900,IncomingTransfer,Salary,4055.268249
26999,755273658,03-05-24 18:28,157.06,Withdrawal,ATM Withdrawal,3898.208249
27000,755273658,03-06-24 21:28,203.2,OutgoingTransfer,Peer-to-Peer Transfer,3695.008249
27001,755273658,03-08-24 18:28,50.74,Purchase,Clothing,3644.268249
27002,755273658,03-09-24 10:28,244.08,Purchase,Restaurant,3400.188249
27003,755273658,03-09-24 21:28,2300,Payment,Credit Card Payment,1100.188249
27004,755273658,03-10-24 16:28,139.38,Return,Amazon Return,1239.568249
27005,755273658,03-11-24 18:28,199.53,Deposit,Mobile Deposit,1439.098249
27006,755273658,3-16-24 21:28,1100,Payment,Rent Payment,339.0982491
27007,755273658,3-18-24 23:28,63.49,OnlineShopping,AliExpress,275.6082491
27008,755273658,3-25-24 23:28,80.44,Purchase,Grocery,195.1682491
27009,755273658,3-30-24 19:28,108.83,Deposit,Cash Deposit,303.9982491
27010,755273658,3-30-24 20:28,240.17,IncomingTransfer,Freelance Payment,544.1682491
27011,755273658,3-31-24 11:28,125.12,Deposit,Mobile Deposit,669.2882491
27012,755273658,04-01-24 9:28,233.38,Return,eBay Return,902.6682491
27013,755273658,04-02-24 21:28,2900,IncomingTransfer,Salary,3802.668249
27014,755273658,04-05-24 12:28,201.81,OutgoingTransfer,Bank Transfer,3600.858249
27015,755273658,04-06-24 12:28,46.75,Purchase,Travel,3554.108249
27016,755273658,04-07-24 21:28,1800,Payment,Credit Card Payment,1754.108249
27017,755273658,4-15-24 21:28,1500,Payment,Rent Payment,254.1082491
27018,755273658,4-28-24 10:28,117.73,Withdrawal,Mobile App Withdrawal,136.3782491
27019,755273658,05-01-24 16:28,162.08,Purchase,Travel,-25.70175087
27020,755273658,05-02-24 21:28,2900,IncomingTransfer,Salary,2874.298249
27021,755273658,05-07-24 21:28,1700,Payment,Credit Card Payment,1174.298249
27022,755273658,05-10-24 22:28,227.46,Return,Best Buy Return,1401.758249
27023,755273658,05-11-24 12:28,197.79,Withdrawal,Branch Withdrawal,1203.968249
27024,755273658,5-13-24 21:28,1500,Payment,Rent Payment,-296.0317509
27025,755273658,5-15-24 20:28,177.46,IncomingTransfer,Freelance Payment,-118.5717509
27026,755273658,5-17-24 22:28,71.32,OutgoingTransfer,Bank Transfer,-189.8917509
27027,755273658,5-18-24 14:28,234.39,Return,Store Return,44.49824913
27028,755273658,5-19-24 21:28,32.63,Purchase,Home Improvement,11.86824913
27029,755273658,5-19-24 21:28,189.6,Deposit,Mobile Deposit,201.4682491
27030,755273658,5-22-24 10:28,207.59,Payment,Mortgage Payment,-6.121750867
27031,755273658,5-30-24 15:28,45.43,Payment,Bill Payment,-51.55175087
27032,755273658,5-31-24 23:28,242.87,OnlineShopping,Amazon,-294.4217509
27033,755273658,06-05-24 21:28,2900,IncomingTransfer,Salary,2605.578249
27034,755273658,06-10-24 21:28,2100,Payment,Credit Card Payment,505.5782491
27035,755273658,6-14-24 21:28,900,Payment,Rent Payment,-394.4217509
27036,755273658,6-17-24 22:28,216.78,Return,Etsy Return,-177.6417509
27037,755273658,6-24-24 19:28,177.44,Deposit,Mobile Deposit,-0.201750867
27038,755273658,6-24-24 23:28,28.52,Payment,Mortgage Payment,-28.72175087
27039,755273658,6-30-24 16:28,242.64,Withdrawal,ATM Withdrawal,-271.3617509
27040,755273658,07-05-24 21:28,2900,IncomingTransfer,Salary,2628.638249
27041,755273658,07-06-24 20:28,149.91,Return,Etsy Return,2778.548249
27042,755273658,07-07-24 14:28,30.99,Purchase,Furniture,2747.558249
27043,755273658,07-07-24 21:28,66.1,Deposit,Direct Deposit,2813.658249
27044,755273658,07-08-24 20:28,156.91,Purchase,Pharmacy,2656.748249
27045,755273658,07-10-24 21:28,1700,Payment,Credit Card Payment,956.7482491
27046,755273658,07-10-24 21:28,178,Deposit,Check Deposit,1134.748249
27047,755273658,07-11-24 21:28,1600,Payment,Rent Payment,-465.2517509
27048,755273658,7-16-24 13:28,202.23,Withdrawal,Mobile App Withdrawal,-667.4817509
27049,755615208,1-20-24 14:28,686.94,Purchase,Grocery,530.3523306
27050,755615208,1-21-24 21:28,659.37,OutgoingTransfer,Bank Transfer,-129.0176694
27051,755615208,1-27-24 12:28,335.96,Withdrawal,ATM Withdrawal,-464.9776694
27052,755615208,1-27-24 13:28,577.64,Purchase,Electronics,-1042.617669
27053,755615208,1-28-24 15:28,734.9,Payment,Loan Payment,-1777.517669
27054,755615208,1-31-24 11:28,567.4,Withdrawal,Branch Withdrawal,-2344.917669
27055,755615208,02-01-24 21:28,10200,IncomingTransfer,Salary,7855.082331
27056,755615208,02-03-24 17:28,341.29,Return,Target Return,8196.372331
27057,755615208,02-06-24 21:28,2100,Payment,Credit Card Payment,6096.372331
27058,755615208,02-11-24 22:28,409.31,Payment,Mortgage Payment,5687.062331
27059,755615208,02-12-24 15:28,830.25,Deposit,Cash Deposit,6517.312331
27060,755615208,2-13-24 11:28,205.78,Return,Walmart Return,6723.092331
27061,755615208,2-15-24 22:28,273.17,OnlineShopping,Target,6449.922331
27062,755615208,2-16-24 21:28,3400,Payment,Installment Payment,3049.922331
27063,755615208,2-25-24 13:28,923.36,Return,Target Return,3973.282331
27064,755615208,2-26-24 19:28,776.44,Withdrawal,Mobile App Withdrawal,3196.842331
27065,755615208,2-29-24 22:28,806.01,Purchase,Clothing,2390.832331
27066,755615208,03-01-24 14:28,718.85,Purchase,Gas,1671.982331
27067,755615208,03-02-24 21:28,10200,IncomingTransfer,Salary,11871.98233
27068,755615208,03-04-24 19:28,929.62,OnlineShopping,Best Buy,10942.36233
27069,755615208,03-07-24 21:28,1900,Payment,Credit Card Payment,9042.362331
27070,755615208,03-09-24 21:28,775.72,Deposit,Mobile Deposit,9818.082331
27071,755615208,03-10-24 11:28,410.84,Purchase,Home Improvement,9407.242331
27072,755615208,3-13-24 21:28,2900,Payment,Insurance Payment,6507.242331
27073,755615208,3-17-24 12:28,407.46,Purchase,Pharmacy,6099.782331
27074,755615208,3-20-24 13:28,595.84,Deposit,Direct Deposit,6695.622331
27075,755615208,3-22-24 22:28,215.8,Purchase,Electronics,6479.822331
27076,755615208,3-23-24 18:28,249,Purchase,Restaurant,6230.822331
27077,755615208,3-26-24 19:28,312.9,Purchase,Travel,5917.922331
27078,755615208,3-27-24 12:28,933.96,OutgoingTransfer,Bank Transfer,4983.962331
27079,755615208,3-29-24 18:28,365.11,Purchase,Grocery,4618.852331
27080,755615208,04-01-24 9:28,741.83,Purchase,Pharmacy,3877.022331
27081,755615208,04-03-24 21:28,10200,IncomingTransfer,Salary,14077.02233
27082,755615208,04-04-24 9:28,588.8,Return,Store Return,14665.82233
27083,755615208,04-04-24 10:28,262.03,Return,AliExpress Return,14927.85233
27084,755615208,04-05-24 10:28,321.59,IncomingTransfer,Freelance Payment,15249.44233
27085,755615208,04-05-24 22:28,722.31,Withdrawal,ATM Withdrawal,14527.13233
27086,755615208,04-05-24 23:28,880.12,Deposit,Direct Deposit,15407.25233
27087,755615208,04-06-24 11:28,390.5,Purchase,Electronics,15016.75233
27088,755615208,04-08-24 21:28,2700,Payment,Credit Card Payment,12316.75233
27089,755615208,04-09-24 21:28,640.28,Return,Store Return,12957.03233
27090,755615208,4-13-24 22:28,419.7,OnlineShopping,Walmart,12537.33233
27091,755615208,4-15-24 21:28,3500,Payment,Insurance Payment,9037.332331
27092,755615208,4-16-24 19:28,256.22,Return,Best Buy Return,9293.552331
27093,755615208,4-18-24 11:28,445.25,Deposit,Mobile Deposit,9738.802331
27094,755615208,4-21-24 11:28,924.8,Deposit,Direct Deposit,10663.60233
27095,755615208,4-27-24 20:28,505.02,Deposit,Mobile Deposit,11168.62233
27096,755615208,4-28-24 16:28,837.92,OutgoingTransfer,Bank Transfer,10330.70233
27097,755615208,4-29-24 13:28,867.58,Purchase,Furniture,9463.122331
27098,755615208,05-01-24 22:28,599.76,Withdrawal,Branch Withdrawal,8863.362331
27099,755615208,05-03-24 21:28,10200,IncomingTransfer,Salary,19063.36233
27100,755615208,05-04-24 14:28,301.19,OutgoingTransfer,Peer-to-Peer Transfer,18762.17233
27101,755615208,05-05-24 11:28,649.77,Purchase,Gas,18112.40233
27102,755615208,05-07-24 11:28,475.57,Deposit,Check Deposit,18587.97233
27103,755615208,05-07-24 17:28,412.89,OutgoingTransfer,Peer-to-Peer Transfer,18175.08233
27104,755615208,05-08-24 21:28,2000,Payment,Credit Card Payment,16175.08233
27105,755615208,05-12-24 21:28,3100,Payment,Installment Payment,13075.08233
27106,755615208,5-20-24 11:28,265.58,Return,Store Return,13340.66233
27107,755615208,5-21-24 11:28,685.6,Purchase,Entertainment,12655.06233
27108,755615208,5-23-24 10:28,263.26,Purchase,Entertainment,12391.80233
27109,755615208,5-29-24 21:28,587.76,Withdrawal,ATM Withdrawal,11804.04233
27110,755615208,5-30-24 20:28,598.26,Purchase,Travel,11205.78233
27111,755615208,5-31-24 16:28,906.96,Purchase,Restaurant,10298.82233
27112,755615208,06-01-24 19:28,271.28,Purchase,Grocery,10027.54233
27113,755615208,06-02-24 21:28,797.43,Payment,Bill Payment,9230.112331
27114,755615208,06-03-24 21:28,739.41,Deposit,Check Deposit,9969.522331
27115,755615208,06-05-24 21:28,10200,IncomingTransfer,Salary,20169.52233
27116,755615208,06-10-24 21:28,2200,Payment,Credit Card Payment,17969.52233
27117,755615208,06-11-24 21:28,4100,Payment,Subscription Payment,13869.52233
27118,755615208,6-15-24 15:28,354.69,Purchase,Furniture,13514.83233
27119,755615208,6-16-24 11:28,816.83,Purchase,Clothing,12698.00233
27120,755615208,6-18-24 13:28,753.24,Deposit,Direct Deposit,13451.24233
27121,755615208,6-19-24 9:28,754.17,Purchase,Pharmacy,12697.07233
27122,755615208,6-19-24 11:28,482.23,Payment,Bill Payment,12214.84233
27123,755615208,6-19-24 12:28,625.81,Deposit,Mobile Deposit,12840.65233
27124,755615208,6-22-24 17:28,813.86,Purchase,Entertainment,12026.79233
27125,755615208,6-25-24 15:28,740.2,Withdrawal,Mobile App Withdrawal,11286.59233
27126,755615208,6-29-24 22:28,935.53,OnlineShopping,eBay,10351.06233
27127,755615208,07-01-24 21:28,10200,IncomingTransfer,Salary,20551.06233
27128,755615208,07-02-24 14:28,719.45,Withdrawal,ATM Withdrawal,19831.61233
27129,755615208,07-04-24 20:28,346.17,Deposit,Cash Deposit,20177.78233
27130,755615208,07-06-24 21:28,2100,Payment,Credit Card Payment,18077.78233
27131,755615208,7-16-24 10:28,476.31,OnlineShopping,Etsy,17601.47233
27132,755615208,7-18-24 21:28,3600,Payment,Insurance Payment,14001.47233
27133,756409758,1-21-24 21:28,124.04,Deposit,Direct Deposit,1248.325555
27134,756409758,1-22-24 9:28,10.23,OutgoingTransfer,Bank Transfer,1238.095555
27135,756409758,1-25-24 12:28,185.22,OutgoingTransfer,Wire Transfer,1052.875555
27136,756409758,1-26-24 13:28,118.21,IncomingTransfer,Freelance Payment,1171.085555
27137,756409758,1-28-24 17:28,61.91,Deposit,Check Deposit,1232.995555
27138,756409758,02-01-24 14:28,50.98,Payment,Bill Payment,1182.015555
27139,756409758,02-01-24 15:28,88.16,Deposit,Cash Deposit,1270.175555
27140,756409758,02-05-24 21:28,2600,IncomingTransfer,Salary,3870.175555
27141,756409758,02-08-24 20:28,209.09,Purchase,Home Improvement,3661.085555
27142,756409758,02-10-24 21:28,2300,Payment,Credit Card Payment,1361.085555
27143,756409758,02-10-24 21:28,1400,Payment,Rent Payment,-38.91444531
27144,756409758,2-16-24 14:28,46.39,Payment,Mortgage Payment,-85.30444531
27145,756409758,2-18-24 14:28,207.69,Deposit,Cash Deposit,122.3855547
27146,756409758,2-25-24 18:28,248.46,Purchase,Gas,-126.0744453
27147,756409758,03-01-24 21:28,2600,IncomingTransfer,Salary,2473.925555
27148,756409758,03-04-24 9:28,216.04,IncomingTransfer,Freelance Payment,2689.965555
27149,756409758,03-06-24 21:28,2400,Payment,Credit Card Payment,289.9655547
27150,756409758,03-07-24 16:28,88.39,Deposit,Mobile Deposit,378.3555547
27151,756409758,3-14-24 21:28,1600,Payment,Rent Payment,-1221.644445
27152,756409758,3-18-24 14:28,110.54,Purchase,Pharmacy,-1332.184445
27153,756409758,3-19-24 19:28,237.5,Deposit,Direct Deposit,-1094.684445
27154,756409758,3-20-24 10:28,121.65,Purchase,Clothing,-1216.334445
27155,756409758,3-23-24 21:28,78.32,Return,Walmart Return,-1138.014445
27156,756409758,3-29-24 18:28,69.67,Purchase,Clothing,-1207.684445
27157,756409758,04-02-24 21:28,2600,IncomingTransfer,Salary,1392.315555
27158,756409758,04-07-24 13:28,156.53,Withdrawal,Branch Withdrawal,1235.785555
27159,756409758,04-07-24 21:28,2800,Payment,Credit Card Payment,-1564.214445
27160,756409758,04-11-24 16:28,183.45,OnlineShopping,eBay,-1747.664445
27161,756409758,4-15-24 21:28,1200,Payment,Rent Payment,-2947.664445
27162,756409758,4-19-24 15:28,85.74,Return,Best Buy Return,-2861.924445
27163,756409758,05-05-24 17:28,143.94,OutgoingTransfer,Peer-to-Peer Transfer,-3005.864445
27164,756409758,05-05-24 21:28,2600,IncomingTransfer,Salary,-405.8644453
27165,756409758,05-10-24 21:28,2300,Payment,Credit Card Payment,-2705.864445
27166,756409758,5-13-24 21:28,1600,Payment,Rent Payment,-4305.864445
27167,756409758,5-18-24 10:28,53.04,OutgoingTransfer,Bank Transfer,-4358.904445
27168,756409758,5-28-24 17:28,231.71,Deposit,Direct Deposit,-4127.194445
27169,756409758,5-30-24 14:28,139.32,OnlineShopping,Etsy,-4266.514445
27170,756409758,5-30-24 17:28,179.94,Return,Best Buy Return,-4086.574445
27171,756409758,5-31-24 9:28,119.19,OutgoingTransfer,Bank Transfer,-4205.764445
27172,756409758,5-31-24 11:28,61.2,Withdrawal,Mobile App Withdrawal,-4266.964445
27173,756409758,06-01-24 21:28,2600,IncomingTransfer,Salary,-1666.964445
27174,756409758,06-06-24 21:28,2800,Payment,Credit Card Payment,-4466.964445
27175,756409758,06-09-24 11:28,104.95,Deposit,Cash Deposit,-4362.014445
27176,756409758,06-11-24 23:28,174.04,Deposit,Direct Deposit,-4187.974445
27177,756409758,6-14-24 21:28,1300,Payment,Rent Payment,-5487.974445
27178,756409758,6-19-24 16:28,36.57,Return,Target Return,-5451.404445
27179,756409758,6-23-24 14:28,221.65,Payment,Mortgage Payment,-5673.054445
27180,756409758,6-25-24 12:28,88.15,Purchase,Grocery,-5761.204445
27181,756409758,6-25-24 14:28,214.66,Return,AliExpress Return,-5546.544445
27182,756409758,6-26-24 22:28,26.22,OutgoingTransfer,Peer-to-Peer Transfer,-5572.764445
27183,756409758,07-04-24 21:28,2600,IncomingTransfer,Salary,-2972.764445
27184,756409758,07-07-24 11:28,166.2,Deposit,Cash Deposit,-2806.564445
27185,756409758,07-09-24 21:28,2400,Payment,Credit Card Payment,-5206.564445
27186,756409758,7-13-24 21:28,1200,Payment,Rent Payment,-6406.564445
27187,756409758,7-15-24 15:28,128.39,Withdrawal,Branch Withdrawal,-6534.954445
27188,756409758,7-16-24 9:28,242.83,Return,Amazon Return,-6292.124445
27189,756477333,1-21-24 10:28,230.77,Withdrawal,ATM Withdrawal,-230.77
27190,756477333,1-24-24 23:28,235.67,Deposit,Mobile Deposit,4.9
27191,756477333,1-29-24 17:28,29.6,OutgoingTransfer,International Transfer,-24.7
27192,756477333,02-01-24 21:28,2550,IncomingTransfer,Salary,2525.3
27193,756477333,02-02-24 17:28,235.72,OnlineShopping,AliExpress,2289.58
27194,756477333,02-07-24 18:28,73.77,Payment,Mortgage Payment,2215.81
27195,756477333,02-09-24 16:28,58.45,Withdrawal,Branch Withdrawal,2157.36
27196,756477333,02-10-24 10:28,208.75,Purchase,Travel,1948.61
27197,756477333,02-10-24 21:28,900,Payment,Insurance Payment,1048.61
27198,756477333,02-11-24 20:28,54.89,Deposit,Direct Deposit,1103.5
27199,756477333,02-12-24 22:28,54.76,Purchase,Pharmacy,1048.74
27200,756477333,2-14-24 16:28,190.43,Payment,Mortgage Payment,858.31
27201,756477333,2-15-24 18:28,219.59,Return,Best Buy Return,1077.9
27202,756477333,2-15-24 20:28,237.65,Deposit,Check Deposit,1315.55
27203,756477333,2-16-24 16:28,164.15,Withdrawal,ATM Withdrawal,1151.4
27204,756477333,2-18-24 21:28,53.92,Deposit,Direct Deposit,1205.32
27205,756477333,2-19-24 15:28,189.65,Return,Best Buy Return,1394.97
27206,756477333,2-19-24 18:28,159.32,OnlineShopping,eBay,1235.65
27207,756477333,2-20-24 13:28,176.65,Payment,Bill Payment,1059
27208,756477333,2-24-24 19:28,17.9,OutgoingTransfer,Wire Transfer,1041.1
27209,756477333,03-01-24 22:28,130.41,OnlineShopping,Walmart,910.69
27210,756477333,03-05-24 21:28,2550,IncomingTransfer,Salary,3460.69
27211,756477333,03-08-24 15:28,146.95,Withdrawal,ATM Withdrawal,3313.74
27212,756477333,03-08-24 18:28,180.19,Deposit,Cash Deposit,3493.93
27213,756477333,03-08-24 23:28,78.85,Purchase,Restaurant,3415.08
27214,756477333,03-10-24 17:28,196.33,Purchase,Gas,3218.75
27215,756477333,03-12-24 17:28,209.62,Payment,Bill Payment,3009.13
27216,756477333,3-13-24 15:28,200.6,Purchase,Travel,2808.53
27217,756477333,3-14-24 21:28,800,Payment,Subscription Payment,2008.53
27218,756477333,3-16-24 14:28,36.83,IncomingTransfer,Freelance Payment,2045.36
27219,756477333,3-18-24 9:28,128.63,OnlineShopping,Etsy,1916.73
27220,756477333,3-19-24 23:28,245.25,Purchase,Home Improvement,1671.48
27221,756477333,3-22-24 18:28,76.93,Purchase,Gas,1594.55
27222,756477333,3-25-24 10:28,161.55,OnlineShopping,AliExpress,1433
27223,756477333,3-25-24 10:28,29.84,Payment,Loan Payment,1403.16
27224,756477333,3-26-24 21:28,23.51,Purchase,Grocery,1379.65
27225,756477333,04-01-24 12:28,18.56,Deposit,Mobile Deposit,1398.21
27226,756477333,04-02-24 21:28,2550,IncomingTransfer,Salary,3948.21
27227,756477333,04-03-24 13:28,213.16,IncomingTransfer,Freelance Payment,4161.37
27228,756477333,04-04-24 15:28,95.18,Payment,Loan Payment,4066.19
27229,756477333,04-06-24 11:28,64.88,Payment,Mortgage Payment,4001.31
27230,756477333,04-09-24 20:28,230.03,Payment,Mortgage Payment,3771.28
27231,756477333,04-11-24 18:28,71.85,OutgoingTransfer,Bank Transfer,3699.43
27232,756477333,04-11-24 21:28,800,Payment,Installment Payment,2899.43
27233,756477333,4-17-24 23:28,114.1,Withdrawal,ATM Withdrawal,2785.33
27234,756477333,4-20-24 18:28,173.78,Return,Target Return,2959.11
27235,756477333,4-21-24 18:28,194.75,Payment,Bill Payment,2764.36
27236,756477333,4-25-24 16:28,150.61,Deposit,Cash Deposit,2914.97
27237,756477333,4-27-24 19:28,199.58,Deposit,Check Deposit,3114.55
27238,756477333,4-27-24 21:28,80.67,Purchase,Home Improvement,3033.88
27239,756477333,05-01-24 21:28,92.37,Purchase,Home Improvement,2941.51
27240,756477333,05-02-24 13:28,143.19,OnlineShopping,Walmart,2798.32
27241,756477333,05-02-24 21:28,2550,IncomingTransfer,Salary,5348.32
27242,756477333,05-04-24 15:28,135.76,Purchase,Clothing,5212.56
27243,756477333,05-10-24 22:28,141.28,OutgoingTransfer,Bank Transfer,5071.28
27244,756477333,5-17-24 21:28,1000,Payment,Subscription Payment,4071.28
27245,756477333,5-20-24 11:28,208.34,Withdrawal,Branch Withdrawal,3862.94
27246,756477333,5-23-24 15:28,22.25,Payment,Bill Payment,3840.69
27247,756477333,5-24-24 13:28,165.27,Return,Best Buy Return,4005.96
27248,756477333,5-27-24 12:28,151.77,Withdrawal,Branch Withdrawal,3854.19
27249,756477333,5-29-24 19:28,67.56,Deposit,Check Deposit,3921.75
27250,756477333,06-01-24 15:28,49.56,Return,Target Return,3971.31
27251,756477333,06-01-24 21:28,2550,IncomingTransfer,Salary,6521.31
27252,756477333,06-04-24 12:28,197.07,Deposit,Cash Deposit,6718.38
27253,756477333,6-15-24 16:28,166.51,Purchase,Gas,6551.87
27254,756477333,6-16-24 13:28,13.22,Purchase,Pharmacy,6538.65
27255,756477333,6-16-24 21:28,900,Payment,Subscription Payment,5638.65
27256,756477333,6-21-24 14:28,167.66,Purchase,Pharmacy,5470.99
27257,756477333,6-22-24 19:28,202.66,Payment,Loan Payment,5268.33
27258,756477333,6-25-24 12:28,106.36,Payment,Mortgage Payment,5161.97
27259,756477333,6-26-24 9:28,26.22,OutgoingTransfer,International Transfer,5135.75
27260,756477333,6-28-24 16:28,199.9,Purchase,Entertainment,4935.85
27261,756477333,6-28-24 18:28,240.7,Withdrawal,Branch Withdrawal,4695.15
27262,756477333,6-30-24 17:28,153.08,IncomingTransfer,Freelance Payment,4848.23
27263,756477333,07-04-24 21:28,2550,IncomingTransfer,Salary,7398.23
27264,756477333,07-05-24 20:28,85.35,IncomingTransfer,Freelance Payment,7483.58
27265,756477333,07-06-24 15:28,216.67,Payment,Bill Payment,7266.91
27266,756477333,07-10-24 21:28,1100,Payment,Insurance Payment,6166.91
27267,756477333,07-11-24 16:28,248.74,Deposit,Cash Deposit,6415.65
27268,756477333,07-12-24 14:28,27.02,Withdrawal,Branch Withdrawal,6388.63
27269,756477333,7-13-24 12:28,46.8,OutgoingTransfer,Bank Transfer,6341.83
27270,756477333,7-16-24 10:28,52.14,OutgoingTransfer,International Transfer,6289.69
27271,756477333,7-17-24 17:28,207,Purchase,Home Improvement,6082.69
27272,757194408,1-22-24 10:28,524.04,Withdrawal,Branch Withdrawal,-524.04
27273,757194408,1-22-24 11:28,390.95,Deposit,Direct Deposit,-133.09
27274,757194408,1-28-24 19:28,278.13,OnlineShopping,AliExpress,-411.22
27275,757194408,02-02-24 21:28,5100,IncomingTransfer,Salary,4688.78
27276,757194408,02-12-24 22:28,84.12,Purchase,Pharmacy,4604.66
27277,757194408,2-13-24 21:28,2000,Payment,Rent Payment,2604.66
27278,757194408,2-17-24 16:28,354.35,IncomingTransfer,Freelance Payment,2959.01
27279,757194408,03-03-24 11:28,122.4,Payment,Loan Payment,2836.61
27280,757194408,03-04-24 21:28,5100,IncomingTransfer,Salary,7936.61
27281,757194408,03-12-24 21:28,3100,Payment,Rent Payment,4836.61
27282,757194408,3-17-24 12:28,247.76,Deposit,Cash Deposit,5084.37
27283,757194408,3-18-24 11:28,361.4,Payment,Mortgage Payment,4722.97
27284,757194408,3-22-24 15:28,201.39,OnlineShopping,eBay,4521.58
27285,757194408,3-22-24 18:28,517.38,Deposit,Mobile Deposit,5038.96
27286,757194408,3-25-24 21:28,323.75,Withdrawal,Mobile App Withdrawal,4715.21
27287,757194408,3-27-24 17:28,228.42,Return,eBay Return,4943.63
27288,757194408,04-01-24 18:28,53.73,Payment,Loan Payment,4889.9
27289,757194408,04-05-24 21:28,5100,IncomingTransfer,Salary,9989.9
27290,757194408,04-08-24 11:28,388.25,Withdrawal,Mobile App Withdrawal,9601.65
27291,757194408,04-09-24 11:28,353.43,Purchase,Entertainment,9248.22
27292,757194408,04-10-24 21:28,3000,Payment,Rent Payment,6248.22
27293,757194408,4-15-24 9:28,310.55,Purchase,Clothing,5937.67
27294,757194408,4-17-24 18:28,80.07,OnlineShopping,eBay,5857.6
27295,757194408,4-24-24 20:28,375.28,Deposit,Direct Deposit,6232.88
27296,757194408,4-25-24 9:28,406.88,OutgoingTransfer,International Transfer,5826
27297,757194408,4-26-24 18:28,165.17,Deposit,Direct Deposit,5991.17
27298,757194408,05-02-24 21:28,5100,IncomingTransfer,Salary,11091.17
27299,757194408,05-05-24 13:28,71.54,Return,Target Return,11162.71
27300,757194408,05-06-24 18:28,87.41,Deposit,Direct Deposit,11250.12
27301,757194408,05-11-24 21:28,347.49,Deposit,Cash Deposit,11597.61
27302,757194408,05-12-24 21:28,1800,Payment,Rent Payment,9797.61
27303,757194408,5-21-24 19:28,349.53,Purchase,Gas,9448.08
27304,757194408,5-24-24 18:28,543.62,Deposit,Direct Deposit,9991.7
27305,757194408,5-28-24 18:28,244.85,Deposit,Check Deposit,10236.55
27306,757194408,06-05-24 21:28,5100,IncomingTransfer,Salary,15336.55
27307,757194408,06-10-24 21:28,3200,Payment,Rent Payment,12136.55
27308,757194408,06-11-24 9:28,462.97,Withdrawal,Branch Withdrawal,11673.58
27309,757194408,6-13-24 14:28,288.07,Withdrawal,ATM Withdrawal,11385.51
27310,757194408,6-13-24 14:28,523.91,Deposit,Mobile Deposit,11909.42
27311,757194408,6-15-24 13:28,55.72,Return,Amazon Return,11965.14
27312,757194408,6-20-24 14:28,370.24,Deposit,Check Deposit,12335.38
27313,757194408,6-23-24 11:28,176.56,OutgoingTransfer,Bank Transfer,12158.82
27314,757194408,6-24-24 19:28,249.42,Deposit,Cash Deposit,12408.24
27315,757194408,6-27-24 12:28,276.37,IncomingTransfer,Freelance Payment,12684.61
27316,757194408,6-30-24 21:28,398.26,Purchase,Pharmacy,12286.35
27317,757194408,07-05-24 21:28,5100,IncomingTransfer,Salary,17386.35
27318,757194408,07-11-24 19:28,189.85,Deposit,Mobile Deposit,17576.2
27319,757194408,07-12-24 18:28,275.41,Payment,Loan Payment,17300.79
27320,757194408,7-14-24 21:28,2100,Payment,Rent Payment,15200.79
27321,757194408,7-15-24 14:28,416.3,OnlineShopping,Target,14784.49
27322,758331483,1-20-24 12:28,207.67,Purchase,Entertainment,478.2739893
27323,758331483,1-20-24 15:28,319.7,Purchase,Restaurant,158.5739893
27324,758331483,1-20-24 22:28,284.9,Deposit,Check Deposit,443.4739893
27325,758331483,1-27-24 10:28,246.76,Return,Target Return,690.2339893
27326,758331483,1-29-24 14:28,75.65,Purchase,Furniture,614.5839893
27327,758331483,1-29-24 23:28,216.14,Purchase,Travel,398.4439893
27328,758331483,02-01-24 21:28,6100,IncomingTransfer,Salary,6498.443989
27329,758331483,02-03-24 18:28,285.24,Deposit,Mobile Deposit,6783.683989
27330,758331483,02-06-24 18:28,280.91,Return,Amazon Return,7064.593989
27331,758331483,02-06-24 21:28,1000,Payment,Credit Card Payment,6064.593989
27332,758331483,02-09-24 15:28,310.07,Payment,Mortgage Payment,5754.523989
27333,758331483,02-10-24 18:28,170.91,OnlineShopping,AliExpress,5583.613989
27334,758331483,02-12-24 13:28,349.71,Withdrawal,ATM Withdrawal,5233.903989
27335,758331483,02-12-24 18:28,212.15,Return,AliExpress Return,5446.053989
27336,758331483,02-12-24 22:28,432.11,Deposit,Mobile Deposit,5878.163989
27337,758331483,2-14-24 19:28,223.64,OnlineShopping,eBay,5654.523989
27338,758331483,2-16-24 23:28,219.43,Return,Walmart Return,5873.953989
27339,758331483,2-17-24 14:28,65.95,Purchase,Home Improvement,5808.003989
27340,758331483,2-18-24 21:28,2100,Payment,Installment Payment,3708.003989
27341,758331483,2-22-24 21:28,436.36,Purchase,Clothing,3271.643989
27342,758331483,2-22-24 23:28,473.26,Payment,Mortgage Payment,2798.383989
27343,758331483,2-25-24 12:28,187.87,IncomingTransfer,Freelance Payment,2986.253989
27344,758331483,2-25-24 15:28,493.2,Purchase,Grocery,2493.053989
27345,758331483,2-26-24 18:28,355.61,Withdrawal,Mobile App Withdrawal,2137.443989
27346,758331483,2-29-24 14:28,123.3,Purchase,Restaurant,2014.143989
27347,758331483,2-29-24 16:28,319.99,Withdrawal,Mobile App Withdrawal,1694.153989
27348,758331483,2-29-24 21:28,114.22,OnlineShopping,Best Buy,1579.933989
27349,758331483,03-05-24 21:28,6100,IncomingTransfer,Salary,7679.933989
27350,758331483,03-07-24 14:28,80.24,OutgoingTransfer,International Transfer,7599.693989
27351,758331483,03-09-24 10:28,81.14,Return,Target Return,7680.833989
27352,758331483,03-10-24 21:28,1400,Payment,Credit Card Payment,6280.833989
27353,758331483,03-11-24 22:28,222.13,Return,Walmart Return,6502.963989
27354,758331483,3-13-24 21:28,2200,Payment,Subscription Payment,4302.963989
27355,758331483,3-15-24 9:28,185.62,Deposit,Cash Deposit,4488.583989
27356,758331483,3-15-24 23:28,228.86,Withdrawal,Mobile App Withdrawal,4259.723989
27357,758331483,3-16-24 15:28,327.18,Deposit,Mobile Deposit,4586.903989
27358,758331483,3-16-24 21:28,300.08,Return,Etsy Return,4886.983989
27359,758331483,3-18-24 11:28,446.83,Withdrawal,ATM Withdrawal,4440.153989
27360,758331483,3-18-24 22:28,173.86,Purchase,Grocery,4266.293989
27361,758331483,3-19-24 15:28,356.19,Return,Amazon Return,4622.483989
27362,758331483,3-22-24 16:28,182.2,Deposit,Check Deposit,4804.683989
27363,758331483,3-26-24 15:28,458.91,IncomingTransfer,Freelance Payment,5263.593989
27364,758331483,3-27-24 20:28,338.42,Payment,Loan Payment,4925.173989
27365,758331483,3-29-24 9:28,469.89,Deposit,Direct Deposit,5395.063989
27366,758331483,3-29-24 17:28,484.73,Payment,Mortgage Payment,4910.333989
27367,758331483,04-01-24 22:28,114.68,Withdrawal,Branch Withdrawal,4795.653989
27368,758331483,04-04-24 11:28,427.42,Deposit,Cash Deposit,5223.073989
27369,758331483,04-05-24 18:28,240.97,OutgoingTransfer,Peer-to-Peer Transfer,4982.103989
27370,758331483,04-05-24 21:28,6100,IncomingTransfer,Salary,11082.10399
27371,758331483,04-06-24 17:28,243.02,Deposit,Direct Deposit,11325.12399
27372,758331483,04-07-24 13:28,233.15,Withdrawal,Branch Withdrawal,11091.97399
27373,758331483,04-07-24 16:28,150.87,OutgoingTransfer,Peer-to-Peer Transfer,10941.10399
27374,758331483,04-07-24 16:28,190.59,Deposit,Direct Deposit,11131.69399
27375,758331483,04-09-24 14:28,475.17,Return,Store Return,11606.86399
27376,758331483,04-09-24 16:28,124.5,Deposit,Direct Deposit,11731.36399
27377,758331483,04-10-24 14:28,60.99,Withdrawal,Branch Withdrawal,11670.37399
27378,758331483,04-10-24 18:28,476.63,OutgoingTransfer,Wire Transfer,11193.74399
27379,758331483,04-10-24 21:28,1500,Payment,Credit Card Payment,9693.743989
27380,758331483,04-12-24 11:28,281.45,Payment,Mortgage Payment,9412.293989
27381,758331483,04-12-24 17:28,533.08,Return,eBay Return,9945.373989
27382,758331483,4-13-24 13:28,324.77,Withdrawal,ATM Withdrawal,9620.603989
27383,758331483,4-13-24 18:28,390.7,Deposit,Check Deposit,10011.30399
27384,758331483,4-13-24 20:28,304.49,Payment,Mortgage Payment,9706.813989
27385,758331483,4-15-24 20:28,197.29,Payment,Mortgage Payment,9509.523989
27386,758331483,4-15-24 21:28,2700,Payment,Subscription Payment,6809.523989
27387,758331483,4-17-24 14:28,227.02,Purchase,Travel,6582.503989
27388,758331483,4-18-24 16:28,246.2,Return,eBay Return,6828.703989
27389,758331483,4-21-24 11:28,182.51,Purchase,Electronics,6646.193989
27390,758331483,4-21-24 11:28,309.61,Return,Etsy Return,6955.803989
27391,758331483,4-22-24 20:28,196.98,Purchase,Pharmacy,6758.823989
27392,758331483,4-22-24 21:28,147.31,OutgoingTransfer,International Transfer,6611.513989
27393,758331483,4-24-24 11:28,72.06,Payment,Loan Payment,6539.453989
27394,758331483,4-27-24 19:28,304.61,Purchase,Home Improvement,6234.843989
27395,758331483,4-29-24 17:28,135.31,OnlineShopping,Walmart,6099.533989
27396,758331483,05-01-24 21:28,6100,IncomingTransfer,Salary,12199.53399
27397,758331483,05-04-24 21:28,457.23,Purchase,Pharmacy,11742.30399
27398,758331483,05-06-24 13:28,199.18,Return,Walmart Return,11941.48399
27399,758331483,05-06-24 21:28,1300,Payment,Credit Card Payment,10641.48399
27400,758331483,05-08-24 20:28,225.45,Withdrawal,Mobile App Withdrawal,10416.03399
27401,758331483,05-09-24 18:28,356.38,Withdrawal,Mobile App Withdrawal,10059.65399
27402,758331483,05-10-24 21:28,2600,Payment,Insurance Payment,7459.653989
27403,758331483,5-16-24 21:28,50.35,Withdrawal,Mobile App Withdrawal,7409.303989
27404,758331483,5-17-24 19:28,480.04,Purchase,Entertainment,6929.263989
27405,758331483,5-18-24 14:28,492.18,OutgoingTransfer,Peer-to-Peer Transfer,6437.083989
27406,758331483,5-18-24 22:28,451.36,Withdrawal,ATM Withdrawal,5985.723989
27407,758331483,5-19-24 14:28,137.65,OnlineShopping,Best Buy,5848.073989
27408,758331483,5-19-24 15:28,438.36,Deposit,Direct Deposit,6286.433989
27409,758331483,5-22-24 16:28,330.33,Payment,Bill Payment,5956.103989
27410,758331483,5-22-24 20:28,100.53,Deposit,Check Deposit,6056.633989
27411,758331483,5-24-24 19:28,106.52,Return,Walmart Return,6163.153989
27412,758331483,5-25-24 14:28,378.46,Payment,Bill Payment,5784.693989
27413,758331483,5-25-24 20:28,214.85,IncomingTransfer,Freelance Payment,5999.543989
27414,758331483,5-31-24 12:28,276.49,Payment,Bill Payment,5723.053989
27415,758331483,06-03-24 23:28,523.55,Withdrawal,Mobile App Withdrawal,5199.503989
27416,758331483,06-04-24 21:28,6100,IncomingTransfer,Salary,11299.50399
27417,758331483,06-06-24 15:28,506.61,Return,Target Return,11806.11399
27418,758331483,06-07-24 13:28,383.01,Deposit,Direct Deposit,12189.12399
27419,758331483,06-09-24 21:28,1100,Payment,Credit Card Payment,11089.12399
27420,758331483,06-10-24 20:28,224.54,Payment,Mortgage Payment,10864.58399
27421,758331483,06-11-24 21:28,2200,Payment,Installment Payment,8664.583989
27422,758331483,6-13-24 17:28,306.51,Purchase,Electronics,8358.073989
27423,758331483,6-16-24 11:28,164.6,Return,Store Return,8522.673989
27424,758331483,6-17-24 22:28,95.1,Return,Walmart Return,8617.773989
27425,758331483,6-18-24 12:28,513.03,OutgoingTransfer,Peer-to-Peer Transfer,8104.743989
27426,758331483,6-19-24 11:28,260.75,Return,AliExpress Return,8365.493989
27427,758331483,6-19-24 12:28,132.73,Purchase,Gas,8232.763989
27428,758331483,6-20-24 10:28,418.38,OnlineShopping,Target,7814.383989
27429,758331483,6-21-24 22:28,185.94,Deposit,Cash Deposit,8000.323989
27430,758331483,6-23-24 12:28,70.36,Purchase,Restaurant,7929.963989
27431,758331483,6-25-24 16:28,166.85,Return,Best Buy Return,8096.813989
27432,758331483,6-30-24 15:28,504.5,OutgoingTransfer,Wire Transfer,7592.313989
27433,758331483,07-01-24 13:28,229.08,Payment,Mortgage Payment,7363.233989
27434,758331483,07-01-24 17:28,194.33,Purchase,Entertainment,7168.903989
27435,758331483,07-02-24 21:28,6100,IncomingTransfer,Salary,13268.90399
27436,758331483,07-03-24 20:28,87.9,Deposit,Mobile Deposit,13356.80399
27437,758331483,07-07-24 13:28,406.5,Withdrawal,Mobile App Withdrawal,12950.30399
27438,758331483,07-07-24 21:28,1300,Payment,Credit Card Payment,11650.30399
27439,758331483,07-08-24 10:28,501.19,Deposit,Direct Deposit,12151.49399
27440,758331483,07-10-24 9:28,142.72,Purchase,Travel,12008.77399
27441,758331483,07-10-24 19:28,80.45,Withdrawal,ATM Withdrawal,11928.32399
27442,758331483,07-11-24 14:28,371.31,Withdrawal,ATM Withdrawal,11557.01399
27443,758331483,07-11-24 21:28,2200,Payment,Insurance Payment,9357.013989
27444,758331483,7-13-24 11:28,400.83,Purchase,Entertainment,8956.183989
27445,758331483,7-13-24 15:28,209.22,Deposit,Cash Deposit,9165.403989
27446,758331483,7-14-24 11:28,69.84,Withdrawal,Mobile App Withdrawal,9095.563989
27447,758331483,7-16-24 16:28,118.96,Withdrawal,Branch Withdrawal,8976.603989
27448,758331483,7-17-24 20:28,498.11,Withdrawal,Branch Withdrawal,8478.493989
27449,765940683,1-28-24 10:28,110.54,Payment,Bill Payment,801.3784512
27450,765940683,1-29-24 12:28,294.01,OnlineShopping,Walmart,507.3684512
27451,765940683,1-31-24 17:28,681.03,Withdrawal,Mobile App Withdrawal,-173.6615488
27452,765940683,02-01-24 11:28,125.44,OnlineShopping,Amazon,-299.1015488
27453,765940683,02-04-24 21:28,9700,IncomingTransfer,Salary,9400.898451
27454,765940683,02-09-24 21:28,2600,Payment,Credit Card Payment,6800.898451
27455,765940683,02-10-24 14:28,575.57,OnlineShopping,Target,6225.328451
27456,765940683,02-11-24 21:28,322.2,Deposit,Direct Deposit,6547.528451
27457,765940683,2-13-24 21:28,185.95,Purchase,Clothing,6361.578451
27458,765940683,2-14-24 21:28,3200,Payment,Rent Payment,3161.578451
27459,765940683,2-19-24 13:28,504.87,Withdrawal,Mobile App Withdrawal,2656.708451
27460,765940683,2-25-24 20:28,257.02,OutgoingTransfer,Peer-to-Peer Transfer,2399.688451
27461,765940683,2-27-24 11:28,522.98,Withdrawal,Branch Withdrawal,1876.708451
27462,765940683,2-28-24 20:28,416.09,Return,Amazon Return,2292.798451
27463,765940683,2-29-24 21:28,410.51,OutgoingTransfer,Bank Transfer,1882.288451
27464,765940683,03-01-24 18:28,256.65,Withdrawal,ATM Withdrawal,1625.638451
27465,765940683,03-02-24 21:28,465.68,Return,Amazon Return,2091.318451
27466,765940683,03-04-24 15:28,534.27,Deposit,Mobile Deposit,2625.588451
27467,765940683,03-05-24 10:28,382.12,Purchase,Gas,2243.468451
27468,765940683,03-05-24 21:28,9700,IncomingTransfer,Salary,11943.46845
27469,765940683,03-08-24 18:28,437.05,IncomingTransfer,Freelance Payment,12380.51845
27470,765940683,03-10-24 18:28,395.11,Deposit,Direct Deposit,12775.62845
27471,765940683,03-10-24 19:28,108.24,Withdrawal,ATM Withdrawal,12667.38845
27472,765940683,03-10-24 21:28,2300,Payment,Credit Card Payment,10367.38845
27473,765940683,03-12-24 13:28,663.02,Purchase,Pharmacy,9704.368451
27474,765940683,3-13-24 11:28,117.41,Purchase,Gas,9586.958451
27475,765940683,3-15-24 17:28,351.94,Return,AliExpress Return,9938.898451
27476,765940683,3-16-24 21:28,5100,Payment,Rent Payment,4838.898451
27477,765940683,3-18-24 11:28,516.18,Return,AliExpress Return,5355.078451
27478,765940683,3-18-24 23:28,350.68,Deposit,Cash Deposit,5705.758451
27479,765940683,3-20-24 9:28,390.98,Return,Walmart Return,6096.738451
27480,765940683,3-24-24 21:28,591.92,Deposit,Cash Deposit,6688.658451
27481,765940683,3-25-24 15:28,688.98,Return,Best Buy Return,7377.638451
27482,765940683,3-29-24 11:28,526.13,OnlineShopping,Best Buy,6851.508451
27483,765940683,04-02-24 17:28,606.97,Withdrawal,Mobile App Withdrawal,6244.538451
27484,765940683,04-02-24 21:28,9700,IncomingTransfer,Salary,15944.53845
27485,765940683,04-02-24 22:28,379.79,Deposit,Direct Deposit,16324.32845
27486,765940683,04-07-24 14:28,241.43,Purchase,Pharmacy,16082.89845
27487,765940683,04-07-24 21:28,1800,Payment,Credit Card Payment,14282.89845
27488,765940683,04-08-24 16:28,155.18,Return,Etsy Return,14438.07845
27489,765940683,04-11-24 13:28,488.11,Deposit,Direct Deposit,14926.18845
27490,765940683,4-15-24 21:28,3800,Payment,Rent Payment,11126.18845
27491,765940683,4-19-24 17:28,119.5,Return,Etsy Return,11245.68845
27492,765940683,4-22-24 16:28,172.46,Payment,Loan Payment,11073.22845
27493,765940683,4-24-24 14:28,745.39,Purchase,Electronics,10327.83845
27494,765940683,4-24-24 21:28,533.51,Deposit,Mobile Deposit,10861.34845
27495,765940683,4-25-24 11:28,445.76,Purchase,Electronics,10415.58845
27496,765940683,4-27-24 11:28,523.6,Deposit,Direct Deposit,10939.18845
27497,765940683,05-02-24 21:28,9700,IncomingTransfer,Salary,20639.18845
27498,765940683,05-05-24 10:28,362.71,Payment,Mortgage Payment,20276.47845
27499,765940683,05-05-24 22:28,710.73,Return,Amazon Return,20987.20845
27500,765940683,05-07-24 21:28,2600,Payment,Credit Card Payment,18387.20845
27501,765940683,05-10-24 20:28,589.72,Deposit,Check Deposit,18976.92845
27502,765940683,05-11-24 21:28,3800,Payment,Rent Payment,15176.92845
27503,765940683,5-16-24 18:28,131.7,Deposit,Direct Deposit,15308.62845
27504,765940683,5-25-24 13:28,597.4,Purchase,Clothing,14711.22845
27505,765940683,5-25-24 20:28,147.25,Deposit,Direct Deposit,14858.47845
27506,765940683,5-28-24 14:28,629.11,Deposit,Direct Deposit,15487.58845
27507,765940683,06-03-24 16:28,594.85,Payment,Loan Payment,14892.73845
27508,765940683,06-03-24 21:28,9700,IncomingTransfer,Salary,24592.73845
27509,765940683,06-05-24 16:28,527.31,OutgoingTransfer,Peer-to-Peer Transfer,24065.42845
27510,765940683,06-08-24 21:28,2400,Payment,Credit Card Payment,21665.42845
27511,765940683,06-09-24 10:28,244.44,Withdrawal,ATM Withdrawal,21420.98845
27512,765940683,06-10-24 9:28,456.26,Payment,Mortgage Payment,20964.72845
27513,765940683,6-18-24 21:28,4400,Payment,Rent Payment,16564.72845
27514,765940683,6-21-24 11:28,327.72,Withdrawal,Mobile App Withdrawal,16237.00845
27515,765940683,6-22-24 16:28,321.26,OutgoingTransfer,Wire Transfer,15915.74845
27516,765940683,07-04-24 21:28,9700,IncomingTransfer,Salary,25615.74845
27517,765940683,07-05-24 12:28,328.62,OutgoingTransfer,Bank Transfer,25287.12845
27518,765940683,07-09-24 21:28,2100,Payment,Credit Card Payment,23187.12845
27519,765940683,07-09-24 22:28,153.95,Purchase,Travel,23033.17845
27520,765940683,7-13-24 21:28,598.39,Deposit,Cash Deposit,23631.56845
27521,765940683,7-14-24 21:28,5100,Payment,Rent Payment,18531.56845
27522,765940683,7-16-24 23:28,680.27,Deposit,Mobile Deposit,19211.83845
27523,766131033,1-20-24 22:28,206.68,Deposit,Mobile Deposit,954.6423893
27524,766131033,1-22-24 10:28,63.23,Withdrawal,Branch Withdrawal,891.4123893
27525,766131033,1-25-24 12:28,164.04,Purchase,Electronics,727.3723893
27526,766131033,1-31-24 12:28,99.26,OutgoingTransfer,International Transfer,628.1123893
27527,766131033,02-01-24 15:28,24.29,Deposit,Mobile Deposit,652.4023893
27528,766131033,02-02-24 21:28,1750,IncomingTransfer,Salary,2402.402389
27529,766131033,02-05-24 21:28,76.5,Purchase,Restaurant,2325.902389
27530,766131033,02-06-24 20:28,136.66,Withdrawal,Branch Withdrawal,2189.242389
27531,766131033,02-07-24 21:28,1200,Payment,Credit Card Payment,989.2423893
27532,766131033,02-09-24 18:28,89.42,Purchase,Clothing,899.8223893
27533,766131033,02-09-24 22:28,76.77,Purchase,Travel,823.0523893
27534,766131033,02-11-24 17:28,120.17,OutgoingTransfer,International Transfer,702.8823893
27535,766131033,02-11-24 21:28,500,Payment,Insurance Payment,202.8823893
27536,766131033,02-12-24 13:28,148.08,OnlineShopping,Amazon,54.80238934
27537,766131033,2-14-24 23:28,160.29,Payment,Loan Payment,-105.4876107
27538,766131033,2-16-24 10:28,79.91,OutgoingTransfer,Peer-to-Peer Transfer,-185.3976107
27539,766131033,2-17-24 21:28,224.86,Payment,Loan Payment,-410.2576107
27540,766131033,2-26-24 9:28,42.91,OnlineShopping,eBay,-453.1676107
27541,766131033,2-26-24 12:28,197.47,Purchase,Furniture,-650.6376107
27542,766131033,2-27-24 10:28,148.02,Withdrawal,Branch Withdrawal,-798.6576107
27543,766131033,2-27-24 13:28,49.96,IncomingTransfer,Freelance Payment,-748.6976107
27544,766131033,2-27-24 14:28,150.3,Return,Walmart Return,-598.3976107
27545,766131033,03-01-24 11:28,123.35,Return,eBay Return,-475.0476107
27546,766131033,03-02-24 21:28,1750,IncomingTransfer,Salary,1274.952389
27547,766131033,03-07-24 21:28,1200,Payment,Credit Card Payment,74.95238934
27548,766131033,03-08-24 12:28,129.27,Purchase,Restaurant,-54.31761066
27549,766131033,03-09-24 17:28,232.02,OutgoingTransfer,International Transfer,-286.3376107
27550,766131033,03-11-24 21:28,700,Payment,Subscription Payment,-986.3376107
27551,766131033,03-12-24 16:28,73.3,IncomingTransfer,Freelance Payment,-913.0376107
27552,766131033,3-16-24 13:28,38.09,IncomingTransfer,Freelance Payment,-874.9476107
27553,766131033,3-20-24 11:28,196.98,Purchase,Grocery,-1071.927611
27554,766131033,3-21-24 15:28,243.31,Payment,Loan Payment,-1315.237611
27555,766131033,3-29-24 17:28,217.94,IncomingTransfer,Freelance Payment,-1097.297611
27556,766131033,3-31-24 18:28,66.91,Return,AliExpress Return,-1030.387611
27557,766131033,04-01-24 14:28,152.54,Deposit,Cash Deposit,-877.8476107
27558,766131033,04-01-24 21:28,1750,IncomingTransfer,Salary,872.1523893
27559,766131033,04-02-24 12:28,118.56,OnlineShopping,Etsy,753.5923893
27560,766131033,04-03-24 14:28,167.15,Purchase,Clothing,586.4423893
27561,766131033,04-06-24 21:28,1100,Payment,Credit Card Payment,-513.5576107
27562,766131033,04-09-24 18:28,17.58,Deposit,Direct Deposit,-495.9776107
27563,766131033,04-10-24 13:28,228.23,OutgoingTransfer,Wire Transfer,-724.2076107
27564,766131033,04-10-24 21:28,600,Payment,Subscription Payment,-1324.207611
27565,766131033,04-11-24 16:28,154.83,Purchase,Restaurant,-1479.037611
27566,766131033,4-16-24 15:28,179.37,Return,AliExpress Return,-1299.667611
27567,766131033,4-19-24 17:28,180.38,Purchase,Restaurant,-1480.047611
27568,766131033,4-19-24 18:28,22.47,Payment,Mortgage Payment,-1502.517611
27569,766131033,4-23-24 15:28,75,Purchase,Grocery,-1577.517611
27570,766131033,4-25-24 16:28,52.63,Deposit,Direct Deposit,-1524.887611
27571,766131033,05-02-24 17:28,136.17,Withdrawal,ATM Withdrawal,-1661.057611
27572,766131033,05-02-24 21:28,1750,IncomingTransfer,Salary,88.94238934
27573,766131033,05-03-24 18:28,55.97,Purchase,Furniture,32.97238934
27574,766131033,05-04-24 21:28,99.07,IncomingTransfer,Freelance Payment,132.0423893
27575,766131033,05-06-24 22:28,185.71,Payment,Loan Payment,-53.66761066
27576,766131033,05-07-24 21:28,1100,Payment,Credit Card Payment,-1153.667611
27577,766131033,05-09-24 16:28,197.55,Deposit,Direct Deposit,-956.1176107
27578,766131033,05-10-24 21:28,219.32,Deposit,Direct Deposit,-736.7976107
27579,766131033,05-12-24 21:28,600,Payment,Subscription Payment,-1336.797611
27580,766131033,5-16-24 9:28,138.95,Purchase,Pharmacy,-1475.747611
27581,766131033,5-17-24 23:28,196.54,Return,Best Buy Return,-1279.207611
27582,766131033,5-20-24 10:28,222.14,Return,Target Return,-1057.067611
27583,766131033,5-22-24 18:28,88.42,Deposit,Cash Deposit,-968.6476107
27584,766131033,06-02-24 21:28,1750,IncomingTransfer,Salary,781.3523893
27585,766131033,06-05-24 17:28,134.62,Purchase,Grocery,646.7323893
27586,766131033,06-07-24 21:28,1100,Payment,Credit Card Payment,-453.2676107
27587,766131033,06-08-24 11:28,22.55,Purchase,Home Improvement,-475.8176107
27588,766131033,06-10-24 9:28,238.65,Withdrawal,ATM Withdrawal,-714.4676107
27589,766131033,06-10-24 21:28,249.88,Purchase,Gas,-964.3476107
27590,766131033,06-11-24 20:28,231.95,IncomingTransfer,Freelance Payment,-732.3976107
27591,766131033,6-14-24 18:28,58.74,Deposit,Check Deposit,-673.6576107
27592,766131033,6-14-24 21:28,500,Payment,Insurance Payment,-1173.657611
27593,766131033,6-16-24 22:28,242.64,Deposit,Cash Deposit,-931.0176107
27594,766131033,07-01-24 11:28,224.5,OnlineShopping,eBay,-1155.517611
27595,766131033,07-01-24 18:28,243.27,Purchase,Entertainment,-1398.787611
27596,766131033,07-02-24 21:28,1750,IncomingTransfer,Salary,351.2123893
27597,766131033,07-05-24 14:28,42.46,IncomingTransfer,Freelance Payment,393.6723893
27598,766131033,07-07-24 21:28,1200,Payment,Credit Card Payment,-806.3276107
27599,766131033,7-15-24 17:28,139.01,IncomingTransfer,Freelance Payment,-667.3176107
27600,766131033,7-18-24 21:28,700,Payment,Installment Payment,-1367.317611
27601,766456683,1-21-24 11:28,36.76,OnlineShopping,Etsy,1488.480807
27602,766456683,1-21-24 16:28,49.33,Deposit,Direct Deposit,1537.810807
27603,766456683,1-22-24 12:28,188.54,OnlineShopping,Walmart,1349.270807
27604,766456683,1-24-24 17:28,160.47,Deposit,Check Deposit,1509.740807
27605,766456683,1-29-24 18:28,187.51,Withdrawal,ATM Withdrawal,1322.230807
27606,766456683,1-31-24 22:28,39.86,IncomingTransfer,Freelance Payment,1362.090807
27607,766456683,02-01-24 21:28,3350,IncomingTransfer,Salary,4712.090807
27608,766456683,02-03-24 13:28,32.46,OnlineShopping,Amazon,4679.630807
27609,766456683,02-06-24 21:28,2600,Payment,Credit Card Payment,2079.630807
27610,766456683,02-07-24 15:28,96.94,Purchase,Clothing,1982.690807
27611,766456683,02-08-24 23:28,29.62,Withdrawal,ATM Withdrawal,1953.070807
27612,766456683,02-10-24 17:28,217.41,Purchase,Furniture,1735.660807
27613,766456683,02-12-24 21:28,1300,Payment,Installment Payment,435.6608065
27614,766456683,2-13-24 19:28,93.53,Deposit,Check Deposit,529.1908065
27615,766456683,2-14-24 15:28,142.95,Payment,Mortgage Payment,386.2408065
27616,766456683,2-20-24 22:28,26.41,Purchase,Travel,359.8308065
27617,766456683,2-29-24 11:28,81.73,Withdrawal,Branch Withdrawal,278.1008065
27618,766456683,03-04-24 21:28,3350,IncomingTransfer,Salary,3628.100807
27619,766456683,03-05-24 17:28,60.59,IncomingTransfer,Freelance Payment,3688.690807
27620,766456683,03-06-24 12:28,231.18,Withdrawal,ATM Withdrawal,3457.510807
27621,766456683,03-08-24 23:28,74.4,Withdrawal,ATM Withdrawal,3383.110807
27622,766456683,03-09-24 21:28,2300,Payment,Credit Card Payment,1083.110807
27623,766456683,03-10-24 11:28,54.26,Purchase,Home Improvement,1028.850807
27624,766456683,03-10-24 22:28,82.43,Payment,Mortgage Payment,946.4208065
27625,766456683,3-16-24 21:28,1000,Payment,Subscription Payment,-53.57919347
27626,766456683,3-18-24 18:28,45.25,Return,Walmart Return,-8.32919347
27627,766456683,3-18-24 18:28,160.73,OnlineShopping,Amazon,-169.0591935
27628,766456683,3-20-24 19:28,214.1,Deposit,Mobile Deposit,45.04080653
27629,766456683,3-20-24 23:28,203.2,Payment,Loan Payment,-158.1591935
27630,766456683,3-21-24 12:28,122.78,Purchase,Travel,-280.9391935
27631,766456683,3-22-24 9:28,194.73,Deposit,Cash Deposit,-86.20919347
27632,766456683,3-22-24 12:28,230.87,Return,AliExpress Return,144.6608065
27633,766456683,3-26-24 18:28,34.67,Withdrawal,ATM Withdrawal,109.9908065
27634,766456683,3-27-24 16:28,165.11,Return,Etsy Return,275.1008065
27635,766456683,04-02-24 14:28,202.1,Purchase,Gas,73.00080653
27636,766456683,04-03-24 21:28,3350,IncomingTransfer,Salary,3423.000807
27637,766456683,04-05-24 9:28,25.51,Deposit,Mobile Deposit,3448.510807
27638,766456683,04-05-24 17:28,218.65,Payment,Mortgage Payment,3229.860807
27639,766456683,04-07-24 21:28,63.09,Purchase,Home Improvement,3166.770807
27640,766456683,04-07-24 22:28,184.78,Return,Best Buy Return,3351.550807
27641,766456683,04-08-24 21:28,2800,Payment,Credit Card Payment,551.5508065
27642,766456683,04-11-24 21:28,138.51,Withdrawal,Mobile App Withdrawal,413.0408065
27643,766456683,4-15-24 21:28,1400,Payment,Subscription Payment,-986.9591935
27644,766456683,4-18-24 12:28,140.24,IncomingTransfer,Freelance Payment,-846.7191935
27645,766456683,4-18-24 16:28,55.19,Withdrawal,ATM Withdrawal,-901.9091935
27646,766456683,4-19-24 9:28,131.03,Purchase,Travel,-1032.939193
27647,766456683,4-20-24 12:28,194.12,Deposit,Check Deposit,-838.8191935
27648,766456683,4-21-24 22:28,50.14,OnlineShopping,eBay,-888.9591935
27649,766456683,4-22-24 20:28,128.76,OutgoingTransfer,Bank Transfer,-1017.719193
27650,766456683,4-26-24 23:28,103.24,Payment,Mortgage Payment,-1120.959193
27651,766456683,05-02-24 18:28,71.32,Withdrawal,ATM Withdrawal,-1192.279193
27652,766456683,05-03-24 11:28,114.03,Deposit,Check Deposit,-1078.249193
27653,766456683,05-03-24 21:28,3350,IncomingTransfer,Salary,2271.750807
27654,766456683,05-05-24 21:28,48.72,Deposit,Check Deposit,2320.470807
27655,766456683,05-08-24 21:28,2900,Payment,Credit Card Payment,-579.5291935
27656,766456683,05-10-24 10:28,80.05,Withdrawal,Branch Withdrawal,-659.5791935
27657,766456683,05-12-24 14:28,109.73,IncomingTransfer,Freelance Payment,-549.8491935
27658,766456683,05-12-24 21:28,1400,Payment,Insurance Payment,-1949.849193
27659,766456683,05-12-24 22:28,40.9,Purchase,Grocery,-1990.749193
27660,766456683,5-14-24 15:28,223.53,OutgoingTransfer,Peer-to-Peer Transfer,-2214.279193
27661,766456683,5-17-24 21:28,45.98,Return,eBay Return,-2168.299193
27662,766456683,5-23-24 17:28,247.14,OnlineShopping,Best Buy,-2415.439193
27663,766456683,5-24-24 14:28,154.4,Payment,Mortgage Payment,-2569.839193
27664,766456683,5-25-24 19:28,77.22,Purchase,Pharmacy,-2647.059193
27665,766456683,5-26-24 11:28,243.56,OutgoingTransfer,Wire Transfer,-2890.619193
27666,766456683,5-27-24 12:28,63.73,Payment,Bill Payment,-2954.349193
27667,766456683,5-28-24 17:28,93.28,OutgoingTransfer,Wire Transfer,-3047.629193
27668,766456683,5-31-24 22:28,124.7,Deposit,Check Deposit,-2922.929193
27669,766456683,06-01-24 13:28,180.1,IncomingTransfer,Freelance Payment,-2742.829193
27670,766456683,06-01-24 18:28,223.27,Return,Store Return,-2519.559193
27671,766456683,06-03-24 12:28,115.03,OutgoingTransfer,Bank Transfer,-2634.589193
27672,766456683,06-03-24 21:28,3350,IncomingTransfer,Salary,715.4108065
27673,766456683,06-06-24 9:28,239.44,OutgoingTransfer,International Transfer,475.9708065
27674,766456683,06-06-24 21:28,180.57,Deposit,Check Deposit,656.5408065
27675,766456683,06-08-24 21:28,2500,Payment,Credit Card Payment,-1843.459193
27676,766456683,06-09-24 19:28,171.48,OutgoingTransfer,Wire Transfer,-2014.939193
27677,766456683,06-11-24 21:28,1200,Payment,Insurance Payment,-3214.939193
27678,766456683,6-17-24 17:28,247.05,Deposit,Cash Deposit,-2967.889193
27679,766456683,6-18-24 16:28,64.79,Withdrawal,ATM Withdrawal,-3032.679193
27680,766456683,6-19-24 14:28,83.97,Return,AliExpress Return,-2948.709193
27681,766456683,6-20-24 10:28,38.41,Purchase,Furniture,-2987.119193
27682,766456683,6-21-24 12:28,39.94,Withdrawal,ATM Withdrawal,-3027.059193
27683,766456683,6-21-24 18:28,56.94,Withdrawal,Branch Withdrawal,-3083.999193
27684,766456683,6-27-24 20:28,11.73,Withdrawal,Mobile App Withdrawal,-3095.729193
27685,766456683,6-28-24 20:28,179.04,OutgoingTransfer,Bank Transfer,-3274.769193
27686,766456683,6-29-24 17:28,207.22,OnlineShopping,Amazon,-3481.989193
27687,766456683,6-30-24 13:28,212.52,Deposit,Cash Deposit,-3269.469193
27688,766456683,07-01-24 21:28,3350,IncomingTransfer,Salary,80.53080653
27689,766456683,07-03-24 12:28,20.99,Deposit,Cash Deposit,101.5208065
27690,766456683,07-05-24 16:28,166.82,Payment,Loan Payment,-65.29919347
27691,766456683,07-06-24 18:28,57.78,Withdrawal,Branch Withdrawal,-123.0791935
27692,766456683,07-06-24 21:28,2700,Payment,Credit Card Payment,-2823.079193
27693,766456683,07-07-24 13:28,153.16,Purchase,Pharmacy,-2976.239193
27694,766456683,07-07-24 19:28,37.56,Deposit,Mobile Deposit,-2938.679193
27695,766456683,07-09-24 9:28,137.17,Purchase,Grocery,-3075.849193
27696,766456683,07-12-24 20:28,126.46,Withdrawal,Mobile App Withdrawal,-3202.309193
27697,766456683,7-14-24 21:28,1400,Payment,Installment Payment,-4602.309193
27698,766456683,7-17-24 10:28,222.49,Purchase,Entertainment,-4824.799193
27699,768921933,1-28-24 10:28,370.39,Deposit,Cash Deposit,1713.096311
27700,768921933,02-03-24 21:28,6000,IncomingTransfer,Salary,7713.096311
27701,768921933,02-07-24 13:28,406.91,Purchase,Pharmacy,7306.186311
27702,768921933,02-08-24 21:28,2700,Payment,Credit Card Payment,4606.186311
27703,768921933,2-14-24 21:28,1500,Payment,Rent Payment,3106.186311
27704,768921933,2-20-24 22:28,198.36,Return,Store Return,3304.546311
27705,768921933,2-22-24 11:28,215.18,OnlineShopping,eBay,3089.366311
27706,768921933,2-25-24 13:28,505.69,Purchase,Pharmacy,2583.676311
27707,768921933,2-25-24 17:28,158.85,IncomingTransfer,Freelance Payment,2742.526311
27708,768921933,03-01-24 23:28,69.98,Deposit,Check Deposit,2812.506311
27709,768921933,03-02-24 10:28,82.51,OutgoingTransfer,Bank Transfer,2729.996311
27710,768921933,03-04-24 21:28,6000,IncomingTransfer,Salary,8729.996311
27711,768921933,03-09-24 11:28,252.67,Payment,Bill Payment,8477.326311
27712,768921933,03-09-24 17:28,444.75,Withdrawal,ATM Withdrawal,8032.576311
27713,768921933,03-09-24 21:28,2800,Payment,Credit Card Payment,5232.576311
27714,768921933,03-11-24 12:28,191.04,OutgoingTransfer,Wire Transfer,5041.536311
27715,768921933,3-14-24 21:28,3800,Payment,Rent Payment,1241.536311
27716,768921933,3-16-24 18:28,410.29,OutgoingTransfer,Bank Transfer,831.2463106
27717,768921933,3-20-24 10:28,220.02,Payment,Loan Payment,611.2263106
27718,768921933,3-23-24 10:28,472.86,Withdrawal,Mobile App Withdrawal,138.3663106
27719,768921933,3-24-24 22:28,168.24,Deposit,Cash Deposit,306.6063106
27720,768921933,3-26-24 23:28,225.62,Deposit,Cash Deposit,532.2263106
27721,768921933,3-28-24 11:28,88.05,IncomingTransfer,Freelance Payment,620.2763106
27722,768921933,04-01-24 21:28,6000,IncomingTransfer,Salary,6620.276311
27723,768921933,04-02-24 23:28,386.18,OutgoingTransfer,International Transfer,6234.096311
27724,768921933,04-05-24 23:28,475.17,Purchase,Furniture,5758.926311
27725,768921933,04-06-24 21:28,3300,Payment,Credit Card Payment,2458.926311
27726,768921933,04-07-24 12:28,73.12,IncomingTransfer,Freelance Payment,2532.046311
27727,768921933,04-08-24 22:28,350.02,Deposit,Cash Deposit,2882.066311
27728,768921933,04-11-24 14:28,507.7,OnlineShopping,Best Buy,2374.366311
27729,768921933,4-13-24 10:28,70.21,Withdrawal,ATM Withdrawal,2304.156311
27730,768921933,4-17-24 20:28,95.83,Purchase,Travel,2208.326311
27731,768921933,4-17-24 21:28,2600,Payment,Rent Payment,-391.6736894
27732,768921933,4-18-24 15:28,503.97,Purchase,Pharmacy,-895.6436894
27733,768921933,4-20-24 17:28,122.01,OutgoingTransfer,Wire Transfer,-1017.653689
27734,768921933,05-01-24 17:28,52.81,Return,Etsy Return,-964.8436894
27735,768921933,05-05-24 21:28,6000,IncomingTransfer,Salary,5035.156311
27736,768921933,05-06-24 14:28,295.61,Purchase,Pharmacy,4739.546311
27737,768921933,05-08-24 10:28,292.06,IncomingTransfer,Freelance Payment,5031.606311
27738,768921933,05-09-24 17:28,90.2,Deposit,Mobile Deposit,5121.806311
27739,768921933,05-10-24 21:28,2400,Payment,Credit Card Payment,2721.806311
27740,768921933,5-17-24 21:28,2900,Payment,Rent Payment,-178.1936894
27741,768921933,5-20-24 18:28,443.07,Withdrawal,Branch Withdrawal,-621.2636894
27742,768921933,5-23-24 9:28,55.41,OnlineShopping,Target,-676.6736894
27743,768921933,5-30-24 14:28,387.55,Purchase,Furniture,-1064.223689
27744,768921933,06-02-24 21:28,6000,IncomingTransfer,Salary,4935.776311
27745,768921933,06-05-24 23:28,412.25,OutgoingTransfer,Peer-to-Peer Transfer,4523.526311
27746,768921933,06-06-24 11:28,339.88,Withdrawal,Branch Withdrawal,4183.646311
27747,768921933,06-07-24 21:28,3000,Payment,Credit Card Payment,1183.646311
27748,768921933,6-14-24 13:28,209.54,Purchase,Restaurant,974.1063106
27749,768921933,6-15-24 21:28,2300,Payment,Rent Payment,-1325.893689
27750,768921933,6-20-24 22:28,475.86,Return,Store Return,-850.0336894
27751,768921933,6-25-24 18:28,210,Purchase,Restaurant,-1060.033689
27752,768921933,6-27-24 9:28,471.31,Withdrawal,Mobile App Withdrawal,-1531.343689
27753,768921933,6-29-24 12:28,64.05,Payment,Bill Payment,-1595.393689
27754,768921933,6-29-24 19:28,539.7,OnlineShopping,Walmart,-2135.093689
27755,768921933,6-30-24 17:28,294.85,OnlineShopping,AliExpress,-2429.943689
27756,768921933,07-02-24 21:28,6000,IncomingTransfer,Salary,3570.056311
27757,768921933,07-07-24 20:28,386.89,OutgoingTransfer,Bank Transfer,3183.166311
27758,768921933,07-07-24 21:28,3600,Payment,Credit Card Payment,-416.8336894
27759,768921933,07-10-24 10:28,307.34,Deposit,Check Deposit,-109.4936894
27760,768921933,07-10-24 21:28,3100,Payment,Rent Payment,-3209.493689
27761,768921933,7-14-24 11:28,459.34,Deposit,Check Deposit,-2750.153689
27762,768921933,7-15-24 13:28,423.53,Purchase,Pharmacy,-3173.683689
27763,768921933,7-17-24 22:28,141.93,OutgoingTransfer,International Transfer,-3315.613689
27764,769189083,1-24-24 20:28,240.61,Payment,Loan Payment,236.9040343
27765,769189083,1-25-24 20:28,194.09,OutgoingTransfer,International Transfer,42.81403431
27766,769189083,1-27-24 19:28,184.05,OutgoingTransfer,International Transfer,-141.2359657
27767,769189083,1-28-24 18:28,67.3,Purchase,Furniture,-208.5359657
27768,769189083,1-29-24 18:28,89.76,Withdrawal,ATM Withdrawal,-298.2959657
27769,769189083,1-31-24 9:28,165.67,Deposit,Mobile Deposit,-132.6259657
27770,769189083,02-02-24 10:28,138.57,Payment,Loan Payment,-271.1959657
27771,769189083,02-04-24 21:28,2650,IncomingTransfer,Salary,2378.804034
27772,769189083,02-06-24 15:28,45.98,Deposit,Check Deposit,2424.784034
27773,769189083,02-09-24 21:28,600,Payment,Credit Card Payment,1824.784034
27774,769189083,02-12-24 10:28,15.17,Purchase,Furniture,1809.614034
27775,769189083,2-13-24 10:28,159.2,Withdrawal,Mobile App Withdrawal,1650.414034
27776,769189083,2-15-24 21:28,1100,Payment,Rent Payment,550.4140343
27777,769189083,2-17-24 21:28,193.48,OutgoingTransfer,Wire Transfer,356.9340343
27778,769189083,2-20-24 17:28,211.08,Payment,Loan Payment,145.8540343
27779,769189083,2-22-24 10:28,187.65,Withdrawal,Mobile App Withdrawal,-41.79596569
27780,769189083,2-22-24 20:28,221.02,OutgoingTransfer,Wire Transfer,-262.8159657
27781,769189083,2-25-24 15:28,155.49,OnlineShopping,Walmart,-418.3059657
27782,769189083,2-25-24 22:28,86.77,OutgoingTransfer,Peer-to-Peer Transfer,-505.0759657
27783,769189083,2-26-24 23:28,146.92,Withdrawal,ATM Withdrawal,-651.9959657
27784,769189083,2-27-24 10:28,134.53,Purchase,Restaurant,-786.5259657
27785,769189083,2-27-24 14:28,190.75,Purchase,Grocery,-977.2759657
27786,769189083,2-28-24 22:28,206.75,IncomingTransfer,Freelance Payment,-770.5259657
27787,769189083,2-29-24 9:28,204.31,Payment,Bill Payment,-974.8359657
27788,769189083,2-29-24 12:28,124.69,OutgoingTransfer,Bank Transfer,-1099.525966
27789,769189083,2-29-24 13:28,68.88,Return,Etsy Return,-1030.645966
27790,769189083,03-04-24 21:28,2650,IncomingTransfer,Salary,1619.354034
27791,769189083,03-04-24 23:28,110.72,Return,Amazon Return,1730.074034
27792,769189083,03-06-24 14:28,89.07,OnlineShopping,Amazon,1641.004034
27793,769189083,03-09-24 10:28,200.65,Deposit,Check Deposit,1841.654034
27794,769189083,03-09-24 16:28,62.22,Payment,Bill Payment,1779.434034
27795,769189083,03-09-24 21:28,800,Payment,Credit Card Payment,979.4340343
27796,769189083,03-10-24 16:28,99.58,Withdrawal,Mobile App Withdrawal,879.8540343
27797,769189083,03-11-24 21:28,800,Payment,Rent Payment,79.85403431
27798,769189083,03-12-24 16:28,74.61,Return,Amazon Return,154.4640343
27799,769189083,3-15-24 19:28,181.62,Deposit,Mobile Deposit,336.0840343
27800,769189083,3-18-24 15:28,217.94,Withdrawal,Mobile App Withdrawal,118.1440343
27801,769189083,3-18-24 20:28,151.47,OutgoingTransfer,International Transfer,-33.32596569
27802,769189083,3-22-24 11:28,16.77,Purchase,Furniture,-50.09596569
27803,769189083,3-23-24 13:28,11.4,Deposit,Direct Deposit,-38.69596569
27804,769189083,3-23-24 22:28,218.63,Purchase,Electronics,-257.3259657
27805,769189083,3-26-24 9:28,29.77,Deposit,Direct Deposit,-227.5559657
27806,769189083,3-30-24 12:28,17.01,Deposit,Mobile Deposit,-210.5459657
27807,769189083,3-30-24 21:28,243.36,Purchase,Grocery,-453.9059657
27808,769189083,3-31-24 15:28,33.92,Deposit,Mobile Deposit,-419.9859657
27809,769189083,04-03-24 13:28,64.1,Withdrawal,ATM Withdrawal,-484.0859657
27810,769189083,04-03-24 21:28,2650,IncomingTransfer,Salary,2165.914034
27811,769189083,04-08-24 21:28,800,Payment,Credit Card Payment,1365.914034
27812,769189083,04-10-24 21:28,800,Payment,Rent Payment,565.9140343
27813,769189083,04-10-24 23:28,195.71,Purchase,Furniture,370.2040343
27814,769189083,04-12-24 17:28,13.73,Withdrawal,Mobile App Withdrawal,356.4740343
27815,769189083,4-13-24 20:28,129.39,Purchase,Pharmacy,227.0840343
27816,769189083,4-15-24 16:28,16.68,Withdrawal,Mobile App Withdrawal,210.4040343
27817,769189083,4-19-24 12:28,154.15,Return,Etsy Return,364.5540343
27818,769189083,4-19-24 14:28,119.47,Return,Etsy Return,484.0240343
27819,769189083,4-21-24 20:28,172.71,Purchase,Travel,311.3140343
27820,769189083,4-24-24 19:28,77.33,IncomingTransfer,Freelance Payment,388.6440343
27821,769189083,4-27-24 20:28,132.43,Deposit,Mobile Deposit,521.0740343
27822,769189083,4-28-24 20:28,184.19,Withdrawal,Mobile App Withdrawal,336.8840343
27823,769189083,4-29-24 12:28,14.66,Purchase,Clothing,322.2240343
27824,769189083,05-03-24 10:28,162.28,Return,Target Return,484.5040343
27825,769189083,05-04-24 21:28,2650,IncomingTransfer,Salary,3134.504034
27826,769189083,05-07-24 16:28,127.37,Purchase,Grocery,3007.134034
27827,769189083,05-08-24 12:28,236.86,Purchase,Electronics,2770.274034
27828,769189083,05-09-24 21:28,700,Payment,Credit Card Payment,2070.274034
27829,769189083,05-11-24 13:28,202.23,Return,Amazon Return,2272.504034
27830,769189083,5-13-24 11:28,17.42,Purchase,Entertainment,2255.084034
27831,769189083,5-14-24 21:28,1700,Payment,Rent Payment,555.0840343
27832,769189083,5-21-24 23:28,160.45,OutgoingTransfer,Bank Transfer,394.6340343
27833,769189083,5-22-24 20:28,55.09,OnlineShopping,Walmart,339.5440343
27834,769189083,5-25-24 20:28,114.39,IncomingTransfer,Freelance Payment,453.9340343
27835,769189083,5-25-24 20:28,174.83,Payment,Mortgage Payment,279.1040343
27836,769189083,5-25-24 21:28,170.94,Withdrawal,ATM Withdrawal,108.1640343
27837,769189083,5-27-24 22:28,110.76,Deposit,Direct Deposit,218.9240343
27838,769189083,5-30-24 18:28,63.43,Deposit,Mobile Deposit,282.3540343
27839,769189083,06-02-24 10:28,180.62,Purchase,Grocery,101.7340343
27840,769189083,06-02-24 13:28,50.04,Withdrawal,Branch Withdrawal,51.69403431
27841,769189083,06-02-24 19:28,125.76,Deposit,Direct Deposit,177.4540343
27842,769189083,06-03-24 21:28,2650,IncomingTransfer,Salary,2827.454034
27843,769189083,06-08-24 21:28,800,Payment,Credit Card Payment,2027.454034
27844,769189083,06-10-24 20:28,239.67,Deposit,Direct Deposit,2267.124034
27845,769189083,06-11-24 21:28,1000,Payment,Rent Payment,1267.124034
27846,769189083,06-11-24 23:28,221.74,Payment,Loan Payment,1045.384034
27847,769189083,06-12-24 21:28,135.3,Deposit,Cash Deposit,1180.684034
27848,769189083,6-14-24 10:28,43.49,OutgoingTransfer,Wire Transfer,1137.194034
27849,769189083,6-15-24 14:28,244.18,Deposit,Mobile Deposit,1381.374034
27850,769189083,6-16-24 19:28,211.58,Deposit,Cash Deposit,1592.954034
27851,769189083,6-18-24 15:28,51.17,Deposit,Mobile Deposit,1644.124034
27852,769189083,6-21-24 9:28,244.05,Deposit,Mobile Deposit,1888.174034
27853,769189083,6-23-24 16:28,249.16,OutgoingTransfer,International Transfer,1639.014034
27854,769189083,6-24-24 20:28,61.64,Deposit,Cash Deposit,1700.654034
27855,769189083,6-26-24 12:28,225.56,Deposit,Cash Deposit,1926.214034
27856,769189083,6-26-24 21:28,87.42,OnlineShopping,Walmart,1838.794034
27857,769189083,6-27-24 23:28,196.99,Withdrawal,Branch Withdrawal,1641.804034
27858,769189083,6-28-24 19:28,181.83,Payment,Bill Payment,1459.974034
27859,769189083,6-29-24 10:28,199.38,Return,Walmart Return,1659.354034
27860,769189083,07-03-24 9:28,80.38,Purchase,Entertainment,1578.974034
27861,769189083,07-05-24 21:28,2650,IncomingTransfer,Salary,4228.974034
27862,769189083,07-08-24 13:28,43.99,Deposit,Mobile Deposit,4272.964034
27863,769189083,07-10-24 21:28,700,Payment,Credit Card Payment,3572.964034
27864,769189083,07-11-24 17:28,211.32,Return,Target Return,3784.284034
27865,769189083,7-14-24 13:28,132.85,Deposit,Cash Deposit,3917.134034
27866,769189083,7-17-24 21:28,1100,Payment,Rent Payment,2817.134034
27867,770575233,1-20-24 15:28,156.38,Return,Target Return,931.3511265
27868,770575233,1-22-24 16:28,366.97,Withdrawal,Branch Withdrawal,564.3811265
27869,770575233,1-28-24 20:28,536.68,OnlineShopping,Etsy,27.70112651
27870,770575233,1-29-24 19:28,114.4,Purchase,Travel,-86.69887349
27871,770575233,1-31-24 22:28,303.34,Withdrawal,Mobile App Withdrawal,-390.0388735
27872,770575233,02-02-24 20:28,157.62,OutgoingTransfer,Peer-to-Peer Transfer,-547.6588735
27873,770575233,02-03-24 15:28,285.44,Deposit,Mobile Deposit,-262.2188735
27874,770575233,02-05-24 21:28,6350,IncomingTransfer,Salary,6087.781127
27875,770575233,02-07-24 18:28,376.29,Payment,Bill Payment,5711.491127
27876,770575233,02-10-24 21:28,1400,Payment,Credit Card Payment,4311.491127
27877,770575233,02-11-24 18:28,242.42,IncomingTransfer,Freelance Payment,4553.911127
27878,770575233,2-16-24 22:28,478.81,IncomingTransfer,Freelance Payment,5032.721127
27879,770575233,2-18-24 21:28,4000,Payment,Rent Payment,1032.721127
27880,770575233,2-20-24 14:28,79.8,OnlineShopping,Amazon,952.9211265
27881,770575233,2-23-24 18:28,499.46,Purchase,Home Improvement,453.4611265
27882,770575233,2-28-24 11:28,342.95,Deposit,Direct Deposit,796.4111265
27883,770575233,03-01-24 21:28,6350,IncomingTransfer,Salary,7146.411127
27884,770575233,03-02-24 15:28,76.89,OutgoingTransfer,International Transfer,7069.521127
27885,770575233,03-03-24 12:28,62.5,Purchase,Home Improvement,7007.021127
27886,770575233,03-03-24 14:28,347.11,Purchase,Clothing,6659.911127
27887,770575233,03-06-24 21:28,1700,Payment,Credit Card Payment,4959.911127
27888,770575233,03-08-24 9:28,286.46,Deposit,Cash Deposit,5246.371127
27889,770575233,03-09-24 11:28,454.78,Purchase,Gas,4791.591127
27890,770575233,03-10-24 14:28,346,OnlineShopping,Amazon,4445.591127
27891,770575233,03-12-24 17:28,328.45,Withdrawal,Branch Withdrawal,4117.141127
27892,770575233,3-13-24 16:28,545.26,OutgoingTransfer,Peer-to-Peer Transfer,3571.881127
27893,770575233,3-14-24 14:28,490.35,Deposit,Mobile Deposit,4062.231127
27894,770575233,3-15-24 10:28,513.39,Deposit,Cash Deposit,4575.621127
27895,770575233,3-17-24 18:28,501.21,IncomingTransfer,Freelance Payment,5076.831127
27896,770575233,3-18-24 21:28,2100,Payment,Rent Payment,2976.831127
27897,770575233,3-20-24 20:28,95.15,Withdrawal,Mobile App Withdrawal,2881.681127
27898,770575233,3-25-24 9:28,478,Deposit,Direct Deposit,3359.681127
27899,770575233,3-25-24 12:28,249.23,Return,Etsy Return,3608.911127
27900,770575233,3-26-24 11:28,496.25,OutgoingTransfer,Wire Transfer,3112.661127
27901,770575233,3-28-24 16:28,354.18,OnlineShopping,Target,2758.481127
27902,770575233,3-29-24 10:28,189.22,OutgoingTransfer,Wire Transfer,2569.261127
27903,770575233,3-31-24 22:28,198.15,Purchase,Entertainment,2371.111127
27904,770575233,04-02-24 11:28,344.2,OutgoingTransfer,Wire Transfer,2026.911127
27905,770575233,04-03-24 21:28,6350,IncomingTransfer,Salary,8376.911127
27906,770575233,04-08-24 11:28,387.89,OnlineShopping,Amazon,7989.021127
27907,770575233,04-08-24 21:28,1500,Payment,Credit Card Payment,6489.021127
27908,770575233,4-14-24 15:28,287.32,Purchase,Restaurant,6201.701127
27909,770575233,4-15-24 21:28,2400,Payment,Rent Payment,3801.701127
27910,770575233,4-17-24 23:28,479.31,OutgoingTransfer,Peer-to-Peer Transfer,3322.391127
27911,770575233,4-18-24 22:28,534.45,Payment,Loan Payment,2787.941127
27912,770575233,4-22-24 17:28,426.32,OutgoingTransfer,Wire Transfer,2361.621127
27913,770575233,4-27-24 21:28,439.64,OnlineShopping,Etsy,1921.981127
27914,770575233,4-28-24 15:28,249.64,OutgoingTransfer,International Transfer,1672.341127
27915,770575233,4-29-24 15:28,194.34,IncomingTransfer,Freelance Payment,1866.681127
27916,770575233,05-01-24 13:28,322.84,Purchase,Restaurant,1543.841127
27917,770575233,05-04-24 21:28,201.18,Purchase,Furniture,1342.661127
27918,770575233,05-05-24 21:28,6350,IncomingTransfer,Salary,7692.661127
27919,770575233,05-10-24 18:28,311.54,Purchase,Pharmacy,7381.121127
27920,770575233,05-10-24 21:28,1300,Payment,Credit Card Payment,6081.121127
27921,770575233,5-14-24 21:28,2000,Payment,Rent Payment,4081.121127
27922,770575233,5-22-24 9:28,415.93,Purchase,Travel,3665.191127
27923,770575233,5-24-24 20:28,176.13,Deposit,Mobile Deposit,3841.321127
27924,770575233,5-27-24 17:28,219.24,OutgoingTransfer,Wire Transfer,3622.081127
27925,770575233,5-29-24 12:28,438.72,Purchase,Clothing,3183.361127
27926,770575233,5-31-24 22:28,497.45,Purchase,Grocery,2685.911127
27927,770575233,06-01-24 21:28,6350,IncomingTransfer,Salary,9035.911127
27928,770575233,06-02-24 15:28,59.07,OutgoingTransfer,Peer-to-Peer Transfer,8976.841127
27929,770575233,06-04-24 17:28,241.12,Deposit,Cash Deposit,9217.961127
27930,770575233,06-06-24 21:28,1300,Payment,Credit Card Payment,7917.961127
27931,770575233,06-08-24 10:28,179.04,Deposit,Direct Deposit,8097.001127
27932,770575233,06-10-24 14:28,543.75,Deposit,Cash Deposit,8640.751127
27933,770575233,6-16-24 14:28,328.89,Return,AliExpress Return,8969.641127
27934,770575233,6-18-24 21:28,3300,Payment,Rent Payment,5669.641127
27935,770575233,6-21-24 21:28,538.37,Payment,Bill Payment,5131.271127
27936,770575233,6-26-24 15:28,118.17,Purchase,Clothing,5013.101127
27937,770575233,6-30-24 20:28,219.44,OutgoingTransfer,Wire Transfer,4793.661127
27938,770575233,07-03-24 9:28,107.41,Payment,Mortgage Payment,4686.251127
27939,770575233,07-03-24 12:28,351.59,Return,Store Return,5037.841127
27940,770575233,07-03-24 21:28,6350,IncomingTransfer,Salary,11387.84113
27941,770575233,07-05-24 23:28,253.26,Deposit,Direct Deposit,11641.10113
27942,770575233,07-07-24 10:28,338.17,Purchase,Travel,11302.93113
27943,770575233,07-08-24 21:28,1400,Payment,Credit Card Payment,9902.931127
27944,770575233,07-09-24 12:28,92.49,OnlineShopping,Best Buy,9810.441127
27945,770575233,07-10-24 21:28,3100,Payment,Rent Payment,6710.441127
27946,771028533,1-25-24 19:28,137.17,Deposit,Check Deposit,137.17
27947,771028533,02-02-24 22:28,36.07,Purchase,Home Improvement,101.1
27948,771028533,02-03-24 21:28,2950,IncomingTransfer,Salary,3051.1
27949,771028533,02-04-24 14:28,30.24,Deposit,Cash Deposit,3081.34
27950,771028533,2-13-24 20:28,220.06,Deposit,Direct Deposit,3301.4
27951,771028533,2-15-24 21:28,1600,Payment,Rent Payment,1701.4
27952,771028533,2-24-24 11:28,164.16,Withdrawal,Mobile App Withdrawal,1537.24
27953,771028533,03-02-24 21:28,2950,IncomingTransfer,Salary,4487.24
27954,771028533,03-10-24 11:28,230.24,Deposit,Check Deposit,4717.48
27955,771028533,3-17-24 21:28,800,Payment,Rent Payment,3917.48
27956,771028533,3-27-24 15:28,125.88,Deposit,Direct Deposit,4043.36
27957,771028533,3-30-24 22:28,186.78,Return,Target Return,4230.14
27958,771028533,04-03-24 21:28,2950,IncomingTransfer,Salary,7180.14
27959,771028533,04-11-24 11:28,187.22,Purchase,Gas,6992.92
27960,771028533,4-17-24 21:28,1800,Payment,Rent Payment,5192.92
27961,771028533,4-20-24 16:28,160.22,Return,Walmart Return,5353.14
27962,771028533,4-30-24 20:28,140.41,Withdrawal,ATM Withdrawal,5212.73
27963,771028533,05-04-24 21:28,2950,IncomingTransfer,Salary,8162.73
27964,771028533,05-07-24 11:28,33.18,Deposit,Cash Deposit,8195.91
27965,771028533,05-07-24 19:28,105.98,Purchase,Electronics,8089.93
27966,771028533,05-08-24 17:28,21.56,Return,Store Return,8111.49
27967,771028533,05-11-24 21:28,1500,Payment,Rent Payment,6611.49
27968,771028533,05-12-24 17:28,54.84,Deposit,Cash Deposit,6666.33
27969,771028533,5-23-24 10:28,229.59,Deposit,Mobile Deposit,6895.92
27970,771028533,5-23-24 21:28,30.64,Purchase,Clothing,6865.28
27971,771028533,5-25-24 20:28,20.62,Payment,Bill Payment,6844.66
27972,771028533,06-04-24 21:28,2950,IncomingTransfer,Salary,9794.66
27973,771028533,06-04-24 22:28,249.37,OutgoingTransfer,Wire Transfer,9545.29
27974,771028533,06-05-24 23:28,241.28,Withdrawal,Branch Withdrawal,9304.01
27975,771028533,06-07-24 11:28,30.8,Withdrawal,Branch Withdrawal,9273.21
27976,771028533,06-08-24 13:28,152.45,OutgoingTransfer,Peer-to-Peer Transfer,9120.76
27977,771028533,6-16-24 21:28,800,Payment,Rent Payment,8320.76
27978,771028533,6-17-24 18:28,114.73,Deposit,Direct Deposit,8435.49
27979,771028533,6-27-24 21:28,93.42,Withdrawal,Branch Withdrawal,8342.07
27980,771028533,07-05-24 21:28,2950,IncomingTransfer,Salary,11292.07
27981,771028533,07-10-24 21:28,192.67,Deposit,Direct Deposit,11484.74
27982,771028533,7-17-24 21:28,1200,Payment,Rent Payment,10284.74
27983,771037008,1-20-24 20:28,526.75,Withdrawal,Branch Withdrawal,-526.75
27984,771037008,1-23-24 14:28,401.72,Deposit,Cash Deposit,-125.03
27985,771037008,1-26-24 14:28,739.95,Purchase,Clothing,-864.98
27986,771037008,1-29-24 15:28,334.54,Deposit,Cash Deposit,-530.44
27987,771037008,02-01-24 10:28,510.53,Payment,Bill Payment,-1040.97
27988,771037008,02-01-24 21:28,9700,IncomingTransfer,Salary,8659.03
27989,771037008,02-04-24 20:28,412.67,Purchase,Clothing,8246.36
27990,771037008,02-05-24 16:28,739.49,Withdrawal,ATM Withdrawal,7506.87
27991,771037008,02-08-24 19:28,358.76,Deposit,Mobile Deposit,7865.63
27992,771037008,02-09-24 21:28,184.97,OutgoingTransfer,Peer-to-Peer Transfer,7680.66
27993,771037008,02-10-24 21:28,141.53,Purchase,Travel,7539.13
27994,771037008,02-12-24 18:28,714.08,Deposit,Check Deposit,8253.21
27995,771037008,2-14-24 19:28,155.26,Deposit,Direct Deposit,8408.47
27996,771037008,2-15-24 11:28,448.71,Deposit,Mobile Deposit,8857.18
27997,771037008,2-15-24 21:28,5300,Payment,Rent Payment,3557.18
27998,771037008,2-15-24 23:28,744.87,Purchase,Furniture,2812.31
27999,771037008,2-17-24 13:28,639.82,OutgoingTransfer,Bank Transfer,2172.49
28000,771037008,2-19-24 20:28,739.75,Deposit,Cash Deposit,2912.24
28001,771037008,2-19-24 21:28,385.24,Deposit,Direct Deposit,3297.48
28002,771037008,2-24-24 20:28,371.54,IncomingTransfer,Freelance Payment,3669.02
28003,771037008,2-25-24 15:28,216.51,Purchase,Home Improvement,3452.51
28004,771037008,2-25-24 15:28,368.36,Purchase,Electronics,3084.15
28005,771037008,2-26-24 16:28,142.41,OnlineShopping,Target,2941.74
28006,771037008,2-29-24 16:28,565.51,OnlineShopping,Best Buy,2376.23
28007,771037008,03-02-24 11:28,501.25,OnlineShopping,Best Buy,1874.98
28008,771037008,03-02-24 21:28,9700,IncomingTransfer,Salary,11574.98
28009,771037008,03-06-24 14:28,602,OnlineShopping,Amazon,10972.98
28010,771037008,03-07-24 21:28,680.08,Withdrawal,ATM Withdrawal,10292.9
28011,771037008,3-13-24 18:28,676.32,Payment,Loan Payment,9616.58
28012,771037008,3-14-24 19:28,496.43,Payment,Mortgage Payment,9120.15
28013,771037008,3-14-24 21:28,6100,Payment,Rent Payment,3020.15
28014,771037008,3-17-24 11:28,627.45,Purchase,Grocery,2392.7
28015,771037008,3-18-24 13:28,329.55,Purchase,Pharmacy,2063.15
28016,771037008,3-18-24 14:28,104.2,Deposit,Mobile Deposit,2167.35
28017,771037008,3-19-24 10:28,272.39,Withdrawal,Mobile App Withdrawal,1894.96
28018,771037008,3-26-24 21:28,177.98,Payment,Mortgage Payment,1716.98
28019,771037008,3-28-24 13:28,614.49,Payment,Mortgage Payment,1102.49
28020,771037008,3-29-24 9:28,636.56,Return,Store Return,1739.05
28021,771037008,3-31-24 16:28,527.02,Withdrawal,Branch Withdrawal,1212.03
28022,771037008,3-31-24 22:28,565.16,Return,eBay Return,1777.19
28023,771037008,04-03-24 11:28,263.63,Purchase,Pharmacy,1513.56
28024,771037008,04-03-24 21:28,9700,IncomingTransfer,Salary,11213.56
28025,771037008,04-06-24 16:28,628.17,OnlineShopping,Target,10585.39
28026,771037008,04-07-24 22:28,105.41,Deposit,Mobile Deposit,10690.8
28027,771037008,4-14-24 21:28,3300,Payment,Rent Payment,7390.8
28028,771037008,4-19-24 14:28,592.61,Return,Best Buy Return,7983.41
28029,771037008,4-19-24 19:28,558.25,OutgoingTransfer,Bank Transfer,7425.16
28030,771037008,4-21-24 14:28,383.26,Purchase,Furniture,7041.9
28031,771037008,4-22-24 12:28,591.03,Withdrawal,ATM Withdrawal,6450.87
28032,771037008,05-01-24 15:28,643.04,Withdrawal,Branch Withdrawal,5807.83
28033,771037008,05-02-24 14:28,326.51,Withdrawal,Branch Withdrawal,5481.32
28034,771037008,05-02-24 21:28,9700,IncomingTransfer,Salary,15181.32
28035,771037008,05-08-24 12:28,305.63,Payment,Mortgage Payment,14875.69
28036,771037008,05-10-24 17:28,551.16,Withdrawal,Branch Withdrawal,14324.53
28037,771037008,05-10-24 23:28,501.01,Withdrawal,Branch Withdrawal,13823.52
28038,771037008,05-11-24 18:28,697.67,OutgoingTransfer,Wire Transfer,13125.85
28039,771037008,05-12-24 12:28,136.32,Purchase,Travel,12989.53
28040,771037008,05-12-24 18:28,651.73,Payment,Loan Payment,12337.8
28041,771037008,5-15-24 14:28,423.4,Withdrawal,ATM Withdrawal,11914.4
28042,771037008,5-16-24 21:28,3800,Payment,Rent Payment,8114.4
28043,771037008,5-18-24 16:28,741.88,Purchase,Grocery,7372.52
28044,771037008,5-18-24 21:28,473.25,IncomingTransfer,Freelance Payment,7845.77
28045,771037008,5-19-24 10:28,105.83,Withdrawal,Mobile App Withdrawal,7739.94
28046,771037008,5-19-24 18:28,285.42,Deposit,Direct Deposit,8025.36
28047,771037008,5-21-24 12:28,654.75,Deposit,Direct Deposit,8680.11
28048,771037008,5-24-24 20:28,572.77,Payment,Bill Payment,8107.34
28049,771037008,5-25-24 14:28,400.3,Payment,Loan Payment,7707.04
28050,771037008,5-25-24 16:28,370.03,Return,Best Buy Return,8077.07
28051,771037008,5-29-24 15:28,229.31,Payment,Bill Payment,7847.76
28052,771037008,06-01-24 21:28,9700,IncomingTransfer,Salary,17547.76
28053,771037008,06-02-24 13:28,198.07,Deposit,Check Deposit,17745.83
28054,771037008,06-02-24 19:28,270.56,Deposit,Mobile Deposit,18016.39
28055,771037008,06-08-24 14:28,618.27,Purchase,Restaurant,17398.12
28056,771037008,06-10-24 10:28,243.96,Purchase,Pharmacy,17154.16
28057,771037008,6-13-24 21:28,2500,Payment,Rent Payment,14654.16
28058,771037008,6-25-24 14:28,245.65,Deposit,Check Deposit,14899.81
28059,771037008,6-26-24 18:28,654.03,Deposit,Mobile Deposit,15553.84
28060,771037008,6-29-24 18:28,651.49,Purchase,Restaurant,14902.35
28061,771037008,6-29-24 20:28,115.45,Deposit,Check Deposit,15017.8
28062,771037008,6-30-24 12:28,734.68,Withdrawal,Mobile App Withdrawal,14283.12
28063,771037008,07-01-24 16:28,686.65,OutgoingTransfer,Bank Transfer,13596.47
28064,771037008,07-02-24 21:28,9700,IncomingTransfer,Salary,23296.47
28065,771037008,07-10-24 9:28,529.8,Withdrawal,ATM Withdrawal,22766.67
28066,771037008,07-12-24 21:28,4000,Payment,Rent Payment,18766.67
28067,771037008,7-13-24 20:28,316.67,OutgoingTransfer,Wire Transfer,18450
28068,771037008,7-14-24 12:28,245.96,Deposit,Direct Deposit,18695.96
28069,771037008,7-16-24 15:28,215.34,Withdrawal,Branch Withdrawal,18480.62
28070,771037008,7-17-24 16:28,602.99,OnlineShopping,Etsy,17877.63
28071,771079833,1-21-24 17:28,187.87,Purchase,Furniture,-187.87
28072,771079833,1-22-24 9:28,73.25,Deposit,Direct Deposit,-114.62
28073,771079833,1-24-24 19:28,160.02,Return,Target Return,45.4
28074,771079833,1-27-24 13:28,74.76,Purchase,Home Improvement,-29.36
28075,771079833,1-27-24 22:28,54.79,Return,Store Return,25.43
28076,771079833,1-29-24 10:28,249.61,Deposit,Mobile Deposit,275.04
28077,771079833,1-29-24 11:28,39.63,Purchase,Home Improvement,235.41
28078,771079833,02-01-24 21:28,2700,IncomingTransfer,Salary,2935.41
28079,771079833,02-03-24 17:28,46.76,Purchase,Restaurant,2888.65
28080,771079833,02-04-24 17:28,119.76,IncomingTransfer,Freelance Payment,3008.41
28081,771079833,02-07-24 23:28,23.73,IncomingTransfer,Freelance Payment,3032.14
28082,771079833,02-10-24 14:28,161.16,OnlineShopping,Walmart,2870.98
28083,771079833,2-13-24 13:28,177.16,Withdrawal,Branch Withdrawal,2693.82
28084,771079833,2-14-24 21:28,1600,Payment,Rent Payment,1093.82
28085,771079833,2-15-24 13:28,232.95,OutgoingTransfer,International Transfer,860.87
28086,771079833,2-15-24 23:28,149.79,Purchase,Furniture,711.08
28087,771079833,2-18-24 15:28,193.05,Withdrawal,Mobile App Withdrawal,518.03
28088,771079833,2-20-24 16:28,40.52,IncomingTransfer,Freelance Payment,558.55
28089,771079833,2-20-24 17:28,26.07,Deposit,Cash Deposit,584.62
28090,771079833,2-24-24 11:28,113.3,Deposit,Check Deposit,697.92
28091,771079833,2-27-24 18:28,213.51,Deposit,Check Deposit,911.43
28092,771079833,2-28-24 9:28,95.63,Purchase,Furniture,815.8
28093,771079833,03-01-24 22:28,122.51,OnlineShopping,Walmart,693.29
28094,771079833,03-03-24 21:28,2700,IncomingTransfer,Salary,3393.29
28095,771079833,03-12-24 22:28,59.83,Deposit,Cash Deposit,3453.12
28096,771079833,3-15-24 17:28,109.48,Payment,Bill Payment,3343.64
28097,771079833,3-18-24 21:28,1100,Payment,Rent Payment,2243.64
28098,771079833,3-18-24 21:28,23.89,Deposit,Check Deposit,2267.53
28099,771079833,3-19-24 14:28,211.35,Deposit,Direct Deposit,2478.88
28100,771079833,3-21-24 14:28,13.21,Purchase,Gas,2465.67
28101,771079833,3-23-24 12:28,126.6,Deposit,Cash Deposit,2592.27
28102,771079833,3-24-24 16:28,125.75,Payment,Loan Payment,2466.52
28103,771079833,3-26-24 13:28,83.68,OutgoingTransfer,Wire Transfer,2382.84
28104,771079833,3-29-24 17:28,178.4,IncomingTransfer,Freelance Payment,2561.24
28105,771079833,3-31-24 10:28,44.95,Purchase,Restaurant,2516.29
28106,771079833,3-31-24 20:28,152.3,OutgoingTransfer,Peer-to-Peer Transfer,2363.99
28107,771079833,04-01-24 10:28,243.29,Deposit,Mobile Deposit,2607.28
28108,771079833,04-02-24 19:28,99.91,OutgoingTransfer,International Transfer,2507.37
28109,771079833,04-03-24 15:28,19.23,Withdrawal,Branch Withdrawal,2488.14
28110,771079833,04-04-24 15:28,221.22,Purchase,Home Improvement,2266.92
28111,771079833,04-04-24 21:28,2700,IncomingTransfer,Salary,4966.92
28112,771079833,04-04-24 22:28,103.48,Withdrawal,Mobile App Withdrawal,4863.44
28113,771079833,04-05-24 12:28,119.27,Purchase,Grocery,4744.17
28114,771079833,04-05-24 14:28,240.5,Return,Amazon Return,4984.67
28115,771079833,04-05-24 21:28,27.18,Deposit,Mobile Deposit,5011.85
28116,771079833,04-06-24 18:28,145.51,Withdrawal,ATM Withdrawal,4866.34
28117,771079833,04-09-24 16:28,147.32,IncomingTransfer,Freelance Payment,5013.66
28118,771079833,04-11-24 21:28,1100,Payment,Rent Payment,3913.66
28119,771079833,4-16-24 21:28,165.48,Payment,Bill Payment,3748.18
28120,771079833,4-19-24 12:28,113.38,OutgoingTransfer,International Transfer,3634.8
28121,771079833,4-21-24 12:28,48.3,Deposit,Check Deposit,3683.1
28122,771079833,4-22-24 22:28,221.81,Return,Etsy Return,3904.91
28123,771079833,4-24-24 14:28,167.8,IncomingTransfer,Freelance Payment,4072.71
28124,771079833,4-27-24 12:28,209.15,Deposit,Direct Deposit,4281.86
28125,771079833,05-01-24 20:28,61.87,Purchase,Furniture,4219.99
28126,771079833,05-02-24 21:28,2700,IncomingTransfer,Salary,6919.99
28127,771079833,05-03-24 11:28,201.43,Purchase,Electronics,6718.56
28128,771079833,05-03-24 14:28,206.68,Payment,Bill Payment,6511.88
28129,771079833,05-04-24 22:28,29.92,OutgoingTransfer,Peer-to-Peer Transfer,6481.96
28130,771079833,05-06-24 23:28,147.71,Payment,Loan Payment,6334.25
28131,771079833,05-07-24 17:28,165.45,OnlineShopping,Target,6168.8
28132,771079833,05-08-24 12:28,113.47,Withdrawal,ATM Withdrawal,6055.33
28133,771079833,05-09-24 23:28,86.32,OnlineShopping,AliExpress,5969.01
28134,771079833,05-11-24 21:28,1100,Payment,Rent Payment,4869.01
28135,771079833,5-16-24 22:28,216.35,Purchase,Grocery,4652.66
28136,771079833,5-18-24 16:28,146.65,Withdrawal,Branch Withdrawal,4506.01
28137,771079833,5-26-24 12:28,82.35,Return,Etsy Return,4588.36
28138,771079833,5-28-24 15:28,179.08,Deposit,Cash Deposit,4767.44
28139,771079833,5-31-24 13:28,80.62,Deposit,Check Deposit,4848.06
28140,771079833,06-01-24 15:28,142.91,Payment,Loan Payment,4705.15
28141,771079833,06-01-24 21:28,2700,IncomingTransfer,Salary,7405.15
28142,771079833,06-03-24 23:28,191.16,OnlineShopping,Walmart,7213.99
28143,771079833,06-08-24 15:28,117.92,OutgoingTransfer,Wire Transfer,7096.07
28144,771079833,06-09-24 12:28,139.55,Payment,Mortgage Payment,6956.52
28145,771079833,06-12-24 10:28,23.18,Purchase,Grocery,6933.34
28146,771079833,6-14-24 15:28,48.08,Purchase,Restaurant,6885.26
28147,771079833,6-15-24 21:28,1300,Payment,Rent Payment,5585.26
28148,771079833,6-15-24 22:28,28.96,Payment,Mortgage Payment,5556.3
28149,771079833,6-16-24 14:28,36.17,OutgoingTransfer,Peer-to-Peer Transfer,5520.13
28150,771079833,6-20-24 16:28,112.3,OnlineShopping,AliExpress,5407.83
28151,771079833,6-23-24 16:28,156.72,Deposit,Check Deposit,5564.55
28152,771079833,6-24-24 9:28,107.62,Deposit,Cash Deposit,5672.17
28153,771079833,6-25-24 13:28,213.99,Purchase,Grocery,5458.18
28154,771079833,6-26-24 19:28,90.84,Payment,Loan Payment,5367.34
28155,771079833,6-28-24 15:28,148.02,Purchase,Clothing,5219.32
28156,771079833,07-01-24 14:28,239.6,Withdrawal,Branch Withdrawal,4979.72
28157,771079833,07-02-24 21:28,2700,IncomingTransfer,Salary,7679.72
28158,771079833,07-10-24 21:28,1100,Payment,Rent Payment,6579.72
28159,771079833,7-15-24 19:28,161.34,Deposit,Mobile Deposit,6741.06
28160,771079833,7-16-24 23:28,186.76,IncomingTransfer,Freelance Payment,6927.82
28161,771284658,1-24-24 20:28,245.04,OnlineShopping,Best Buy,391.3330185
28162,771284658,1-26-24 14:28,169.23,Deposit,Direct Deposit,560.5630185
28163,771284658,1-29-24 13:28,89.61,Purchase,Entertainment,470.9530185
28164,771284658,1-29-24 20:28,120.68,Payment,Bill Payment,350.2730185
28165,771284658,1-30-24 21:28,83.29,Purchase,Electronics,266.9830185
28166,771284658,1-31-24 16:28,145.57,Withdrawal,Mobile App Withdrawal,121.4130185
28167,771284658,02-04-24 18:28,102.05,Deposit,Check Deposit,223.4630185
28168,771284658,02-04-24 21:28,1750,IncomingTransfer,Salary,1973.463018
28169,771284658,02-09-24 21:28,1200,Payment,Credit Card Payment,773.4630185
28170,771284658,02-10-24 21:28,700,Payment,Subscription Payment,73.46301848
28171,771284658,2-19-24 20:28,74.74,Payment,Loan Payment,-1.276981524
28172,771284658,2-21-24 16:28,208.96,Deposit,Direct Deposit,207.6830185
28173,771284658,2-22-24 18:28,98.88,Deposit,Cash Deposit,306.5630185
28174,771284658,2-22-24 23:28,59.11,Purchase,Travel,247.4530185
28175,771284658,03-05-24 9:28,16.55,Purchase,Pharmacy,230.9030185
28176,771284658,03-05-24 21:28,1750,IncomingTransfer,Salary,1980.903018
28177,771284658,03-10-24 21:28,1100,Payment,Credit Card Payment,880.9030185
28178,771284658,3-16-24 21:28,800,Payment,Subscription Payment,80.90301848
28179,771284658,3-18-24 22:28,76.59,Payment,Mortgage Payment,4.313018476
28180,771284658,3-19-24 21:28,23.32,Purchase,Pharmacy,-19.00698152
28181,771284658,3-21-24 23:28,199.21,Return,Store Return,180.2030185
28182,771284658,3-26-24 19:28,63.69,IncomingTransfer,Freelance Payment,243.8930185
28183,771284658,04-03-24 21:28,97.13,Return,Etsy Return,341.0230185
28184,771284658,04-04-24 14:28,235,Return,Store Return,576.0230185
28185,771284658,04-04-24 21:28,1750,IncomingTransfer,Salary,2326.023018
28186,771284658,04-07-24 10:28,170.34,Deposit,Cash Deposit,2496.363018
28187,771284658,04-09-24 21:28,1000,Payment,Credit Card Payment,1496.363018
28188,771284658,04-10-24 12:28,119.57,Deposit,Direct Deposit,1615.933018
28189,771284658,4-18-24 21:28,600,Payment,Subscription Payment,1015.933018
28190,771284658,4-19-24 13:28,204.12,Purchase,Electronics,811.8130185
28191,771284658,4-24-24 23:28,169.95,OnlineShopping,Best Buy,641.8630185
28192,771284658,4-30-24 10:28,153.9,Purchase,Gas,487.9630185
28193,771284658,05-03-24 21:28,1750,IncomingTransfer,Salary,2237.963018
28194,771284658,05-05-24 18:28,230.84,Purchase,Grocery,2007.123018
28195,771284658,05-08-24 21:28,1100,Payment,Credit Card Payment,907.1230185
28196,771284658,5-14-24 12:28,159.14,Deposit,Direct Deposit,1066.263018
28197,771284658,5-14-24 23:28,110.11,Deposit,Direct Deposit,1176.373018
28198,771284658,5-18-24 21:28,700,Payment,Subscription Payment,476.3730185
28199,771284658,5-19-24 20:28,239.07,Purchase,Electronics,237.3030185
28200,771284658,5-26-24 17:28,179.42,Withdrawal,Branch Withdrawal,57.88301848
28201,771284658,06-01-24 19:28,12.85,Deposit,Check Deposit,70.73301848
28202,771284658,06-01-24 21:28,1750,IncomingTransfer,Salary,1820.733018
28203,771284658,06-06-24 10:28,234.87,OutgoingTransfer,Peer-to-Peer Transfer,1585.863018
28204,771284658,06-06-24 21:28,1100,Payment,Credit Card Payment,485.8630185
28205,771284658,06-10-24 20:28,185.7,Purchase,Restaurant,300.1630185
28206,771284658,06-11-24 18:28,126.72,Deposit,Check Deposit,426.8830185
28207,771284658,06-12-24 9:28,191.91,OutgoingTransfer,International Transfer,234.9730185
28208,771284658,06-12-24 21:28,500,Payment,Insurance Payment,-265.0269815
28209,771284658,6-17-24 14:28,31.24,Purchase,Furniture,-296.2669815
28210,771284658,6-21-24 13:28,144.15,Withdrawal,Mobile App Withdrawal,-440.4169815
28211,771284658,6-22-24 14:28,152.35,Purchase,Gas,-592.7669815
28212,771284658,6-23-24 11:28,107.11,Deposit,Mobile Deposit,-485.6569815
28213,771284658,07-02-24 21:28,1750,IncomingTransfer,Salary,1264.343018
28214,771284658,07-04-24 20:28,40.68,Deposit,Cash Deposit,1305.023018
28215,771284658,07-05-24 14:28,208.85,Withdrawal,Branch Withdrawal,1096.173018
28216,771284658,07-07-24 21:28,1300,Payment,Credit Card Payment,-203.8269815
28217,771284658,07-09-24 22:28,128.24,Deposit,Mobile Deposit,-75.58698152
28218,771284658,07-11-24 9:28,44.19,Withdrawal,Mobile App Withdrawal,-119.7769815
28219,771284658,07-11-24 21:28,700,Payment,Subscription Payment,-819.7769815
28220,771288258,1-23-24 11:28,112.69,Return,Best Buy Return,1253.791946
28221,771288258,1-23-24 18:28,338.62,Payment,Mortgage Payment,915.171946
28222,771288258,1-28-24 20:28,151.26,IncomingTransfer,Freelance Payment,1066.431946
28223,771288258,1-30-24 9:28,62.7,Purchase,Entertainment,1003.731946
28224,771288258,1-30-24 10:28,364.92,Payment,Loan Payment,638.811946
28225,771288258,1-31-24 17:28,181.65,OnlineShopping,Amazon,457.161946
28226,771288258,02-03-24 18:28,53.79,OutgoingTransfer,Peer-to-Peer Transfer,403.371946
28227,771288258,02-04-24 21:28,3600,IncomingTransfer,Salary,4003.371946
28228,771288258,02-04-24 22:28,291.75,Purchase,Entertainment,3711.621946
28229,771288258,02-05-24 9:28,289,Return,Etsy Return,4000.621946
28230,771288258,02-05-24 23:28,180.98,Deposit,Cash Deposit,4181.601946
28231,771288258,02-06-24 23:28,318,Purchase,Electronics,3863.601946
28232,771288258,02-07-24 9:28,280.8,Purchase,Electronics,3582.801946
28233,771288258,02-09-24 21:28,2000,Payment,Credit Card Payment,1582.801946
28234,771288258,2-16-24 13:28,208.82,Withdrawal,Branch Withdrawal,1373.981946
28235,771288258,2-16-24 18:28,258.43,Deposit,Direct Deposit,1632.411946
28236,771288258,2-16-24 21:28,1000,Payment,Subscription Payment,632.411946
28237,771288258,2-17-24 15:28,201.41,Deposit,Direct Deposit,833.821946
28238,771288258,2-20-24 20:28,391.52,Purchase,Pharmacy,442.301946
28239,771288258,2-22-24 22:28,183.82,Payment,Mortgage Payment,258.481946
28240,771288258,2-23-24 9:28,350.71,Purchase,Furniture,-92.228054
28241,771288258,2-25-24 18:28,57.95,OutgoingTransfer,Wire Transfer,-150.178054
28242,771288258,2-25-24 22:28,275.95,IncomingTransfer,Freelance Payment,125.771946
28243,771288258,2-27-24 16:28,87.34,OnlineShopping,Best Buy,38.431946
28244,771288258,2-28-24 17:28,100.53,OnlineShopping,Walmart,-62.098054
28245,771288258,03-02-24 18:28,295.22,Deposit,Mobile Deposit,233.121946
28246,771288258,03-04-24 21:28,3600,IncomingTransfer,Salary,3833.121946
28247,771288258,03-09-24 21:28,2600,Payment,Credit Card Payment,1233.121946
28248,771288258,03-10-24 21:28,1600,Payment,Installment Payment,-366.878054
28249,771288258,3-13-24 21:28,222.41,OnlineShopping,eBay,-589.288054
28250,771288258,3-14-24 14:28,22.55,OutgoingTransfer,Bank Transfer,-611.838054
28251,771288258,3-19-24 22:28,374.88,Deposit,Direct Deposit,-236.958054
28252,771288258,3-21-24 17:28,203.77,OnlineShopping,Walmart,-440.728054
28253,771288258,3-21-24 19:28,211.23,Deposit,Mobile Deposit,-229.498054
28254,771288258,04-01-24 19:28,93.5,Deposit,Mobile Deposit,-135.998054
28255,771288258,04-02-24 17:28,36.65,Withdrawal,Mobile App Withdrawal,-172.648054
28256,771288258,04-03-24 9:28,302.76,Payment,Bill Payment,-475.408054
28257,771288258,04-03-24 21:28,3600,IncomingTransfer,Salary,3124.591946
28258,771288258,04-06-24 20:28,189.2,Payment,Loan Payment,2935.391946
28259,771288258,04-07-24 13:28,387.33,OutgoingTransfer,Peer-to-Peer Transfer,2548.061946
28260,771288258,04-07-24 22:28,315.72,Deposit,Cash Deposit,2863.781946
28261,771288258,04-08-24 21:28,2200,Payment,Credit Card Payment,663.781946
28262,771288258,04-09-24 14:28,201.61,OutgoingTransfer,International Transfer,462.171946
28263,771288258,4-15-24 22:28,109.67,Withdrawal,ATM Withdrawal,352.501946
28264,771288258,4-17-24 21:28,1100,Payment,Subscription Payment,-747.498054
28265,771288258,4-22-24 16:28,43.91,Withdrawal,ATM Withdrawal,-791.408054
28266,771288258,4-27-24 10:28,223.91,Purchase,Pharmacy,-1015.318054
28267,771288258,4-28-24 13:28,302.79,Withdrawal,ATM Withdrawal,-1318.108054
28268,771288258,05-03-24 21:28,3600,IncomingTransfer,Salary,2281.891946
28269,771288258,05-04-24 17:28,320.84,Deposit,Cash Deposit,2602.731946
28270,771288258,05-04-24 17:28,265.69,Payment,Bill Payment,2337.041946
28271,771288258,05-05-24 13:28,399.31,Deposit,Check Deposit,2736.351946
28272,771288258,05-07-24 9:28,63.99,Deposit,Check Deposit,2800.341946
28273,771288258,05-07-24 18:28,62.39,OnlineShopping,eBay,2737.951946
28274,771288258,05-08-24 13:28,111.46,Return,Best Buy Return,2849.411946
28275,771288258,05-08-24 21:28,2500,Payment,Credit Card Payment,349.411946
28276,771288258,05-09-24 21:28,62.33,Return,Target Return,411.741946
28277,771288258,05-12-24 18:28,317.97,Withdrawal,Branch Withdrawal,93.771946
28278,771288258,5-13-24 12:28,232.44,Purchase,Home Improvement,-138.668054
28279,771288258,5-16-24 21:28,1400,Payment,Insurance Payment,-1538.668054
28280,771288258,5-20-24 20:28,33.38,Deposit,Direct Deposit,-1505.288054
28281,771288258,5-22-24 11:28,376.23,Withdrawal,ATM Withdrawal,-1881.518054
28282,771288258,5-24-24 14:28,256.92,Deposit,Direct Deposit,-1624.598054
28283,771288258,5-25-24 11:28,254.75,Purchase,Restaurant,-1879.348054
28284,771288258,5-30-24 23:28,75.58,Deposit,Cash Deposit,-1803.768054
28285,771288258,06-01-24 16:28,185.37,Deposit,Check Deposit,-1618.398054
28286,771288258,06-03-24 17:28,131.33,Deposit,Cash Deposit,-1487.068054
28287,771288258,06-03-24 21:28,3600,IncomingTransfer,Salary,2112.931946
28288,771288258,06-06-24 18:28,250.83,Return,Amazon Return,2363.761946
28289,771288258,06-08-24 21:28,2500,Payment,Credit Card Payment,-136.238054
28290,771288258,06-09-24 22:28,103,OnlineShopping,Amazon,-239.238054
28291,771288258,6-17-24 21:28,1400,Payment,Insurance Payment,-1639.238054
28292,771288258,6-22-24 10:28,391.43,IncomingTransfer,Freelance Payment,-1247.808054
28293,771288258,6-30-24 19:28,392.88,OnlineShopping,Amazon,-1640.688054
28294,771288258,07-01-24 21:28,3600,IncomingTransfer,Salary,1959.311946
28295,771288258,07-02-24 12:28,157.07,Purchase,Clothing,1802.241946
28296,771288258,07-04-24 23:28,366.58,Deposit,Cash Deposit,2168.821946
28297,771288258,07-06-24 14:28,74.08,Return,Store Return,2242.901946
28298,771288258,07-06-24 21:28,2800,Payment,Credit Card Payment,-557.098054
28299,771288258,07-07-24 19:28,89.81,Purchase,Furniture,-646.908054
28300,771288258,07-08-24 12:28,336.37,Withdrawal,Branch Withdrawal,-983.278054
28301,771288258,07-08-24 16:28,226.84,Deposit,Check Deposit,-756.438054
28302,771288258,07-12-24 23:28,63.32,OutgoingTransfer,International Transfer,-819.758054
28303,771288258,7-13-24 20:28,372.05,Withdrawal,Branch Withdrawal,-1191.808054
28304,771288258,7-16-24 19:28,63.38,Return,Best Buy Return,-1128.428054
28305,771288258,7-16-24 21:28,1500,Payment,Insurance Payment,-2628.428054
28306,771433608,1-23-24 20:28,306.29,Payment,Mortgage Payment,-306.29
28307,771433608,1-28-24 19:28,361.27,OutgoingTransfer,Bank Transfer,-667.56
28308,771433608,1-30-24 21:28,677.75,Deposit,Cash Deposit,10.19
28309,771433608,02-03-24 21:28,9550,IncomingTransfer,Salary,9560.19
28310,771433608,02-06-24 15:28,514.44,OutgoingTransfer,International Transfer,9045.75
28311,771433608,02-10-24 17:28,644.8,OnlineShopping,Walmart,8400.95
28312,771433608,02-12-24 21:28,3400,Payment,Rent Payment,5000.95
28313,771433608,02-12-24 23:28,358.7,Return,AliExpress Return,5359.65
28314,771433608,2-13-24 23:28,405.39,IncomingTransfer,Freelance Payment,5765.04
28315,771433608,2-17-24 14:28,121.63,Purchase,Restaurant,5643.41
28316,771433608,2-18-24 16:28,293.66,Deposit,Cash Deposit,5937.07
28317,771433608,2-21-24 17:28,711.61,Purchase,Electronics,5225.46
28318,771433608,2-21-24 17:28,704.13,Return,Etsy Return,5929.59
28319,771433608,2-24-24 11:28,204.44,Purchase,Travel,5725.15
28320,771433608,2-29-24 16:28,490.05,Payment,Loan Payment,5235.1
28321,771433608,03-01-24 15:28,482.48,Withdrawal,ATM Withdrawal,4752.62
28322,771433608,03-02-24 21:28,9550,IncomingTransfer,Salary,14302.62
28323,771433608,03-10-24 21:28,221.71,OnlineShopping,Amazon,14080.91
28324,771433608,03-11-24 9:28,304.81,Deposit,Mobile Deposit,14385.72
28325,771433608,03-11-24 15:28,602.51,Withdrawal,Branch Withdrawal,13783.21
28326,771433608,3-13-24 9:28,500.47,Return,Best Buy Return,14283.68
28327,771433608,3-15-24 16:28,559.62,Purchase,Pharmacy,13724.06
28328,771433608,3-17-24 21:28,4300,Payment,Rent Payment,9424.06
28329,771433608,3-19-24 17:28,713.05,Withdrawal,ATM Withdrawal,8711.01
28330,771433608,3-20-24 18:28,487.15,Deposit,Check Deposit,9198.16
28331,771433608,3-20-24 19:28,320.99,Deposit,Cash Deposit,9519.15
28332,771433608,3-27-24 9:28,231.61,Purchase,Pharmacy,9287.54
28333,771433608,3-31-24 10:28,595.05,Payment,Loan Payment,8692.49
28334,771433608,04-01-24 21:28,9550,IncomingTransfer,Salary,18242.49
28335,771433608,04-04-24 10:28,576.89,IncomingTransfer,Freelance Payment,18819.38
28336,771433608,04-06-24 14:28,108.7,Purchase,Pharmacy,18710.68
28337,771433608,04-09-24 18:28,528.58,Withdrawal,Branch Withdrawal,18182.1
28338,771433608,4-15-24 21:28,5000,Payment,Rent Payment,13182.1
28339,771433608,4-16-24 17:28,229.19,OnlineShopping,Target,12952.91
28340,771433608,4-17-24 19:28,201.12,Deposit,Mobile Deposit,13154.03
28341,771433608,4-19-24 18:28,519.39,Withdrawal,Mobile App Withdrawal,12634.64
28342,771433608,4-21-24 12:28,702.03,Deposit,Mobile Deposit,13336.67
28343,771433608,4-22-24 11:28,354.72,OutgoingTransfer,Peer-to-Peer Transfer,12981.95
28344,771433608,4-23-24 19:28,127.31,OutgoingTransfer,Peer-to-Peer Transfer,12854.64
28345,771433608,4-24-24 19:28,313.94,Purchase,Travel,12540.7
28346,771433608,4-27-24 19:28,420.7,Withdrawal,ATM Withdrawal,12120
28347,771433608,4-27-24 21:28,420.15,Purchase,Pharmacy,11699.85
28348,771433608,4-28-24 17:28,304.85,Payment,Loan Payment,11395
28349,771433608,05-02-24 13:28,209.42,Purchase,Clothing,11185.58
28350,771433608,05-02-24 17:28,107.49,OutgoingTransfer,International Transfer,11078.09
28351,771433608,05-02-24 23:28,655.17,Return,Etsy Return,11733.26
28352,771433608,05-03-24 21:28,9550,IncomingTransfer,Salary,21283.26
28353,771433608,05-06-24 22:28,241.66,Withdrawal,Mobile App Withdrawal,21041.6
28354,771433608,05-08-24 11:28,420.01,Deposit,Cash Deposit,21461.61
28355,771433608,05-11-24 10:28,694.24,Purchase,Grocery,20767.37
28356,771433608,05-11-24 21:28,3000,Payment,Rent Payment,17767.37
28357,771433608,05-12-24 22:28,141.79,Deposit,Mobile Deposit,17909.16
28358,771433608,5-17-24 23:28,633.29,Purchase,Pharmacy,17275.87
28359,771433608,5-18-24 14:28,531.93,OnlineShopping,Amazon,16743.94
28360,771433608,5-20-24 13:28,386.86,Deposit,Check Deposit,17130.8
28361,771433608,5-20-24 17:28,132.6,OnlineShopping,eBay,16998.2
28362,771433608,5-21-24 19:28,248.59,Purchase,Restaurant,16749.61
28363,771433608,5-22-24 13:28,164.35,OutgoingTransfer,Bank Transfer,16585.26
28364,771433608,5-22-24 17:28,514.25,OutgoingTransfer,Wire Transfer,16071.01
28365,771433608,5-25-24 17:28,615.05,IncomingTransfer,Freelance Payment,16686.06
28366,771433608,5-27-24 12:28,286.38,IncomingTransfer,Freelance Payment,16972.44
28367,771433608,06-01-24 11:28,183.22,Deposit,Mobile Deposit,17155.66
28368,771433608,06-02-24 21:28,9550,IncomingTransfer,Salary,26705.66
28369,771433608,06-04-24 20:28,229.19,Deposit,Check Deposit,26934.85
28370,771433608,06-08-24 19:28,133.57,Withdrawal,Mobile App Withdrawal,26801.28
28371,771433608,06-08-24 20:28,367.74,Purchase,Clothing,26433.54
28372,771433608,06-12-24 9:28,190.06,OutgoingTransfer,Wire Transfer,26243.48
28373,771433608,06-12-24 19:28,356.24,Deposit,Check Deposit,26599.72
28374,771433608,6-13-24 21:28,464.99,Deposit,Mobile Deposit,27064.71
28375,771433608,6-16-24 18:28,108.36,OutgoingTransfer,Bank Transfer,26956.35
28376,771433608,6-16-24 21:28,3600,Payment,Rent Payment,23356.35
28377,771433608,6-18-24 18:28,449.78,Deposit,Check Deposit,23806.13
28378,771433608,6-21-24 12:28,626.92,Return,eBay Return,24433.05
28379,771433608,6-24-24 21:28,721.63,OnlineShopping,Etsy,23711.42
28380,771433608,07-01-24 12:28,293.11,Withdrawal,Branch Withdrawal,23418.31
28381,771433608,07-01-24 12:28,709.11,Purchase,Restaurant,22709.2
28382,771433608,07-02-24 18:28,469.65,Withdrawal,Mobile App Withdrawal,22239.55
28383,771433608,07-02-24 21:28,9550,IncomingTransfer,Salary,31789.55
28384,771433608,07-05-24 16:28,234.28,Withdrawal,Branch Withdrawal,31555.27
28385,771433608,07-09-24 12:28,534.15,Purchase,Entertainment,31021.12
28386,771433608,7-13-24 21:28,4900,Payment,Rent Payment,26121.12
28387,771433608,7-16-24 18:28,714.83,Purchase,Electronics,25406.29
28388,771486933,1-27-24 15:28,43.41,OnlineShopping,Walmart,1477.667652
28389,771486933,1-29-24 9:28,145.8,Payment,Bill Payment,1331.867652
28390,771486933,1-31-24 20:28,127.39,Purchase,Pharmacy,1204.477652
28391,771486933,02-02-24 21:28,1750,IncomingTransfer,Salary,2954.477652
28392,771486933,02-07-24 21:28,2900,Payment,Credit Card Payment,54.47765191
28393,771486933,02-08-24 20:28,127.51,OutgoingTransfer,Bank Transfer,-73.03234809
28394,771486933,02-11-24 13:28,46.55,OnlineShopping,Etsy,-119.5823481
28395,771486933,2-14-24 21:28,700,Payment,Rent Payment,-819.5823481
28396,771486933,2-18-24 13:28,20.59,Return,Store Return,-798.9923481
28397,771486933,2-19-24 17:28,34.7,IncomingTransfer,Freelance Payment,-764.2923481
28398,771486933,2-20-24 16:28,235.54,Withdrawal,ATM Withdrawal,-999.8323481
28399,771486933,2-23-24 20:28,84.6,Purchase,Entertainment,-1084.432348
28400,771486933,2-25-24 11:28,72.52,IncomingTransfer,Freelance Payment,-1011.912348
28401,771486933,2-25-24 13:28,18.51,OnlineShopping,Walmart,-1030.422348
28402,771486933,2-29-24 14:28,149.04,OnlineShopping,AliExpress,-1179.462348
28403,771486933,03-01-24 21:28,1750,IncomingTransfer,Salary,570.5376519
28404,771486933,03-04-24 21:28,167.24,Withdrawal,Mobile App Withdrawal,403.2976519
28405,771486933,03-04-24 23:28,213.1,OnlineShopping,eBay,190.1976519
28406,771486933,03-04-24 23:28,38.78,OutgoingTransfer,International Transfer,151.4176519
28407,771486933,03-06-24 21:28,2700,Payment,Credit Card Payment,-2548.582348
28408,771486933,03-08-24 11:28,22.85,Return,eBay Return,-2525.732348
28409,771486933,03-11-24 22:28,21.06,OutgoingTransfer,International Transfer,-2546.792348
28410,771486933,3-16-24 19:28,112.02,OnlineShopping,Best Buy,-2658.812348
28411,771486933,3-16-24 21:28,600,Payment,Rent Payment,-3258.812348
28412,771486933,3-17-24 15:28,157.35,Deposit,Mobile Deposit,-3101.462348
28413,771486933,3-18-24 20:28,16.91,Purchase,Travel,-3118.372348
28414,771486933,3-21-24 11:28,12.78,OnlineShopping,Best Buy,-3131.152348
28415,771486933,3-23-24 19:28,230.97,Withdrawal,ATM Withdrawal,-3362.122348
28416,771486933,3-24-24 18:28,241.36,OnlineShopping,Target,-3603.482348
28417,771486933,3-30-24 16:28,57.25,Withdrawal,Branch Withdrawal,-3660.732348
28418,771486933,04-01-24 18:28,225.18,Payment,Bill Payment,-3885.912348
28419,771486933,04-04-24 19:28,159.8,Purchase,Grocery,-4045.712348
28420,771486933,04-04-24 21:28,58.24,Deposit,Cash Deposit,-3987.472348
28421,771486933,04-05-24 21:28,1750,IncomingTransfer,Salary,-2237.472348
28422,771486933,04-05-24 23:28,72.39,Deposit,Direct Deposit,-2165.082348
28423,771486933,04-06-24 15:28,79.17,Deposit,Check Deposit,-2085.912348
28424,771486933,04-06-24 17:28,145.69,Purchase,Gas,-2231.602348
28425,771486933,04-06-24 21:28,65.34,OutgoingTransfer,Peer-to-Peer Transfer,-2296.942348
28426,771486933,04-08-24 10:28,110.08,IncomingTransfer,Freelance Payment,-2186.862348
28427,771486933,04-10-24 17:28,58.92,Payment,Mortgage Payment,-2245.782348
28428,771486933,04-10-24 21:28,2400,Payment,Credit Card Payment,-4645.782348
28429,771486933,04-11-24 11:28,78.75,Deposit,Direct Deposit,-4567.032348
28430,771486933,04-12-24 15:28,50.98,Withdrawal,ATM Withdrawal,-4618.012348
28431,771486933,4-16-24 20:28,20.21,OutgoingTransfer,International Transfer,-4638.222348
28432,771486933,4-16-24 21:28,700,Payment,Rent Payment,-5338.222348
28433,771486933,4-18-24 9:28,215.74,OutgoingTransfer,Bank Transfer,-5553.962348
28434,771486933,4-18-24 17:28,113.6,Purchase,Gas,-5667.562348
28435,771486933,4-18-24 20:28,10.87,OnlineShopping,Best Buy,-5678.432348
28436,771486933,4-19-24 9:28,171.43,OutgoingTransfer,Wire Transfer,-5849.862348
28437,771486933,4-21-24 13:28,242.48,Purchase,Restaurant,-6092.342348
28438,771486933,4-21-24 14:28,162.24,Purchase,Travel,-6254.582348
28439,771486933,4-22-24 10:28,61.72,OutgoingTransfer,Wire Transfer,-6316.302348
28440,771486933,4-23-24 15:28,121.43,Purchase,Travel,-6437.732348
28441,771486933,4-23-24 19:28,59.11,Deposit,Direct Deposit,-6378.622348
28442,771486933,4-29-24 14:28,70.54,Deposit,Cash Deposit,-6308.082348
28443,771486933,05-01-24 15:28,241.87,IncomingTransfer,Freelance Payment,-6066.212348
28444,771486933,05-04-24 21:28,1750,IncomingTransfer,Salary,-4316.212348
28445,771486933,05-09-24 21:28,2600,Payment,Credit Card Payment,-6916.212348
28446,771486933,05-10-24 11:28,92.88,OutgoingTransfer,Bank Transfer,-7009.092348
28447,771486933,05-12-24 11:28,245.61,Return,Target Return,-6763.482348
28448,771486933,5-13-24 21:28,800,Payment,Rent Payment,-7563.482348
28449,771486933,5-13-24 22:28,202.14,Payment,Bill Payment,-7765.622348
28450,771486933,5-13-24 23:28,234.7,Withdrawal,ATM Withdrawal,-8000.322348
28451,771486933,5-16-24 19:28,42,IncomingTransfer,Freelance Payment,-7958.322348
28452,771486933,5-18-24 22:28,219.46,OnlineShopping,Etsy,-8177.782348
28453,771486933,5-19-24 11:28,128.2,Return,Store Return,-8049.582348
28454,771486933,5-25-24 11:28,145.82,Withdrawal,ATM Withdrawal,-8195.402348
28455,771486933,5-27-24 17:28,35.58,Withdrawal,Mobile App Withdrawal,-8230.982348
28456,771486933,5-30-24 21:28,129.4,OutgoingTransfer,Wire Transfer,-8360.382348
28457,771486933,5-31-24 17:28,246.32,Purchase,Clothing,-8606.702348
28458,771486933,06-02-24 21:28,1750,IncomingTransfer,Salary,-6856.702348
28459,771486933,06-05-24 15:28,166.67,OnlineShopping,Best Buy,-7023.372348
28460,771486933,06-05-24 20:28,150.78,Payment,Loan Payment,-7174.152348
28461,771486933,06-07-24 21:28,2900,Payment,Credit Card Payment,-10074.15235
28462,771486933,06-09-24 15:28,116.91,Deposit,Direct Deposit,-9957.242348
28463,771486933,06-10-24 20:28,114.27,OnlineShopping,Best Buy,-10071.51235
28464,771486933,06-12-24 12:28,121.49,Payment,Bill Payment,-10193.00235
28465,771486933,6-14-24 18:28,103.67,Return,Amazon Return,-10089.33235
28466,771486933,6-15-24 19:28,175.22,Purchase,Pharmacy,-10264.55235
28467,771486933,6-15-24 21:28,900,Payment,Rent Payment,-11164.55235
28468,771486933,6-16-24 16:28,78.15,IncomingTransfer,Freelance Payment,-11086.40235
28469,771486933,6-17-24 19:28,45.93,Payment,Bill Payment,-11132.33235
28470,771486933,6-22-24 20:28,163.72,OutgoingTransfer,Bank Transfer,-11296.05235
28471,771486933,6-27-24 9:28,143.09,Purchase,Travel,-11439.14235
28472,771486933,6-30-24 11:28,28.04,Purchase,Gas,-11467.18235
28473,771486933,07-01-24 20:28,245.35,OnlineShopping,Best Buy,-11712.53235
28474,771486933,07-01-24 21:28,1750,IncomingTransfer,Salary,-9962.532348
28475,771486933,07-02-24 9:28,234.88,Deposit,Direct Deposit,-9727.652348
28476,771486933,07-04-24 13:28,167.42,Return,Amazon Return,-9560.232348
28477,771486933,07-04-24 16:28,218.6,OnlineShopping,Walmart,-9778.832348
28478,771486933,07-05-24 16:28,83.33,Deposit,Check Deposit,-9695.502348
28479,771486933,07-05-24 17:28,12.99,Withdrawal,ATM Withdrawal,-9708.492348
28480,771486933,07-06-24 21:28,2500,Payment,Credit Card Payment,-12208.49235
28481,771486933,07-07-24 10:28,69.48,OutgoingTransfer,International Transfer,-12277.97235
28482,771486933,07-10-24 17:28,169.55,Payment,Mortgage Payment,-12447.52235
28483,771486933,07-10-24 22:28,196.27,Purchase,Gas,-12643.79235
28484,771486933,07-12-24 9:28,110.5,Deposit,Direct Deposit,-12533.29235
28485,771486933,7-13-24 20:28,44.77,Payment,Bill Payment,-12578.06235
28486,771486933,7-13-24 21:28,900,Payment,Rent Payment,-13478.06235
28487,771486933,7-13-24 22:28,79.59,Withdrawal,ATM Withdrawal,-13557.65235
28488,771486933,7-17-24 14:28,85.89,Payment,Loan Payment,-13643.54235
28489,771486933,7-17-24 20:28,241.24,Deposit,Check Deposit,-13402.30235
28490,771497283,1-20-24 12:28,204.98,Deposit,Check Deposit,1375.005347
28491,771497283,1-20-24 13:28,168.57,Withdrawal,Branch Withdrawal,1206.435347
28492,771497283,1-21-24 19:28,221.6,Withdrawal,Mobile App Withdrawal,984.835347
28493,771497283,1-26-24 17:28,70.41,Deposit,Cash Deposit,1055.245347
28494,771497283,1-28-24 22:28,187.19,Deposit,Mobile Deposit,1242.435347
28495,771497283,1-29-24 17:28,213.7,Deposit,Mobile Deposit,1456.135347
28496,771497283,1-30-24 9:28,137.47,Withdrawal,Mobile App Withdrawal,1318.665347
28497,771497283,1-30-24 22:28,37.49,Withdrawal,Mobile App Withdrawal,1281.175347
28498,771497283,02-03-24 14:28,146.37,Purchase,Pharmacy,1134.805347
28499,771497283,02-05-24 21:28,2300,IncomingTransfer,Salary,3434.805347
28500,771497283,02-07-24 9:28,23.61,Deposit,Direct Deposit,3458.415347
28501,771497283,02-07-24 10:28,55.09,Return,AliExpress Return,3513.505347
28502,771497283,02-07-24 13:28,25.76,Withdrawal,Branch Withdrawal,3487.745347
28503,771497283,02-10-24 15:28,196.13,IncomingTransfer,Freelance Payment,3683.875347
28504,771497283,02-10-24 20:28,130.82,Withdrawal,ATM Withdrawal,3553.055347
28505,771497283,02-10-24 21:28,1700,Payment,Credit Card Payment,1853.055347
28506,771497283,02-12-24 14:28,160.99,Purchase,Entertainment,1692.065347
28507,771497283,02-12-24 19:28,139.86,Purchase,Gas,1552.205347
28508,771497283,2-15-24 9:28,231.93,Payment,Bill Payment,1320.275347
28509,771497283,2-16-24 12:28,223.97,IncomingTransfer,Freelance Payment,1544.245347
28510,771497283,2-18-24 13:28,131.27,Purchase,Entertainment,1412.975347
28511,771497283,2-18-24 13:28,189.75,Deposit,Direct Deposit,1602.725347
28512,771497283,2-18-24 21:28,1300,Payment,Rent Payment,302.725347
28513,771497283,2-18-24 22:28,194.29,Return,Best Buy Return,497.015347
28514,771497283,2-24-24 22:28,239.12,Purchase,Gas,257.895347
28515,771497283,2-27-24 23:28,15.86,Payment,Bill Payment,242.035347
28516,771497283,2-29-24 17:28,86.7,Withdrawal,Branch Withdrawal,155.335347
28517,771497283,03-01-24 21:28,2300,IncomingTransfer,Salary,2455.335347
28518,771497283,03-04-24 9:28,10.53,Purchase,Grocery,2444.805347
28519,771497283,03-06-24 21:28,1600,Payment,Credit Card Payment,844.805347
28520,771497283,03-08-24 16:28,87.66,OnlineShopping,eBay,757.145347
28521,771497283,03-12-24 23:28,203.65,OnlineShopping,Amazon,553.495347
28522,771497283,3-13-24 21:28,1200,Payment,Rent Payment,-646.504653
28523,771497283,3-15-24 19:28,242.35,Return,Store Return,-404.154653
28524,771497283,3-18-24 20:28,223.83,Purchase,Travel,-627.984653
28525,771497283,3-19-24 14:28,223.2,Purchase,Pharmacy,-851.184653
28526,771497283,3-21-24 23:28,200.99,Purchase,Furniture,-1052.174653
28527,771497283,3-23-24 13:28,218.57,Deposit,Cash Deposit,-833.604653
28528,771497283,3-24-24 21:28,10.31,IncomingTransfer,Freelance Payment,-823.294653
28529,771497283,3-27-24 10:28,27.36,Purchase,Furniture,-850.654653
28530,771497283,3-29-24 9:28,112.84,Withdrawal,Mobile App Withdrawal,-963.494653
28531,771497283,3-29-24 23:28,215.14,Purchase,Entertainment,-1178.634653
28532,771497283,3-31-24 17:28,163.3,OnlineShopping,eBay,-1341.934653
28533,771497283,04-03-24 21:28,2300,IncomingTransfer,Salary,958.065347
28534,771497283,04-06-24 14:28,137.85,OnlineShopping,AliExpress,820.215347
28535,771497283,04-08-24 21:28,1500,Payment,Credit Card Payment,-679.784653
28536,771497283,04-08-24 23:28,11.55,Purchase,Entertainment,-691.334653
28537,771497283,04-10-24 21:28,900,Payment,Rent Payment,-1591.334653
28538,771497283,4-13-24 22:28,222.79,Purchase,Furniture,-1814.124653
28539,771497283,4-16-24 15:28,71.87,Purchase,Grocery,-1885.994653
28540,771497283,4-18-24 19:28,227.88,Deposit,Cash Deposit,-1658.114653
28541,771497283,4-20-24 19:28,116.69,Withdrawal,Mobile App Withdrawal,-1774.804653
28542,771497283,4-24-24 9:28,168.22,OnlineShopping,Etsy,-1943.024653
28543,771497283,4-26-24 10:28,81.87,Deposit,Direct Deposit,-1861.154653
28544,771497283,4-26-24 11:28,137.38,Purchase,Clothing,-1998.534653
28545,771497283,4-27-24 17:28,167.68,Withdrawal,Mobile App Withdrawal,-2166.214653
28546,771497283,4-28-24 11:28,132.43,Deposit,Direct Deposit,-2033.784653
28547,771497283,4-29-24 13:28,126,Deposit,Cash Deposit,-1907.784653
28548,771497283,4-30-24 14:28,70.2,OnlineShopping,Target,-1977.984653
28549,771497283,05-01-24 9:28,60.68,Return,Etsy Return,-1917.304653
28550,771497283,05-01-24 22:28,130.98,Withdrawal,Mobile App Withdrawal,-2048.284653
28551,771497283,05-02-24 12:28,56.69,OnlineShopping,eBay,-2104.974653
28552,771497283,05-03-24 21:28,2300,IncomingTransfer,Salary,195.025347
28553,771497283,05-08-24 21:28,1900,Payment,Credit Card Payment,-1704.974653
28554,771497283,05-10-24 15:28,147.46,OnlineShopping,Amazon,-1852.434653
28555,771497283,5-17-24 21:28,1300,Payment,Rent Payment,-3152.434653
28556,771497283,5-19-24 21:28,116.5,OutgoingTransfer,Wire Transfer,-3268.934653
28557,771497283,5-20-24 15:28,66.67,OutgoingTransfer,Peer-to-Peer Transfer,-3335.604653
28558,771497283,5-22-24 18:28,40.15,Withdrawal,Branch Withdrawal,-3375.754653
28559,771497283,5-29-24 15:28,221.93,Payment,Mortgage Payment,-3597.684653
28560,771497283,5-29-24 16:28,213.41,Deposit,Cash Deposit,-3384.274653
28561,771497283,5-31-24 17:28,236.43,IncomingTransfer,Freelance Payment,-3147.844653
28562,771497283,06-02-24 21:28,2300,IncomingTransfer,Salary,-847.844653
28563,771497283,06-04-24 10:28,233.61,Purchase,Furniture,-1081.454653
28564,771497283,06-07-24 21:28,1500,Payment,Credit Card Payment,-2581.454653
28565,771497283,06-08-24 20:28,92.13,Payment,Loan Payment,-2673.584653
28566,771497283,6-13-24 18:28,36.57,Withdrawal,Branch Withdrawal,-2710.154653
28567,771497283,6-14-24 11:28,183.57,Purchase,Restaurant,-2893.724653
28568,771497283,6-14-24 21:28,600,Payment,Rent Payment,-3493.724653
28569,771497283,6-16-24 18:28,213.15,Payment,Bill Payment,-3706.874653
28570,771497283,6-17-24 15:28,100.63,OnlineShopping,Walmart,-3807.504653
28571,771497283,6-18-24 22:28,63.08,Deposit,Mobile Deposit,-3744.424653
28572,771497283,6-18-24 22:28,114.24,Withdrawal,ATM Withdrawal,-3858.664653
28573,771497283,6-21-24 19:28,34.53,OnlineShopping,Best Buy,-3893.194653
28574,771497283,6-24-24 21:28,136.97,Deposit,Mobile Deposit,-3756.224653
28575,771497283,6-25-24 13:28,117.89,Deposit,Direct Deposit,-3638.334653
28576,771497283,6-26-24 14:28,79.9,OutgoingTransfer,Peer-to-Peer Transfer,-3718.234653
28577,771497283,6-29-24 10:28,25.3,Withdrawal,ATM Withdrawal,-3743.534653
28578,771497283,07-05-24 13:28,168.86,Return,AliExpress Return,-3574.674653
28579,771497283,07-05-24 21:28,2300,IncomingTransfer,Salary,-1274.674653
28580,771497283,07-07-24 13:28,25.34,Deposit,Check Deposit,-1249.334653
28581,771497283,07-08-24 12:28,149.34,Return,Etsy Return,-1099.994653
28582,771497283,07-08-24 21:28,99.85,Deposit,Check Deposit,-1000.144653
28583,771497283,07-10-24 21:28,1500,Payment,Credit Card Payment,-2500.144653
28584,771497283,07-11-24 21:28,1500,Payment,Rent Payment,-4000.144653
28585,771497283,07-11-24 22:28,187.72,Deposit,Check Deposit,-3812.424653
28586,771497283,7-16-24 13:28,210.48,OnlineShopping,AliExpress,-4022.904653
28587,771499233,1-21-24 19:28,243.17,Deposit,Check Deposit,1151.5525
28588,771499233,1-23-24 11:28,79.89,Deposit,Check Deposit,1231.4425
28589,771499233,1-24-24 21:28,24.77,OnlineShopping,AliExpress,1206.6725
28590,771499233,1-25-24 18:28,177.55,Purchase,Travel,1029.1225
28591,771499233,1-28-24 14:28,39.74,Withdrawal,Branch Withdrawal,989.3825003
28592,771499233,02-02-24 17:28,10.74,Return,Store Return,1000.1225
28593,771499233,02-02-24 20:28,48.6,OnlineShopping,eBay,951.5225003
28594,771499233,02-02-24 23:28,32.94,Deposit,Cash Deposit,984.4625003
28595,771499233,02-04-24 21:28,2350,IncomingTransfer,Salary,3334.4625
28596,771499233,02-06-24 13:28,140.33,OutgoingTransfer,Wire Transfer,3194.1325
28597,771499233,02-09-24 21:28,1200,Payment,Credit Card Payment,1994.1325
28598,771499233,02-11-24 21:28,900,Payment,Rent Payment,1094.1325
28599,771499233,02-12-24 11:28,233.41,Payment,Bill Payment,860.7225003
28600,771499233,2-19-24 14:28,37.07,Deposit,Check Deposit,897.7925003
28601,771499233,2-25-24 21:28,132.84,IncomingTransfer,Freelance Payment,1030.6325
28602,771499233,2-28-24 22:28,160.57,OutgoingTransfer,Peer-to-Peer Transfer,870.0625003
28603,771499233,03-01-24 11:28,92.1,Payment,Bill Payment,777.9625003
28604,771499233,03-01-24 13:28,97.72,Withdrawal,ATM Withdrawal,680.2425003
28605,771499233,03-01-24 21:28,2350,IncomingTransfer,Salary,3030.2425
28606,771499233,03-02-24 12:28,88.04,Return,Target Return,3118.2825
28607,771499233,03-03-24 17:28,135.61,OutgoingTransfer,Peer-to-Peer Transfer,2982.6725
28608,771499233,03-05-24 20:28,33.18,IncomingTransfer,Freelance Payment,3015.8525
28609,771499233,03-06-24 11:28,57.48,Purchase,Clothing,2958.3725
28610,771499233,03-06-24 21:28,1600,Payment,Credit Card Payment,1358.3725
28611,771499233,03-07-24 18:28,141.55,OutgoingTransfer,Bank Transfer,1216.8225
28612,771499233,03-08-24 10:28,59.02,Return,Best Buy Return,1275.8425
28613,771499233,03-08-24 19:28,243.66,Purchase,Clothing,1032.1825
28614,771499233,03-09-24 10:28,102.62,Deposit,Cash Deposit,1134.8025
28615,771499233,03-09-24 18:28,26.1,Payment,Bill Payment,1108.7025
28616,771499233,03-10-24 19:28,186.51,Purchase,Entertainment,922.1925003
28617,771499233,03-11-24 21:28,900,Payment,Rent Payment,22.19250028
28618,771499233,03-12-24 17:28,193.73,Purchase,Restaurant,-171.5374997
28619,771499233,03-12-24 18:28,197.67,Payment,Loan Payment,-369.2074997
28620,771499233,3-14-24 19:28,109.15,OutgoingTransfer,Bank Transfer,-478.3574997
28621,771499233,3-22-24 9:28,180.44,Purchase,Pharmacy,-658.7974997
28622,771499233,3-22-24 15:28,14.74,Purchase,Restaurant,-673.5374997
28623,771499233,3-22-24 21:28,110.45,OnlineShopping,Etsy,-783.9874997
28624,771499233,3-31-24 11:28,39.45,Purchase,Pharmacy,-823.4374997
28625,771499233,04-02-24 10:28,47.57,OnlineShopping,Amazon,-871.0074997
28626,771499233,04-03-24 17:28,46.89,Withdrawal,ATM Withdrawal,-917.8974997
28627,771499233,04-05-24 21:28,2350,IncomingTransfer,Salary,1432.1025
28628,771499233,04-10-24 14:28,247.33,Purchase,Home Improvement,1184.7725
28629,771499233,04-10-24 21:28,1400,Payment,Credit Card Payment,-215.2274997
28630,771499233,04-12-24 11:28,130.99,Withdrawal,ATM Withdrawal,-346.2174997
28631,771499233,4-14-24 21:28,43.49,Return,eBay Return,-302.7274997
28632,771499233,4-16-24 21:28,900,Payment,Rent Payment,-1202.7275
28633,771499233,4-17-24 18:28,118.88,Deposit,Cash Deposit,-1083.8475
28634,771499233,4-19-24 22:28,91.09,OnlineShopping,Etsy,-1174.9375
28635,771499233,4-21-24 15:28,140.04,Return,AliExpress Return,-1034.8975
28636,771499233,4-23-24 10:28,191.55,Purchase,Travel,-1226.4475
28637,771499233,4-29-24 18:28,31.47,Payment,Mortgage Payment,-1257.9175
28638,771499233,05-01-24 10:28,67.96,Deposit,Cash Deposit,-1189.9575
28639,771499233,05-02-24 19:28,156.02,Deposit,Direct Deposit,-1033.9375
28640,771499233,05-04-24 13:28,10.33,Deposit,Mobile Deposit,-1023.6075
28641,771499233,05-05-24 21:28,2350,IncomingTransfer,Salary,1326.3925
28642,771499233,05-10-24 11:28,36.98,Payment,Loan Payment,1289.4125
28643,771499233,05-10-24 21:28,1300,Payment,Credit Card Payment,-10.58749972
28644,771499233,05-11-24 10:28,52.75,OnlineShopping,eBay,-63.33749972
28645,771499233,5-13-24 21:28,120.21,Purchase,Electronics,-183.5474997
28646,771499233,5-17-24 21:28,900,Payment,Rent Payment,-1083.5475
28647,771499233,5-17-24 21:28,171.69,IncomingTransfer,Freelance Payment,-911.8574997
28648,771499233,5-20-24 9:28,212.85,Payment,Bill Payment,-1124.7075
28649,771499233,5-20-24 22:28,173.23,Withdrawal,Mobile App Withdrawal,-1297.9375
28650,771499233,5-22-24 15:28,201.5,Deposit,Check Deposit,-1096.4375
28651,771499233,5-24-24 17:28,181.46,Deposit,Direct Deposit,-914.9774997
28652,771499233,5-26-24 14:28,160.96,Payment,Mortgage Payment,-1075.9375
28653,771499233,5-27-24 17:28,168.89,Deposit,Check Deposit,-907.0474997
28654,771499233,5-27-24 18:28,105.85,Deposit,Mobile Deposit,-801.1974997
28655,771499233,5-30-24 11:28,33.71,Payment,Mortgage Payment,-834.9074997
28656,771499233,06-04-24 21:28,2350,IncomingTransfer,Salary,1515.0925
28657,771499233,06-06-24 21:28,30.8,Deposit,Direct Deposit,1545.8925
28658,771499233,06-08-24 16:28,171.71,Withdrawal,Branch Withdrawal,1374.1825
28659,771499233,06-09-24 14:28,51.97,IncomingTransfer,Freelance Payment,1426.1525
28660,771499233,06-09-24 21:28,1300,Payment,Credit Card Payment,126.1525003
28661,771499233,6-14-24 23:28,80.9,Withdrawal,Mobile App Withdrawal,45.25250028
28662,771499233,6-15-24 21:28,1000,Payment,Rent Payment,-954.7474997
28663,771499233,6-18-24 18:28,110.56,Withdrawal,Branch Withdrawal,-1065.3075
28664,771499233,6-19-24 23:28,15.74,Deposit,Check Deposit,-1049.5675
28665,771499233,6-22-24 11:28,236.42,Purchase,Home Improvement,-1285.9875
28666,771499233,6-24-24 20:28,128.5,Deposit,Check Deposit,-1157.4875
28667,771499233,6-27-24 22:28,88.32,Purchase,Grocery,-1245.8075
28668,771499233,6-28-24 12:28,37.35,Purchase,Restaurant,-1283.1575
28669,771499233,07-03-24 15:28,93.93,Return,AliExpress Return,-1189.2275
28670,771499233,07-04-24 21:28,2350,IncomingTransfer,Salary,1160.7725
28671,771499233,07-06-24 13:28,45.01,Payment,Mortgage Payment,1115.7625
28672,771499233,07-06-24 22:28,99.6,OnlineShopping,Best Buy,1016.1625
28673,771499233,07-07-24 21:28,248.08,OutgoingTransfer,Peer-to-Peer Transfer,768.0825003
28674,771499233,07-07-24 22:28,44.3,Deposit,Cash Deposit,812.3825003
28675,771499233,07-09-24 21:28,1300,Payment,Credit Card Payment,-487.6174997
28676,771499233,07-12-24 17:28,104.21,Withdrawal,ATM Withdrawal,-591.8274997
28677,771499233,7-13-24 19:28,124.55,OutgoingTransfer,International Transfer,-716.3774997
28678,771499233,7-14-24 11:28,34.18,Deposit,Check Deposit,-682.1974997
28679,771499233,7-14-24 14:28,57.28,Deposit,Mobile Deposit,-624.9174997
28680,771499233,7-15-24 21:28,1300,Payment,Rent Payment,-1924.9175
28681,771546708,1-20-24 12:28,89.42,Withdrawal,ATM Withdrawal,-89.42
28682,771546708,1-20-24 17:28,179.61,Withdrawal,Mobile App Withdrawal,-269.03
28683,771546708,1-21-24 10:28,117.03,Return,Etsy Return,-152
28684,771546708,1-21-24 16:28,102.09,OnlineShopping,eBay,-254.09
28685,771546708,1-29-24 11:28,244.1,Return,Amazon Return,-9.99
28686,771546708,1-30-24 12:28,39.81,Withdrawal,Branch Withdrawal,-49.8
28687,771546708,1-31-24 9:28,13.58,Deposit,Direct Deposit,-36.22
28688,771546708,02-02-24 14:28,124.89,Return,Walmart Return,88.67
28689,771546708,02-05-24 9:28,201.09,Deposit,Direct Deposit,289.76
28690,771546708,02-05-24 21:28,2350,IncomingTransfer,Salary,2639.76
28691,771546708,02-09-24 22:28,151.06,OnlineShopping,eBay,2488.7
28692,771546708,02-10-24 15:28,72.63,Withdrawal,ATM Withdrawal,2416.07
28693,771546708,02-12-24 21:28,37.53,OutgoingTransfer,Peer-to-Peer Transfer,2378.54
28694,771546708,2-15-24 21:28,700,Payment,Installment Payment,1678.54
28695,771546708,2-16-24 19:28,143.39,OutgoingTransfer,Bank Transfer,1535.15
28696,771546708,2-17-24 14:28,10.88,Payment,Loan Payment,1524.27
28697,771546708,2-20-24 14:28,29.36,IncomingTransfer,Freelance Payment,1553.63
28698,771546708,2-24-24 15:28,171.27,OutgoingTransfer,Bank Transfer,1382.36
28699,771546708,2-25-24 22:28,82.03,Payment,Loan Payment,1300.33
28700,771546708,2-28-24 16:28,157.16,Return,Best Buy Return,1457.49
28701,771546708,2-29-24 17:28,129.44,Deposit,Check Deposit,1586.93
28702,771546708,03-02-24 21:28,2350,IncomingTransfer,Salary,3936.93
28703,771546708,03-04-24 13:28,142.07,Deposit,Mobile Deposit,4079
28704,771546708,03-06-24 14:28,182.97,Return,Etsy Return,4261.97
28705,771546708,03-09-24 13:28,144.63,Purchase,Furniture,4117.34
28706,771546708,03-09-24 19:28,36.07,Purchase,Travel,4081.27
28707,771546708,03-11-24 21:28,900,Payment,Insurance Payment,3181.27
28708,771546708,03-11-24 22:28,127.77,Deposit,Check Deposit,3309.04
28709,771546708,3-14-24 19:28,158.16,Purchase,Electronics,3150.88
28710,771546708,3-15-24 17:28,174.07,Withdrawal,Branch Withdrawal,2976.81
28711,771546708,3-18-24 9:28,162.54,OnlineShopping,eBay,2814.27
28712,771546708,3-22-24 17:28,86.7,Purchase,Gas,2727.57
28713,771546708,3-23-24 21:28,209.17,Withdrawal,Mobile App Withdrawal,2518.4
28714,771546708,3-24-24 11:28,187.86,Payment,Loan Payment,2330.54
28715,771546708,3-30-24 19:28,124.69,Purchase,Furniture,2205.85
28716,771546708,3-31-24 16:28,65.54,Return,eBay Return,2271.39
28717,771546708,04-02-24 21:28,242.47,Purchase,Grocery,2028.92
28718,771546708,04-03-24 21:28,2350,IncomingTransfer,Salary,4378.92
28719,771546708,04-04-24 9:28,77.66,Withdrawal,Branch Withdrawal,4301.26
28720,771546708,04-04-24 11:28,106.87,Deposit,Cash Deposit,4408.13
28721,771546708,04-08-24 14:28,221.45,Deposit,Check Deposit,4629.58
28722,771546708,4-18-24 21:28,800,Payment,Installment Payment,3829.58
28723,771546708,4-22-24 14:28,132.91,OnlineShopping,Etsy,3696.67
28724,771546708,4-23-24 23:28,85.12,Purchase,Clothing,3611.55
28725,771546708,4-24-24 10:28,229.07,Deposit,Cash Deposit,3840.62
28726,771546708,4-25-24 17:28,244.49,Return,Target Return,4085.11
28727,771546708,4-28-24 19:28,150.9,Deposit,Direct Deposit,4236.01
28728,771546708,05-02-24 18:28,53.72,Payment,Mortgage Payment,4182.29
28729,771546708,05-02-24 21:28,2350,IncomingTransfer,Salary,6532.29
28730,771546708,05-03-24 10:28,195.77,Deposit,Direct Deposit,6728.06
28731,771546708,05-05-24 16:28,32.09,OnlineShopping,Amazon,6695.97
28732,771546708,05-08-24 19:28,18.23,Return,Store Return,6714.2
28733,771546708,05-10-24 13:28,165.56,Withdrawal,Branch Withdrawal,6548.64
28734,771546708,05-12-24 21:28,800,Payment,Subscription Payment,5748.64
28735,771546708,5-16-24 13:28,48.71,IncomingTransfer,Freelance Payment,5797.35
28736,771546708,5-18-24 14:28,138.03,Deposit,Mobile Deposit,5935.38
28737,771546708,5-23-24 12:28,131.53,Purchase,Gas,5803.85
28738,771546708,5-23-24 14:28,32.26,Deposit,Direct Deposit,5836.11
28739,771546708,5-23-24 20:28,226.03,IncomingTransfer,Freelance Payment,6062.14
28740,771546708,5-25-24 20:28,70.49,Withdrawal,Mobile App Withdrawal,5991.65
28741,771546708,5-26-24 14:28,126.24,Return,Store Return,6117.89
28742,771546708,5-28-24 14:28,105.96,OnlineShopping,Walmart,6011.93
28743,771546708,5-28-24 19:28,29.73,OutgoingTransfer,Peer-to-Peer Transfer,5982.2
28744,771546708,5-31-24 9:28,39.56,OutgoingTransfer,Wire Transfer,5942.64
28745,771546708,5-31-24 12:28,113.29,Deposit,Cash Deposit,6055.93
28746,771546708,06-02-24 21:28,179.62,Payment,Loan Payment,5876.31
28747,771546708,06-03-24 9:28,197.98,OutgoingTransfer,Peer-to-Peer Transfer,5678.33
28748,771546708,06-03-24 19:28,96.39,Return,Best Buy Return,5774.72
28749,771546708,06-05-24 21:28,2350,IncomingTransfer,Salary,8124.72
28750,771546708,06-05-24 23:28,17.61,Purchase,Home Improvement,8107.11
28751,771546708,06-12-24 15:28,210.56,Deposit,Cash Deposit,8317.67
28752,771546708,6-14-24 21:28,600,Payment,Subscription Payment,7717.67
28753,771546708,6-18-24 23:28,111.65,Withdrawal,Mobile App Withdrawal,7606.02
28754,771546708,6-19-24 19:28,72.4,Deposit,Check Deposit,7678.42
28755,771546708,6-20-24 19:28,72.28,Return,eBay Return,7750.7
28756,771546708,6-21-24 20:28,119.63,Purchase,Travel,7631.07
28757,771546708,6-23-24 20:28,101.92,Purchase,Home Improvement,7529.15
28758,771546708,6-24-24 11:28,183.03,Return,Best Buy Return,7712.18
28759,771546708,6-24-24 21:28,223.92,Purchase,Restaurant,7488.26
28760,771546708,07-01-24 15:28,242.99,Deposit,Check Deposit,7731.25
28761,771546708,07-02-24 23:28,166.7,Withdrawal,ATM Withdrawal,7564.55
28762,771546708,07-03-24 16:28,199.24,Payment,Mortgage Payment,7365.31
28763,771546708,07-04-24 21:28,2350,IncomingTransfer,Salary,9715.31
28764,771546708,07-06-24 22:28,53.84,Purchase,Pharmacy,9661.47
28765,771546708,07-10-24 19:28,166.58,Deposit,Cash Deposit,9828.05
28766,771546708,07-12-24 13:28,169.41,Deposit,Direct Deposit,9997.46
28767,771546708,7-13-24 21:28,239.74,OutgoingTransfer,International Transfer,9757.72
28768,771546708,7-13-24 21:28,210.78,Deposit,Direct Deposit,9968.5
28769,771546708,7-14-24 21:28,800,Payment,Insurance Payment,9168.5
28770,771546708,7-15-24 11:28,208.06,Return,Store Return,9376.56
28771,771546708,7-15-24 13:28,73.14,Payment,Bill Payment,9303.42
28772,771546708,7-17-24 10:28,160.18,Withdrawal,Mobile App Withdrawal,9143.24
28773,771546708,7-17-24 18:28,187.53,OutgoingTransfer,Peer-to-Peer Transfer,8955.71
28774,771638733,02-03-24 21:28,3450,IncomingTransfer,Salary,3450
28775,771638733,02-09-24 21:28,166.75,Purchase,Grocery,3283.25
28776,771638733,2-15-24 21:28,2000,Payment,Rent Payment,1283.25
28777,771638733,2-18-24 16:28,369.69,Return,Etsy Return,1652.94
28778,771638733,2-18-24 19:28,327.21,Purchase,Restaurant,1325.73
28779,771638733,2-21-24 12:28,246.5,Withdrawal,Mobile App Withdrawal,1079.23
28780,771638733,2-21-24 12:28,84,OnlineShopping,Walmart,995.23
28781,771638733,2-23-24 19:28,40,OutgoingTransfer,Bank Transfer,955.23
28782,771638733,2-27-24 9:28,70.04,OutgoingTransfer,Bank Transfer,885.19
28783,771638733,03-02-24 21:28,3450,IncomingTransfer,Salary,4335.19
28784,771638733,03-10-24 12:28,346.28,Purchase,Travel,3988.91
28785,771638733,03-10-24 21:28,1300,Payment,Rent Payment,2688.91
28786,771638733,3-14-24 13:28,267.96,Deposit,Check Deposit,2956.87
28787,771638733,3-15-24 12:28,391.14,Withdrawal,ATM Withdrawal,2565.73
28788,771638733,3-16-24 21:28,397.21,OnlineShopping,Target,2168.52
28789,771638733,3-19-24 10:28,194.52,Deposit,Cash Deposit,2363.04
28790,771638733,3-22-24 16:28,100.37,IncomingTransfer,Freelance Payment,2463.41
28791,771638733,3-25-24 18:28,325.11,Purchase,Restaurant,2138.3
28792,771638733,3-26-24 12:28,151.92,Deposit,Mobile Deposit,2290.22
28793,771638733,04-01-24 13:28,66.73,Return,Etsy Return,2356.95
28794,771638733,04-03-24 16:28,195.22,OnlineShopping,Amazon,2161.73
28795,771638733,04-03-24 20:28,105.48,Deposit,Check Deposit,2267.21
28796,771638733,04-03-24 21:28,3450,IncomingTransfer,Salary,5717.21
28797,771638733,04-04-24 16:28,378.44,Deposit,Check Deposit,6095.65
28798,771638733,04-05-24 22:28,57.95,OnlineShopping,Amazon,6037.7
28799,771638733,04-06-24 22:28,90.48,IncomingTransfer,Freelance Payment,6128.18
28800,771638733,04-08-24 13:28,309.61,Payment,Loan Payment,5818.57
28801,771638733,04-08-24 14:28,183.6,Deposit,Cash Deposit,6002.17
28802,771638733,04-09-24 21:28,213.54,Return,Amazon Return,6215.71
28803,771638733,04-11-24 22:28,303.71,Payment,Loan Payment,5912
28804,771638733,4-14-24 21:28,2100,Payment,Rent Payment,3812
28805,771638733,4-18-24 20:28,359.49,Withdrawal,Branch Withdrawal,3452.51
28806,771638733,4-21-24 14:28,101.36,Payment,Loan Payment,3351.15
28807,771638733,4-21-24 16:28,67.02,Purchase,Entertainment,3284.13
28808,771638733,4-22-24 12:28,32.47,IncomingTransfer,Freelance Payment,3316.6
28809,771638733,4-25-24 10:28,233.48,Deposit,Direct Deposit,3550.08
28810,771638733,4-28-24 16:28,303.91,Deposit,Direct Deposit,3853.99
28811,771638733,05-02-24 21:28,3450,IncomingTransfer,Salary,7303.99
28812,771638733,05-06-24 14:28,181.58,Payment,Bill Payment,7122.41
28813,771638733,05-10-24 12:28,186.57,Deposit,Cash Deposit,7308.98
28814,771638733,5-15-24 10:28,153.19,OutgoingTransfer,International Transfer,7155.79
28815,771638733,5-15-24 21:28,1900,Payment,Rent Payment,5255.79
28816,771638733,5-18-24 13:28,56.25,Payment,Loan Payment,5199.54
28817,771638733,5-31-24 11:28,101.94,Deposit,Mobile Deposit,5301.48
28818,771638733,06-01-24 16:28,326.15,Return,Amazon Return,5627.63
28819,771638733,06-03-24 14:28,37.51,Payment,Mortgage Payment,5590.12
28820,771638733,06-04-24 14:28,108.83,OnlineShopping,Best Buy,5481.29
28821,771638733,06-04-24 21:28,3450,IncomingTransfer,Salary,8931.29
28822,771638733,06-07-24 16:28,56.51,Deposit,Cash Deposit,8987.8
28823,771638733,06-07-24 18:28,324.22,Return,eBay Return,9312.02
28824,771638733,06-08-24 15:28,394.03,OnlineShopping,Walmart,8917.99
28825,771638733,06-11-24 22:28,138.13,Purchase,Restaurant,8779.86
28826,771638733,6-14-24 16:28,25.67,Deposit,Cash Deposit,8805.53
28827,771638733,6-15-24 21:28,1300,Payment,Rent Payment,7505.53
28828,771638733,6-16-24 14:28,370.03,Purchase,Entertainment,7135.5
28829,771638733,6-18-24 9:28,277.36,Deposit,Direct Deposit,7412.86
28830,771638733,6-19-24 16:28,396.5,Deposit,Cash Deposit,7809.36
28831,771638733,6-21-24 22:28,79.54,OutgoingTransfer,Wire Transfer,7729.82
28832,771638733,6-24-24 22:28,57.3,Withdrawal,Mobile App Withdrawal,7672.52
28833,771638733,6-25-24 13:28,337.58,OnlineShopping,Target,7334.94
28834,771638733,6-28-24 15:28,288.68,Payment,Loan Payment,7046.26
28835,771638733,6-30-24 15:28,363.72,Deposit,Mobile Deposit,7409.98
28836,771638733,07-02-24 13:28,336.47,Purchase,Gas,7073.51
28837,771638733,07-02-24 21:28,3450,IncomingTransfer,Salary,10523.51
28838,771638733,07-07-24 14:28,62.96,Payment,Mortgage Payment,10460.55
28839,771638733,07-08-24 15:28,299.96,Deposit,Cash Deposit,10760.51
28840,771638733,07-10-24 17:28,22.64,Return,eBay Return,10783.15
28841,771638733,07-10-24 21:28,250.84,Deposit,Cash Deposit,11033.99
28842,771638733,07-12-24 20:28,229.62,Deposit,Check Deposit,11263.61
28843,771638733,7-14-24 21:28,1200,Payment,Rent Payment,10063.61
28844,771638733,7-15-24 18:28,362.74,OnlineShopping,AliExpress,9700.87
28845,771816408,1-22-24 23:28,30.55,Purchase,Electronics,352.6243358
28846,771816408,1-28-24 16:28,211.04,Purchase,Restaurant,141.5843358
28847,771816408,1-30-24 21:28,98.61,OutgoingTransfer,Bank Transfer,42.97433581
28848,771816408,1-31-24 12:28,12.99,Purchase,Grocery,29.98433581
28849,771816408,02-02-24 9:28,97.31,OutgoingTransfer,Peer-to-Peer Transfer,-67.32566419
28850,771816408,02-02-24 21:28,2850,IncomingTransfer,Salary,2782.674336
28851,771816408,02-07-24 21:28,1000,Payment,Credit Card Payment,1782.674336
28852,771816408,02-11-24 12:28,20.99,OnlineShopping,eBay,1761.684336
28853,771816408,02-12-24 17:28,235.68,Return,Target Return,1997.364336
28854,771816408,2-16-24 18:28,70.36,Withdrawal,ATM Withdrawal,1927.004336
28855,771816408,2-18-24 21:28,800,Payment,Subscription Payment,1127.004336
28856,771816408,2-19-24 15:28,22.71,OutgoingTransfer,Peer-to-Peer Transfer,1104.294336
28857,771816408,2-21-24 11:28,135.58,Return,eBay Return,1239.874336
28858,771816408,2-21-24 23:28,18.94,Deposit,Check Deposit,1258.814336
28859,771816408,2-25-24 20:28,133.6,Deposit,Check Deposit,1392.414336
28860,771816408,2-29-24 18:28,25.7,Deposit,Check Deposit,1418.114336
28861,771816408,03-01-24 12:28,28.48,Return,Best Buy Return,1446.594336
28862,771816408,03-01-24 21:28,2850,IncomingTransfer,Salary,4296.594336
28863,771816408,03-03-24 14:28,140.9,OnlineShopping,Best Buy,4155.694336
28864,771816408,03-05-24 18:28,170.04,Withdrawal,Branch Withdrawal,3985.654336
28865,771816408,03-06-24 21:28,1000,Payment,Credit Card Payment,2985.654336
28866,771816408,03-08-24 15:28,28.56,Withdrawal,ATM Withdrawal,2957.094336
28867,771816408,03-10-24 10:28,36.57,OnlineShopping,Amazon,2920.524336
28868,771816408,03-11-24 20:28,195.09,Withdrawal,Branch Withdrawal,2725.434336
28869,771816408,3-13-24 11:28,153.62,Purchase,Restaurant,2571.814336
28870,771816408,3-14-24 22:28,135.66,Withdrawal,Branch Withdrawal,2436.154336
28871,771816408,3-15-24 21:28,1200,Payment,Insurance Payment,1236.154336
28872,771816408,3-16-24 13:28,55.84,Purchase,Gas,1180.314336
28873,771816408,3-17-24 12:28,130.96,Deposit,Check Deposit,1311.274336
28874,771816408,3-17-24 18:28,47.71,Deposit,Check Deposit,1358.984336
28875,771816408,3-17-24 19:28,154.48,Return,Best Buy Return,1513.464336
28876,771816408,3-18-24 23:28,82.84,Return,Target Return,1596.304336
28877,771816408,3-20-24 12:28,166.09,Deposit,Mobile Deposit,1762.394336
28878,771816408,3-22-24 17:28,11.99,OnlineShopping,Target,1750.404336
28879,771816408,3-30-24 16:28,208.38,Deposit,Mobile Deposit,1958.784336
28880,771816408,3-31-24 11:28,58.72,Payment,Loan Payment,1900.064336
28881,771816408,04-01-24 12:28,72.19,Purchase,Furniture,1827.874336
28882,771816408,04-02-24 17:28,104.38,IncomingTransfer,Freelance Payment,1932.254336
28883,771816408,04-03-24 21:28,2850,IncomingTransfer,Salary,4782.254336
28884,771816408,04-05-24 22:28,219.62,Deposit,Cash Deposit,5001.874336
28885,771816408,04-08-24 21:28,700,Payment,Credit Card Payment,4301.874336
28886,771816408,04-11-24 17:28,204.21,IncomingTransfer,Freelance Payment,4506.084336
28887,771816408,04-11-24 22:28,14.5,Payment,Bill Payment,4491.584336
28888,771816408,4-13-24 20:28,219.47,Purchase,Restaurant,4272.114336
28889,771816408,4-14-24 21:28,900,Payment,Installment Payment,3372.114336
28890,771816408,4-16-24 11:28,246.28,Purchase,Restaurant,3125.834336
28891,771816408,4-19-24 16:28,232.01,OutgoingTransfer,Wire Transfer,2893.824336
28892,771816408,4-20-24 11:28,23.65,Return,Store Return,2917.474336
28893,771816408,4-24-24 22:28,99.26,Deposit,Direct Deposit,3016.734336
28894,771816408,4-27-24 22:28,188.2,Return,eBay Return,3204.934336
28895,771816408,05-02-24 21:28,2850,IncomingTransfer,Salary,6054.934336
28896,771816408,05-04-24 12:28,132.61,Deposit,Check Deposit,6187.544336
28897,771816408,05-04-24 14:28,118.11,Deposit,Direct Deposit,6305.654336
28898,771816408,05-04-24 15:28,181.69,Deposit,Direct Deposit,6487.344336
28899,771816408,05-07-24 21:28,800,Payment,Credit Card Payment,5687.344336
28900,771816408,05-08-24 12:28,245.38,Deposit,Mobile Deposit,5932.724336
28901,771816408,5-14-24 9:28,86.22,Purchase,Pharmacy,5846.504336
28902,771816408,5-15-24 13:28,232.76,Payment,Loan Payment,5613.744336
28903,771816408,5-17-24 21:28,1100,Payment,Insurance Payment,4513.744336
28904,771816408,5-19-24 14:28,174.01,Purchase,Furniture,4339.734336
28905,771816408,5-19-24 21:28,103.97,Purchase,Grocery,4235.764336
28906,771816408,5-20-24 10:28,29.18,Purchase,Grocery,4206.584336
28907,771816408,5-20-24 21:28,160.26,OutgoingTransfer,International Transfer,4046.324336
28908,771816408,5-21-24 22:28,97.24,Return,Etsy Return,4143.564336
28909,771816408,5-23-24 9:28,53.27,Deposit,Direct Deposit,4196.834336
28910,771816408,5-23-24 20:28,201.72,Payment,Bill Payment,3995.114336
28911,771816408,5-29-24 13:28,95.21,Return,AliExpress Return,4090.324336
28912,771816408,06-01-24 21:28,2850,IncomingTransfer,Salary,6940.324336
28913,771816408,06-02-24 15:28,211.88,Withdrawal,Branch Withdrawal,6728.444336
28914,771816408,06-06-24 13:28,102.1,Deposit,Direct Deposit,6830.544336
28915,771816408,06-06-24 17:28,35.22,Deposit,Check Deposit,6865.764336
28916,771816408,06-06-24 21:28,700,Payment,Credit Card Payment,6165.764336
28917,771816408,6-15-24 21:28,1100,Payment,Installment Payment,5065.764336
28918,771816408,6-16-24 12:28,191.79,Return,Target Return,5257.554336
28919,771816408,6-17-24 21:28,111.25,Return,Best Buy Return,5368.804336
28920,771816408,6-19-24 11:28,14.96,Deposit,Check Deposit,5383.764336
28921,771816408,6-30-24 13:28,222.29,Purchase,Restaurant,5161.474336
28922,771816408,07-01-24 21:28,2850,IncomingTransfer,Salary,8011.474336
28923,771816408,07-06-24 21:28,1000,Payment,Credit Card Payment,7011.474336
28924,771816408,07-09-24 22:28,117.54,Purchase,Entertainment,6893.934336
28925,771816408,07-10-24 21:28,1000,Payment,Installment Payment,5893.934336
28926,771816408,07-11-24 23:28,116.86,OutgoingTransfer,Bank Transfer,5777.074336
28927,771816408,07-12-24 11:28,98.09,Payment,Loan Payment,5678.984336
28928,771816408,7-15-24 22:28,207.68,Purchase,Home Improvement,5471.304336
28929,771872733,1-27-24 11:28,267.75,Purchase,Gas,988.839857
28930,771872733,1-27-24 20:28,182.7,Purchase,Furniture,806.139857
28931,771872733,1-28-24 21:28,328.95,OutgoingTransfer,Bank Transfer,477.189857
28932,771872733,1-28-24 21:28,258.34,Return,Store Return,735.529857
28933,771872733,1-29-24 21:28,472.19,Purchase,Restaurant,263.339857
28934,771872733,1-31-24 9:28,135.62,Purchase,Furniture,127.719857
28935,771872733,02-02-24 9:28,478.93,Purchase,Electronics,-351.210143
28936,771872733,02-03-24 14:28,341.33,OutgoingTransfer,Bank Transfer,-692.540143
28937,771872733,02-03-24 21:28,6100,IncomingTransfer,Salary,5407.459857
28938,771872733,02-04-24 11:28,262.73,OnlineShopping,eBay,5144.729857
28939,771872733,02-06-24 12:28,191.68,Purchase,Travel,4953.049857
28940,771872733,02-08-24 17:28,340.01,Deposit,Mobile Deposit,5293.059857
28941,771872733,02-08-24 21:28,1600,Payment,Credit Card Payment,3693.059857
28942,771872733,02-09-24 13:28,86.96,Purchase,Gas,3606.099857
28943,771872733,02-10-24 21:28,2500,Payment,Rent Payment,1106.099857
28944,771872733,02-10-24 22:28,442.88,Return,Target Return,1548.979857
28945,771872733,2-14-24 14:28,202.83,IncomingTransfer,Freelance Payment,1751.809857
28946,771872733,2-18-24 14:28,282.06,Deposit,Check Deposit,2033.869857
28947,771872733,2-21-24 18:28,294.05,OutgoingTransfer,Bank Transfer,1739.819857
28948,771872733,2-22-24 10:28,149.87,Deposit,Cash Deposit,1889.689857
28949,771872733,2-22-24 11:28,63.7,Withdrawal,Mobile App Withdrawal,1825.989857
28950,771872733,2-22-24 19:28,483.13,Purchase,Entertainment,1342.859857
28951,771872733,2-24-24 20:28,276.88,Purchase,Electronics,1065.979857
28952,771872733,2-29-24 17:28,519.76,OutgoingTransfer,International Transfer,546.219857
28953,771872733,2-29-24 20:28,455.56,Withdrawal,Branch Withdrawal,90.65985703
28954,771872733,2-29-24 21:28,343.38,Purchase,Gas,-252.720143
28955,771872733,03-01-24 21:28,6100,IncomingTransfer,Salary,5847.279857
28956,771872733,03-02-24 13:28,378.88,OnlineShopping,AliExpress,5468.399857
28957,771872733,03-05-24 19:28,467.32,Purchase,Electronics,5001.079857
28958,771872733,03-06-24 21:28,2100,Payment,Credit Card Payment,2901.079857
28959,771872733,3-13-24 16:28,314.75,Payment,Loan Payment,2586.329857
28960,771872733,3-13-24 16:28,214.83,Purchase,Furniture,2371.499857
28961,771872733,3-16-24 10:28,371.78,Deposit,Direct Deposit,2743.279857
28962,771872733,3-16-24 20:28,542.3,Payment,Bill Payment,2200.979857
28963,771872733,3-16-24 21:28,3500,Payment,Rent Payment,-1299.020143
28964,771872733,3-24-24 13:28,304.5,OutgoingTransfer,Peer-to-Peer Transfer,-1603.520143
28965,771872733,3-24-24 17:28,204.77,Withdrawal,Branch Withdrawal,-1808.290143
28966,771872733,3-25-24 21:28,501.17,Withdrawal,ATM Withdrawal,-2309.460143
28967,771872733,3-26-24 23:28,523.58,Deposit,Mobile Deposit,-1785.880143
28968,771872733,3-27-24 16:28,448.78,Purchase,Travel,-2234.660143
28969,771872733,04-02-24 21:28,6100,IncomingTransfer,Salary,3865.339857
28970,771872733,04-07-24 21:28,2100,Payment,Credit Card Payment,1765.339857
28971,771872733,04-11-24 21:28,3100,Payment,Rent Payment,-1334.660143
28972,771872733,04-12-24 9:28,82.21,Withdrawal,Branch Withdrawal,-1416.870143
28973,771872733,4-14-24 16:28,491.75,Deposit,Check Deposit,-925.120143
28974,771872733,4-16-24 14:28,515.79,Deposit,Mobile Deposit,-409.330143
28975,771872733,4-17-24 19:28,169.21,Deposit,Check Deposit,-240.120143
28976,771872733,4-20-24 10:28,87.07,Withdrawal,Branch Withdrawal,-327.190143
28977,771872733,4-20-24 21:28,73.52,Deposit,Cash Deposit,-253.670143
28978,771872733,4-21-24 14:28,126.85,Deposit,Direct Deposit,-126.820143
28979,771872733,4-22-24 16:28,170.24,Deposit,Direct Deposit,43.41985703
28980,771872733,4-26-24 20:28,163.29,Withdrawal,Mobile App Withdrawal,-119.870143
28981,771872733,4-27-24 13:28,185.08,OnlineShopping,AliExpress,-304.950143
28982,771872733,4-28-24 14:28,477.75,OutgoingTransfer,Peer-to-Peer Transfer,-782.700143
28983,771872733,05-02-24 21:28,6100,IncomingTransfer,Salary,5317.299857
28984,771872733,05-03-24 18:28,145.03,OnlineShopping,Best Buy,5172.269857
28985,771872733,05-05-24 21:28,71.52,OnlineShopping,Etsy,5100.749857
28986,771872733,05-06-24 14:28,543.28,Deposit,Check Deposit,5644.029857
28987,771872733,05-07-24 21:28,1800,Payment,Credit Card Payment,3844.029857
28988,771872733,5-13-24 9:28,80.13,Deposit,Cash Deposit,3924.159857
28989,771872733,5-15-24 10:28,326.85,OnlineShopping,Best Buy,3597.309857
28990,771872733,5-16-24 21:28,1900,Payment,Rent Payment,1697.309857
28991,771872733,5-21-24 19:28,379.02,OnlineShopping,Target,1318.289857
28992,771872733,5-24-24 16:28,545.3,Payment,Mortgage Payment,772.989857
28993,771872733,5-25-24 22:28,477.85,Return,Store Return,1250.839857
28994,771872733,5-26-24 15:28,86.67,OnlineShopping,Etsy,1164.169857
28995,771872733,5-26-24 20:28,160.9,Return,AliExpress Return,1325.069857
28996,771872733,5-27-24 18:28,528.06,Deposit,Direct Deposit,1853.129857
28997,771872733,5-28-24 14:28,192.66,Deposit,Mobile Deposit,2045.789857
28998,771872733,5-29-24 12:28,262.59,OnlineShopping,Etsy,1783.199857
28999,771872733,06-02-24 11:28,362.1,Purchase,Entertainment,1421.099857
29000,771872733,06-03-24 21:28,6100,IncomingTransfer,Salary,7521.099857
29001,771872733,06-08-24 21:28,1500,Payment,Credit Card Payment,6021.099857
29002,771872733,06-10-24 11:28,284.02,Return,eBay Return,6305.119857
29003,771872733,06-10-24 21:28,3000,Payment,Rent Payment,3305.119857
29004,771872733,6-14-24 10:28,287.51,Deposit,Mobile Deposit,3592.629857
29005,771872733,6-18-24 10:28,259.65,Deposit,Direct Deposit,3852.279857
29006,771872733,6-20-24 22:28,316.96,OnlineShopping,AliExpress,3535.319857
29007,771872733,6-23-24 16:28,337.23,Return,Best Buy Return,3872.549857
29008,771872733,6-30-24 15:28,440.93,IncomingTransfer,Freelance Payment,4313.479857
29009,771872733,07-04-24 21:28,6100,IncomingTransfer,Salary,10413.47986
29010,771872733,07-07-24 13:28,124.4,Purchase,Pharmacy,10289.07986
29011,771872733,07-08-24 10:28,455.46,Return,Walmart Return,10744.53986
29012,771872733,07-08-24 15:28,83.3,Purchase,Gas,10661.23986
29013,771872733,07-09-24 21:28,2000,Payment,Credit Card Payment,8661.239857
29014,771872733,7-13-24 18:28,374.08,Deposit,Check Deposit,9035.319857
29015,771872733,7-18-24 21:28,2900,Payment,Rent Payment,6135.319857
29016,772145658,1-27-24 20:28,726.86,Deposit,Check Deposit,2147.826129
29017,772145658,1-30-24 21:28,157.73,Payment,Mortgage Payment,1990.096129
29018,772145658,02-01-24 15:28,121.99,Purchase,Gas,1868.106129
29019,772145658,02-03-24 12:28,570.93,IncomingTransfer,Freelance Payment,2439.036129
29020,772145658,02-03-24 21:28,9800,IncomingTransfer,Salary,12239.03613
29021,772145658,02-08-24 21:28,2700,Payment,Credit Card Payment,9539.036129
29022,772145658,2-13-24 22:28,584.26,Deposit,Mobile Deposit,10123.29613
29023,772145658,2-16-24 18:28,117.44,Deposit,Mobile Deposit,10240.73613
29024,772145658,2-17-24 12:28,390.85,Payment,Bill Payment,9849.886129
29025,772145658,2-17-24 21:28,3200,Payment,Rent Payment,6649.886129
29026,772145658,2-20-24 13:28,741.97,Purchase,Entertainment,5907.916129
29027,772145658,2-26-24 17:28,242.76,Deposit,Cash Deposit,6150.676129
29028,772145658,03-02-24 21:28,9800,IncomingTransfer,Salary,15950.67613
29029,772145658,03-07-24 18:28,220.99,Purchase,Home Improvement,15729.68613
29030,772145658,03-07-24 21:28,2300,Payment,Credit Card Payment,13429.68613
29031,772145658,03-11-24 17:28,557.09,IncomingTransfer,Freelance Payment,13986.77613
29032,772145658,3-15-24 10:28,572.22,Deposit,Check Deposit,14558.99613
29033,772145658,3-16-24 21:28,2600,Payment,Rent Payment,11958.99613
29034,772145658,3-29-24 22:28,636,Withdrawal,ATM Withdrawal,11322.99613
29035,772145658,04-02-24 21:28,351.91,Withdrawal,ATM Withdrawal,10971.08613
29036,772145658,04-03-24 21:28,9800,IncomingTransfer,Salary,20771.08613
29037,772145658,04-08-24 21:28,2300,Payment,Credit Card Payment,18471.08613
29038,772145658,04-11-24 21:28,4400,Payment,Rent Payment,14071.08613
29039,772145658,4-19-24 20:28,191.54,OnlineShopping,AliExpress,13879.54613
29040,772145658,4-22-24 12:28,239.98,Return,Target Return,14119.52613
29041,772145658,4-27-24 20:28,345.5,Withdrawal,ATM Withdrawal,13774.02613
29042,772145658,05-01-24 21:28,9800,IncomingTransfer,Salary,23574.02613
29043,772145658,05-06-24 21:28,2800,Payment,Credit Card Payment,20774.02613
29044,772145658,05-08-24 15:28,382.75,Deposit,Check Deposit,21156.77613
29045,772145658,05-10-24 21:28,2500,Payment,Rent Payment,18656.77613
29046,772145658,05-11-24 13:28,134.97,Withdrawal,Branch Withdrawal,18521.80613
29047,772145658,5-19-24 22:28,307.07,OutgoingTransfer,Peer-to-Peer Transfer,18214.73613
29048,772145658,5-21-24 20:28,561.26,Purchase,Clothing,17653.47613
29049,772145658,06-01-24 21:28,9800,IncomingTransfer,Salary,27453.47613
29050,772145658,06-06-24 21:28,2300,Payment,Credit Card Payment,25153.47613
29051,772145658,06-10-24 21:28,6000,Payment,Rent Payment,19153.47613
29052,772145658,6-17-24 15:28,293.4,Return,Store Return,19446.87613
29053,772145658,6-22-24 14:28,580.15,Withdrawal,Branch Withdrawal,18866.72613
29054,772145658,6-22-24 17:28,434.76,Payment,Loan Payment,18431.96613
29055,772145658,6-29-24 10:28,268.05,Purchase,Electronics,18163.91613
29056,772145658,07-04-24 21:28,9800,IncomingTransfer,Salary,27963.91613
29057,772145658,07-04-24 23:28,284.3,Payment,Loan Payment,27679.61613
29058,772145658,07-06-24 19:28,603.54,OutgoingTransfer,Peer-to-Peer Transfer,27076.07613
29059,772145658,07-09-24 13:28,342.14,IncomingTransfer,Freelance Payment,27418.21613
29060,772145658,07-09-24 21:28,2300,Payment,Credit Card Payment,25118.21613
29061,772145658,7-17-24 21:28,2900,Payment,Rent Payment,22218.21613
29062,772148058,1-24-24 18:28,161.24,Payment,Bill Payment,381.1783922
29063,772148058,1-26-24 16:28,657.94,OutgoingTransfer,Wire Transfer,-276.7616078
29064,772148058,1-29-24 15:28,549.82,Purchase,Restaurant,-826.5816078
29065,772148058,02-02-24 15:28,489.18,Withdrawal,Mobile App Withdrawal,-1315.761608
29066,772148058,02-03-24 10:28,450.04,OnlineShopping,Etsy,-1765.801608
29067,772148058,02-03-24 21:28,8850,IncomingTransfer,Salary,7084.198392
29068,772148058,02-04-24 18:28,412.28,Deposit,Check Deposit,7496.478392
29069,772148058,02-07-24 18:28,202.29,Payment,Bill Payment,7294.188392
29070,772148058,02-08-24 15:28,422.64,Return,AliExpress Return,7716.828392
29071,772148058,02-08-24 21:28,1000,Payment,Credit Card Payment,6716.828392
29072,772148058,02-12-24 22:28,418.29,Purchase,Gas,6298.538392
29073,772148058,2-16-24 21:28,2300,Payment,Rent Payment,3998.538392
29074,772148058,2-18-24 11:28,380.03,Deposit,Cash Deposit,4378.568392
29075,772148058,2-25-24 12:28,253.94,Deposit,Mobile Deposit,4632.508392
29076,772148058,2-27-24 19:28,527.34,Purchase,Travel,4105.168392
29077,772148058,2-28-24 16:28,600.12,Return,Amazon Return,4705.288392
29078,772148058,03-01-24 19:28,406.34,Purchase,Electronics,4298.948392
29079,772148058,03-03-24 21:28,8850,IncomingTransfer,Salary,13148.94839
29080,772148058,03-06-24 16:28,276.11,OnlineShopping,eBay,12872.83839
29081,772148058,03-08-24 21:28,1100,Payment,Credit Card Payment,11772.83839
29082,772148058,03-11-24 15:28,683.18,Deposit,Mobile Deposit,12456.01839
29083,772148058,03-12-24 21:28,4200,Payment,Rent Payment,8256.018392
29084,772148058,3-18-24 23:28,361.84,Deposit,Mobile Deposit,8617.858392
29085,772148058,3-22-24 13:28,700.89,Purchase,Restaurant,7916.968392
29086,772148058,3-25-24 22:28,211.21,Purchase,Restaurant,7705.758392
29087,772148058,3-30-24 13:28,384.63,OnlineShopping,eBay,7321.128392
29088,772148058,04-03-24 20:28,110.47,Purchase,Restaurant,7210.658392
29089,772148058,04-04-24 18:28,483.54,IncomingTransfer,Freelance Payment,7694.198392
29090,772148058,04-05-24 21:28,8850,IncomingTransfer,Salary,16544.19839
29091,772148058,04-07-24 14:28,333.43,OnlineShopping,Target,16210.76839
29092,772148058,04-09-24 12:28,132.1,Payment,Bill Payment,16078.66839
29093,772148058,04-10-24 17:28,451.81,Withdrawal,Mobile App Withdrawal,15626.85839
29094,772148058,04-10-24 21:28,800,Payment,Credit Card Payment,14826.85839
29095,772148058,4-17-24 9:28,240.09,OutgoingTransfer,Wire Transfer,14586.76839
29096,772148058,4-17-24 21:28,3500,Payment,Rent Payment,11086.76839
29097,772148058,4-20-24 17:28,180.02,Purchase,Furniture,10906.74839
29098,772148058,4-21-24 14:28,283.06,Deposit,Direct Deposit,11189.80839
29099,772148058,4-21-24 18:28,128.64,Purchase,Gas,11061.16839
29100,772148058,4-22-24 21:28,661.61,Withdrawal,Branch Withdrawal,10399.55839
29101,772148058,4-26-24 19:28,297.99,OnlineShopping,Target,10101.56839
29102,772148058,4-26-24 19:28,173.11,OutgoingTransfer,Peer-to-Peer Transfer,9928.458392
29103,772148058,4-27-24 15:28,700.27,IncomingTransfer,Freelance Payment,10628.72839
29104,772148058,4-29-24 13:28,358.3,Purchase,Travel,10270.42839
29105,772148058,05-02-24 21:28,8850,IncomingTransfer,Salary,19120.42839
29106,772148058,05-06-24 20:28,290.22,Payment,Bill Payment,18830.20839
29107,772148058,05-07-24 10:28,327.77,Purchase,Travel,18502.43839
29108,772148058,05-07-24 21:28,1100,Payment,Credit Card Payment,17402.43839
29109,772148058,05-10-24 21:28,442.05,Purchase,Pharmacy,16960.38839
29110,772148058,05-11-24 12:28,485.89,OnlineShopping,AliExpress,16474.49839
29111,772148058,05-12-24 21:28,5100,Payment,Rent Payment,11374.49839
29112,772148058,5-16-24 13:28,745.72,Deposit,Direct Deposit,12120.21839
29113,772148058,5-19-24 12:28,661.3,Deposit,Mobile Deposit,12781.51839
29114,772148058,5-22-24 9:28,726.71,Deposit,Check Deposit,13508.22839
29115,772148058,5-28-24 15:28,303.57,OnlineShopping,Best Buy,13204.65839
29116,772148058,5-30-24 23:28,748.59,Deposit,Direct Deposit,13953.24839
29117,772148058,06-05-24 21:28,8850,IncomingTransfer,Salary,22803.24839
29118,772148058,06-10-24 21:28,1100,Payment,Credit Card Payment,21703.24839
29119,772148058,06-10-24 21:28,3600,Payment,Rent Payment,18103.24839
29120,772148058,6-14-24 11:28,739.45,Deposit,Direct Deposit,18842.69839
29121,772148058,6-16-24 15:28,500.41,Deposit,Mobile Deposit,19343.10839
29122,772148058,6-22-24 17:28,596.71,OutgoingTransfer,Wire Transfer,18746.39839
29123,772148058,07-01-24 22:28,435.41,Withdrawal,Mobile App Withdrawal,18310.98839
29124,772148058,07-02-24 15:28,101.18,Purchase,Electronics,18209.80839
29125,772148058,07-02-24 21:28,8850,IncomingTransfer,Salary,27059.80839
29126,772148058,07-07-24 18:28,618.56,Payment,Loan Payment,26441.24839
29127,772148058,07-07-24 21:28,1000,Payment,Credit Card Payment,25441.24839
29128,772148058,07-08-24 19:28,110.04,Payment,Mortgage Payment,25331.20839
29129,772148058,07-12-24 21:28,3200,Payment,Rent Payment,22131.20839
29130,772148058,7-15-24 16:28,645.21,Payment,Mortgage Payment,21485.99839
29131,772148058,7-16-24 17:28,528.19,Return,Etsy Return,22014.18839
29132,772148058,7-16-24 20:28,481.29,Withdrawal,Branch Withdrawal,21532.89839
29133,772177308,1-20-24 12:28,166.25,OnlineShopping,Target,-166.25
29134,772177308,1-26-24 10:28,205,IncomingTransfer,Freelance Payment,38.75
29135,772177308,1-26-24 23:28,157.94,Deposit,Mobile Deposit,196.69
29136,772177308,1-30-24 17:28,196.33,Deposit,Check Deposit,393.02
29137,772177308,1-30-24 23:28,191.57,Deposit,Mobile Deposit,584.59
29138,772177308,02-01-24 15:28,45.19,IncomingTransfer,Freelance Payment,629.78
29139,772177308,02-02-24 21:28,89.77,OnlineShopping,Target,540.01
29140,772177308,02-04-24 20:28,21.65,Return,Walmart Return,561.66
29141,772177308,02-04-24 21:28,2700,IncomingTransfer,Salary,3261.66
29142,772177308,02-06-24 10:28,127.79,Deposit,Check Deposit,3389.45
29143,772177308,02-10-24 21:28,1200,Payment,Rent Payment,2189.45
29144,772177308,2-14-24 20:28,182.7,Purchase,Pharmacy,2006.75
29145,772177308,2-15-24 23:28,71.32,Withdrawal,Branch Withdrawal,1935.43
29146,772177308,2-18-24 12:28,155.94,Purchase,Pharmacy,1779.49
29147,772177308,2-25-24 15:28,245.76,Withdrawal,ATM Withdrawal,1533.73
29148,772177308,03-01-24 20:28,146.11,OutgoingTransfer,Bank Transfer,1387.62
29149,772177308,03-02-24 22:28,213.94,OutgoingTransfer,Peer-to-Peer Transfer,1173.68
29150,772177308,03-04-24 16:28,230.56,Withdrawal,Branch Withdrawal,943.12
29151,772177308,03-04-24 21:28,2700,IncomingTransfer,Salary,3643.12
29152,772177308,03-07-24 22:28,103.56,Purchase,Home Improvement,3539.56
29153,772177308,03-12-24 19:28,227.33,Return,Amazon Return,3766.89
29154,772177308,3-13-24 12:28,194.14,Withdrawal,ATM Withdrawal,3572.75
29155,772177308,3-14-24 13:28,131.43,Withdrawal,Branch Withdrawal,3441.32
29156,772177308,3-15-24 16:28,167.57,Deposit,Check Deposit,3608.89
29157,772177308,3-15-24 21:28,1300,Payment,Rent Payment,2308.89
29158,772177308,3-15-24 21:28,18.59,Purchase,Pharmacy,2290.3
29159,772177308,3-19-24 9:28,232.91,IncomingTransfer,Freelance Payment,2523.21
29160,772177308,3-20-24 14:28,185.53,Return,Target Return,2708.74
29161,772177308,3-23-24 21:28,48.47,Purchase,Entertainment,2660.27
29162,772177308,3-29-24 13:28,53.22,OutgoingTransfer,Wire Transfer,2607.05
29163,772177308,3-31-24 11:28,135.08,Purchase,Clothing,2471.97
29164,772177308,04-02-24 21:28,2700,IncomingTransfer,Salary,5171.97
29165,772177308,04-06-24 11:28,240.79,Deposit,Cash Deposit,5412.76
29166,772177308,04-06-24 17:28,228.24,OnlineShopping,Best Buy,5184.52
29167,772177308,04-08-24 13:28,158.14,Purchase,Travel,5026.38
29168,772177308,04-08-24 21:28,146.75,Withdrawal,Branch Withdrawal,4879.63
29169,772177308,04-09-24 14:28,35.5,Return,Walmart Return,4915.13
29170,772177308,4-17-24 21:28,1300,Payment,Rent Payment,3615.13
29171,772177308,4-18-24 20:28,93.08,Deposit,Mobile Deposit,3708.21
29172,772177308,4-25-24 9:28,193.47,Withdrawal,ATM Withdrawal,3514.74
29173,772177308,4-29-24 18:28,173.07,Purchase,Restaurant,3341.67
29174,772177308,05-01-24 9:28,13.34,Purchase,Pharmacy,3328.33
29175,772177308,05-01-24 21:28,2700,IncomingTransfer,Salary,6028.33
29176,772177308,05-03-24 21:28,71.24,Purchase,Furniture,5957.09
29177,772177308,05-06-24 15:28,77.17,Return,Store Return,6034.26
29178,772177308,05-06-24 18:28,211.32,OnlineShopping,AliExpress,5822.94
29179,772177308,05-09-24 16:28,145.12,Payment,Bill Payment,5677.82
29180,772177308,05-11-24 16:28,195.58,Deposit,Check Deposit,5873.4
29181,772177308,5-13-24 20:28,26.94,Deposit,Direct Deposit,5900.34
29182,772177308,5-16-24 18:28,36.35,Deposit,Cash Deposit,5936.69
29183,772177308,5-18-24 21:28,900,Payment,Rent Payment,5036.69
29184,772177308,5-23-24 18:28,101.61,Deposit,Mobile Deposit,5138.3
29185,772177308,5-24-24 12:28,160.19,Return,Store Return,5298.49
29186,772177308,5-26-24 13:28,194.62,Deposit,Mobile Deposit,5493.11
29187,772177308,5-27-24 11:28,36.66,OutgoingTransfer,Bank Transfer,5456.45
29188,772177308,06-01-24 21:28,2700,IncomingTransfer,Salary,8156.45
29189,772177308,06-04-24 10:28,122.91,Purchase,Pharmacy,8033.54
29190,772177308,06-05-24 14:28,206.91,Withdrawal,Mobile App Withdrawal,7826.63
29191,772177308,06-05-24 16:28,220.14,Deposit,Direct Deposit,8046.77
29192,772177308,06-07-24 10:28,88.99,Deposit,Check Deposit,8135.76
29193,772177308,06-12-24 21:28,1200,Payment,Rent Payment,6935.76
29194,772177308,06-12-24 21:28,121.3,Purchase,Entertainment,6814.46
29195,772177308,6-14-24 11:28,188.67,Withdrawal,Mobile App Withdrawal,6625.79
29196,772177308,6-19-24 22:28,67.5,OnlineShopping,eBay,6558.29
29197,772177308,6-20-24 20:28,152.87,IncomingTransfer,Freelance Payment,6711.16
29198,772177308,07-01-24 19:28,157.62,Deposit,Mobile Deposit,6868.78
29199,772177308,07-02-24 13:28,67.44,Payment,Mortgage Payment,6801.34
29200,772177308,07-02-24 21:28,2700,IncomingTransfer,Salary,9501.34
29201,772177308,07-04-24 19:28,198.82,Deposit,Check Deposit,9700.16
29202,772177308,07-07-24 19:28,39.17,OnlineShopping,Etsy,9660.99
29203,772177308,07-09-24 16:28,74.11,Purchase,Furniture,9586.88
29204,772177308,07-12-24 18:28,201.48,OutgoingTransfer,Wire Transfer,9385.4
29205,772177308,07-12-24 21:28,1500,Payment,Rent Payment,7885.4
29206,772177308,7-17-24 14:28,97.43,OnlineShopping,eBay,7787.97
29207,772231233,1-21-24 12:28,55.7,OutgoingTransfer,Wire Transfer,424.4575626
29208,772231233,1-21-24 19:28,162.79,Purchase,Electronics,261.6675626
29209,772231233,1-21-24 22:28,22.58,Return,Amazon Return,284.2475626
29210,772231233,1-25-24 20:28,214.57,Purchase,Entertainment,69.6775626
29211,772231233,1-28-24 10:28,233.9,Return,Amazon Return,303.5775626
29212,772231233,1-28-24 16:28,223.94,Purchase,Electronics,79.6375626
29213,772231233,1-28-24 20:28,47.27,Withdrawal,ATM Withdrawal,32.3675626
29214,772231233,1-30-24 10:28,145.41,Payment,Bill Payment,-113.0424374
29215,772231233,1-31-24 17:28,95.63,Withdrawal,Branch Withdrawal,-208.6724374
29216,772231233,02-02-24 16:28,189.27,Purchase,Pharmacy,-397.9424374
29217,772231233,02-02-24 18:28,125.22,Payment,Bill Payment,-523.1624374
29218,772231233,02-04-24 22:28,45.61,Deposit,Check Deposit,-477.5524374
29219,772231233,02-05-24 21:28,2600,IncomingTransfer,Salary,2122.447563
29220,772231233,02-05-24 21:28,238.69,Return,AliExpress Return,2361.137563
29221,772231233,02-07-24 15:28,193.36,OutgoingTransfer,Wire Transfer,2167.777563
29222,772231233,02-10-24 15:28,222.43,Withdrawal,Branch Withdrawal,1945.347563
29223,772231233,02-10-24 21:28,1000,Payment,Credit Card Payment,945.3475626
29224,772231233,2-14-24 20:28,142.98,Withdrawal,Mobile App Withdrawal,802.3675626
29225,772231233,2-15-24 17:28,159.42,Payment,Loan Payment,642.9475626
29226,772231233,2-16-24 21:28,700,Payment,Insurance Payment,-57.0524374
29227,772231233,2-18-24 19:28,82.29,OutgoingTransfer,Bank Transfer,-139.3424374
29228,772231233,2-19-24 11:28,161.96,Purchase,Furniture,-301.3024374
29229,772231233,2-19-24 21:28,84.18,Purchase,Grocery,-385.4824374
29230,772231233,2-19-24 22:28,209.3,Purchase,Restaurant,-594.7824374
29231,772231233,2-21-24 18:28,210.92,IncomingTransfer,Freelance Payment,-383.8624374
29232,772231233,2-21-24 22:28,161.21,Return,Walmart Return,-222.6524374
29233,772231233,2-21-24 23:28,131.11,Withdrawal,ATM Withdrawal,-353.7624374
29234,772231233,2-25-24 11:28,102.57,Purchase,Gas,-456.3324374
29235,772231233,2-25-24 17:28,171.25,Deposit,Check Deposit,-285.0824374
29236,772231233,2-25-24 18:28,245.59,Purchase,Grocery,-530.6724374
29237,772231233,2-26-24 10:28,15.61,OutgoingTransfer,Peer-to-Peer Transfer,-546.2824374
29238,772231233,03-03-24 22:28,32.02,Deposit,Cash Deposit,-514.2624374
29239,772231233,03-04-24 21:28,2600,IncomingTransfer,Salary,2085.737563
29240,772231233,03-09-24 21:28,900,Payment,Credit Card Payment,1185.737563
29241,772231233,03-11-24 17:28,103.15,OnlineShopping,Etsy,1082.587563
29242,772231233,03-12-24 22:28,70.19,OutgoingTransfer,Peer-to-Peer Transfer,1012.397563
29243,772231233,3-14-24 9:28,233.34,Return,Amazon Return,1245.737563
29244,772231233,3-15-24 21:28,700,Payment,Installment Payment,545.7375626
29245,772231233,3-18-24 18:28,222.62,Return,Etsy Return,768.3575626
29246,772231233,3-19-24 12:28,72.33,Payment,Loan Payment,696.0275626
29247,772231233,3-24-24 17:28,167.28,Return,Walmart Return,863.3075626
29248,772231233,3-26-24 9:28,182.97,Deposit,Cash Deposit,1046.277563
29249,772231233,3-29-24 12:28,213.89,Withdrawal,Branch Withdrawal,832.3875626
29250,772231233,3-29-24 13:28,196.3,Payment,Bill Payment,636.0875626
29251,772231233,04-04-24 12:28,243.18,Payment,Loan Payment,392.9075626
29252,772231233,04-04-24 15:28,151.15,Purchase,Grocery,241.7575626
29253,772231233,04-04-24 21:28,2600,IncomingTransfer,Salary,2841.757563
29254,772231233,04-06-24 15:28,169.01,Return,eBay Return,3010.767563
29255,772231233,04-09-24 21:28,800,Payment,Credit Card Payment,2210.767563
29256,772231233,04-12-24 21:28,800,Payment,Subscription Payment,1410.767563
29257,772231233,4-18-24 9:28,150.94,Withdrawal,ATM Withdrawal,1259.827563
29258,772231233,4-19-24 9:28,67.85,Purchase,Travel,1191.977563
29259,772231233,4-22-24 13:28,11.7,IncomingTransfer,Freelance Payment,1203.677563
29260,772231233,4-26-24 19:28,188.85,Deposit,Check Deposit,1392.527563
29261,772231233,05-01-24 12:28,107.83,Deposit,Check Deposit,1500.357563
29262,772231233,05-01-24 17:28,45.29,Deposit,Check Deposit,1545.647563
29263,772231233,05-02-24 21:28,2600,IncomingTransfer,Salary,4145.647563
29264,772231233,05-03-24 15:28,70.46,Purchase,Entertainment,4075.187563
29265,772231233,05-07-24 20:28,180.78,Withdrawal,ATM Withdrawal,3894.407563
29266,772231233,05-07-24 21:28,900,Payment,Credit Card Payment,2994.407563
29267,772231233,05-09-24 12:28,127.83,Withdrawal,Branch Withdrawal,2866.577563
29268,772231233,5-13-24 16:28,85.41,Purchase,Pharmacy,2781.167563
29269,772231233,5-16-24 21:28,800,Payment,Insurance Payment,1981.167563
29270,772231233,5-17-24 22:28,78.72,Deposit,Cash Deposit,2059.887563
29271,772231233,5-19-24 18:28,131.3,Payment,Mortgage Payment,1928.587563
29272,772231233,5-21-24 22:28,234.54,Deposit,Check Deposit,2163.127563
29273,772231233,5-24-24 12:28,110.8,Purchase,Pharmacy,2052.327563
29274,772231233,5-25-24 14:28,30.43,Deposit,Mobile Deposit,2082.757563
29275,772231233,06-02-24 22:28,49.32,Withdrawal,Branch Withdrawal,2033.437563
29276,772231233,06-03-24 13:28,78.42,Purchase,Entertainment,1955.017563
29277,772231233,06-05-24 14:28,185.25,Return,eBay Return,2140.267563
29278,772231233,06-05-24 21:28,2600,IncomingTransfer,Salary,4740.267563
29279,772231233,06-06-24 18:28,102.09,Deposit,Direct Deposit,4842.357563
29280,772231233,06-06-24 21:28,145.97,Deposit,Cash Deposit,4988.327563
29281,772231233,06-06-24 23:28,79.71,IncomingTransfer,Freelance Payment,5068.037563
29282,772231233,06-07-24 9:28,109.95,Purchase,Clothing,4958.087563
29283,772231233,06-10-24 21:28,800,Payment,Credit Card Payment,4158.087563
29284,772231233,06-12-24 19:28,28.86,Payment,Loan Payment,4129.227563
29285,772231233,6-13-24 11:28,143.55,Return,Walmart Return,4272.777563
29286,772231233,6-13-24 21:28,800,Payment,Subscription Payment,3472.777563
29287,772231233,6-15-24 15:28,233.78,Deposit,Check Deposit,3706.557563
29288,772231233,6-15-24 15:28,172.25,Withdrawal,Mobile App Withdrawal,3534.307563
29289,772231233,6-17-24 14:28,14.02,Return,Best Buy Return,3548.327563
29290,772231233,6-21-24 21:28,136.65,Withdrawal,Branch Withdrawal,3411.677563
29291,772231233,6-23-24 15:28,239.74,Deposit,Cash Deposit,3651.417563
29292,772231233,6-23-24 20:28,180.01,Return,AliExpress Return,3831.427563
29293,772231233,6-24-24 11:28,169.4,Deposit,Cash Deposit,4000.827563
29294,772231233,6-26-24 20:28,247.07,Deposit,Mobile Deposit,4247.897563
29295,772231233,6-29-24 22:28,160.76,Deposit,Direct Deposit,4408.657563
29296,772231233,6-30-24 22:28,30.87,OutgoingTransfer,Bank Transfer,4377.787563
29297,772231233,07-01-24 18:28,48.5,Return,Etsy Return,4426.287563
29298,772231233,07-02-24 19:28,245.9,Purchase,Home Improvement,4180.387563
29299,772231233,07-05-24 21:28,2600,IncomingTransfer,Salary,6780.387563
29300,772231233,07-06-24 20:28,136.83,Payment,Loan Payment,6643.557563
29301,772231233,07-07-24 18:28,194.57,Deposit,Direct Deposit,6838.127563
29302,772231233,07-09-24 21:28,240.62,IncomingTransfer,Freelance Payment,7078.747563
29303,772231233,07-10-24 21:28,1000,Payment,Credit Card Payment,6078.747563
29304,772231233,07-11-24 10:28,95.97,Return,AliExpress Return,6174.717563
29305,772231233,07-11-24 14:28,202.11,OutgoingTransfer,Peer-to-Peer Transfer,5972.607563
29306,772231233,7-13-24 16:28,162.95,Withdrawal,Branch Withdrawal,5809.657563
29307,772231233,7-13-24 20:28,171.27,Return,AliExpress Return,5980.927563
29308,772231233,7-14-24 20:28,241.7,Withdrawal,Branch Withdrawal,5739.227563
29309,772231233,7-15-24 21:28,1000,Payment,Installment Payment,4739.227563
29310,772268058,1-23-24 10:28,107.03,OutgoingTransfer,Wire Transfer,1060.930673
29311,772268058,1-24-24 21:28,42.85,Deposit,Check Deposit,1103.780673
29312,772268058,1-25-24 23:28,146.92,OnlineShopping,Amazon,956.8606731
29313,772268058,1-27-24 21:28,184.26,Return,Etsy Return,1141.120673
29314,772268058,02-01-24 19:28,46.99,Deposit,Direct Deposit,1188.110673
29315,772268058,02-05-24 21:28,1800,IncomingTransfer,Salary,2988.110673
29316,772268058,02-06-24 22:28,230.23,Payment,Mortgage Payment,2757.880673
29317,772268058,02-08-24 14:28,201.47,Purchase,Gas,2556.410673
29318,772268058,02-09-24 11:28,16.42,Withdrawal,Mobile App Withdrawal,2539.990673
29319,772268058,02-09-24 17:28,207.98,Purchase,Clothing,2332.010673
29320,772268058,02-09-24 17:28,42.86,Withdrawal,Mobile App Withdrawal,2289.150673
29321,772268058,02-10-24 10:28,102.34,OnlineShopping,Target,2186.810673
29322,772268058,02-10-24 21:28,2000,Payment,Credit Card Payment,186.8106731
29323,772268058,02-10-24 21:28,1100,Payment,Rent Payment,-913.1893269
29324,772268058,2-13-24 10:28,22.68,Purchase,Restaurant,-935.8693269
29325,772268058,2-15-24 15:28,113.66,Payment,Mortgage Payment,-1049.529327
29326,772268058,2-18-24 22:28,94.74,Purchase,Restaurant,-1144.269327
29327,772268058,03-02-24 21:28,1800,IncomingTransfer,Salary,655.7306731
29328,772268058,03-04-24 23:28,15.67,Purchase,Furniture,640.0606731
29329,772268058,03-04-24 23:28,207.83,Return,eBay Return,847.8906731
29330,772268058,03-06-24 11:28,106.68,OnlineShopping,Amazon,741.2106731
29331,772268058,03-07-24 21:28,1800,Payment,Credit Card Payment,-1058.789327
29332,772268058,03-08-24 17:28,19.15,OutgoingTransfer,International Transfer,-1077.939327
29333,772268058,03-10-24 20:28,77.76,IncomingTransfer,Freelance Payment,-1000.179327
29334,772268058,03-11-24 15:28,86.96,OnlineShopping,eBay,-1087.139327
29335,772268058,3-18-24 19:28,243.04,Deposit,Direct Deposit,-844.0993269
29336,772268058,3-18-24 21:28,900,Payment,Rent Payment,-1744.099327
29337,772268058,3-21-24 11:28,191.28,Withdrawal,ATM Withdrawal,-1935.379327
29338,772268058,3-23-24 19:28,213.73,Withdrawal,Branch Withdrawal,-2149.109327
29339,772268058,3-24-24 16:28,178.78,Purchase,Restaurant,-2327.889327
29340,772268058,3-26-24 16:28,65.2,OnlineShopping,AliExpress,-2393.089327
29341,772268058,3-27-24 9:28,111.85,Deposit,Mobile Deposit,-2281.239327
29342,772268058,3-29-24 18:28,110.45,Withdrawal,Mobile App Withdrawal,-2391.689327
29343,772268058,3-30-24 19:28,202.58,Deposit,Mobile Deposit,-2189.109327
29344,772268058,04-02-24 21:28,1800,IncomingTransfer,Salary,-389.1093269
29345,772268058,04-03-24 15:28,241.66,Withdrawal,Mobile App Withdrawal,-630.7693269
29346,772268058,04-04-24 11:28,88.08,Return,Amazon Return,-542.6893269
29347,772268058,04-04-24 22:28,226.57,OnlineShopping,Best Buy,-769.2593269
29348,772268058,04-06-24 21:28,149.62,Withdrawal,Branch Withdrawal,-918.8793269
29349,772268058,04-07-24 12:28,37.12,Purchase,Travel,-955.9993269
29350,772268058,04-07-24 21:28,2000,Payment,Credit Card Payment,-2955.999327
29351,772268058,4-16-24 21:28,1000,Payment,Rent Payment,-3955.999327
29352,772268058,4-19-24 9:28,215.81,Deposit,Direct Deposit,-3740.189327
29353,772268058,4-19-24 13:28,213.23,Return,AliExpress Return,-3526.959327
29354,772268058,4-22-24 9:28,64.12,OutgoingTransfer,Bank Transfer,-3591.079327
29355,772268058,4-22-24 15:28,100.2,OutgoingTransfer,Peer-to-Peer Transfer,-3691.279327
29356,772268058,4-23-24 21:28,10.57,Purchase,Furniture,-3701.849327
29357,772268058,4-26-24 14:28,74.26,OnlineShopping,eBay,-3776.109327
29358,772268058,4-28-24 10:28,16.89,Withdrawal,Branch Withdrawal,-3792.999327
29359,772268058,4-30-24 14:28,208.17,Withdrawal,Branch Withdrawal,-4001.169327
29360,772268058,4-30-24 16:28,221.16,OutgoingTransfer,Peer-to-Peer Transfer,-4222.329327
29361,772268058,4-30-24 23:28,141.02,Return,Best Buy Return,-4081.309327
29362,772268058,05-01-24 9:28,55.13,Purchase,Travel,-4136.439327
29363,772268058,05-01-24 15:28,69.35,OnlineShopping,Etsy,-4205.789327
29364,772268058,05-02-24 21:28,1800,IncomingTransfer,Salary,-2405.789327
29365,772268058,05-02-24 22:28,54.1,Purchase,Entertainment,-2459.889327
29366,772268058,05-03-24 9:28,31.14,Withdrawal,Branch Withdrawal,-2491.029327
29367,772268058,05-04-24 11:28,235.21,Purchase,Gas,-2726.239327
29368,772268058,05-05-24 19:28,130.95,Withdrawal,ATM Withdrawal,-2857.189327
29369,772268058,05-07-24 21:28,2000,Payment,Credit Card Payment,-4857.189327
29370,772268058,05-07-24 22:28,201.07,Purchase,Entertainment,-5058.259327
29371,772268058,05-12-24 21:28,1000,Payment,Rent Payment,-6058.259327
29372,772268058,5-13-24 11:28,64.92,OnlineShopping,Target,-6123.179327
29373,772268058,5-18-24 18:28,178.37,OnlineShopping,AliExpress,-6301.549327
29374,772268058,5-20-24 19:28,87.18,Payment,Mortgage Payment,-6388.729327
29375,772268058,5-22-24 19:28,31.76,Purchase,Gas,-6420.489327
29376,772268058,5-22-24 19:28,154.16,OnlineShopping,Etsy,-6574.649327
29377,772268058,5-26-24 20:28,110.64,Deposit,Cash Deposit,-6464.009327
29378,772268058,5-28-24 20:28,74.9,OnlineShopping,Amazon,-6538.909327
29379,772268058,06-01-24 15:28,248.71,IncomingTransfer,Freelance Payment,-6290.199327
29380,772268058,06-02-24 21:28,1800,IncomingTransfer,Salary,-4490.199327
29381,772268058,06-07-24 17:28,106,Purchase,Electronics,-4596.199327
29382,772268058,06-07-24 21:28,1700,Payment,Credit Card Payment,-6296.199327
29383,772268058,06-11-24 11:28,73.08,OnlineShopping,Target,-6369.279327
29384,772268058,06-11-24 23:28,12.55,Deposit,Check Deposit,-6356.729327
29385,772268058,6-13-24 21:28,900,Payment,Rent Payment,-7256.729327
29386,772268058,6-16-24 11:28,57.53,Deposit,Check Deposit,-7199.199327
29387,772268058,6-20-24 17:28,129.94,Withdrawal,Mobile App Withdrawal,-7329.139327
29388,772268058,6-26-24 15:28,222.8,Return,Amazon Return,-7106.339327
29389,772268058,6-29-24 22:28,73.06,Return,Best Buy Return,-7033.279327
29390,772268058,07-02-24 18:28,53.29,Withdrawal,Branch Withdrawal,-7086.569327
29391,772268058,07-02-24 21:28,1800,IncomingTransfer,Salary,-5286.569327
29392,772268058,07-07-24 21:28,1500,Payment,Credit Card Payment,-6786.569327
29393,772268058,07-11-24 18:28,20.82,Return,eBay Return,-6765.749327
29394,772268058,7-13-24 21:28,800,Payment,Rent Payment,-7565.749327
29395,772268058,7-15-24 10:28,134.97,Payment,Mortgage Payment,-7700.719327
29396,772268058,7-17-24 12:28,164.62,Return,Etsy Return,-7536.099327
29397,772310958,1-21-24 15:28,105.4,Purchase,Travel,621.3240088
29398,772310958,1-21-24 20:28,178.18,OnlineShopping,Etsy,443.1440088
29399,772310958,1-26-24 14:28,114.14,OutgoingTransfer,International Transfer,329.0040088
29400,772310958,1-27-24 19:28,33.44,Purchase,Electronics,295.5640088
29401,772310958,1-28-24 10:28,78.12,Withdrawal,Branch Withdrawal,217.4440088
29402,772310958,1-29-24 12:28,100.31,Deposit,Mobile Deposit,317.7540088
29403,772310958,02-01-24 21:28,1650,IncomingTransfer,Salary,1967.754009
29404,772310958,02-03-24 21:28,239,OnlineShopping,Etsy,1728.754009
29405,772310958,02-04-24 11:28,32.48,Purchase,Entertainment,1696.274009
29406,772310958,02-06-24 21:28,900,Payment,Credit Card Payment,796.2740088
29407,772310958,02-08-24 17:28,235.48,Payment,Loan Payment,560.7940088
29408,772310958,02-09-24 12:28,228.52,Purchase,Home Improvement,332.2740088
29409,772310958,02-09-24 17:28,246.14,Withdrawal,Mobile App Withdrawal,86.13400877
29410,772310958,02-10-24 19:28,166.67,Deposit,Direct Deposit,252.8040088
29411,772310958,02-10-24 19:28,233.69,Payment,Bill Payment,19.11400877
29412,772310958,02-12-24 19:28,43.97,Deposit,Check Deposit,63.08400877
29413,772310958,2-14-24 19:28,216.88,Withdrawal,ATM Withdrawal,-153.7959912
29414,772310958,2-18-24 20:28,71.55,Withdrawal,ATM Withdrawal,-225.3459912
29415,772310958,2-18-24 21:28,900,Payment,Rent Payment,-1125.345991
29416,772310958,2-19-24 15:28,89.29,Deposit,Direct Deposit,-1036.055991
29417,772310958,2-25-24 13:28,63.6,Withdrawal,ATM Withdrawal,-1099.655991
29418,772310958,2-29-24 10:28,223.43,Payment,Loan Payment,-1323.085991
29419,772310958,03-02-24 21:28,1650,IncomingTransfer,Salary,326.9140088
29420,772310958,03-03-24 14:28,206.38,Withdrawal,Mobile App Withdrawal,120.5340088
29421,772310958,03-05-24 14:28,191.09,Purchase,Furniture,-70.55599123
29422,772310958,03-07-24 21:28,1100,Payment,Credit Card Payment,-1170.555991
29423,772310958,03-11-24 20:28,201.2,IncomingTransfer,Freelance Payment,-969.3559912
29424,772310958,03-12-24 21:28,400,Payment,Rent Payment,-1369.355991
29425,772310958,3-15-24 10:28,82.99,Return,Target Return,-1286.365991
29426,772310958,3-16-24 14:28,151.03,IncomingTransfer,Freelance Payment,-1135.335991
29427,772310958,3-17-24 15:28,201.28,OutgoingTransfer,Bank Transfer,-1336.615991
29428,772310958,3-17-24 21:28,156.1,Withdrawal,ATM Withdrawal,-1492.715991
29429,772310958,3-19-24 13:28,219.6,IncomingTransfer,Freelance Payment,-1273.115991
29430,772310958,3-20-24 16:28,249.99,OnlineShopping,AliExpress,-1523.105991
29431,772310958,3-23-24 19:28,183.75,Purchase,Entertainment,-1706.855991
29432,772310958,3-24-24 18:28,108.73,OutgoingTransfer,Peer-to-Peer Transfer,-1815.585991
29433,772310958,3-28-24 21:28,72.01,OutgoingTransfer,Wire Transfer,-1887.595991
29434,772310958,3-30-24 19:28,85.05,Purchase,Restaurant,-1972.645991
29435,772310958,04-03-24 21:28,1650,IncomingTransfer,Salary,-322.6459912
29436,772310958,04-05-24 17:28,220.02,Purchase,Gas,-542.6659912
29437,772310958,04-06-24 10:28,85.83,OutgoingTransfer,Peer-to-Peer Transfer,-628.4959912
29438,772310958,04-08-24 15:28,160.87,Payment,Loan Payment,-789.3659912
29439,772310958,04-08-24 21:28,1100,Payment,Credit Card Payment,-1889.365991
29440,772310958,04-11-24 19:28,141.38,Withdrawal,Mobile App Withdrawal,-2030.745991
29441,772310958,04-12-24 16:28,18.46,IncomingTransfer,Freelance Payment,-2012.285991
29442,772310958,4-15-24 15:28,37.79,Deposit,Check Deposit,-1974.495991
29443,772310958,4-15-24 15:28,159.1,OnlineShopping,Amazon,-2133.595991
29444,772310958,4-16-24 21:28,800,Payment,Rent Payment,-2933.595991
29445,772310958,4-18-24 21:28,226.94,Payment,Bill Payment,-3160.535991
29446,772310958,4-19-24 9:28,223.45,OutgoingTransfer,Wire Transfer,-3383.985991
29447,772310958,4-21-24 13:28,166.97,Deposit,Mobile Deposit,-3217.015991
29448,772310958,4-22-24 17:28,201.85,Deposit,Direct Deposit,-3015.165991
29449,772310958,4-24-24 9:28,108.93,Return,Best Buy Return,-2906.235991
29450,772310958,4-26-24 11:28,10.43,IncomingTransfer,Freelance Payment,-2895.805991
29451,772310958,4-27-24 12:28,159.6,Purchase,Pharmacy,-3055.405991
29452,772310958,4-27-24 15:28,44.7,Return,Best Buy Return,-3010.705991
29453,772310958,4-28-24 20:28,246,Deposit,Cash Deposit,-2764.705991
29454,772310958,05-01-24 17:28,85,IncomingTransfer,Freelance Payment,-2679.705991
29455,772310958,05-04-24 11:28,235.18,Deposit,Cash Deposit,-2444.525991
29456,772310958,05-04-24 13:28,45.14,Purchase,Electronics,-2489.665991
29457,772310958,05-04-24 21:28,1650,IncomingTransfer,Salary,-839.6659912
29458,772310958,05-09-24 21:28,900,Payment,Credit Card Payment,-1739.665991
29459,772310958,05-11-24 16:28,181.63,Deposit,Direct Deposit,-1558.035991
29460,772310958,05-11-24 20:28,57.77,Purchase,Clothing,-1615.805991
29461,772310958,05-12-24 12:28,43.82,Withdrawal,Mobile App Withdrawal,-1659.625991
29462,772310958,5-16-24 16:28,238.8,OnlineShopping,Best Buy,-1898.425991
29463,772310958,5-17-24 21:28,900,Payment,Rent Payment,-2798.425991
29464,772310958,5-18-24 12:28,87.1,Deposit,Mobile Deposit,-2711.325991
29465,772310958,5-19-24 10:28,241.82,OutgoingTransfer,Bank Transfer,-2953.145991
29466,772310958,5-24-24 16:28,232.61,OutgoingTransfer,Bank Transfer,-3185.755991
29467,772310958,5-24-24 19:28,109.32,Purchase,Electronics,-3295.075991
29468,772310958,5-26-24 20:28,191.4,Purchase,Electronics,-3486.475991
29469,772310958,5-27-24 17:28,218.15,Purchase,Clothing,-3704.625991
29470,772310958,5-28-24 12:28,186.4,Deposit,Cash Deposit,-3518.225991
29471,772310958,5-29-24 22:28,28.61,OnlineShopping,Best Buy,-3546.835991
29472,772310958,5-30-24 9:28,225.06,Purchase,Home Improvement,-3771.895991
29473,772310958,5-31-24 15:28,212.12,Withdrawal,Mobile App Withdrawal,-3984.015991
29474,772310958,5-31-24 18:28,225.5,Withdrawal,ATM Withdrawal,-4209.515991
29475,772310958,5-31-24 23:28,164.76,OutgoingTransfer,International Transfer,-4374.275991
29476,772310958,06-02-24 19:28,87.06,Deposit,Check Deposit,-4287.215991
29477,772310958,06-02-24 21:28,1650,IncomingTransfer,Salary,-2637.215991
29478,772310958,06-03-24 10:28,38.16,Withdrawal,Mobile App Withdrawal,-2675.375991
29479,772310958,06-04-24 18:28,174.48,Withdrawal,Mobile App Withdrawal,-2849.855991
29480,772310958,06-05-24 11:28,168.09,Payment,Loan Payment,-3017.945991
29481,772310958,06-07-24 21:28,1100,Payment,Credit Card Payment,-4117.945991
29482,772310958,06-10-24 17:28,17.98,Purchase,Furniture,-4135.925991
29483,772310958,06-12-24 16:28,107.83,Withdrawal,Mobile App Withdrawal,-4243.755991
29484,772310958,6-14-24 16:28,208.65,OutgoingTransfer,Peer-to-Peer Transfer,-4452.405991
29485,772310958,6-16-24 16:28,65.72,Return,Amazon Return,-4386.685991
29486,772310958,6-17-24 13:28,223.53,Withdrawal,Branch Withdrawal,-4610.215991
29487,772310958,6-18-24 21:28,800,Payment,Rent Payment,-5410.215991
29488,772310958,6-20-24 16:28,17.73,Payment,Bill Payment,-5427.945991
29489,772310958,6-22-24 11:28,66.54,IncomingTransfer,Freelance Payment,-5361.405991
29490,772310958,6-24-24 19:28,56.35,Deposit,Check Deposit,-5305.055991
29491,772310958,6-27-24 19:28,165.79,Withdrawal,ATM Withdrawal,-5470.845991
29492,772310958,6-29-24 17:28,10.87,OnlineShopping,Etsy,-5481.715991
29493,772310958,6-29-24 18:28,149.76,Purchase,Grocery,-5631.475991
29494,772310958,6-30-24 10:28,20.17,Withdrawal,Branch Withdrawal,-5651.645991
29495,772310958,07-01-24 21:28,1650,IncomingTransfer,Salary,-4001.645991
29496,772310958,07-02-24 20:28,175.18,Purchase,Home Improvement,-4176.825991
29497,772310958,07-03-24 11:28,120.02,Deposit,Check Deposit,-4056.805991
29498,772310958,07-06-24 21:28,1100,Payment,Credit Card Payment,-5156.805991
29499,772310958,07-07-24 16:28,185.69,OutgoingTransfer,International Transfer,-5342.495991
29500,772310958,07-08-24 15:28,77.6,Purchase,Home Improvement,-5420.095991
29501,772310958,07-08-24 23:28,113.35,Purchase,Entertainment,-5533.445991
29502,772310958,07-11-24 13:28,126.67,Purchase,Grocery,-5660.115991
29503,772310958,7-13-24 20:28,59.31,Payment,Loan Payment,-5719.425991
29504,772310958,7-13-24 21:28,31.33,Purchase,Pharmacy,-5750.755991
29505,772310958,7-17-24 10:28,125.82,OutgoingTransfer,Bank Transfer,-5876.575991
29506,772310958,7-17-24 12:28,133.6,OutgoingTransfer,Wire Transfer,-6010.175991
29507,772310958,7-17-24 17:28,37.86,Withdrawal,Mobile App Withdrawal,-6048.035991
29508,772310958,7-17-24 21:28,600,Payment,Rent Payment,-6648.035991
29509,772339383,1-22-24 16:28,237.6,Deposit,Direct Deposit,1311.57159
29510,772339383,1-23-24 16:28,308.56,Deposit,Direct Deposit,1620.13159
29511,772339383,1-26-24 18:28,368.18,OnlineShopping,Etsy,1251.95159
29512,772339383,1-28-24 15:28,76.73,Withdrawal,ATM Withdrawal,1175.22159
29513,772339383,1-28-24 17:28,184.49,Withdrawal,Branch Withdrawal,990.7315898
29514,772339383,1-29-24 15:28,47.37,Deposit,Cash Deposit,1038.10159
29515,772339383,02-03-24 13:28,230.94,Deposit,Direct Deposit,1269.04159
29516,772339383,02-03-24 16:28,277.34,OutgoingTransfer,Peer-to-Peer Transfer,991.7015898
29517,772339383,02-04-24 21:28,4250,IncomingTransfer,Salary,5241.70159
29518,772339383,02-04-24 22:28,134.59,Purchase,Furniture,5107.11159
29519,772339383,02-07-24 18:28,202.53,IncomingTransfer,Freelance Payment,5309.64159
29520,772339383,02-08-24 21:28,164.71,Purchase,Restaurant,5144.93159
29521,772339383,02-08-24 22:28,119.26,Purchase,Home Improvement,5025.67159
29522,772339383,02-09-24 19:28,224.77,Purchase,Gas,4800.90159
29523,772339383,02-09-24 21:28,1800,Payment,Credit Card Payment,3000.90159
29524,772339383,02-10-24 10:28,295.26,Withdrawal,Branch Withdrawal,2705.64159
29525,772339383,02-10-24 11:28,170.97,Payment,Mortgage Payment,2534.67159
29526,772339383,02-10-24 15:28,123.13,Deposit,Cash Deposit,2657.80159
29527,772339383,02-10-24 21:28,2200,Payment,Rent Payment,457.8015898
29528,772339383,02-12-24 16:28,60.93,Deposit,Cash Deposit,518.7315898
29529,772339383,2-13-24 20:28,165.28,Payment,Bill Payment,353.4515898
29530,772339383,2-14-24 11:28,289.44,Deposit,Direct Deposit,642.8915898
29531,772339383,2-14-24 12:28,272.36,Payment,Mortgage Payment,370.5315898
29532,772339383,2-18-24 13:28,315.58,Purchase,Travel,54.95158984
29533,772339383,2-18-24 17:28,133.04,Return,Amazon Return,187.9915898
29534,772339383,2-19-24 17:28,154.24,Withdrawal,ATM Withdrawal,33.75158984
29535,772339383,2-20-24 13:28,257.36,Purchase,Furniture,-223.6084102
29536,772339383,2-21-24 9:28,193.43,Payment,Loan Payment,-417.0384102
29537,772339383,2-21-24 21:28,123.83,OutgoingTransfer,Bank Transfer,-540.8684102
29538,772339383,2-24-24 17:28,346.95,Payment,Bill Payment,-887.8184102
29539,772339383,2-26-24 10:28,56.84,Payment,Mortgage Payment,-944.6584102
29540,772339383,2-26-24 19:28,387.9,Withdrawal,Mobile App Withdrawal,-1332.55841
29541,772339383,2-26-24 20:28,281.35,Return,eBay Return,-1051.20841
29542,772339383,2-26-24 20:28,360.74,Payment,Mortgage Payment,-1411.94841
29543,772339383,2-28-24 19:28,380.45,OutgoingTransfer,Bank Transfer,-1792.39841
29544,772339383,03-03-24 21:28,4250,IncomingTransfer,Salary,2457.60159
29545,772339383,03-08-24 21:28,1900,Payment,Credit Card Payment,557.6015898
29546,772339383,03-09-24 10:28,381.14,Deposit,Direct Deposit,938.7415898
29547,772339383,03-09-24 15:28,149.04,Withdrawal,ATM Withdrawal,789.7015898
29548,772339383,03-10-24 21:28,2500,Payment,Rent Payment,-1710.29841
29549,772339383,03-12-24 15:28,359.59,Purchase,Furniture,-2069.88841
29550,772339383,03-12-24 17:28,190.2,Return,Store Return,-1879.68841
29551,772339383,3-13-24 19:28,398.14,Purchase,Furniture,-2277.82841
29552,772339383,3-15-24 14:28,99.95,OutgoingTransfer,Bank Transfer,-2377.77841
29553,772339383,3-15-24 17:28,364.79,Withdrawal,Mobile App Withdrawal,-2742.56841
29554,772339383,3-15-24 18:28,27.85,Withdrawal,Mobile App Withdrawal,-2770.41841
29555,772339383,3-20-24 19:28,50.66,Purchase,Gas,-2821.07841
29556,772339383,3-22-24 15:28,209.21,OutgoingTransfer,Peer-to-Peer Transfer,-3030.28841
29557,772339383,3-22-24 16:28,256.68,Deposit,Check Deposit,-2773.60841
29558,772339383,3-29-24 23:28,337.26,Return,Amazon Return,-2436.34841
29559,772339383,3-31-24 17:28,167.59,Payment,Bill Payment,-2603.93841
29560,772339383,04-02-24 20:28,251.73,Deposit,Cash Deposit,-2352.20841
29561,772339383,04-03-24 21:28,4250,IncomingTransfer,Salary,1897.79159
29562,772339383,04-04-24 12:28,240.46,IncomingTransfer,Freelance Payment,2138.25159
29563,772339383,04-05-24 22:28,200.44,OnlineShopping,AliExpress,1937.81159
29564,772339383,04-07-24 12:28,212.71,Deposit,Cash Deposit,2150.52159
29565,772339383,04-07-24 21:28,195.62,Purchase,Pharmacy,1954.90159
29566,772339383,04-08-24 17:28,325.75,IncomingTransfer,Freelance Payment,2280.65159
29567,772339383,04-08-24 21:28,1500,Payment,Credit Card Payment,780.6515898
29568,772339383,04-11-24 20:28,346.7,Deposit,Direct Deposit,1127.35159
29569,772339383,4-13-24 21:28,1600,Payment,Rent Payment,-472.6484102
29570,772339383,4-14-24 15:28,359.42,IncomingTransfer,Freelance Payment,-113.2284102
29571,772339383,4-15-24 14:28,182.16,Deposit,Direct Deposit,68.93158984
29572,772339383,4-19-24 9:28,268.64,OnlineShopping,eBay,-199.7084102
29573,772339383,4-19-24 10:28,117.51,Deposit,Mobile Deposit,-82.19841016
29574,772339383,4-19-24 10:28,283.5,Withdrawal,Branch Withdrawal,-365.6984102
29575,772339383,4-26-24 21:28,209.8,Withdrawal,ATM Withdrawal,-575.4984102
29576,772339383,4-29-24 18:28,240.45,Deposit,Direct Deposit,-335.0484102
29577,772339383,05-01-24 10:28,132.9,Deposit,Cash Deposit,-202.1484102
29578,772339383,05-02-24 18:28,128,Deposit,Mobile Deposit,-74.14841016
29579,772339383,05-03-24 21:28,4250,IncomingTransfer,Salary,4175.85159
29580,772339383,05-04-24 16:28,170.03,Deposit,Check Deposit,4345.88159
29581,772339383,05-06-24 23:28,239.5,Withdrawal,Branch Withdrawal,4106.38159
29582,772339383,05-08-24 21:28,1800,Payment,Credit Card Payment,2306.38159
29583,772339383,05-10-24 18:28,158.07,Return,Etsy Return,2464.45159
29584,772339383,05-12-24 19:28,226.42,Deposit,Direct Deposit,2690.87159
29585,772339383,05-12-24 21:28,1900,Payment,Rent Payment,790.8715898
29586,772339383,5-13-24 10:28,329.17,IncomingTransfer,Freelance Payment,1120.04159
29587,772339383,5-13-24 12:28,29.65,Withdrawal,Branch Withdrawal,1090.39159
29588,772339383,5-14-24 10:28,384.7,Deposit,Mobile Deposit,1475.09159
29589,772339383,5-15-24 17:28,264.7,Deposit,Check Deposit,1739.79159
29590,772339383,5-16-24 23:28,215.94,Payment,Bill Payment,1523.85159
29591,772339383,5-17-24 23:28,37.95,Payment,Mortgage Payment,1485.90159
29592,772339383,5-18-24 10:28,369.44,OutgoingTransfer,Peer-to-Peer Transfer,1116.46159
29593,772339383,5-18-24 21:28,269.25,IncomingTransfer,Freelance Payment,1385.71159
29594,772339383,5-20-24 17:28,78.83,OnlineShopping,AliExpress,1306.88159
29595,772339383,5-22-24 16:28,111.13,Purchase,Grocery,1195.75159
29596,772339383,5-24-24 19:28,326.67,Withdrawal,ATM Withdrawal,869.0815898
29597,772339383,5-24-24 19:28,388.29,OnlineShopping,Best Buy,480.7915898
29598,772339383,5-25-24 10:28,321.25,Return,Walmart Return,802.0415898
29599,772339383,5-26-24 14:28,112.21,Deposit,Mobile Deposit,914.2515898
29600,772339383,5-26-24 22:28,198.34,Withdrawal,Mobile App Withdrawal,715.9115898
29601,772339383,5-29-24 9:28,198.89,Deposit,Direct Deposit,914.8015898
29602,772339383,5-30-24 15:28,239.47,IncomingTransfer,Freelance Payment,1154.27159
29603,772339383,5-31-24 22:28,42.5,Purchase,Grocery,1111.77159
29604,772339383,06-01-24 14:28,204.45,OutgoingTransfer,Peer-to-Peer Transfer,907.3215898
29605,772339383,06-03-24 16:28,156.76,Deposit,Direct Deposit,1064.08159
29606,772339383,06-04-24 12:28,49.93,Withdrawal,Mobile App Withdrawal,1014.15159
29607,772339383,06-05-24 18:28,78.51,Purchase,Home Improvement,935.6415898
29608,772339383,06-05-24 21:28,4250,IncomingTransfer,Salary,5185.64159
29609,772339383,06-07-24 10:28,103.69,OnlineShopping,Amazon,5081.95159
29610,772339383,06-07-24 17:28,325.8,Deposit,Cash Deposit,5407.75159
29611,772339383,06-09-24 19:28,71.4,Return,AliExpress Return,5479.15159
29612,772339383,06-10-24 21:28,1400,Payment,Credit Card Payment,4079.15159
29613,772339383,06-12-24 23:28,337.92,Deposit,Check Deposit,4417.07159
29614,772339383,6-13-24 11:28,350.53,Payment,Loan Payment,4066.54159
29615,772339383,6-13-24 19:28,210.34,OutgoingTransfer,Peer-to-Peer Transfer,3856.20159
29616,772339383,6-15-24 11:28,344.87,IncomingTransfer,Freelance Payment,4201.07159
29617,772339383,6-15-24 16:28,176.12,Deposit,Check Deposit,4377.19159
29618,772339383,6-15-24 21:28,1100,Payment,Rent Payment,3277.19159
29619,772339383,6-17-24 13:28,349.82,Payment,Mortgage Payment,2927.37159
29620,772339383,6-17-24 19:28,110.87,Return,Best Buy Return,3038.24159
29621,772339383,6-18-24 13:28,261.52,OutgoingTransfer,International Transfer,2776.72159
29622,772339383,6-19-24 17:28,398.65,Withdrawal,ATM Withdrawal,2378.07159
29623,772339383,6-20-24 19:28,322.29,Purchase,Pharmacy,2055.78159
29624,772339383,6-21-24 15:28,107.23,Return,Target Return,2163.01159
29625,772339383,6-23-24 20:28,380.66,Deposit,Mobile Deposit,2543.67159
29626,772339383,6-24-24 17:28,308.21,Deposit,Direct Deposit,2851.88159
29627,772339383,6-25-24 23:28,66.86,Purchase,Grocery,2785.02159
29628,772339383,6-26-24 14:28,115.47,IncomingTransfer,Freelance Payment,2900.49159
29629,772339383,6-27-24 12:28,213.79,OnlineShopping,Best Buy,2686.70159
29630,772339383,6-28-24 18:28,47.62,IncomingTransfer,Freelance Payment,2734.32159
29631,772339383,6-29-24 18:28,43.49,Return,AliExpress Return,2777.81159
29632,772339383,07-02-24 17:28,125.86,Withdrawal,Branch Withdrawal,2651.95159
29633,772339383,07-02-24 17:28,87.48,Withdrawal,ATM Withdrawal,2564.47159
29634,772339383,07-03-24 10:28,355.38,OutgoingTransfer,Bank Transfer,2209.09159
29635,772339383,07-04-24 21:28,4250,IncomingTransfer,Salary,6459.09159
29636,772339383,07-05-24 21:28,53.94,Payment,Loan Payment,6405.15159
29637,772339383,07-06-24 13:28,137.4,Withdrawal,Mobile App Withdrawal,6267.75159
29638,772339383,07-08-24 15:28,328.63,Deposit,Check Deposit,6596.38159
29639,772339383,07-09-24 21:28,1500,Payment,Credit Card Payment,5096.38159
29640,772339383,07-12-24 19:28,271.77,Deposit,Mobile Deposit,5368.15159
29641,772339383,7-13-24 14:28,158.85,Withdrawal,Mobile App Withdrawal,5209.30159
29642,772339383,7-14-24 13:28,242.04,Withdrawal,ATM Withdrawal,4967.26159
29643,772339383,7-14-24 21:28,1200,Payment,Rent Payment,3767.26159
29644,772339383,7-14-24 22:28,290.69,Purchase,Grocery,3476.57159
29645,772339383,7-15-24 15:28,277.08,Return,Best Buy Return,3753.65159
29646,772339383,7-17-24 16:28,347.65,Deposit,Check Deposit,4101.30159
29647,772339383,7-17-24 19:28,133.3,OutgoingTransfer,Peer-to-Peer Transfer,3968.00159
29648,772366833,1-20-24 13:28,301.96,OutgoingTransfer,Bank Transfer,1065.195452
29649,772366833,1-21-24 17:28,211.84,Withdrawal,Mobile App Withdrawal,853.3554521
29650,772366833,1-23-24 13:28,80.09,OutgoingTransfer,Bank Transfer,773.2654521
29651,772366833,1-23-24 17:28,44.91,Withdrawal,Branch Withdrawal,728.3554521
29652,772366833,1-24-24 11:28,37.5,Deposit,Mobile Deposit,765.8554521
29653,772366833,1-27-24 18:28,104.03,Deposit,Mobile Deposit,869.8854521
29654,772366833,1-28-24 22:28,63.96,Purchase,Gas,805.9254521
29655,772366833,1-30-24 13:28,247.68,OnlineShopping,Walmart,558.2454521
29656,772366833,02-01-24 16:28,241.31,Deposit,Mobile Deposit,799.5554521
29657,772366833,02-04-24 14:28,353.75,Withdrawal,Branch Withdrawal,445.8054521
29658,772366833,02-04-24 21:28,4700,IncomingTransfer,Salary,5145.805452
29659,772366833,02-04-24 21:28,137.66,Return,eBay Return,5283.465452
29660,772366833,02-05-24 14:28,282.2,OnlineShopping,Amazon,5001.265452
29661,772366833,02-05-24 19:28,343.46,Deposit,Check Deposit,5344.725452
29662,772366833,02-06-24 11:28,208.32,Return,AliExpress Return,5553.045452
29663,772366833,02-06-24 18:28,109.32,OutgoingTransfer,Bank Transfer,5443.725452
29664,772366833,02-06-24 20:28,245.35,Withdrawal,Mobile App Withdrawal,5198.375452
29665,772366833,02-09-24 21:28,2200,Payment,Credit Card Payment,2998.375452
29666,772366833,02-10-24 20:28,299.28,OutgoingTransfer,Peer-to-Peer Transfer,2699.095452
29667,772366833,02-12-24 9:28,276.55,Return,Best Buy Return,2975.645452
29668,772366833,02-12-24 18:28,131.26,OnlineShopping,Walmart,2844.385452
29669,772366833,02-12-24 21:28,1400,Payment,Rent Payment,1444.385452
29670,772366833,2-17-24 19:28,198.1,OutgoingTransfer,Bank Transfer,1246.285452
29671,772366833,2-18-24 11:28,184.03,OutgoingTransfer,Peer-to-Peer Transfer,1062.255452
29672,772366833,2-19-24 18:28,128.19,Withdrawal,ATM Withdrawal,934.0654521
29673,772366833,2-20-24 17:28,206.54,Withdrawal,Branch Withdrawal,727.5254521
29674,772366833,2-21-24 17:28,345.69,Return,Target Return,1073.215452
29675,772366833,2-21-24 23:28,353.37,Return,AliExpress Return,1426.585452
29676,772366833,2-22-24 13:28,129.62,Purchase,Restaurant,1296.965452
29677,772366833,2-22-24 23:28,318.68,Return,Best Buy Return,1615.645452
29678,772366833,2-23-24 14:28,337.73,Deposit,Direct Deposit,1953.375452
29679,772366833,2-24-24 11:28,348.06,OutgoingTransfer,Wire Transfer,1605.315452
29680,772366833,2-24-24 11:28,202.65,IncomingTransfer,Freelance Payment,1807.965452
29681,772366833,2-27-24 15:28,339.07,Deposit,Cash Deposit,2147.035452
29682,772366833,2-27-24 23:28,271.55,Return,Best Buy Return,2418.585452
29683,772366833,03-01-24 9:28,141.63,Deposit,Check Deposit,2560.215452
29684,772366833,03-01-24 21:28,396.53,Deposit,Direct Deposit,2956.745452
29685,772366833,03-02-24 11:28,256.15,Withdrawal,Mobile App Withdrawal,2700.595452
29686,772366833,03-02-24 12:28,62.19,Purchase,Pharmacy,2638.405452
29687,772366833,03-02-24 19:28,242.6,OnlineShopping,eBay,2395.805452
29688,772366833,03-02-24 21:28,4700,IncomingTransfer,Salary,7095.805452
29689,772366833,03-02-24 22:28,237.13,Return,Target Return,7332.935452
29690,772366833,03-05-24 17:28,312.91,Payment,Mortgage Payment,7020.025452
29691,772366833,03-07-24 12:28,191.24,Withdrawal,Branch Withdrawal,6828.785452
29692,772366833,03-07-24 21:28,2400,Payment,Credit Card Payment,4428.785452
29693,772366833,03-10-24 13:28,355.51,Payment,Mortgage Payment,4073.275452
29694,772366833,3-13-24 20:28,394.36,Purchase,Furniture,3678.915452
29695,772366833,3-13-24 21:28,2000,Payment,Rent Payment,1678.915452
29696,772366833,3-14-24 21:28,258.57,Deposit,Check Deposit,1937.485452
29697,772366833,3-15-24 22:28,182.28,OutgoingTransfer,Wire Transfer,1755.205452
29698,772366833,3-19-24 19:28,267.21,Deposit,Direct Deposit,2022.415452
29699,772366833,3-21-24 20:28,183.39,Payment,Loan Payment,1839.025452
29700,772366833,3-23-24 17:28,209.92,Deposit,Direct Deposit,2048.945452
29701,772366833,3-24-24 10:28,111.78,OutgoingTransfer,Wire Transfer,1937.165452
29702,772366833,3-27-24 19:28,246.01,OutgoingTransfer,International Transfer,1691.155452
29703,772366833,3-29-24 12:28,201.78,IncomingTransfer,Freelance Payment,1892.935452
29704,772366833,3-30-24 12:28,101.64,OutgoingTransfer,Bank Transfer,1791.295452
29705,772366833,3-30-24 18:28,383.8,Purchase,Entertainment,1407.495452
29706,772366833,3-31-24 10:28,387.21,Withdrawal,Branch Withdrawal,1020.285452
29707,772366833,04-03-24 11:28,307.56,Purchase,Furniture,712.7254521
29708,772366833,04-03-24 20:28,298.68,IncomingTransfer,Freelance Payment,1011.405452
29709,772366833,04-03-24 21:28,4700,IncomingTransfer,Salary,5711.405452
29710,772366833,04-03-24 21:28,171.88,Deposit,Direct Deposit,5883.285452
29711,772366833,04-06-24 15:28,102.01,Deposit,Mobile Deposit,5985.295452
29712,772366833,04-07-24 11:28,187.2,Withdrawal,Mobile App Withdrawal,5798.095452
29713,772366833,04-07-24 20:28,106.1,OutgoingTransfer,International Transfer,5691.995452
29714,772366833,04-08-24 11:28,199.55,Deposit,Direct Deposit,5891.545452
29715,772366833,04-08-24 11:28,342.95,OutgoingTransfer,International Transfer,5548.595452
29716,772366833,04-08-24 20:28,23.93,Purchase,Entertainment,5524.665452
29717,772366833,04-08-24 21:28,2500,Payment,Credit Card Payment,3024.665452
29718,772366833,04-09-24 19:28,171.55,OnlineShopping,Walmart,2853.115452
29719,772366833,04-10-24 19:28,272.23,Purchase,Electronics,2580.885452
29720,772366833,04-11-24 14:28,142.72,IncomingTransfer,Freelance Payment,2723.605452
29721,772366833,04-11-24 14:28,83,IncomingTransfer,Freelance Payment,2806.605452
29722,772366833,04-12-24 19:28,104.48,Withdrawal,ATM Withdrawal,2702.125452
29723,772366833,04-12-24 21:28,396.72,Purchase,Home Improvement,2305.405452
29724,772366833,4-13-24 21:28,2400,Payment,Rent Payment,-94.59454795
29725,772366833,4-14-24 15:28,181.4,Deposit,Direct Deposit,86.80545205
29726,772366833,4-16-24 10:28,28.41,Withdrawal,ATM Withdrawal,58.39545205
29727,772366833,4-16-24 10:28,386.49,Purchase,Clothing,-328.0945479
29728,772366833,4-17-24 17:28,110.38,Purchase,Furniture,-438.4745479
29729,772366833,4-21-24 21:28,107.11,OutgoingTransfer,Bank Transfer,-545.5845479
29730,772366833,4-22-24 19:28,151.36,Deposit,Check Deposit,-394.2245479
29731,772366833,4-23-24 17:28,158.95,Return,Amazon Return,-235.2745479
29732,772366833,4-24-24 11:28,273.4,Deposit,Direct Deposit,38.12545205
29733,772366833,05-01-24 21:28,4700,IncomingTransfer,Salary,4738.125452
29734,772366833,05-02-24 22:28,325.76,OutgoingTransfer,International Transfer,4412.365452
29735,772366833,05-03-24 16:28,367.1,Deposit,Mobile Deposit,4779.465452
29736,772366833,05-05-24 15:28,357.82,Deposit,Cash Deposit,5137.285452
29737,772366833,05-06-24 21:28,2600,Payment,Credit Card Payment,2537.285452
29738,772366833,05-07-24 15:28,174.05,Deposit,Direct Deposit,2711.335452
29739,772366833,05-10-24 17:28,351.74,Payment,Bill Payment,2359.595452
29740,772366833,05-10-24 22:28,290.94,Deposit,Check Deposit,2650.535452
29741,772366833,05-11-24 14:28,93.9,Purchase,Travel,2556.635452
29742,772366833,5-13-24 11:28,61.04,Withdrawal,Mobile App Withdrawal,2495.595452
29743,772366833,5-13-24 16:28,370.96,Deposit,Direct Deposit,2866.555452
29744,772366833,5-14-24 15:28,286.34,Deposit,Check Deposit,3152.895452
29745,772366833,5-18-24 21:28,2200,Payment,Rent Payment,952.8954521
29746,772366833,5-19-24 11:28,101.39,Purchase,Restaurant,851.5054521
29747,772366833,5-19-24 21:28,154.98,Deposit,Cash Deposit,1006.485452
29748,772366833,5-20-24 23:28,180.18,OutgoingTransfer,Wire Transfer,826.3054521
29749,772366833,5-21-24 10:28,174.18,Purchase,Electronics,652.1254521
29750,772366833,5-21-24 12:28,94.6,Payment,Mortgage Payment,557.5254521
29751,772366833,5-23-24 12:28,133.93,OutgoingTransfer,Peer-to-Peer Transfer,423.5954521
29752,772366833,5-23-24 18:28,297.66,OutgoingTransfer,Peer-to-Peer Transfer,125.9354521
29753,772366833,5-24-24 14:28,203.78,Deposit,Cash Deposit,329.7154521
29754,772366833,5-25-24 16:28,356.2,OnlineShopping,Best Buy,-26.48454795
29755,772366833,5-30-24 18:28,379.65,Return,Walmart Return,353.1654521
29756,772366833,5-30-24 19:28,103.9,Deposit,Mobile Deposit,457.0654521
29757,772366833,06-05-24 21:28,4700,IncomingTransfer,Salary,5157.065452
29758,772366833,06-10-24 21:28,2500,Payment,Credit Card Payment,2657.065452
29759,772366833,06-10-24 21:28,1800,Payment,Rent Payment,857.0654521
29760,772366833,06-10-24 23:28,279.79,Withdrawal,Branch Withdrawal,577.2754521
29761,772366833,6-13-24 11:28,21,Return,Target Return,598.2754521
29762,772366833,6-18-24 9:28,375.48,Deposit,Mobile Deposit,973.7554521
29763,772366833,6-19-24 18:28,81.44,OnlineShopping,AliExpress,892.3154521
29764,772366833,6-22-24 13:28,57.96,OnlineShopping,Best Buy,834.3554521
29765,772366833,6-23-24 20:28,274.49,Deposit,Direct Deposit,1108.845452
29766,772366833,6-26-24 11:28,323.53,Deposit,Cash Deposit,1432.375452
29767,772366833,6-27-24 16:28,96.13,Return,Amazon Return,1528.505452
29768,772366833,6-29-24 10:28,291.95,Purchase,Furniture,1236.555452
29769,772366833,07-02-24 18:28,95.5,IncomingTransfer,Freelance Payment,1332.055452
29770,772366833,07-02-24 21:28,4700,IncomingTransfer,Salary,6032.055452
29771,772366833,07-06-24 12:28,315.88,Payment,Mortgage Payment,5716.175452
29772,772366833,07-06-24 18:28,69.79,OutgoingTransfer,Wire Transfer,5646.385452
29773,772366833,07-07-24 10:28,266.27,Purchase,Electronics,5380.115452
29774,772366833,07-07-24 21:28,2200,Payment,Credit Card Payment,3180.115452
29775,772366833,07-08-24 18:28,372.72,Withdrawal,Branch Withdrawal,2807.395452
29776,772366833,07-09-24 16:28,73,Withdrawal,Mobile App Withdrawal,2734.395452
29777,772366833,07-10-24 12:28,58.33,IncomingTransfer,Freelance Payment,2792.725452
29778,772366833,07-12-24 19:28,273.66,Deposit,Check Deposit,3066.385452
29779,772366833,7-13-24 21:28,332.88,Return,Target Return,3399.265452
29780,772366833,7-14-24 21:28,1200,Payment,Rent Payment,2199.265452
29781,772366833,7-15-24 21:28,76.98,Deposit,Check Deposit,2276.245452
29782,772366833,7-17-24 10:28,44.98,Withdrawal,Branch Withdrawal,2231.265452
29783,773342808,1-21-24 14:28,243.29,Deposit,Direct Deposit,1473.214236
29784,773342808,1-22-24 13:28,200.77,Withdrawal,Branch Withdrawal,1272.444236
29785,773342808,1-27-24 16:28,130.21,Deposit,Cash Deposit,1402.654236
29786,773342808,1-27-24 18:28,191.94,Return,Walmart Return,1594.594236
29787,773342808,1-28-24 11:28,48.55,OnlineShopping,Walmart,1546.044236
29788,773342808,02-01-24 21:28,2600,IncomingTransfer,Salary,4146.044236
29789,773342808,02-02-24 13:28,212.26,Withdrawal,ATM Withdrawal,3933.784236
29790,773342808,02-04-24 12:28,27.67,Withdrawal,Branch Withdrawal,3906.114236
29791,773342808,02-04-24 13:28,134.88,Purchase,Restaurant,3771.234236
29792,773342808,02-06-24 13:28,217.33,Withdrawal,ATM Withdrawal,3553.904236
29793,773342808,02-06-24 21:28,2300,Payment,Credit Card Payment,1253.904236
29794,773342808,02-07-24 21:28,22.09,Purchase,Electronics,1231.814236
29795,773342808,02-10-24 21:28,700,Payment,Subscription Payment,531.8142359
29796,773342808,2-13-24 11:28,172.64,Payment,Bill Payment,359.1742359
29797,773342808,2-18-24 20:28,124.97,Purchase,Gas,234.2042359
29798,773342808,2-20-24 10:28,211.64,Withdrawal,ATM Withdrawal,22.56423589
29799,773342808,2-20-24 21:28,238.71,Purchase,Gas,-216.1457641
29800,773342808,2-21-24 12:28,135.54,OnlineShopping,Best Buy,-351.6857641
29801,773342808,2-22-24 12:28,92.67,Deposit,Check Deposit,-259.0157641
29802,773342808,2-22-24 14:28,159.27,Withdrawal,Mobile App Withdrawal,-418.2857641
29803,773342808,2-22-24 16:28,177.85,Deposit,Direct Deposit,-240.4357641
29804,773342808,03-01-24 16:28,136.25,OutgoingTransfer,Bank Transfer,-376.6857641
29805,773342808,03-02-24 11:28,191.15,OnlineShopping,eBay,-567.8357641
29806,773342808,03-03-24 21:28,2600,IncomingTransfer,Salary,2032.164236
29807,773342808,03-04-24 10:28,194.14,OutgoingTransfer,Peer-to-Peer Transfer,1838.024236
29808,773342808,03-08-24 15:28,96.51,Purchase,Entertainment,1741.514236
29809,773342808,03-08-24 21:28,2000,Payment,Credit Card Payment,-258.4857641
29810,773342808,03-11-24 21:28,800,Payment,Subscription Payment,-1058.485764
29811,773342808,03-12-24 15:28,169.03,Purchase,Travel,-1227.515764
29812,773342808,3-15-24 22:28,17.7,Deposit,Mobile Deposit,-1209.815764
29813,773342808,3-20-24 14:28,211.09,Deposit,Check Deposit,-998.7257641
29814,773342808,3-20-24 16:28,155.3,OutgoingTransfer,Bank Transfer,-1154.025764
29815,773342808,3-20-24 19:28,216.66,Return,Best Buy Return,-937.3657641
29816,773342808,3-26-24 17:28,30.75,Deposit,Mobile Deposit,-906.6157641
29817,773342808,04-01-24 14:28,142.49,Withdrawal,Branch Withdrawal,-1049.105764
29818,773342808,04-01-24 21:28,2600,IncomingTransfer,Salary,1550.894236
29819,773342808,04-02-24 12:28,246.45,Return,eBay Return,1797.344236
29820,773342808,04-03-24 17:28,166.96,Withdrawal,Branch Withdrawal,1630.384236
29821,773342808,04-04-24 9:28,167.96,OnlineShopping,Etsy,1462.424236
29822,773342808,04-04-24 23:28,15.45,Withdrawal,ATM Withdrawal,1446.974236
29823,773342808,04-06-24 21:28,2500,Payment,Credit Card Payment,-1053.025764
29824,773342808,04-06-24 21:28,226.67,OnlineShopping,AliExpress,-1279.695764
29825,773342808,04-11-24 21:28,69.63,Deposit,Direct Deposit,-1210.065764
29826,773342808,04-12-24 21:28,1000,Payment,Installment Payment,-2210.065764
29827,773342808,4-14-24 11:28,134.99,Withdrawal,Branch Withdrawal,-2345.055764
29828,773342808,4-15-24 10:28,141.97,OnlineShopping,Amazon,-2487.025764
29829,773342808,4-15-24 15:28,165.27,IncomingTransfer,Freelance Payment,-2321.755764
29830,773342808,4-16-24 12:28,224.67,Return,Amazon Return,-2097.085764
29831,773342808,4-18-24 13:28,238.61,Deposit,Direct Deposit,-1858.475764
29832,773342808,4-18-24 15:28,184.72,Purchase,Furniture,-2043.195764
29833,773342808,4-20-24 10:28,39.11,Withdrawal,Mobile App Withdrawal,-2082.305764
29834,773342808,4-22-24 16:28,222.75,Payment,Loan Payment,-2305.055764
29835,773342808,4-27-24 18:28,192.23,Return,Target Return,-2112.825764
29836,773342808,4-28-24 11:28,124.07,OutgoingTransfer,Wire Transfer,-2236.895764
29837,773342808,05-01-24 18:28,203.66,Purchase,Furniture,-2440.555764
29838,773342808,05-02-24 9:28,178.19,Deposit,Mobile Deposit,-2262.365764
29839,773342808,05-04-24 21:28,2600,IncomingTransfer,Salary,337.6342359
29840,773342808,05-06-24 18:28,33.82,OutgoingTransfer,International Transfer,303.8142359
29841,773342808,05-09-24 16:28,111.77,Purchase,Electronics,192.0442359
29842,773342808,05-09-24 21:28,2700,Payment,Credit Card Payment,-2507.955764
29843,773342808,05-10-24 16:28,97.91,Return,Walmart Return,-2410.045764
29844,773342808,05-11-24 21:28,900,Payment,Insurance Payment,-3310.045764
29845,773342808,05-12-24 11:28,214.7,Purchase,Clothing,-3524.745764
29846,773342808,5-14-24 11:28,56,Purchase,Grocery,-3580.745764
29847,773342808,5-17-24 10:28,127.05,Return,Best Buy Return,-3453.695764
29848,773342808,5-22-24 22:28,141.18,Deposit,Mobile Deposit,-3312.515764
29849,773342808,5-29-24 17:28,165.31,OutgoingTransfer,Bank Transfer,-3477.825764
29850,773342808,5-30-24 23:28,75.89,Deposit,Check Deposit,-3401.935764
29851,773342808,06-01-24 21:28,2600,IncomingTransfer,Salary,-801.9357641
29852,773342808,06-06-24 21:28,2600,Payment,Credit Card Payment,-3401.935764
29853,773342808,06-06-24 23:28,224.66,Purchase,Furniture,-3626.595764
29854,773342808,06-07-24 21:28,67.61,Withdrawal,Mobile App Withdrawal,-3694.205764
29855,773342808,06-08-24 22:28,131.63,Deposit,Mobile Deposit,-3562.575764
29856,773342808,06-10-24 10:28,183.67,OutgoingTransfer,Bank Transfer,-3746.245764
29857,773342808,06-10-24 17:28,88.19,OnlineShopping,Walmart,-3834.435764
29858,773342808,6-13-24 20:28,78.47,OutgoingTransfer,Bank Transfer,-3912.905764
29859,773342808,6-17-24 11:28,39.88,OnlineShopping,Etsy,-3952.785764
29860,773342808,6-17-24 21:28,1200,Payment,Installment Payment,-5152.785764
29861,773342808,6-18-24 21:28,18.86,Payment,Loan Payment,-5171.645764
29862,773342808,6-20-24 12:28,95.48,OutgoingTransfer,Bank Transfer,-5267.125764
29863,773342808,6-23-24 14:28,167.94,Withdrawal,Branch Withdrawal,-5435.065764
29864,773342808,6-24-24 21:28,101.9,OnlineShopping,Best Buy,-5536.965764
29865,773342808,6-26-24 10:28,130.59,Withdrawal,Mobile App Withdrawal,-5667.555764
29866,773342808,6-28-24 10:28,97.22,Payment,Bill Payment,-5764.775764
29867,773342808,6-28-24 12:28,90.54,Purchase,Restaurant,-5855.315764
29868,773342808,6-28-24 20:28,221.95,Deposit,Direct Deposit,-5633.365764
29869,773342808,07-01-24 10:28,199.19,IncomingTransfer,Freelance Payment,-5434.175764
29870,773342808,07-03-24 11:28,240.64,OutgoingTransfer,Peer-to-Peer Transfer,-5674.815764
29871,773342808,07-03-24 12:28,140,Purchase,Restaurant,-5814.815764
29872,773342808,07-03-24 21:28,2600,IncomingTransfer,Salary,-3214.815764
29873,773342808,07-04-24 15:28,70.62,Withdrawal,Mobile App Withdrawal,-3285.435764
29874,773342808,07-04-24 21:28,35.27,OnlineShopping,Amazon,-3320.705764
29875,773342808,07-08-24 21:28,2400,Payment,Credit Card Payment,-5720.705764
29876,773342808,07-11-24 9:28,168.87,IncomingTransfer,Freelance Payment,-5551.835764
29877,773342808,7-14-24 21:28,700,Payment,Subscription Payment,-6251.835764
29878,773342808,7-16-24 9:28,222.32,Return,Amazon Return,-6029.515764
29879,773342808,7-16-24 20:28,46.84,Deposit,Mobile Deposit,-5982.675764
29880,774588633,1-20-24 16:28,226.6,Deposit,Check Deposit,226.6
29881,774588633,1-24-24 20:28,52.07,OutgoingTransfer,Bank Transfer,174.53
29882,774588633,1-26-24 9:28,159.09,Withdrawal,Branch Withdrawal,15.44
29883,774588633,1-27-24 18:28,155.16,Payment,Mortgage Payment,-139.72
29884,774588633,1-31-24 22:28,148.57,Purchase,Home Improvement,-288.29
29885,774588633,02-05-24 20:28,20.74,Deposit,Direct Deposit,-267.55
29886,774588633,02-06-24 11:28,59.3,IncomingTransfer,Freelance Payment,-208.25
29887,774588633,02-09-24 9:28,201.57,Payment,Mortgage Payment,-409.82
29888,774588633,2-13-24 20:28,53.46,Deposit,Check Deposit,-356.36
29889,774588633,2-14-24 17:28,24.81,Return,Etsy Return,-331.55
29890,774588633,2-15-24 12:28,174.06,Payment,Bill Payment,-505.61
29891,774588633,2-17-24 20:28,69.8,Withdrawal,Branch Withdrawal,-575.41
29892,774588633,2-19-24 18:28,144.47,Purchase,Electronics,-719.88
29893,774588633,2-19-24 21:28,241.81,Purchase,Restaurant,-961.69
29894,774588633,2-20-24 20:28,226.02,Return,Amazon Return,-735.67
29895,774588633,2-23-24 22:28,74.89,OnlineShopping,eBay,-810.56
29896,774588633,2-26-24 19:28,105.37,Withdrawal,Branch Withdrawal,-915.93
29897,774588633,2-27-24 19:28,162.89,Withdrawal,Mobile App Withdrawal,-1078.82
29898,774588633,2-27-24 21:28,124.57,Withdrawal,ATM Withdrawal,-1203.39
29899,774588633,03-04-24 13:28,178.26,Deposit,Mobile Deposit,-1025.13
29900,774588633,03-04-24 20:28,155.04,Purchase,Pharmacy,-1180.17
29901,774588633,03-05-24 17:28,183.64,Return,Walmart Return,-996.53
29902,774588633,03-05-24 21:28,22.52,Purchase,Grocery,-1019.05
29903,774588633,03-09-24 12:28,249.79,Withdrawal,Mobile App Withdrawal,-1268.84
29904,774588633,03-10-24 16:28,61.6,OnlineShopping,eBay,-1330.44
29905,774588633,03-10-24 21:28,44.07,Deposit,Mobile Deposit,-1286.37
29906,774588633,3-16-24 20:28,41.85,Purchase,Gas,-1328.22
29907,774588633,3-21-24 11:28,40.14,OnlineShopping,Best Buy,-1368.36
29908,774588633,3-30-24 16:28,135.93,Return,Walmart Return,-1232.43
29909,774588633,04-03-24 9:28,81.02,OnlineShopping,Amazon,-1313.45
29910,774588633,04-03-24 16:28,26.83,Return,Etsy Return,-1286.62
29911,774588633,04-04-24 13:28,82.54,Return,Best Buy Return,-1204.08
29912,774588633,04-05-24 9:28,60.94,Deposit,Mobile Deposit,-1143.14
29913,774588633,04-05-24 9:28,67.82,Purchase,Electronics,-1210.96
29914,774588633,04-05-24 16:28,50.81,Purchase,Pharmacy,-1261.77
29915,774588633,04-05-24 21:28,38.95,Withdrawal,Branch Withdrawal,-1300.72
29916,774588633,04-09-24 9:28,81.39,Deposit,Cash Deposit,-1219.33
29917,774588633,04-10-24 21:28,41.34,Withdrawal,ATM Withdrawal,-1260.67
29918,774588633,4-13-24 16:28,248.8,Deposit,Cash Deposit,-1011.87
29919,774588633,4-19-24 12:28,230.15,Deposit,Mobile Deposit,-781.72
29920,774588633,4-19-24 14:28,236.19,OutgoingTransfer,Bank Transfer,-1017.91
29921,774588633,4-23-24 20:28,135.44,Withdrawal,ATM Withdrawal,-1153.35
29922,774588633,4-24-24 14:28,230.02,Deposit,Cash Deposit,-923.33
29923,774588633,4-24-24 15:28,43.53,Deposit,Cash Deposit,-879.8
29924,774588633,4-25-24 13:28,115.88,Return,Etsy Return,-763.92
29925,774588633,4-25-24 17:28,80.94,Return,AliExpress Return,-682.98
29926,774588633,4-30-24 11:28,45.8,Withdrawal,Branch Withdrawal,-728.78
29927,774588633,05-04-24 13:28,206.5,Withdrawal,Mobile App Withdrawal,-935.28
29928,774588633,05-06-24 23:28,161.96,Purchase,Pharmacy,-1097.24
29929,774588633,05-09-24 15:28,201.5,Withdrawal,Mobile App Withdrawal,-1298.74
29930,774588633,05-11-24 17:28,16.33,OutgoingTransfer,International Transfer,-1315.07
29931,774588633,5-15-24 12:28,129.08,Return,Target Return,-1185.99
29932,774588633,5-15-24 23:28,23.95,Purchase,Gas,-1209.94
29933,774588633,5-16-24 13:28,183.42,Deposit,Mobile Deposit,-1026.52
29934,774588633,5-20-24 22:28,80.27,IncomingTransfer,Freelance Payment,-946.25
29935,774588633,5-22-24 23:28,35.17,Purchase,Travel,-981.42
29936,774588633,5-26-24 12:28,129.87,Deposit,Check Deposit,-851.55
29937,774588633,5-27-24 16:28,88.54,Return,eBay Return,-763.01
29938,774588633,5-30-24 20:28,153.74,IncomingTransfer,Freelance Payment,-609.27
29939,774588633,5-31-24 17:28,148.11,Withdrawal,Mobile App Withdrawal,-757.38
29940,774588633,06-04-24 16:28,235.27,Payment,Bill Payment,-992.65
29941,774588633,06-04-24 16:28,240.02,Withdrawal,ATM Withdrawal,-1232.67
29942,774588633,06-04-24 19:28,38.04,Deposit,Mobile Deposit,-1194.63
29943,774588633,06-06-24 15:28,52.49,Withdrawal,ATM Withdrawal,-1247.12
29944,774588633,06-06-24 15:28,149.06,Purchase,Clothing,-1396.18
29945,774588633,06-06-24 22:28,87.25,IncomingTransfer,Freelance Payment,-1308.93
29946,774588633,06-08-24 22:28,38.04,Withdrawal,Branch Withdrawal,-1346.97
29947,774588633,06-09-24 17:28,78.99,Purchase,Home Improvement,-1425.96
29948,774588633,6-13-24 18:28,164.39,Purchase,Grocery,-1590.35
29949,774588633,6-14-24 11:28,46.79,Deposit,Check Deposit,-1543.56
29950,774588633,6-18-24 10:28,224.74,Return,Walmart Return,-1318.82
29951,774588633,6-21-24 18:28,62.66,Payment,Loan Payment,-1381.48
29952,774588633,6-23-24 15:28,194.74,Return,Target Return,-1186.74
29953,774588633,6-25-24 20:28,28.13,Withdrawal,Mobile App Withdrawal,-1214.87
29954,774588633,6-26-24 16:28,196.28,Withdrawal,Mobile App Withdrawal,-1411.15
29955,774588633,6-27-24 12:28,69.22,Purchase,Pharmacy,-1480.37
29956,774588633,6-28-24 10:28,151.07,OnlineShopping,AliExpress,-1631.44
29957,774588633,07-02-24 10:28,177.61,Deposit,Check Deposit,-1453.83
29958,774588633,07-02-24 16:28,110.73,OutgoingTransfer,Wire Transfer,-1564.56
29959,774588633,07-07-24 10:28,31.78,Payment,Mortgage Payment,-1596.34
29960,774588633,07-08-24 23:28,190.15,Deposit,Mobile Deposit,-1406.19
29961,774588633,07-09-24 20:28,151.57,Purchase,Electronics,-1557.76
29962,774588633,07-11-24 17:28,76.19,IncomingTransfer,Freelance Payment,-1481.57
29963,774588633,7-14-24 15:28,57.25,Withdrawal,Mobile App Withdrawal,-1538.82
29964,778619358,1-20-24 20:28,196.09,Purchase,Grocery,269.4454668
29965,778619358,1-21-24 11:28,214.1,Deposit,Mobile Deposit,483.5454668
29966,778619358,1-24-24 22:28,66.89,Purchase,Furniture,416.6554668
29967,778619358,1-26-24 21:28,44.38,Withdrawal,Branch Withdrawal,372.2754668
29968,778619358,1-27-24 13:28,156.51,OnlineShopping,AliExpress,215.7654668
29969,778619358,1-28-24 19:28,212.06,Withdrawal,ATM Withdrawal,3.705466792
29970,778619358,1-30-24 19:28,231.95,Deposit,Cash Deposit,235.6554668
29971,778619358,1-31-24 15:28,238.51,Deposit,Check Deposit,474.1654668
29972,778619358,02-01-24 14:28,113.21,Withdrawal,ATM Withdrawal,360.9554668
29973,778619358,02-04-24 21:28,2250,IncomingTransfer,Salary,2610.955467
29974,778619358,02-05-24 15:28,105.11,Purchase,Electronics,2505.845467
29975,778619358,02-08-24 14:28,111.46,Purchase,Home Improvement,2394.385467
29976,778619358,02-09-24 19:28,187.46,Purchase,Furniture,2206.925467
29977,778619358,02-09-24 21:28,1200,Payment,Credit Card Payment,1006.925467
29978,778619358,02-10-24 22:28,187.47,IncomingTransfer,Freelance Payment,1194.395467
29979,778619358,2-13-24 21:28,700,Payment,Rent Payment,494.3954668
29980,778619358,2-13-24 22:28,194.17,Purchase,Restaurant,300.2254668
29981,778619358,2-14-24 9:28,14.66,Withdrawal,Mobile App Withdrawal,285.5654668
29982,778619358,2-15-24 17:28,189.35,Purchase,Entertainment,96.21546679
29983,778619358,2-19-24 11:28,174.02,OutgoingTransfer,International Transfer,-77.80453321
29984,778619358,2-22-24 22:28,17.11,Deposit,Mobile Deposit,-60.69453321
29985,778619358,2-25-24 14:28,110.53,Withdrawal,Mobile App Withdrawal,-171.2245332
29986,778619358,2-26-24 20:28,214.16,Deposit,Direct Deposit,42.93546679
29987,778619358,2-28-24 13:28,113,Deposit,Check Deposit,155.9354668
29988,778619358,2-29-24 21:28,101.82,Purchase,Electronics,54.11546679
29989,778619358,03-01-24 21:28,2250,IncomingTransfer,Salary,2304.115467
29990,778619358,03-02-24 14:28,247.18,OnlineShopping,Etsy,2056.935467
29991,778619358,03-04-24 12:28,211.94,Deposit,Check Deposit,2268.875467
29992,778619358,03-04-24 14:28,100.39,Purchase,Home Improvement,2168.485467
29993,778619358,03-05-24 17:28,100.62,Withdrawal,Mobile App Withdrawal,2067.865467
29994,778619358,03-06-24 21:28,1200,Payment,Credit Card Payment,867.8654668
29995,778619358,03-08-24 16:28,216.33,Deposit,Mobile Deposit,1084.195467
29996,778619358,03-10-24 19:28,23.18,Purchase,Pharmacy,1061.015467
29997,778619358,3-16-24 21:28,600,Payment,Rent Payment,461.0154668
29998,778619358,3-18-24 15:28,190.96,Payment,Mortgage Payment,270.0554668
29999,778619358,3-25-24 11:28,198.69,Return,Walmart Return,468.7454668
30000,778619358,3-25-24 20:28,171.03,Deposit,Check Deposit,639.7754668
30001,778619358,3-26-24 19:28,117.73,Payment,Bill Payment,522.0454668
30002,778619358,3-26-24 19:28,166.13,Purchase,Pharmacy,355.9154668
30003,778619358,3-27-24 21:28,140.32,Withdrawal,ATM Withdrawal,215.5954668
30004,778619358,3-28-24 10:28,123.56,Purchase,Pharmacy,92.03546679
30005,778619358,3-31-24 14:28,191.65,Deposit,Check Deposit,283.6854668
30006,778619358,04-01-24 20:28,82.99,Payment,Mortgage Payment,200.6954668
30007,778619358,04-01-24 21:28,2250,IncomingTransfer,Salary,2450.695467
30008,778619358,04-03-24 12:28,92.05,Purchase,Grocery,2358.645467
30009,778619358,04-03-24 18:28,190.31,Payment,Mortgage Payment,2168.335467
30010,778619358,04-06-24 21:28,900,Payment,Credit Card Payment,1268.335467
30011,778619358,04-08-24 23:28,168.9,IncomingTransfer,Freelance Payment,1437.235467
30012,778619358,04-09-24 15:28,227.11,Deposit,Check Deposit,1664.345467
30013,778619358,4-13-24 15:28,58.33,Purchase,Electronics,1606.015467
30014,778619358,4-13-24 21:28,1300,Payment,Rent Payment,306.0154668
30015,778619358,4-15-24 19:28,169.49,OutgoingTransfer,Bank Transfer,136.5254668
30016,778619358,4-17-24 21:28,240.48,IncomingTransfer,Freelance Payment,377.0054668
30017,778619358,4-20-24 11:28,60.43,Purchase,Pharmacy,316.5754668
30018,778619358,4-20-24 18:28,60.51,Deposit,Cash Deposit,377.0854668
30019,778619358,4-23-24 23:28,90.6,OutgoingTransfer,International Transfer,286.4854668
30020,778619358,4-26-24 23:28,52.01,Return,Walmart Return,338.4954668
30021,778619358,4-29-24 19:28,28.96,Purchase,Restaurant,309.5354668
30022,778619358,05-01-24 21:28,2250,IncomingTransfer,Salary,2559.535467
30023,778619358,05-06-24 18:28,29.15,Deposit,Direct Deposit,2588.685467
30024,778619358,05-06-24 21:28,1100,Payment,Credit Card Payment,1488.685467
30025,778619358,05-10-24 12:28,20.32,Deposit,Check Deposit,1509.005467
30026,778619358,5-13-24 21:28,900,Payment,Rent Payment,609.0054668
30027,778619358,5-14-24 18:28,156.19,Withdrawal,Branch Withdrawal,452.8154668
30028,778619358,5-19-24 13:28,204.12,Return,AliExpress Return,656.9354668
30029,778619358,5-21-24 16:28,61.62,OutgoingTransfer,International Transfer,595.3154668
30030,778619358,5-23-24 22:28,226.46,Withdrawal,Branch Withdrawal,368.8554668
30031,778619358,5-25-24 12:28,242.54,Deposit,Direct Deposit,611.3954668
30032,778619358,5-26-24 17:28,182.19,OutgoingTransfer,Bank Transfer,429.2054668
30033,778619358,5-27-24 18:28,123.97,OnlineShopping,Walmart,305.2354668
30034,778619358,5-28-24 20:28,143.87,Payment,Mortgage Payment,161.3654668
30035,778619358,06-02-24 10:28,33.19,Return,Walmart Return,194.5554668
30036,778619358,06-02-24 21:28,15.45,Purchase,Home Improvement,179.1054668
30037,778619358,06-03-24 15:28,243.1,Payment,Bill Payment,-63.99453321
30038,778619358,06-05-24 21:28,2250,IncomingTransfer,Salary,2186.005467
30039,778619358,06-07-24 23:28,109.96,Return,Store Return,2295.965467
30040,778619358,06-10-24 17:28,44,Deposit,Direct Deposit,2339.965467
30041,778619358,06-10-24 21:28,1300,Payment,Credit Card Payment,1039.965467
30042,778619358,06-10-24 21:28,132.79,Withdrawal,ATM Withdrawal,907.1754668
30043,778619358,6-16-24 21:28,600,Payment,Rent Payment,307.1754668
30044,778619358,6-20-24 19:28,201.72,OutgoingTransfer,Peer-to-Peer Transfer,105.4554668
30045,778619358,6-20-24 22:28,219.47,Deposit,Cash Deposit,324.9254668
30046,778619358,6-22-24 10:28,58.77,Withdrawal,ATM Withdrawal,266.1554668
30047,778619358,6-23-24 19:28,123.03,Purchase,Home Improvement,143.1254668
30048,778619358,6-23-24 20:28,77.35,Payment,Loan Payment,65.77546679
30049,778619358,6-30-24 14:28,219.8,Withdrawal,ATM Withdrawal,-154.0245332
30050,778619358,07-01-24 10:28,41.08,Return,Amazon Return,-112.9445332
30051,778619358,07-01-24 21:28,2250,IncomingTransfer,Salary,2137.055467
30052,778619358,07-01-24 23:28,52.16,OnlineShopping,Target,2084.895467
30053,778619358,07-02-24 9:28,13.5,Purchase,Grocery,2071.395467
30054,778619358,07-06-24 21:28,1100,Payment,Credit Card Payment,971.3954668
30055,778619358,07-12-24 9:28,24.72,Withdrawal,Mobile App Withdrawal,946.6754668
30056,778619358,7-14-24 13:28,131.36,Withdrawal,ATM Withdrawal,815.3154668
30057,778619358,7-16-24 19:28,86.38,Deposit,Cash Deposit,901.6954668
30058,778619358,7-16-24 23:28,200.41,Purchase,Restaurant,701.2854668
30059,778619358,7-17-24 13:28,88.08,OnlineShopping,Amazon,613.2054668
30060,778619358,7-18-24 21:28,600,Payment,Rent Payment,13.20546679
30061,778712658,1-20-24 19:28,221.78,OnlineShopping,Best Buy,345.1614369
30062,778712658,1-21-24 17:28,235.17,Purchase,Travel,109.9914369
30063,778712658,1-22-24 13:28,200.02,OnlineShopping,Best Buy,-90.02856314
30064,778712658,1-22-24 18:28,176.65,Withdrawal,Branch Withdrawal,-266.6785631
30065,778712658,1-25-24 11:28,225.11,Return,Amazon Return,-41.56856314
30066,778712658,1-26-24 11:28,241.21,OutgoingTransfer,Peer-to-Peer Transfer,-282.7785631
30067,778712658,1-30-24 21:28,166.89,Deposit,Check Deposit,-115.8885631
30068,778712658,02-05-24 21:28,2300,IncomingTransfer,Salary,2184.111437
30069,778712658,02-05-24 21:28,151.43,OnlineShopping,Target,2032.681437
30070,778712658,02-07-24 15:28,130.43,Payment,Mortgage Payment,1902.251437
30071,778712658,02-09-24 13:28,143.45,Payment,Bill Payment,1758.801437
30072,778712658,02-10-24 21:28,1200,Payment,Credit Card Payment,558.8014369
30073,778712658,2-15-24 12:28,148.78,Payment,Bill Payment,410.0214369
30074,778712658,2-15-24 21:28,900,Payment,Insurance Payment,-489.9785631
30075,778712658,2-15-24 21:28,164.94,OnlineShopping,eBay,-654.9185631
30076,778712658,2-18-24 16:28,182.75,Purchase,Furniture,-837.6685631
30077,778712658,2-19-24 15:28,131.8,Deposit,Direct Deposit,-705.8685631
30078,778712658,2-21-24 16:28,131.93,Purchase,Entertainment,-837.7985631
30079,778712658,2-22-24 22:28,98.59,Payment,Bill Payment,-936.3885631
30080,778712658,2-26-24 20:28,88.08,IncomingTransfer,Freelance Payment,-848.3085631
30081,778712658,03-05-24 21:28,2300,IncomingTransfer,Salary,1451.691437
30082,778712658,03-07-24 19:28,54.65,IncomingTransfer,Freelance Payment,1506.341437
30083,778712658,03-09-24 17:28,105.96,Deposit,Cash Deposit,1612.301437
30084,778712658,03-10-24 21:28,1100,Payment,Credit Card Payment,512.3014369
30085,778712658,03-10-24 21:28,600,Payment,Installment Payment,-87.69856314
30086,778712658,03-12-24 12:28,228.32,Return,Etsy Return,140.6214369
30087,778712658,03-12-24 13:28,224.63,Deposit,Mobile Deposit,365.2514369
30088,778712658,3-13-24 17:28,130.08,OnlineShopping,AliExpress,235.1714369
30089,778712658,3-18-24 14:28,208.62,Purchase,Restaurant,26.55143686
30090,778712658,3-19-24 18:28,124.56,Payment,Bill Payment,-98.00856314
30091,778712658,3-21-24 21:28,86.69,Deposit,Cash Deposit,-11.31856314
30092,778712658,3-21-24 21:28,180.58,Deposit,Direct Deposit,169.2614369
30093,778712658,3-23-24 11:28,204.84,Deposit,Direct Deposit,374.1014369
30094,778712658,3-24-24 13:28,142.39,Deposit,Mobile Deposit,516.4914369
30095,778712658,3-25-24 12:28,125.22,Deposit,Direct Deposit,641.7114369
30096,778712658,3-27-24 13:28,80.46,Deposit,Mobile Deposit,722.1714369
30097,778712658,3-28-24 13:28,190.72,Return,Best Buy Return,912.8914369
30098,778712658,3-31-24 15:28,241.71,Withdrawal,Mobile App Withdrawal,671.1814369
30099,778712658,3-31-24 22:28,247.54,Deposit,Cash Deposit,918.7214369
30100,778712658,04-02-24 10:28,63.83,Purchase,Grocery,854.8914369
30101,778712658,04-03-24 21:28,2300,IncomingTransfer,Salary,3154.891437
30102,778712658,04-05-24 15:28,108.5,IncomingTransfer,Freelance Payment,3263.391437
30103,778712658,04-07-24 18:28,31.91,Purchase,Gas,3231.481437
30104,778712658,04-08-24 10:28,202.29,Deposit,Cash Deposit,3433.771437
30105,778712658,04-08-24 21:28,1200,Payment,Credit Card Payment,2233.771437
30106,778712658,04-09-24 11:28,218.58,Payment,Mortgage Payment,2015.191437
30107,778712658,04-10-24 11:28,130.5,Deposit,Mobile Deposit,2145.691437
30108,778712658,04-10-24 23:28,181.24,OnlineShopping,eBay,1964.451437
30109,778712658,4-16-24 21:28,700,Payment,Installment Payment,1264.451437
30110,778712658,4-18-24 12:28,206.63,Purchase,Travel,1057.821437
30111,778712658,4-23-24 17:28,131.18,Deposit,Cash Deposit,1189.001437
30112,778712658,4-25-24 12:28,55.74,Payment,Mortgage Payment,1133.261437
30113,778712658,4-26-24 14:28,17.49,Purchase,Gas,1115.771437
30114,778712658,4-27-24 19:28,225.86,OnlineShopping,Etsy,889.9114369
30115,778712658,05-01-24 10:28,37.5,Withdrawal,Branch Withdrawal,852.4114369
30116,778712658,05-01-24 16:28,13.25,Withdrawal,Branch Withdrawal,839.1614369
30117,778712658,05-01-24 23:28,168.52,Return,Store Return,1007.681437
30118,778712658,05-02-24 12:28,49.12,OutgoingTransfer,Wire Transfer,958.5614369
30119,778712658,05-02-24 23:28,165.55,Withdrawal,Mobile App Withdrawal,793.0114369
30120,778712658,05-05-24 17:28,108.89,OnlineShopping,Target,684.1214369
30121,778712658,05-05-24 21:28,2300,IncomingTransfer,Salary,2984.121437
30122,778712658,05-06-24 10:28,159.4,Payment,Loan Payment,2824.721437
30123,778712658,05-10-24 11:28,208.58,Deposit,Check Deposit,3033.301437
30124,778712658,05-10-24 21:28,1000,Payment,Credit Card Payment,2033.301437
30125,778712658,05-12-24 21:28,1000,Payment,Subscription Payment,1033.301437
30126,778712658,5-13-24 9:28,18.36,OnlineShopping,Walmart,1014.941437
30127,778712658,5-17-24 17:28,182.9,Purchase,Furniture,832.0414369
30128,778712658,5-18-24 10:28,157.23,Deposit,Cash Deposit,989.2714369
30129,778712658,5-24-24 9:28,84.37,Deposit,Check Deposit,1073.641437
30130,778712658,5-24-24 17:28,246.85,Purchase,Home Improvement,826.7914369
30131,778712658,5-25-24 18:28,155.21,Withdrawal,Branch Withdrawal,671.5814369
30132,778712658,5-27-24 18:28,84.67,IncomingTransfer,Freelance Payment,756.2514369
30133,778712658,5-28-24 9:28,190.64,Purchase,Entertainment,565.6114369
30134,778712658,5-28-24 18:28,16.52,Withdrawal,Branch Withdrawal,549.0914369
30135,778712658,5-30-24 23:28,150.02,Purchase,Grocery,399.0714369
30136,778712658,06-01-24 20:28,205.97,Withdrawal,Branch Withdrawal,193.1014369
30137,778712658,06-03-24 22:28,46.64,OnlineShopping,eBay,146.4614369
30138,778712658,06-04-24 21:28,2300,IncomingTransfer,Salary,2446.461437
30139,778712658,06-07-24 19:28,124.62,OnlineShopping,Etsy,2321.841437
30140,778712658,06-08-24 17:28,63.66,Deposit,Cash Deposit,2385.501437
30141,778712658,06-09-24 15:28,97.98,Purchase,Clothing,2287.521437
30142,778712658,06-09-24 19:28,153.8,Purchase,Entertainment,2133.721437
30143,778712658,06-09-24 21:28,1200,Payment,Credit Card Payment,933.7214369
30144,778712658,06-12-24 21:28,700,Payment,Installment Payment,233.7214369
30145,778712658,6-16-24 11:28,191.55,Payment,Bill Payment,42.17143686
30146,778712658,6-16-24 15:28,58.27,IncomingTransfer,Freelance Payment,100.4414369
30147,778712658,6-17-24 11:28,24.65,Return,Etsy Return,125.0914369
30148,778712658,6-17-24 21:28,85.01,Withdrawal,Mobile App Withdrawal,40.08143686
30149,778712658,6-19-24 22:28,18.9,Deposit,Check Deposit,58.98143686
30150,778712658,6-21-24 20:28,100.48,Payment,Mortgage Payment,-41.49856314
30151,778712658,6-22-24 10:28,102.38,Return,Best Buy Return,60.88143686
30152,778712658,6-23-24 10:28,75.13,Deposit,Cash Deposit,136.0114369
30153,778712658,6-24-24 10:28,145.1,Withdrawal,Branch Withdrawal,-9.088563145
30154,778712658,6-27-24 21:28,58.14,Deposit,Mobile Deposit,49.05143686
30155,778712658,6-28-24 13:28,63.5,OnlineShopping,Target,-14.44856314
30156,778712658,6-29-24 19:28,220.31,Purchase,Grocery,-234.7585631
30157,778712658,6-29-24 22:28,24.5,OutgoingTransfer,International Transfer,-259.2585631
30158,778712658,07-02-24 21:28,2300,IncomingTransfer,Salary,2040.741437
30159,778712658,07-06-24 22:28,96.86,Purchase,Home Improvement,1943.881437
30160,778712658,07-07-24 13:28,118.65,IncomingTransfer,Freelance Payment,2062.531437
30161,778712658,07-07-24 21:28,1100,Payment,Credit Card Payment,962.5314369
30162,778712658,07-09-24 22:28,81.72,Deposit,Cash Deposit,1044.251437
30163,778712658,7-13-24 21:28,900,Payment,Installment Payment,144.2514369
30164,778712658,7-15-24 11:28,190.35,Purchase,Electronics,-46.09856314
30165,778855383,1-24-24 21:28,220.43,Deposit,Cash Deposit,220.43
30166,778855383,1-25-24 13:28,123.94,Payment,Mortgage Payment,96.49
30167,778855383,1-29-24 16:28,156.32,Withdrawal,ATM Withdrawal,-59.83
30168,778855383,02-01-24 22:28,199.93,OutgoingTransfer,Wire Transfer,-259.76
30169,778855383,02-02-24 21:28,1800,IncomingTransfer,Salary,1540.24
30170,778855383,02-12-24 14:28,182.83,Purchase,Electronics,1357.41
30171,778855383,2-17-24 21:28,1100,Payment,Rent Payment,257.41
30172,778855383,2-18-24 11:28,49.46,OnlineShopping,AliExpress,207.95
30173,778855383,2-22-24 11:28,192.43,Payment,Mortgage Payment,15.52
30174,778855383,2-22-24 23:28,100.06,Purchase,Travel,-84.54
30175,778855383,2-26-24 14:28,111.76,OutgoingTransfer,International Transfer,-196.3
30176,778855383,2-27-24 13:28,145.23,Deposit,Mobile Deposit,-51.07
30177,778855383,03-02-24 14:28,122.47,Purchase,Entertainment,-173.54
30178,778855383,03-04-24 15:28,127.19,Withdrawal,Mobile App Withdrawal,-300.73
30179,778855383,03-05-24 21:28,1800,IncomingTransfer,Salary,1499.27
30180,778855383,3-14-24 21:28,700,Payment,Rent Payment,799.27
30181,778855383,3-17-24 11:28,26.23,OnlineShopping,Walmart,773.04
30182,778855383,3-20-24 12:28,101.96,Deposit,Check Deposit,875
30183,778855383,3-23-24 17:28,52.07,Payment,Mortgage Payment,822.93
30184,778855383,3-25-24 23:28,248.59,Deposit,Direct Deposit,1071.52
30185,778855383,04-01-24 21:28,1800,IncomingTransfer,Salary,2871.52
30186,778855383,04-10-24 17:28,198.07,Withdrawal,ATM Withdrawal,2673.45
30187,778855383,04-11-24 21:28,900,Payment,Rent Payment,1773.45
30188,778855383,04-12-24 20:28,196.63,Withdrawal,ATM Withdrawal,1576.82
30189,778855383,4-14-24 10:28,219.26,IncomingTransfer,Freelance Payment,1796.08
30190,778855383,4-16-24 13:28,55.22,Withdrawal,Branch Withdrawal,1740.86
30191,778855383,4-19-24 16:28,139.26,Withdrawal,ATM Withdrawal,1601.6
30192,778855383,4-22-24 20:28,179.17,Return,Best Buy Return,1780.77
30193,778855383,4-25-24 19:28,79.3,Deposit,Check Deposit,1860.07
30194,778855383,05-01-24 21:28,1800,IncomingTransfer,Salary,3660.07
30195,778855383,05-04-24 20:28,203.49,OnlineShopping,AliExpress,3456.58
30196,778855383,5-15-24 21:28,700,Payment,Rent Payment,2756.58
30197,778855383,5-18-24 22:28,63.7,OutgoingTransfer,Wire Transfer,2692.88
30198,778855383,5-19-24 12:28,203.47,IncomingTransfer,Freelance Payment,2896.35
30199,778855383,5-19-24 15:28,80.56,Purchase,Clothing,2815.79
30200,778855383,5-20-24 16:28,212.81,OutgoingTransfer,Bank Transfer,2602.98
30201,778855383,5-22-24 21:28,216.4,Return,Store Return,2819.38
30202,778855383,5-23-24 17:28,191.56,Purchase,Home Improvement,2627.82
30203,778855383,5-25-24 20:28,168.95,Deposit,Mobile Deposit,2796.77
30204,778855383,5-27-24 20:28,248.31,Deposit,Mobile Deposit,3045.08
30205,778855383,5-27-24 20:28,237.59,OnlineShopping,AliExpress,2807.49
30206,778855383,5-29-24 12:28,86.89,Withdrawal,ATM Withdrawal,2720.6
30207,778855383,06-05-24 21:28,1800,IncomingTransfer,Salary,4520.6
30208,778855383,6-15-24 21:28,700,Payment,Rent Payment,3820.6
30209,778855383,6-15-24 22:28,123.94,Payment,Loan Payment,3696.66
30210,778855383,6-16-24 12:28,15.74,OutgoingTransfer,Peer-to-Peer Transfer,3680.92
30211,778855383,6-22-24 15:28,179.2,Purchase,Entertainment,3501.72
30212,778855383,6-27-24 23:28,56.83,Purchase,Entertainment,3444.89
30213,778855383,6-29-24 17:28,215.03,Deposit,Direct Deposit,3659.92
30214,778855383,07-04-24 21:28,1800,IncomingTransfer,Salary,5459.92
30215,778855383,7-13-24 11:28,203.72,OutgoingTransfer,Wire Transfer,5256.2
30216,778855383,7-15-24 21:28,1100,Payment,Rent Payment,4156.2
30217,778867533,1-24-24 9:28,397.28,Return,Store Return,397.28
30218,778867533,1-24-24 13:28,361.46,Payment,Bill Payment,35.82
30219,778867533,02-02-24 21:28,3800,IncomingTransfer,Salary,3835.82
30220,778867533,02-08-24 10:28,316.72,Purchase,Gas,3519.1
30221,778867533,02-09-24 15:28,289.59,OnlineShopping,eBay,3229.51
30222,778867533,02-11-24 21:28,2200,Payment,Rent Payment,1029.51
30223,778867533,2-17-24 10:28,142.83,Withdrawal,Branch Withdrawal,886.68
30224,778867533,2-17-24 21:28,217.53,Purchase,Furniture,669.15
30225,778867533,2-27-24 18:28,37.46,Purchase,Entertainment,631.69
30226,778867533,03-04-24 21:28,3800,IncomingTransfer,Salary,4431.69
30227,778867533,03-10-24 18:28,169.21,OutgoingTransfer,Bank Transfer,4262.48
30228,778867533,03-11-24 21:28,1300,Payment,Rent Payment,2962.48
30229,778867533,3-15-24 17:28,96.65,Return,Store Return,3059.13
30230,778867533,3-21-24 14:28,360.22,IncomingTransfer,Freelance Payment,3419.35
30231,778867533,3-22-24 14:28,334.64,Withdrawal,Mobile App Withdrawal,3084.71
30232,778867533,3-28-24 12:28,310.19,Withdrawal,Branch Withdrawal,2774.52
30233,778867533,04-04-24 10:28,200.24,Purchase,Home Improvement,2574.28
30234,778867533,04-04-24 13:28,239.51,IncomingTransfer,Freelance Payment,2813.79
30235,778867533,04-05-24 21:28,3800,IncomingTransfer,Salary,6613.79
30236,778867533,04-10-24 16:28,300.48,OutgoingTransfer,International Transfer,6313.31
30237,778867533,4-16-24 14:28,231.09,OnlineShopping,Amazon,6082.22
30238,778867533,4-17-24 21:28,1800,Payment,Rent Payment,4282.22
30239,778867533,4-20-24 21:28,349.8,OnlineShopping,Target,3932.42
30240,778867533,05-01-24 21:28,3800,IncomingTransfer,Salary,7732.42
30241,778867533,05-02-24 12:28,233.75,Withdrawal,ATM Withdrawal,7498.67
30242,778867533,05-12-24 21:28,2100,Payment,Rent Payment,5398.67
30243,778867533,5-16-24 23:28,392.09,Deposit,Direct Deposit,5790.76
30244,778867533,06-05-24 21:28,3800,IncomingTransfer,Salary,9590.76
30245,778867533,6-17-24 21:28,1100,Payment,Rent Payment,8490.76
30246,778867533,6-19-24 21:28,349.48,OutgoingTransfer,Wire Transfer,8141.28
30247,778867533,6-30-24 17:28,219.23,OutgoingTransfer,International Transfer,7922.05
30248,778867533,07-03-24 21:28,3800,IncomingTransfer,Salary,11722.05
30249,778867533,07-12-24 15:28,204.51,Purchase,Grocery,11517.54
30250,778867533,7-13-24 21:28,2100,Payment,Rent Payment,9417.54
30251,778867533,7-15-24 16:28,365.94,Withdrawal,Branch Withdrawal,9051.6
30252,778873608,1-21-24 20:28,171.11,IncomingTransfer,Freelance Payment,1814.505917
30253,778873608,1-22-24 21:28,697.82,Return,AliExpress Return,2512.325917
30254,778873608,1-26-24 11:28,518.33,Deposit,Direct Deposit,3030.655917
30255,778873608,1-27-24 13:28,214.85,OnlineShopping,Amazon,2815.805917
30256,778873608,1-28-24 12:28,420.83,Deposit,Direct Deposit,3236.635917
30257,778873608,1-28-24 17:28,683.76,OutgoingTransfer,Peer-to-Peer Transfer,2552.875917
30258,778873608,1-29-24 14:28,134.56,Return,Etsy Return,2687.435917
30259,778873608,1-31-24 22:28,113.35,Withdrawal,Branch Withdrawal,2574.085917
30260,778873608,02-01-24 10:28,677.24,OnlineShopping,Target,1896.845917
30261,778873608,02-01-24 19:28,390.04,Payment,Mortgage Payment,1506.805917
30262,778873608,02-01-24 20:28,136.65,Purchase,Pharmacy,1370.155917
30263,778873608,02-01-24 21:28,7300,IncomingTransfer,Salary,8670.155917
30264,778873608,02-04-24 14:28,578.95,OnlineShopping,Amazon,8091.205917
30265,778873608,02-06-24 13:28,184.72,Payment,Loan Payment,7906.485917
30266,778873608,02-06-24 21:28,2300,Payment,Credit Card Payment,5606.485917
30267,778873608,02-07-24 9:28,608.17,Deposit,Mobile Deposit,6214.655917
30268,778873608,02-07-24 11:28,107.54,Deposit,Check Deposit,6322.195917
30269,778873608,02-10-24 11:28,414.86,Withdrawal,Branch Withdrawal,5907.335917
30270,778873608,02-10-24 20:28,566.53,Withdrawal,Branch Withdrawal,5340.805917
30271,778873608,02-11-24 14:28,361.78,Withdrawal,ATM Withdrawal,4979.025917
30272,778873608,2-14-24 21:28,3600,Payment,Rent Payment,1379.025917
30273,778873608,2-15-24 23:28,722.56,Deposit,Direct Deposit,2101.585917
30274,778873608,2-18-24 18:28,557.25,Return,Walmart Return,2658.835917
30275,778873608,2-18-24 21:28,328.29,Deposit,Direct Deposit,2987.125917
30276,778873608,2-19-24 16:28,427.86,Deposit,Mobile Deposit,3414.985917
30277,778873608,2-20-24 19:28,648.88,Withdrawal,ATM Withdrawal,2766.105917
30278,778873608,2-22-24 9:28,404.48,Purchase,Entertainment,2361.625917
30279,778873608,2-22-24 16:28,500.49,Deposit,Check Deposit,2862.115917
30280,778873608,2-24-24 22:28,320.95,Deposit,Cash Deposit,3183.065917
30281,778873608,2-26-24 19:28,282.62,Deposit,Direct Deposit,3465.685917
30282,778873608,2-26-24 21:28,432.9,Withdrawal,ATM Withdrawal,3032.785917
30283,778873608,2-28-24 9:28,211.58,Purchase,Gas,2821.205917
30284,778873608,2-28-24 19:28,159.03,Purchase,Furniture,2662.175917
30285,778873608,03-03-24 21:28,7300,IncomingTransfer,Salary,9962.175917
30286,778873608,03-04-24 13:28,382.06,Withdrawal,ATM Withdrawal,9580.115917
30287,778873608,03-05-24 9:28,278.91,Deposit,Check Deposit,9859.025917
30288,778873608,03-06-24 15:28,500.09,OutgoingTransfer,Bank Transfer,9358.935917
30289,778873608,03-06-24 20:28,284.96,Purchase,Furniture,9073.975917
30290,778873608,03-08-24 14:28,379.82,Deposit,Cash Deposit,9453.795917
30291,778873608,03-08-24 21:28,2800,Payment,Credit Card Payment,6653.795917
30292,778873608,03-09-24 19:28,445.52,Payment,Bill Payment,6208.275917
30293,778873608,03-09-24 22:28,497.96,Withdrawal,Mobile App Withdrawal,5710.315917
30294,778873608,03-10-24 10:28,414.05,Purchase,Home Improvement,5296.265917
30295,778873608,03-10-24 15:28,208.98,Withdrawal,ATM Withdrawal,5087.285917
30296,778873608,03-11-24 9:28,454.48,Purchase,Grocery,4632.805917
30297,778873608,03-11-24 14:28,281.2,Deposit,Mobile Deposit,4914.005917
30298,778873608,03-11-24 21:28,2400,Payment,Rent Payment,2514.005917
30299,778873608,03-12-24 21:28,668.36,OnlineShopping,Etsy,1845.645917
30300,778873608,3-15-24 17:28,377.58,Deposit,Direct Deposit,2223.225917
30301,778873608,3-15-24 20:28,383.14,Deposit,Check Deposit,2606.365917
30302,778873608,3-17-24 19:28,474.24,Withdrawal,ATM Withdrawal,2132.125917
30303,778873608,3-27-24 10:28,661.52,Purchase,Clothing,1470.605917
30304,778873608,3-29-24 16:28,519.87,OutgoingTransfer,Peer-to-Peer Transfer,950.7359174
30305,778873608,04-01-24 10:28,582.59,Deposit,Mobile Deposit,1533.325917
30306,778873608,04-02-24 10:28,178.54,Return,AliExpress Return,1711.865917
30307,778873608,04-02-24 21:28,7300,IncomingTransfer,Salary,9011.865917
30308,778873608,04-04-24 12:28,587.97,Withdrawal,Mobile App Withdrawal,8423.895917
30309,778873608,04-04-24 13:28,106.03,Withdrawal,Branch Withdrawal,8317.865917
30310,778873608,04-07-24 21:28,2100,Payment,Credit Card Payment,6217.865917
30311,778873608,04-10-24 12:28,339.57,Purchase,Clothing,5878.295917
30312,778873608,04-10-24 14:28,297.25,OnlineShopping,AliExpress,5581.045917
30313,778873608,04-12-24 9:28,241.91,Purchase,Entertainment,5339.135917
30314,778873608,04-12-24 17:28,747.39,Withdrawal,ATM Withdrawal,4591.745917
30315,778873608,4-14-24 11:28,572.5,OnlineShopping,eBay,4019.245917
30316,778873608,4-15-24 22:28,172.73,IncomingTransfer,Freelance Payment,4191.975917
30317,778873608,4-16-24 21:28,4400,Payment,Rent Payment,-208.0240826
30318,778873608,4-16-24 23:28,186.25,Deposit,Check Deposit,-21.77408263
30319,778873608,4-17-24 12:28,222.5,Return,Walmart Return,200.7259174
30320,778873608,4-17-24 18:28,739.47,Purchase,Entertainment,-538.7440826
30321,778873608,4-20-24 22:28,674.26,Deposit,Check Deposit,135.5159174
30322,778873608,4-21-24 13:28,515,Payment,Mortgage Payment,-379.4840826
30323,778873608,4-21-24 22:28,705.19,Purchase,Grocery,-1084.674083
30324,778873608,4-22-24 11:28,167.49,Deposit,Cash Deposit,-917.1840826
30325,778873608,4-22-24 17:28,535.09,Purchase,Electronics,-1452.274083
30326,778873608,4-23-24 13:28,607.8,Payment,Mortgage Payment,-2060.074083
30327,778873608,4-24-24 16:28,197.94,Payment,Bill Payment,-2258.014083
30328,778873608,4-24-24 22:28,347.14,OnlineShopping,AliExpress,-2605.154083
30329,778873608,4-28-24 16:28,532.55,Purchase,Furniture,-3137.704083
30330,778873608,05-02-24 18:28,109.32,Payment,Mortgage Payment,-3247.024083
30331,778873608,05-03-24 12:28,316.93,OnlineShopping,Target,-3563.954083
30332,778873608,05-04-24 21:28,7300,IncomingTransfer,Salary,3736.045917
30333,778873608,05-05-24 19:28,174.58,Payment,Loan Payment,3561.465917
30334,778873608,05-06-24 21:28,287.91,Withdrawal,Mobile App Withdrawal,3273.555917
30335,778873608,05-09-24 21:28,2200,Payment,Credit Card Payment,1073.555917
30336,778873608,05-12-24 21:28,4300,Payment,Rent Payment,-3226.444083
30337,778873608,5-23-24 21:28,345.46,Withdrawal,ATM Withdrawal,-3571.904083
30338,778873608,5-25-24 13:28,563.43,Purchase,Electronics,-4135.334083
30339,778873608,5-26-24 20:28,704.07,Purchase,Travel,-4839.404083
30340,778873608,5-27-24 15:28,379.95,Withdrawal,Mobile App Withdrawal,-5219.354083
30341,778873608,5-28-24 18:28,580.74,Withdrawal,Branch Withdrawal,-5800.094083
30342,778873608,5-29-24 12:28,660.12,Purchase,Travel,-6460.214083
30343,778873608,5-31-24 15:28,650.12,Purchase,Entertainment,-7110.334083
30344,778873608,06-01-24 14:28,553.57,OutgoingTransfer,Bank Transfer,-7663.904083
30345,778873608,06-03-24 17:28,109.92,Withdrawal,Mobile App Withdrawal,-7773.824083
30346,778873608,06-04-24 18:28,225.68,Purchase,Home Improvement,-7999.504083
30347,778873608,06-04-24 21:28,7300,IncomingTransfer,Salary,-699.5040826
30348,778873608,06-04-24 23:28,384.07,Payment,Bill Payment,-1083.574083
30349,778873608,06-05-24 21:28,316.96,Purchase,Pharmacy,-1400.534083
30350,778873608,06-07-24 21:28,191.34,Purchase,Gas,-1591.874083
30351,778873608,06-08-24 20:28,512.84,Purchase,Electronics,-2104.714083
30352,778873608,06-09-24 21:28,2800,Payment,Credit Card Payment,-4904.714083
30353,778873608,06-09-24 22:28,194.59,Deposit,Direct Deposit,-4710.124083
30354,778873608,06-10-24 19:28,132.96,Withdrawal,ATM Withdrawal,-4843.084083
30355,778873608,06-12-24 13:28,229.19,Deposit,Check Deposit,-4613.894083
30356,778873608,6-13-24 9:28,273.39,Deposit,Cash Deposit,-4340.504083
30357,778873608,6-14-24 9:28,237.95,Deposit,Cash Deposit,-4102.554083
30358,778873608,6-14-24 14:28,178.69,Payment,Loan Payment,-4281.244083
30359,778873608,6-15-24 13:28,648.67,IncomingTransfer,Freelance Payment,-3632.574083
30360,778873608,6-17-24 17:28,679.02,Purchase,Electronics,-4311.594083
30361,778873608,6-17-24 21:28,4400,Payment,Rent Payment,-8711.594083
30362,778873608,6-18-24 14:28,145.01,OutgoingTransfer,Peer-to-Peer Transfer,-8856.604083
30363,778873608,6-19-24 10:28,672.05,Purchase,Gas,-9528.654083
30364,778873608,6-22-24 22:28,640.49,OnlineShopping,Walmart,-10169.14408
30365,778873608,6-23-24 11:28,626.37,Deposit,Direct Deposit,-9542.774083
30366,778873608,6-26-24 15:28,449.04,OnlineShopping,AliExpress,-9991.814083
30367,778873608,6-30-24 12:28,435.46,Purchase,Pharmacy,-10427.27408
30368,778873608,6-30-24 18:28,545.18,Withdrawal,Mobile App Withdrawal,-10972.45408
30369,778873608,07-01-24 21:28,7300,IncomingTransfer,Salary,-3672.454083
30370,778873608,07-02-24 10:28,595.34,Purchase,Restaurant,-4267.794083
30371,778873608,07-03-24 20:28,326.79,Deposit,Check Deposit,-3941.004083
30372,778873608,07-06-24 16:28,187.11,Purchase,Gas,-4128.114083
30373,778873608,07-06-24 20:28,112.49,OnlineShopping,Amazon,-4240.604083
30374,778873608,07-06-24 21:28,3000,Payment,Credit Card Payment,-7240.604083
30375,778873608,07-07-24 17:28,524.17,Purchase,Clothing,-7764.774083
30376,778873608,07-08-24 11:28,272.61,Payment,Mortgage Payment,-8037.384083
30377,778873608,07-08-24 18:28,622.68,Purchase,Travel,-8660.064083
30378,778873608,07-11-24 9:28,106.5,Deposit,Check Deposit,-8553.564083
30379,778873608,07-11-24 12:28,485.6,IncomingTransfer,Freelance Payment,-8067.964083
30380,778873608,07-12-24 10:28,574.12,OnlineShopping,Amazon,-8642.084083
30381,778873608,07-12-24 11:28,156.56,Purchase,Electronics,-8798.644083
30382,778873608,7-13-24 21:28,4400,Payment,Rent Payment,-13198.64408
30383,778873608,7-15-24 13:28,472.39,Return,Amazon Return,-12726.25408
30384,778873608,7-15-24 17:28,675.61,Withdrawal,ATM Withdrawal,-13401.86408
30385,778873608,7-16-24 13:28,216.44,Payment,Mortgage Payment,-13618.30408
30386,778888083,1-20-24 20:28,102.66,Deposit,Mobile Deposit,102.66
30387,778888083,1-31-24 21:28,251.24,OutgoingTransfer,Wire Transfer,-148.58
30388,778888083,02-03-24 21:28,4150,IncomingTransfer,Salary,4001.42
30389,778888083,02-11-24 18:28,107.9,Deposit,Mobile Deposit,4109.32
30390,778888083,02-12-24 17:28,384.75,Deposit,Direct Deposit,4494.07
30391,778888083,2-14-24 21:28,1500,Payment,Rent Payment,2994.07
30392,778888083,2-16-24 20:28,107.3,Withdrawal,Mobile App Withdrawal,2886.77
30393,778888083,2-18-24 20:28,296.41,Purchase,Home Improvement,2590.36
30394,778888083,2-18-24 20:28,113.74,Purchase,Travel,2476.62
30395,778888083,2-19-24 10:28,191.34,Deposit,Cash Deposit,2667.96
30396,778888083,2-20-24 11:28,269.2,Return,Target Return,2937.16
30397,778888083,2-22-24 13:28,269.71,OutgoingTransfer,International Transfer,2667.45
30398,778888083,2-24-24 14:28,59.44,Withdrawal,Mobile App Withdrawal,2608.01
30399,778888083,2-24-24 17:28,202.91,Purchase,Entertainment,2405.1
30400,778888083,2-26-24 21:28,385.85,Payment,Loan Payment,2019.25
30401,778888083,2-29-24 9:28,55.4,Withdrawal,ATM Withdrawal,1963.85
30402,778888083,03-03-24 21:28,299.9,Purchase,Entertainment,1663.95
30403,778888083,03-04-24 17:28,204.95,Purchase,Electronics,1459
30404,778888083,03-04-24 21:28,156.07,Deposit,Cash Deposit,1615.07
30405,778888083,03-05-24 21:28,4150,IncomingTransfer,Salary,5765.07
30406,778888083,03-06-24 13:28,308.56,OnlineShopping,Best Buy,5456.51
30407,778888083,3-14-24 15:28,390.53,Purchase,Home Improvement,5065.98
30408,778888083,3-14-24 21:28,1600,Payment,Rent Payment,3465.98
30409,778888083,3-17-24 14:28,376.17,Deposit,Cash Deposit,3842.15
30410,778888083,3-24-24 22:28,230.51,OutgoingTransfer,Bank Transfer,3611.64
30411,778888083,3-29-24 11:28,398.81,Deposit,Mobile Deposit,4010.45
30412,778888083,3-29-24 23:28,99.37,OutgoingTransfer,Wire Transfer,3911.08
30413,778888083,04-03-24 21:28,245.08,Return,Walmart Return,4156.16
30414,778888083,04-05-24 16:28,358.57,OutgoingTransfer,Bank Transfer,3797.59
30415,778888083,04-05-24 21:28,4150,IncomingTransfer,Salary,7947.59
30416,778888083,04-05-24 21:28,127.69,OnlineShopping,Best Buy,7819.9
30417,778888083,04-09-24 12:28,117.31,OutgoingTransfer,Wire Transfer,7702.59
30418,778888083,4-18-24 12:28,261.96,Deposit,Cash Deposit,7964.55
30419,778888083,4-18-24 21:28,2300,Payment,Rent Payment,5664.55
30420,778888083,4-22-24 10:28,354.3,Deposit,Cash Deposit,6018.85
30421,778888083,4-22-24 12:28,143.59,OutgoingTransfer,Peer-to-Peer Transfer,5875.26
30422,778888083,4-25-24 10:28,256.13,Purchase,Entertainment,5619.13
30423,778888083,05-01-24 13:28,374.56,Withdrawal,Branch Withdrawal,5244.57
30424,778888083,05-02-24 13:28,207.05,Deposit,Cash Deposit,5451.62
30425,778888083,05-02-24 21:28,306,Purchase,Furniture,5145.62
30426,778888083,05-03-24 9:28,52.24,Deposit,Check Deposit,5197.86
30427,778888083,05-04-24 20:28,121.49,Deposit,Direct Deposit,5319.35
30428,778888083,05-05-24 21:28,4150,IncomingTransfer,Salary,9469.35
30429,778888083,05-09-24 10:28,239.61,Purchase,Entertainment,9229.74
30430,778888083,05-09-24 13:28,285.73,Purchase,Clothing,8944.01
30431,778888083,05-10-24 23:28,391.32,Withdrawal,ATM Withdrawal,8552.69
30432,778888083,5-15-24 21:28,1800,Payment,Rent Payment,6752.69
30433,778888083,5-23-24 21:28,24.33,Return,Etsy Return,6777.02
30434,778888083,5-26-24 13:28,176.9,Payment,Bill Payment,6600.12
30435,778888083,5-30-24 17:28,290.15,Payment,Bill Payment,6309.97
30436,778888083,5-31-24 22:28,80.63,Withdrawal,Mobile App Withdrawal,6229.34
30437,778888083,06-02-24 21:28,39.4,Purchase,Grocery,6189.94
30438,778888083,06-03-24 21:28,4150,IncomingTransfer,Salary,10339.94
30439,778888083,06-10-24 20:28,213.06,IncomingTransfer,Freelance Payment,10553
30440,778888083,06-12-24 19:28,70.01,Purchase,Pharmacy,10482.99
30441,778888083,06-12-24 21:28,2100,Payment,Rent Payment,8382.99
30442,778888083,6-14-24 13:28,236.23,Purchase,Electronics,8146.76
30443,778888083,6-15-24 17:28,100.28,Withdrawal,ATM Withdrawal,8046.48
30444,778888083,6-15-24 22:28,244.63,Purchase,Travel,7801.85
30445,778888083,6-21-24 13:28,157.7,Deposit,Mobile Deposit,7959.55
30446,778888083,6-21-24 17:28,353.89,OnlineShopping,Etsy,7605.66
30447,778888083,6-22-24 13:28,72.19,Deposit,Check Deposit,7677.85
30448,778888083,6-27-24 23:28,394.16,Deposit,Check Deposit,8072.01
30449,778888083,07-01-24 12:28,295.39,Withdrawal,ATM Withdrawal,7776.62
30450,778888083,07-04-24 16:28,65.99,Deposit,Cash Deposit,7842.61
30451,778888083,07-04-24 21:28,4150,IncomingTransfer,Salary,11992.61
30452,778888083,07-06-24 21:28,178.81,Return,AliExpress Return,12171.42
30453,778888083,07-09-24 21:28,53.07,Withdrawal,Mobile App Withdrawal,12118.35
30454,778888083,07-11-24 14:28,115.17,Withdrawal,Branch Withdrawal,12003.18
30455,778888083,7-13-24 17:28,34.74,Withdrawal,Branch Withdrawal,11968.44
30456,778888083,7-13-24 22:28,385.25,OutgoingTransfer,Peer-to-Peer Transfer,11583.19
30457,778888083,7-14-24 11:28,138.12,Purchase,Travel,11445.07
30458,778888083,7-15-24 11:28,298.77,Purchase,Restaurant,11146.3
30459,778888083,7-16-24 21:28,2600,Payment,Rent Payment,8546.3
30460,778984383,1-21-24 20:28,252.16,Purchase,Furniture,1001.084067
30461,778984383,1-24-24 17:28,469.95,OnlineShopping,Amazon,531.134067
30462,778984383,1-26-24 9:28,127.52,OutgoingTransfer,International Transfer,403.614067
30463,778984383,1-29-24 17:28,13.8,OutgoingTransfer,Wire Transfer,389.814067
30464,778984383,1-31-24 17:28,70.17,Purchase,Grocery,319.644067
30465,778984383,02-05-24 22:28,115.33,Return,AliExpress Return,434.974067
30466,778984383,02-06-24 13:28,374.32,Deposit,Direct Deposit,809.294067
30467,778984383,02-07-24 10:28,76.21,Purchase,Clothing,733.084067
30468,778984383,2-17-24 10:28,15.18,Deposit,Cash Deposit,748.264067
30469,778984383,2-17-24 19:28,125.49,Withdrawal,Branch Withdrawal,622.774067
30470,778984383,2-21-24 11:28,182.68,OnlineShopping,Best Buy,440.094067
30471,778984383,2-22-24 15:28,400.83,Payment,Loan Payment,39.26406701
30472,778984383,2-25-24 18:28,323.47,Return,Store Return,362.734067
30473,778984383,2-26-24 22:28,184.9,Return,AliExpress Return,547.634067
30474,778984383,03-05-24 13:28,362.19,Payment,Bill Payment,185.444067
30475,778984383,03-06-24 20:28,428.09,Deposit,Cash Deposit,613.534067
30476,778984383,03-06-24 22:28,154.5,Payment,Bill Payment,459.034067
30477,778984383,03-09-24 10:28,100.5,Withdrawal,Branch Withdrawal,358.534067
30478,778984383,03-12-24 18:28,204.21,Deposit,Cash Deposit,562.744067
30479,778984383,3-14-24 11:28,311.28,OutgoingTransfer,Peer-to-Peer Transfer,251.464067
30480,778984383,3-18-24 14:28,228.18,IncomingTransfer,Freelance Payment,479.644067
30481,778984383,3-24-24 13:28,98.06,OutgoingTransfer,Peer-to-Peer Transfer,381.584067
30482,778984383,3-25-24 18:28,48.83,OutgoingTransfer,Wire Transfer,332.754067
30483,778984383,3-29-24 15:28,314.21,Withdrawal,Mobile App Withdrawal,18.54406701
30484,778984383,04-01-24 10:28,191.69,Return,Amazon Return,210.234067
30485,778984383,04-01-24 19:28,76.4,IncomingTransfer,Freelance Payment,286.634067
30486,778984383,04-07-24 13:28,338.09,OutgoingTransfer,International Transfer,-51.45593299
30487,778984383,04-07-24 14:28,207.3,OutgoingTransfer,International Transfer,-258.755933
30488,778984383,4-16-24 21:28,315.61,OutgoingTransfer,International Transfer,-574.365933
30489,778984383,4-17-24 12:28,439.38,Deposit,Check Deposit,-134.985933
30490,778984383,4-17-24 18:28,117.99,OutgoingTransfer,International Transfer,-252.975933
30491,778984383,4-18-24 20:28,65.23,OnlineShopping,eBay,-318.205933
30492,778984383,4-20-24 20:28,157.77,Payment,Mortgage Payment,-475.975933
30493,778984383,4-26-24 21:28,287.82,OnlineShopping,AliExpress,-763.795933
30494,778984383,4-28-24 18:28,162.04,Withdrawal,Branch Withdrawal,-925.835933
30495,778984383,4-28-24 21:28,66.33,Purchase,Entertainment,-992.165933
30496,778984383,4-30-24 10:28,216.55,OutgoingTransfer,International Transfer,-1208.715933
30497,778984383,05-01-24 9:28,60.57,Withdrawal,Mobile App Withdrawal,-1269.285933
30498,778984383,05-08-24 11:28,18.76,Deposit,Cash Deposit,-1250.525933
30499,778984383,05-08-24 16:28,172.29,Withdrawal,Mobile App Withdrawal,-1422.815933
30500,778984383,5-13-24 15:28,210.63,OutgoingTransfer,Wire Transfer,-1633.445933
30501,778984383,5-16-24 16:28,311.24,Deposit,Direct Deposit,-1322.205933
30502,778984383,5-16-24 20:28,60.15,Payment,Bill Payment,-1382.355933
30503,778984383,5-17-24 14:28,263.5,Payment,Bill Payment,-1645.855933
30504,778984383,5-21-24 9:28,442.98,OnlineShopping,Best Buy,-2088.835933
30505,778984383,5-21-24 19:28,449.14,Withdrawal,Branch Withdrawal,-2537.975933
30506,778984383,5-23-24 18:28,278.73,Payment,Bill Payment,-2816.705933
30507,778984383,5-24-24 17:28,10.39,Payment,Bill Payment,-2827.095933
30508,778984383,5-27-24 12:28,129.73,Payment,Loan Payment,-2956.825933
30509,778984383,5-30-24 18:28,471.8,Withdrawal,ATM Withdrawal,-3428.625933
30510,778984383,06-02-24 10:28,440.92,OutgoingTransfer,International Transfer,-3869.545933
30511,778984383,06-02-24 16:28,105.25,Withdrawal,ATM Withdrawal,-3974.795933
30512,778984383,06-02-24 22:28,362.22,OnlineShopping,Etsy,-4337.015933
30513,778984383,06-04-24 15:28,214.79,Deposit,Check Deposit,-4122.225933
30514,778984383,06-10-24 9:28,139.77,Deposit,Mobile Deposit,-3982.455933
30515,778984383,06-10-24 14:28,308.29,Purchase,Furniture,-4290.745933
30516,778984383,6-14-24 11:28,338.89,Payment,Loan Payment,-4629.635933
30517,778984383,6-15-24 14:28,301.62,Withdrawal,Mobile App Withdrawal,-4931.255933
30518,778984383,6-16-24 16:28,202.48,Return,Etsy Return,-4728.775933
30519,778984383,6-17-24 21:28,185.62,Purchase,Clothing,-4914.395933
30520,778984383,6-18-24 9:28,346.08,Return,Store Return,-4568.315933
30521,778984383,6-20-24 19:28,395.9,Deposit,Cash Deposit,-4172.415933
30522,778984383,6-21-24 12:28,113.05,Purchase,Gas,-4285.465933
30523,778984383,6-24-24 17:28,229.65,Deposit,Mobile Deposit,-4055.815933
30524,778984383,6-25-24 22:28,66.01,OutgoingTransfer,Wire Transfer,-4121.825933
30525,778984383,07-01-24 14:28,344.49,IncomingTransfer,Freelance Payment,-3777.335933
30526,778984383,07-05-24 11:28,357.34,Deposit,Cash Deposit,-3419.995933
30527,778984383,07-06-24 15:28,17.14,OnlineShopping,Target,-3437.135933
30528,778984383,07-08-24 12:28,265.69,OnlineShopping,Walmart,-3702.825933
30529,778984383,07-08-24 21:28,44.48,Payment,Loan Payment,-3747.305933
30530,778984383,07-11-24 16:28,348.65,Withdrawal,ATM Withdrawal,-4095.955933
30531,778984383,7-16-24 20:28,187.45,IncomingTransfer,Freelance Payment,-3908.505933
30532,778984383,7-17-24 19:28,367.67,Purchase,Clothing,-4276.175933
30533,779114283,1-23-24 14:28,81.27,Purchase,Travel,746.1407589
30534,779114283,1-23-24 23:28,122.39,Return,Walmart Return,868.5307589
30535,779114283,1-25-24 19:28,49.98,Deposit,Direct Deposit,918.5107589
30536,779114283,1-25-24 22:28,129.45,Withdrawal,ATM Withdrawal,789.0607589
30537,779114283,1-26-24 16:28,137.94,Withdrawal,Branch Withdrawal,651.1207589
30538,779114283,1-28-24 14:28,75.85,Deposit,Direct Deposit,726.9707589
30539,779114283,1-30-24 23:28,235.52,Deposit,Cash Deposit,962.4907589
30540,779114283,02-01-24 12:28,95.39,Return,Etsy Return,1057.880759
30541,779114283,02-01-24 21:28,2550,IncomingTransfer,Salary,3607.880759
30542,779114283,02-01-24 22:28,94.77,Payment,Loan Payment,3513.110759
30543,779114283,02-04-24 22:28,136.24,Return,Etsy Return,3649.350759
30544,779114283,02-05-24 22:28,23.64,Deposit,Check Deposit,3672.990759
30545,779114283,02-06-24 21:28,1000,Payment,Credit Card Payment,2672.990759
30546,779114283,02-11-24 12:28,235.57,Return,Best Buy Return,2908.560759
30547,779114283,02-11-24 18:28,206.74,Payment,Bill Payment,2701.820759
30548,779114283,02-12-24 15:28,150.22,Deposit,Mobile Deposit,2852.040759
30549,779114283,2-17-24 20:28,228.92,OnlineShopping,Target,2623.120759
30550,779114283,2-18-24 21:28,1200,Payment,Rent Payment,1423.120759
30551,779114283,2-19-24 13:28,79.51,OnlineShopping,eBay,1343.610759
30552,779114283,2-20-24 23:28,82.05,Deposit,Cash Deposit,1425.660759
30553,779114283,2-28-24 9:28,175.41,Deposit,Mobile Deposit,1601.070759
30554,779114283,03-05-24 21:28,2550,IncomingTransfer,Salary,4151.070759
30555,779114283,03-05-24 23:28,81.23,OnlineShopping,Target,4069.840759
30556,779114283,03-10-24 13:28,191.82,Withdrawal,Mobile App Withdrawal,3878.020759
30557,779114283,03-10-24 21:28,1400,Payment,Credit Card Payment,2478.020759
30558,779114283,03-11-24 18:28,107.88,OnlineShopping,Walmart,2370.140759
30559,779114283,3-13-24 11:28,39.32,Deposit,Mobile Deposit,2409.460759
30560,779114283,3-14-24 12:28,80.2,Purchase,Gas,2329.260759
30561,779114283,3-14-24 20:28,213.36,Payment,Mortgage Payment,2115.900759
30562,779114283,3-14-24 23:28,158.51,Deposit,Check Deposit,2274.410759
30563,779114283,3-17-24 20:28,104.42,Purchase,Home Improvement,2169.990759
30564,779114283,3-18-24 21:28,1400,Payment,Rent Payment,769.9907589
30565,779114283,3-19-24 13:28,81.5,Payment,Loan Payment,688.4907589
30566,779114283,3-24-24 15:28,34.05,Return,Amazon Return,722.5407589
30567,779114283,3-27-24 14:28,242.94,OutgoingTransfer,Peer-to-Peer Transfer,479.6007589
30568,779114283,04-03-24 18:28,240.22,Deposit,Check Deposit,719.8207589
30569,779114283,04-03-24 21:28,2550,IncomingTransfer,Salary,3269.820759
30570,779114283,04-05-24 11:28,69.8,Purchase,Entertainment,3200.020759
30571,779114283,04-05-24 18:28,40.04,OnlineShopping,Amazon,3159.980759
30572,779114283,04-08-24 21:28,1100,Payment,Credit Card Payment,2059.980759
30573,779114283,04-08-24 21:28,226.25,IncomingTransfer,Freelance Payment,2286.230759
30574,779114283,04-10-24 12:28,71.92,Purchase,Home Improvement,2214.310759
30575,779114283,04-10-24 16:28,128.4,Deposit,Mobile Deposit,2342.710759
30576,779114283,4-15-24 12:28,162.91,OnlineShopping,Best Buy,2179.800759
30577,779114283,4-18-24 21:28,900,Payment,Rent Payment,1279.800759
30578,779114283,4-19-24 10:28,114.82,Withdrawal,Branch Withdrawal,1164.980759
30579,779114283,4-25-24 22:28,124.04,Deposit,Check Deposit,1289.020759
30580,779114283,4-27-24 18:28,168.19,OnlineShopping,eBay,1120.830759
30581,779114283,4-28-24 15:28,55.56,Withdrawal,Mobile App Withdrawal,1065.270759
30582,779114283,05-01-24 23:28,119.63,OutgoingTransfer,Peer-to-Peer Transfer,945.6407589
30583,779114283,05-02-24 14:28,52.12,Withdrawal,ATM Withdrawal,893.5207589
30584,779114283,05-05-24 21:28,2550,IncomingTransfer,Salary,3443.520759
30585,779114283,05-10-24 21:28,1300,Payment,Credit Card Payment,2143.520759
30586,779114283,05-12-24 12:28,116.96,Deposit,Direct Deposit,2260.480759
30587,779114283,05-12-24 13:28,159.32,Purchase,Entertainment,2101.160759
30588,779114283,5-16-24 21:28,1600,Payment,Rent Payment,501.1607589
30589,779114283,5-19-24 20:28,78.35,OutgoingTransfer,International Transfer,422.8107589
30590,779114283,5-20-24 10:28,141.22,Deposit,Check Deposit,564.0307589
30591,779114283,5-21-24 15:28,135.73,Withdrawal,ATM Withdrawal,428.3007589
30592,779114283,5-23-24 18:28,223.79,OnlineShopping,Walmart,204.5107589
30593,779114283,5-25-24 15:28,125.77,Return,Target Return,330.2807589
30594,779114283,5-25-24 22:28,120.05,Purchase,Travel,210.2307589
30595,779114283,5-27-24 16:28,46.95,OutgoingTransfer,International Transfer,163.2807589
30596,779114283,5-27-24 18:28,143.32,Payment,Loan Payment,19.96075886
30597,779114283,06-01-24 22:28,68.09,Purchase,Travel,-48.12924114
30598,779114283,06-01-24 22:28,240.77,Payment,Bill Payment,-288.8992411
30599,779114283,06-05-24 21:28,2550,IncomingTransfer,Salary,2261.100759
30600,779114283,06-06-24 18:28,13.82,Purchase,Electronics,2247.280759
30601,779114283,06-09-24 20:28,79.48,Purchase,Travel,2167.800759
30602,779114283,06-10-24 21:28,1200,Payment,Credit Card Payment,967.8007589
30603,779114283,6-13-24 20:28,79.87,Purchase,Clothing,887.9307589
30604,779114283,6-13-24 21:28,1000,Payment,Rent Payment,-112.0692411
30605,779114283,6-13-24 23:28,96.46,Deposit,Cash Deposit,-15.60924114
30606,779114283,6-18-24 23:28,167.79,Withdrawal,Branch Withdrawal,-183.3992411
30607,779114283,6-22-24 16:28,194.61,Withdrawal,Mobile App Withdrawal,-378.0092411
30608,779114283,6-22-24 17:28,174.19,Purchase,Clothing,-552.1992411
30609,779114283,6-24-24 18:28,188.35,Withdrawal,Mobile App Withdrawal,-740.5492411
30610,779114283,6-28-24 10:28,170.4,OnlineShopping,Amazon,-910.9492411
30611,779114283,07-03-24 19:28,147.36,Withdrawal,Mobile App Withdrawal,-1058.309241
30612,779114283,07-05-24 21:28,2550,IncomingTransfer,Salary,1491.690759
30613,779114283,07-10-24 21:28,1100,Payment,Credit Card Payment,391.6907589
30614,779114283,7-13-24 15:28,188.89,Purchase,Grocery,202.8007589
30615,779114283,7-14-24 21:28,1500,Payment,Rent Payment,-1297.199241
30616,779149683,1-22-24 9:28,247.41,Return,eBay Return,1267.203966
30617,779149683,1-22-24 19:28,122.57,Payment,Loan Payment,1144.633966
30618,779149683,1-24-24 9:28,242.56,Withdrawal,Mobile App Withdrawal,902.0739661
30619,779149683,1-28-24 14:28,468.63,OnlineShopping,Walmart,433.4439661
30620,779149683,1-28-24 21:28,42.47,Purchase,Restaurant,390.9739661
30621,779149683,1-31-24 15:28,126.79,Purchase,Pharmacy,264.1839661
30622,779149683,02-01-24 21:28,3150,IncomingTransfer,Salary,3414.183966
30623,779149683,02-02-24 12:28,342.24,Purchase,Home Improvement,3071.943966
30624,779149683,02-04-24 14:28,84.08,Withdrawal,ATM Withdrawal,2987.863966
30625,779149683,02-06-24 21:28,2200,Payment,Credit Card Payment,787.8639661
30626,779149683,02-07-24 13:28,119.35,OutgoingTransfer,International Transfer,668.5139661
30627,779149683,02-08-24 10:28,265.69,Return,Amazon Return,934.2039661
30628,779149683,2-14-24 16:28,320.05,IncomingTransfer,Freelance Payment,1254.253966
30629,779149683,2-15-24 21:28,1600,Payment,Rent Payment,-345.7460339
30630,779149683,2-16-24 18:28,70.84,Deposit,Mobile Deposit,-274.9060339
30631,779149683,2-20-24 20:28,388.43,Purchase,Grocery,-663.3360339
30632,779149683,2-24-24 13:28,385.97,Deposit,Cash Deposit,-277.3660339
30633,779149683,2-25-24 16:28,474.43,Withdrawal,Branch Withdrawal,-751.7960339
30634,779149683,2-27-24 17:28,117.09,OutgoingTransfer,International Transfer,-868.8860339
30635,779149683,2-28-24 16:28,145.48,Payment,Mortgage Payment,-1014.366034
30636,779149683,2-29-24 9:28,80.55,OnlineShopping,Target,-1094.916034
30637,779149683,03-01-24 21:28,198.31,Purchase,Restaurant,-1293.226034
30638,779149683,03-05-24 21:28,3150,IncomingTransfer,Salary,1856.773966
30639,779149683,03-08-24 11:28,197.16,Withdrawal,Mobile App Withdrawal,1659.613966
30640,779149683,03-10-24 21:28,2700,Payment,Credit Card Payment,-1040.386034
30641,779149683,03-11-24 14:28,382.56,Purchase,Entertainment,-1422.946034
30642,779149683,03-12-24 21:28,1900,Payment,Rent Payment,-3322.946034
30643,779149683,3-14-24 14:28,169.61,Purchase,Restaurant,-3492.556034
30644,779149683,3-14-24 18:28,404.64,Purchase,Clothing,-3897.196034
30645,779149683,3-14-24 19:28,91.83,Deposit,Cash Deposit,-3805.366034
30646,779149683,3-19-24 10:28,74.9,Withdrawal,Mobile App Withdrawal,-3880.266034
30647,779149683,3-20-24 11:28,359.48,Withdrawal,Branch Withdrawal,-4239.746034
30648,779149683,3-22-24 11:28,140.92,Withdrawal,Mobile App Withdrawal,-4380.666034
30649,779149683,3-29-24 14:28,393.44,Purchase,Clothing,-4774.106034
30650,779149683,04-03-24 21:28,3150,IncomingTransfer,Salary,-1624.106034
30651,779149683,04-08-24 14:28,51.03,Return,Best Buy Return,-1573.076034
30652,779149683,04-08-24 21:28,2700,Payment,Credit Card Payment,-4273.076034
30653,779149683,04-09-24 20:28,115.56,IncomingTransfer,Freelance Payment,-4157.516034
30654,779149683,04-12-24 14:28,346.14,Payment,Loan Payment,-4503.656034
30655,779149683,4-13-24 11:28,157.8,OutgoingTransfer,Wire Transfer,-4661.456034
30656,779149683,4-13-24 15:28,23.94,Withdrawal,Mobile App Withdrawal,-4685.396034
30657,779149683,4-16-24 17:28,99.97,IncomingTransfer,Freelance Payment,-4585.426034
30658,779149683,4-16-24 21:28,1500,Payment,Rent Payment,-6085.426034
30659,779149683,4-18-24 21:28,209.42,Payment,Mortgage Payment,-6294.846034
30660,779149683,4-21-24 11:28,339.18,Deposit,Mobile Deposit,-5955.666034
30661,779149683,4-21-24 16:28,307.03,Deposit,Cash Deposit,-5648.636034
30662,779149683,4-22-24 20:28,256.8,Withdrawal,Mobile App Withdrawal,-5905.436034
30663,779149683,4-23-24 20:28,286.93,OutgoingTransfer,Peer-to-Peer Transfer,-6192.366034
30664,779149683,4-24-24 14:28,300.62,Payment,Loan Payment,-6492.986034
30665,779149683,4-27-24 18:28,326.07,Withdrawal,Mobile App Withdrawal,-6819.056034
30666,779149683,4-28-24 15:28,433.28,Purchase,Furniture,-7252.336034
30667,779149683,4-28-24 18:28,214.51,Purchase,Grocery,-7466.846034
30668,779149683,05-04-24 21:28,3150,IncomingTransfer,Salary,-4316.846034
30669,779149683,05-05-24 11:28,360.99,Deposit,Cash Deposit,-3955.856034
30670,779149683,05-07-24 17:28,32.8,Purchase,Entertainment,-3988.656034
30671,779149683,05-09-24 21:28,2100,Payment,Credit Card Payment,-6088.656034
30672,779149683,05-11-24 11:28,13.95,Withdrawal,ATM Withdrawal,-6102.606034
30673,779149683,05-12-24 22:28,170.58,Withdrawal,ATM Withdrawal,-6273.186034
30674,779149683,5-17-24 14:28,260.43,Purchase,Grocery,-6533.616034
30675,779149683,5-17-24 21:28,1000,Payment,Rent Payment,-7533.616034
30676,779149683,5-17-24 22:28,112.55,Purchase,Clothing,-7646.166034
30677,779149683,5-18-24 18:28,406.55,Return,Store Return,-7239.616034
30678,779149683,5-22-24 14:28,49.51,Deposit,Direct Deposit,-7190.106034
30679,779149683,5-24-24 13:28,39.93,Purchase,Clothing,-7230.036034
30680,779149683,5-24-24 22:28,332.04,Purchase,Clothing,-7562.076034
30681,779149683,5-24-24 22:28,248.07,Purchase,Home Improvement,-7810.146034
30682,779149683,5-29-24 18:28,364.87,Purchase,Grocery,-8175.016034
30683,779149683,06-01-24 21:28,3150,IncomingTransfer,Salary,-5025.016034
30684,779149683,06-05-24 19:28,483.54,Withdrawal,Mobile App Withdrawal,-5508.556034
30685,779149683,06-06-24 21:28,2500,Payment,Credit Card Payment,-8008.556034
30686,779149683,06-06-24 22:28,113.34,Payment,Mortgage Payment,-8121.896034
30687,779149683,06-07-24 21:28,352.26,Deposit,Direct Deposit,-7769.636034
30688,779149683,06-08-24 14:28,239.52,Payment,Loan Payment,-8009.156034
30689,779149683,06-09-24 12:28,405.47,OnlineShopping,eBay,-8414.626034
30690,779149683,06-12-24 9:28,272.51,Withdrawal,Mobile App Withdrawal,-8687.136034
30691,779149683,06-12-24 21:28,1800,Payment,Rent Payment,-10487.13603
30692,779149683,6-13-24 9:28,126.24,Purchase,Grocery,-10613.37603
30693,779149683,6-14-24 14:28,389.92,Purchase,Restaurant,-11003.29603
30694,779149683,6-17-24 12:28,308.27,Withdrawal,Mobile App Withdrawal,-11311.56603
30695,779149683,6-17-24 17:28,56.45,Return,Best Buy Return,-11255.11603
30696,779149683,6-17-24 17:28,494.57,Payment,Mortgage Payment,-11749.68603
30697,779149683,6-20-24 14:28,247.09,Withdrawal,Branch Withdrawal,-11996.77603
30698,779149683,6-21-24 16:28,135.45,OutgoingTransfer,Bank Transfer,-12132.22603
30699,779149683,6-22-24 10:28,26.87,Withdrawal,Mobile App Withdrawal,-12159.09603
30700,779149683,6-23-24 13:28,490.28,OnlineShopping,Walmart,-12649.37603
30701,779149683,6-28-24 23:28,354.88,Withdrawal,Branch Withdrawal,-13004.25603
30702,779149683,07-03-24 21:28,3150,IncomingTransfer,Salary,-9854.256034
30703,779149683,07-04-24 10:28,295.08,OnlineShopping,Walmart,-10149.33603
30704,779149683,07-05-24 18:28,248.58,Deposit,Cash Deposit,-9900.756034
30705,779149683,07-05-24 22:28,42.32,Payment,Mortgage Payment,-9943.076034
30706,779149683,07-08-24 21:28,1900,Payment,Credit Card Payment,-11843.07603
30707,779149683,07-10-24 21:28,1800,Payment,Rent Payment,-13643.07603
30708,779149683,7-16-24 15:28,106.8,Withdrawal,Branch Withdrawal,-13749.87603
30709,779216358,02-01-24 15:28,749.36,Return,Best Buy Return,749.36
30710,779216358,02-02-24 19:28,326.15,Return,Best Buy Return,1075.51
30711,779216358,02-03-24 21:28,7100,IncomingTransfer,Salary,8175.51
30712,779216358,02-08-24 17:28,168.45,Withdrawal,ATM Withdrawal,8007.06
30713,779216358,2-14-24 21:28,2900,Payment,Installment Payment,5107.06
30714,779216358,2-23-24 17:28,566.72,Purchase,Electronics,4540.34
30715,779216358,2-28-24 15:28,644.11,OutgoingTransfer,Peer-to-Peer Transfer,3896.23
30716,779216358,03-03-24 21:28,7100,IncomingTransfer,Salary,10996.23
30717,779216358,03-04-24 17:28,377.49,OutgoingTransfer,Bank Transfer,10618.74
30718,779216358,3-14-24 21:28,2500,Payment,Subscription Payment,8118.74
30719,779216358,04-02-24 21:28,7100,IncomingTransfer,Salary,15218.74
30720,779216358,04-04-24 15:28,395.76,Deposit,Check Deposit,15614.5
30721,779216358,04-04-24 21:28,346.38,Purchase,Grocery,15268.12
30722,779216358,4-13-24 21:28,2900,Payment,Insurance Payment,12368.12
30723,779216358,4-14-24 12:28,714.35,Deposit,Direct Deposit,13082.47
30724,779216358,4-23-24 22:28,106.82,Deposit,Direct Deposit,13189.29
30725,779216358,05-03-24 21:28,7100,IncomingTransfer,Salary,20289.29
30726,779216358,05-12-24 17:28,640.69,Deposit,Cash Deposit,20929.98
30727,779216358,05-12-24 21:28,295.41,Return,AliExpress Return,21225.39
30728,779216358,05-12-24 21:28,469.79,Deposit,Direct Deposit,21695.18
30729,779216358,5-17-24 21:28,2400,Payment,Installment Payment,19295.18
30730,779216358,5-31-24 15:28,424.51,OutgoingTransfer,International Transfer,18870.67
30731,779216358,06-05-24 21:28,7100,IncomingTransfer,Salary,25970.67
30732,779216358,06-10-24 21:28,3000,Payment,Insurance Payment,22970.67
30733,779216358,6-14-24 13:28,517.27,Deposit,Check Deposit,23487.94
30734,779216358,6-28-24 10:28,181.7,Return,Amazon Return,23669.64
30735,779216358,07-04-24 21:28,7100,IncomingTransfer,Salary,30769.64
30736,779216358,07-10-24 21:28,2800,Payment,Installment Payment,27969.64
30737,779216358,7-17-24 21:28,573.64,Return,Best Buy Return,28543.28
30738,779249583,1-25-24 9:28,110.69,Purchase,Clothing,1718.253517
30739,779249583,02-05-24 21:28,2750,IncomingTransfer,Salary,4468.253517
30740,779249583,02-06-24 17:28,57.5,OutgoingTransfer,Wire Transfer,4410.753517
30741,779249583,02-09-24 9:28,197.33,Deposit,Check Deposit,4608.083517
30742,779249583,02-10-24 21:28,3500,Payment,Credit Card Payment,1108.083517
30743,779249583,02-10-24 22:28,44.8,Withdrawal,Mobile App Withdrawal,1063.283517
30744,779249583,2-16-24 21:28,1600,Payment,Rent Payment,-536.7164828
30745,779249583,2-18-24 14:28,179.34,Withdrawal,Mobile App Withdrawal,-716.0564828
30746,779249583,2-26-24 22:28,122.12,OutgoingTransfer,Peer-to-Peer Transfer,-838.1764828
30747,779249583,2-28-24 12:28,144.17,Deposit,Cash Deposit,-694.0064828
30748,779249583,2-29-24 20:28,94.34,Purchase,Pharmacy,-788.3464828
30749,779249583,03-04-24 10:28,73.68,IncomingTransfer,Freelance Payment,-714.6664828
30750,779249583,03-04-24 21:28,2750,IncomingTransfer,Salary,2035.333517
30751,779249583,03-09-24 21:28,2500,Payment,Credit Card Payment,-464.6664828
30752,779249583,3-15-24 21:28,1600,Payment,Rent Payment,-2064.666483
30753,779249583,3-20-24 17:28,224.18,Purchase,Furniture,-2288.846483
30754,779249583,04-02-24 21:28,2750,IncomingTransfer,Salary,461.1535172
30755,779249583,04-06-24 17:28,41.68,OutgoingTransfer,Peer-to-Peer Transfer,419.4735172
30756,779249583,04-07-24 21:28,3300,Payment,Credit Card Payment,-2880.526483
30757,779249583,04-11-24 21:28,1200,Payment,Rent Payment,-4080.526483
30758,779249583,4-14-24 10:28,62.83,IncomingTransfer,Freelance Payment,-4017.696483
30759,779249583,4-14-24 15:28,151.29,IncomingTransfer,Freelance Payment,-3866.406483
30760,779249583,4-23-24 22:28,99.48,Purchase,Entertainment,-3965.886483
30761,779249583,05-01-24 14:28,112.61,OutgoingTransfer,Bank Transfer,-4078.496483
30762,779249583,05-03-24 21:28,2750,IncomingTransfer,Salary,-1328.496483
30763,779249583,05-08-24 21:28,2600,Payment,Credit Card Payment,-3928.496483
30764,779249583,05-10-24 21:28,1100,Payment,Rent Payment,-5028.496483
30765,779249583,5-19-24 18:28,170.39,Withdrawal,Mobile App Withdrawal,-5198.886483
30766,779249583,06-02-24 19:28,127.82,OutgoingTransfer,International Transfer,-5326.706483
30767,779249583,06-05-24 21:28,2750,IncomingTransfer,Salary,-2576.706483
30768,779249583,06-10-24 21:28,3500,Payment,Credit Card Payment,-6076.706483
30769,779249583,06-12-24 21:28,900,Payment,Rent Payment,-6976.706483
30770,779249583,6-16-24 11:28,204.4,Deposit,Cash Deposit,-6772.306483
30771,779249583,6-19-24 15:28,13.72,OutgoingTransfer,Peer-to-Peer Transfer,-6786.026483
30772,779249583,6-23-24 13:28,145.73,Purchase,Grocery,-6931.756483
30773,779249583,6-28-24 19:28,232.83,IncomingTransfer,Freelance Payment,-6698.926483
30774,779249583,6-30-24 22:28,180.04,Deposit,Cash Deposit,-6518.886483
30775,779249583,07-02-24 9:28,210.49,Purchase,Grocery,-6729.376483
30776,779249583,07-02-24 21:28,2750,IncomingTransfer,Salary,-3979.376483
30777,779249583,07-03-24 9:28,16.51,OutgoingTransfer,International Transfer,-3995.886483
30778,779249583,07-07-24 21:28,2900,Payment,Credit Card Payment,-6895.886483
30779,779249583,07-10-24 11:28,125.98,OutgoingTransfer,Wire Transfer,-7021.866483
30780,779249583,07-11-24 21:28,81.39,OnlineShopping,AliExpress,-7103.256483
30781,779249583,07-11-24 22:28,137.87,Withdrawal,Mobile App Withdrawal,-7241.126483
30782,779249583,7-15-24 9:28,95.19,OnlineShopping,AliExpress,-7336.316483
30783,779249583,7-16-24 18:28,63.9,Withdrawal,Mobile App Withdrawal,-7400.216483
30784,779249583,7-18-24 21:28,1300,Payment,Rent Payment,-8700.216483
30785,779404383,1-25-24 10:28,197.32,Withdrawal,Branch Withdrawal,781.2744174
30786,779404383,1-25-24 12:28,477.14,IncomingTransfer,Freelance Payment,1258.414417
30787,779404383,1-26-24 23:28,147.16,Deposit,Direct Deposit,1405.574417
30788,779404383,02-02-24 21:28,4700,IncomingTransfer,Salary,6105.574417
30789,779404383,02-05-24 18:28,135.01,Purchase,Clothing,5970.564417
30790,779404383,02-07-24 21:28,1700,Payment,Credit Card Payment,4270.564417
30791,779404383,02-08-24 15:28,396.06,Withdrawal,ATM Withdrawal,3874.504417
30792,779404383,02-10-24 13:28,396.68,Purchase,Pharmacy,3477.824417
30793,779404383,2-16-24 21:28,1500,Payment,Rent Payment,1977.824417
30794,779404383,2-19-24 22:28,26.8,Deposit,Cash Deposit,2004.624417
30795,779404383,2-20-24 19:28,129.46,Return,Etsy Return,2134.084417
30796,779404383,2-21-24 23:28,304.54,Deposit,Cash Deposit,2438.624417
30797,779404383,2-22-24 15:28,73.17,OnlineShopping,Walmart,2365.454417
30798,779404383,2-23-24 11:28,376.48,Deposit,Cash Deposit,2741.934417
30799,779404383,2-23-24 14:28,260.08,Withdrawal,Branch Withdrawal,2481.854417
30800,779404383,2-24-24 18:28,368.91,Withdrawal,Branch Withdrawal,2112.944417
30801,779404383,03-03-24 21:28,73.6,Payment,Bill Payment,2039.344417
30802,779404383,03-04-24 21:28,4700,IncomingTransfer,Salary,6739.344417
30803,779404383,03-06-24 10:28,94.65,Deposit,Mobile Deposit,6833.994417
30804,779404383,03-06-24 10:28,428.05,IncomingTransfer,Freelance Payment,7262.044417
30805,779404383,03-06-24 18:28,232.34,Withdrawal,ATM Withdrawal,7029.704417
30806,779404383,03-09-24 21:28,1300,Payment,Credit Card Payment,5729.704417
30807,779404383,03-10-24 13:28,57.14,IncomingTransfer,Freelance Payment,5786.844417
30808,779404383,03-12-24 13:28,201.72,Withdrawal,Mobile App Withdrawal,5585.124417
30809,779404383,3-13-24 13:28,337.69,Withdrawal,Branch Withdrawal,5247.434417
30810,779404383,3-15-24 14:28,394.46,OutgoingTransfer,International Transfer,4852.974417
30811,779404383,3-15-24 21:28,2200,Payment,Rent Payment,2652.974417
30812,779404383,3-15-24 23:28,308.03,OutgoingTransfer,International Transfer,2344.944417
30813,779404383,3-19-24 9:28,169.06,Deposit,Check Deposit,2514.004417
30814,779404383,3-19-24 15:28,308.66,Purchase,Home Improvement,2205.344417
30815,779404383,3-23-24 16:28,28.43,IncomingTransfer,Freelance Payment,2233.774417
30816,779404383,3-26-24 10:28,185.81,Return,Walmart Return,2419.584417
30817,779404383,3-26-24 17:28,36.16,Return,AliExpress Return,2455.744417
30818,779404383,3-29-24 12:28,347.01,Purchase,Restaurant,2108.734417
30819,779404383,3-30-24 13:28,439.89,OnlineShopping,Best Buy,1668.844417
30820,779404383,04-03-24 21:28,4700,IncomingTransfer,Salary,6368.844417
30821,779404383,04-08-24 21:28,1600,Payment,Credit Card Payment,4768.844417
30822,779404383,04-09-24 14:28,15.97,Return,Best Buy Return,4784.814417
30823,779404383,04-10-24 14:28,374.17,Deposit,Cash Deposit,5158.984417
30824,779404383,04-10-24 23:28,158.62,Deposit,Direct Deposit,5317.604417
30825,779404383,4-14-24 18:28,84.53,IncomingTransfer,Freelance Payment,5402.134417
30826,779404383,4-14-24 21:28,1400,Payment,Rent Payment,4002.134417
30827,779404383,4-16-24 19:28,150.71,Return,Amazon Return,4152.844417
30828,779404383,4-22-24 13:28,326.47,Purchase,Clothing,3826.374417
30829,779404383,4-22-24 22:28,369.4,IncomingTransfer,Freelance Payment,4195.774417
30830,779404383,4-26-24 23:28,127.41,Withdrawal,Branch Withdrawal,4068.364417
30831,779404383,4-29-24 10:28,278.95,Deposit,Cash Deposit,4347.314417
30832,779404383,4-30-24 9:28,162.49,Withdrawal,Branch Withdrawal,4184.824417
30833,779404383,4-30-24 17:28,224.61,Return,Target Return,4409.434417
30834,779404383,4-30-24 20:28,401.35,Withdrawal,ATM Withdrawal,4008.084417
30835,779404383,05-02-24 19:28,13.47,Purchase,Pharmacy,3994.614417
30836,779404383,05-03-24 18:28,81.43,Withdrawal,ATM Withdrawal,3913.184417
30837,779404383,05-05-24 21:28,4700,IncomingTransfer,Salary,8613.184417
30838,779404383,05-10-24 15:28,349.61,Purchase,Pharmacy,8263.574417
30839,779404383,05-10-24 21:28,1700,Payment,Credit Card Payment,6563.574417
30840,779404383,05-11-24 21:28,2200,Payment,Rent Payment,4363.574417
30841,779404383,5-13-24 9:28,346.53,OutgoingTransfer,Peer-to-Peer Transfer,4017.044417
30842,779404383,5-13-24 11:28,410.28,Purchase,Pharmacy,3606.764417
30843,779404383,5-14-24 11:28,272.63,Purchase,Electronics,3334.134417
30844,779404383,5-15-24 15:28,494.65,Withdrawal,ATM Withdrawal,2839.484417
30845,779404383,5-16-24 22:28,318.47,Withdrawal,Branch Withdrawal,2521.014417
30846,779404383,5-22-24 17:28,376.57,Purchase,Pharmacy,2144.444417
30847,779404383,5-28-24 10:28,54.99,Withdrawal,Mobile App Withdrawal,2089.454417
30848,779404383,5-29-24 20:28,207.73,Withdrawal,Mobile App Withdrawal,1881.724417
30849,779404383,06-01-24 21:28,4700,IncomingTransfer,Salary,6581.724417
30850,779404383,06-05-24 22:28,209.58,Deposit,Mobile Deposit,6791.304417
30851,779404383,06-06-24 21:28,1800,Payment,Credit Card Payment,4991.304417
30852,779404383,06-07-24 14:28,132.15,Purchase,Gas,4859.154417
30853,779404383,06-08-24 18:28,142.79,Deposit,Check Deposit,5001.944417
30854,779404383,06-09-24 16:28,282.49,Purchase,Home Improvement,4719.454417
30855,779404383,06-10-24 15:28,250.13,Deposit,Mobile Deposit,4969.584417
30856,779404383,6-13-24 23:28,175.63,Return,eBay Return,5145.214417
30857,779404383,6-14-24 13:28,96.6,Withdrawal,Mobile App Withdrawal,5048.614417
30858,779404383,6-15-24 13:28,244.29,OnlineShopping,Target,4804.324417
30859,779404383,6-16-24 21:28,1500,Payment,Rent Payment,3304.324417
30860,779404383,6-17-24 21:28,442.45,Payment,Mortgage Payment,2861.874417
30861,779404383,6-19-24 20:28,224.98,OutgoingTransfer,Wire Transfer,2636.894417
30862,779404383,6-21-24 20:28,412.42,Purchase,Clothing,2224.474417
30863,779404383,6-23-24 21:28,481.45,Withdrawal,Mobile App Withdrawal,1743.024417
30864,779404383,6-23-24 21:28,377.01,Payment,Loan Payment,1366.014417
30865,779404383,6-30-24 10:28,159.23,Deposit,Cash Deposit,1525.244417
30866,779404383,07-01-24 21:28,4700,IncomingTransfer,Salary,6225.244417
30867,779404383,07-02-24 14:28,282.34,Withdrawal,Mobile App Withdrawal,5942.904417
30868,779404383,07-02-24 22:28,365,Payment,Mortgage Payment,5577.904417
30869,779404383,07-03-24 18:28,93.52,Purchase,Restaurant,5484.384417
30870,779404383,07-03-24 22:28,428.78,Purchase,Home Improvement,5055.604417
30871,779404383,07-04-24 16:28,358.85,Purchase,Entertainment,4696.754417
30872,779404383,07-06-24 21:28,1800,Payment,Credit Card Payment,2896.754417
30873,779404383,07-10-24 15:28,306.19,IncomingTransfer,Freelance Payment,3202.944417
30874,779404383,07-11-24 22:28,32.69,Deposit,Cash Deposit,3235.634417
30875,779404383,7-14-24 11:28,138.49,OutgoingTransfer,Wire Transfer,3097.144417
30876,779404383,7-15-24 20:28,16.44,Withdrawal,Mobile App Withdrawal,3080.704417
30877,779404383,7-17-24 19:28,65.05,Deposit,Check Deposit,3145.754417
30878,779404383,7-18-24 21:28,2400,Payment,Rent Payment,745.7544174
30879,779530908,1-20-24 12:28,172.9,Withdrawal,Mobile App Withdrawal,-172.9
30880,779530908,1-21-24 10:28,205.75,OnlineShopping,Walmart,-378.65
30881,779530908,1-28-24 11:28,117.61,OutgoingTransfer,Wire Transfer,-496.26
30882,779530908,1-31-24 14:28,238.22,Purchase,Electronics,-734.48
30883,779530908,02-04-24 21:28,2600,IncomingTransfer,Salary,1865.52
30884,779530908,02-05-24 16:28,169.73,Deposit,Cash Deposit,2035.25
30885,779530908,02-12-24 21:28,1400,Payment,Rent Payment,635.25
30886,779530908,2-13-24 18:28,48.8,Payment,Loan Payment,586.45
30887,779530908,2-13-24 18:28,64.6,Deposit,Direct Deposit,651.05
30888,779530908,2-25-24 12:28,63.15,Deposit,Cash Deposit,714.2
30889,779530908,03-01-24 18:28,128.77,Payment,Mortgage Payment,585.43
30890,779530908,03-03-24 15:28,187.73,Purchase,Pharmacy,397.7
30891,779530908,03-04-24 14:28,153.03,Return,AliExpress Return,550.73
30892,779530908,03-04-24 21:28,2600,IncomingTransfer,Salary,3150.73
30893,779530908,03-06-24 10:28,52.36,IncomingTransfer,Freelance Payment,3203.09
30894,779530908,03-10-24 18:28,51.29,Payment,Loan Payment,3151.8
30895,779530908,03-12-24 21:28,1500,Payment,Rent Payment,1651.8
30896,779530908,03-12-24 21:28,214.55,OutgoingTransfer,Bank Transfer,1437.25
30897,779530908,3-13-24 9:28,71.19,Deposit,Cash Deposit,1508.44
30898,779530908,3-13-24 12:28,50.48,Withdrawal,Branch Withdrawal,1457.96
30899,779530908,3-14-24 21:28,211.09,Purchase,Furniture,1246.87
30900,779530908,3-15-24 13:28,249.67,IncomingTransfer,Freelance Payment,1496.54
30901,779530908,3-16-24 10:28,57.24,Deposit,Cash Deposit,1553.78
30902,779530908,3-19-24 18:28,214.45,Withdrawal,Mobile App Withdrawal,1339.33
30903,779530908,3-19-24 20:28,240.1,OutgoingTransfer,Bank Transfer,1099.23
30904,779530908,3-19-24 21:28,164.34,Return,eBay Return,1263.57
30905,779530908,3-20-24 11:28,128.16,Purchase,Electronics,1135.41
30906,779530908,3-26-24 22:28,103.34,Purchase,Clothing,1032.07
30907,779530908,04-02-24 19:28,12.42,OutgoingTransfer,Wire Transfer,1019.65
30908,779530908,04-02-24 21:28,2600,IncomingTransfer,Salary,3619.65
30909,779530908,04-08-24 22:28,123.84,Deposit,Direct Deposit,3743.49
30910,779530908,04-11-24 21:28,1400,Payment,Rent Payment,2343.49
30911,779530908,4-16-24 9:28,163.95,Purchase,Restaurant,2179.54
30912,779530908,4-25-24 17:28,185.11,Return,eBay Return,2364.65
30913,779530908,4-26-24 11:28,171.3,OnlineShopping,Best Buy,2193.35
30914,779530908,05-03-24 21:28,2600,IncomingTransfer,Salary,4793.35
30915,779530908,05-06-24 17:28,114.88,Deposit,Mobile Deposit,4908.23
30916,779530908,05-06-24 21:28,239.73,Withdrawal,ATM Withdrawal,4668.5
30917,779530908,05-07-24 18:28,244.47,Purchase,Electronics,4424.03
30918,779530908,05-08-24 14:28,155.88,OnlineShopping,Etsy,4268.15
30919,779530908,05-10-24 21:28,1700,Payment,Rent Payment,2568.15
30920,779530908,5-13-24 20:28,40.07,Purchase,Entertainment,2528.08
30921,779530908,5-17-24 12:28,110.79,Withdrawal,Mobile App Withdrawal,2417.29
30922,779530908,5-26-24 15:28,128.12,OutgoingTransfer,Wire Transfer,2289.17
30923,779530908,5-28-24 22:28,89.71,Deposit,Check Deposit,2378.88
30924,779530908,5-31-24 13:28,81.02,Deposit,Direct Deposit,2459.9
30925,779530908,06-01-24 15:28,199.13,Withdrawal,Branch Withdrawal,2260.77
30926,779530908,06-05-24 21:28,2600,IncomingTransfer,Salary,4860.77
30927,779530908,06-07-24 15:28,132.29,Deposit,Direct Deposit,4993.06
30928,779530908,06-10-24 17:28,84.98,Return,AliExpress Return,5078.04
30929,779530908,6-15-24 11:28,225.46,Return,Best Buy Return,5303.5
30930,779530908,6-17-24 14:28,34,OnlineShopping,eBay,5269.5
30931,779530908,6-17-24 22:28,68.88,Purchase,Electronics,5200.62
30932,779530908,6-18-24 21:28,1200,Payment,Rent Payment,4000.62
30933,779530908,6-20-24 12:28,24.89,OnlineShopping,Etsy,3975.73
30934,779530908,6-25-24 22:28,30.97,Withdrawal,Mobile App Withdrawal,3944.76
30935,779530908,6-27-24 16:28,127.96,Return,Walmart Return,4072.72
30936,779530908,6-28-24 20:28,122.89,Return,Store Return,4195.61
30937,779530908,07-01-24 19:28,232.79,OnlineShopping,Etsy,3962.82
30938,779530908,07-01-24 21:28,2600,IncomingTransfer,Salary,6562.82
30939,779530908,07-02-24 11:28,201.1,OutgoingTransfer,International Transfer,6361.72
30940,779530908,07-03-24 21:28,32.15,Purchase,Clothing,6329.57
30941,779530908,07-05-24 23:28,86.04,Withdrawal,Branch Withdrawal,6243.53
30942,779530908,07-09-24 21:28,186.52,OutgoingTransfer,Bank Transfer,6057.01
30943,779530908,07-11-24 12:28,38.11,Purchase,Electronics,6018.9
30944,779530908,07-12-24 22:28,133.34,Purchase,Pharmacy,5885.56
30945,779530908,7-13-24 13:28,30.3,OutgoingTransfer,Bank Transfer,5855.26
30946,779530908,7-15-24 17:28,182.24,Withdrawal,ATM Withdrawal,5673.02
30947,779530908,7-17-24 14:28,43.82,Payment,Bill Payment,5629.2
30948,779530908,7-17-24 21:28,1000,Payment,Rent Payment,4629.2
30949,779638983,1-20-24 12:28,38.59,Deposit,Check Deposit,1149.148262
30950,779638983,1-24-24 17:28,186.54,Deposit,Direct Deposit,1335.688262
30951,779638983,1-28-24 22:28,150.44,Deposit,Mobile Deposit,1486.128262
30952,779638983,02-03-24 18:28,27.29,Purchase,Gas,1458.838262
30953,779638983,02-03-24 22:28,125.69,Deposit,Check Deposit,1584.528262
30954,779638983,02-04-24 10:28,191.52,Payment,Loan Payment,1393.008262
30955,779638983,02-04-24 14:28,106.55,OutgoingTransfer,Wire Transfer,1286.458262
30956,779638983,02-04-24 21:28,2450,IncomingTransfer,Salary,3736.458262
30957,779638983,02-06-24 15:28,108.28,Deposit,Direct Deposit,3844.738262
30958,779638983,02-06-24 17:28,15.18,OnlineShopping,Walmart,3829.558262
30959,779638983,02-08-24 11:28,149.08,Withdrawal,Mobile App Withdrawal,3680.478262
30960,779638983,02-08-24 16:28,177.04,Deposit,Cash Deposit,3857.518262
30961,779638983,02-09-24 21:28,1900,Payment,Credit Card Payment,1957.518262
30962,779638983,02-10-24 10:28,181.29,IncomingTransfer,Freelance Payment,2138.808262
30963,779638983,2-15-24 21:28,1300,Payment,Rent Payment,838.8082618
30964,779638983,2-16-24 22:28,227.8,Payment,Loan Payment,611.0082618
30965,779638983,2-17-24 11:28,232.84,Deposit,Direct Deposit,843.8482618
30966,779638983,2-18-24 10:28,120.64,Purchase,Grocery,723.2082618
30967,779638983,2-20-24 11:28,118.21,Return,Etsy Return,841.4182618
30968,779638983,2-20-24 21:28,157.52,Payment,Mortgage Payment,683.8982618
30969,779638983,2-22-24 15:28,16.53,IncomingTransfer,Freelance Payment,700.4282618
30970,779638983,2-23-24 19:28,203.33,Withdrawal,ATM Withdrawal,497.0982618
30971,779638983,2-25-24 10:28,179.28,Deposit,Check Deposit,676.3782618
30972,779638983,2-26-24 11:28,22.3,Withdrawal,Branch Withdrawal,654.0782618
30973,779638983,2-27-24 22:28,56.92,Purchase,Pharmacy,597.1582618
30974,779638983,2-28-24 20:28,173.07,Withdrawal,Branch Withdrawal,424.0882618
30975,779638983,2-29-24 23:28,205.92,IncomingTransfer,Freelance Payment,630.0082618
30976,779638983,03-04-24 21:28,2450,IncomingTransfer,Salary,3080.008262
30977,779638983,03-06-24 14:28,219.87,OnlineShopping,eBay,2860.138262
30978,779638983,03-06-24 16:28,243.78,Purchase,Entertainment,2616.358262
30979,779638983,03-07-24 13:28,65.13,IncomingTransfer,Freelance Payment,2681.488262
30980,779638983,03-07-24 22:28,155.37,Deposit,Direct Deposit,2836.858262
30981,779638983,03-08-24 16:28,197.24,OutgoingTransfer,Bank Transfer,2639.618262
30982,779638983,03-09-24 21:28,2200,Payment,Credit Card Payment,439.6182618
30983,779638983,03-12-24 13:28,101.19,OutgoingTransfer,Wire Transfer,338.4282618
30984,779638983,03-12-24 14:28,196.77,Withdrawal,Branch Withdrawal,141.6582618
30985,779638983,3-13-24 13:28,173.15,Withdrawal,Mobile App Withdrawal,-31.49173824
30986,779638983,3-14-24 19:28,174.03,Deposit,Mobile Deposit,142.5382618
30987,779638983,3-16-24 10:28,118.04,OutgoingTransfer,Peer-to-Peer Transfer,24.49826176
30988,779638983,3-17-24 11:28,88.09,Withdrawal,Branch Withdrawal,-63.59173824
30989,779638983,3-18-24 21:28,800,Payment,Rent Payment,-863.5917382
30990,779638983,3-21-24 21:28,242.46,Withdrawal,ATM Withdrawal,-1106.051738
30991,779638983,3-23-24 16:28,52.6,Purchase,Grocery,-1158.651738
30992,779638983,3-25-24 11:28,56.18,Return,Target Return,-1102.471738
30993,779638983,3-25-24 12:28,133.71,Payment,Bill Payment,-1236.181738
30994,779638983,3-30-24 13:28,177.63,Deposit,Check Deposit,-1058.551738
30995,779638983,04-01-24 21:28,2450,IncomingTransfer,Salary,1391.448262
30996,779638983,04-06-24 21:28,1900,Payment,Credit Card Payment,-508.5517382
30997,779638983,04-09-24 11:28,122.08,Deposit,Mobile Deposit,-386.4717382
30998,779638983,4-13-24 21:28,194.51,Return,Amazon Return,-191.9617382
30999,779638983,4-15-24 13:28,243.63,Purchase,Electronics,-435.5917382
31000,779638983,4-16-24 21:28,700,Payment,Rent Payment,-1135.591738
31001,779638983,4-17-24 17:28,96.25,OutgoingTransfer,International Transfer,-1231.841738
31002,779638983,4-18-24 17:28,137.7,Return,Amazon Return,-1094.141738
31003,779638983,4-25-24 17:28,105.94,Deposit,Mobile Deposit,-988.2017382
31004,779638983,4-26-24 15:28,115.44,Deposit,Check Deposit,-872.7617382
31005,779638983,05-01-24 11:28,131.18,Purchase,Pharmacy,-1003.941738
31006,779638983,05-02-24 15:28,223.54,OutgoingTransfer,International Transfer,-1227.481738
31007,779638983,05-03-24 21:28,2450,IncomingTransfer,Salary,1222.518262
31008,779638983,05-06-24 17:28,10.36,Purchase,Pharmacy,1212.158262
31009,779638983,05-08-24 21:28,1900,Payment,Credit Card Payment,-687.8417382
31010,779638983,05-10-24 16:28,163.13,Withdrawal,Branch Withdrawal,-850.9717382
31011,779638983,05-11-24 13:28,241.51,Payment,Mortgage Payment,-1092.481738
31012,779638983,05-11-24 20:28,56.64,OnlineShopping,Etsy,-1149.121738
31013,779638983,5-16-24 10:28,178.91,Withdrawal,Mobile App Withdrawal,-1328.031738
31014,779638983,5-16-24 21:28,800,Payment,Rent Payment,-2128.031738
31015,779638983,5-19-24 17:28,11.98,Purchase,Electronics,-2140.011738
31016,779638983,5-19-24 18:28,121.67,Purchase,Electronics,-2261.681738
31017,779638983,5-21-24 17:28,64.65,IncomingTransfer,Freelance Payment,-2197.031738
31018,779638983,5-22-24 16:28,38.71,Purchase,Gas,-2235.741738
31019,779638983,5-27-24 10:28,78.77,Deposit,Direct Deposit,-2156.971738
31020,779638983,5-28-24 17:28,164.49,OnlineShopping,Walmart,-2321.461738
31021,779638983,5-29-24 19:28,39.86,OnlineShopping,Etsy,-2361.321738
31022,779638983,06-03-24 21:28,2450,IncomingTransfer,Salary,88.67826176
31023,779638983,06-08-24 21:28,1700,Payment,Credit Card Payment,-1611.321738
31024,779638983,06-08-24 21:28,196.35,Withdrawal,ATM Withdrawal,-1807.671738
31025,779638983,06-09-24 15:28,24.98,Withdrawal,ATM Withdrawal,-1832.651738
31026,779638983,06-11-24 15:28,233.13,Withdrawal,Mobile App Withdrawal,-2065.781738
31027,779638983,06-12-24 16:28,214.63,Deposit,Mobile Deposit,-1851.151738
31028,779638983,6-16-24 21:28,1000,Payment,Rent Payment,-2851.151738
31029,779638983,6-18-24 17:28,119.33,Payment,Loan Payment,-2970.481738
31030,779638983,6-18-24 23:28,202.9,Payment,Loan Payment,-3173.381738
31031,779638983,6-21-24 16:28,103.95,Payment,Bill Payment,-3277.331738
31032,779638983,6-22-24 22:28,110.4,Purchase,Gas,-3387.731738
31033,779638983,6-23-24 19:28,33.56,Withdrawal,ATM Withdrawal,-3421.291738
31034,779638983,6-24-24 11:28,232.97,Purchase,Entertainment,-3654.261738
31035,779638983,6-27-24 19:28,235.1,Deposit,Mobile Deposit,-3419.161738
31036,779638983,6-28-24 22:28,202.83,Withdrawal,Branch Withdrawal,-3621.991738
31037,779638983,6-29-24 22:28,72.71,Purchase,Home Improvement,-3694.701738
31038,779638983,07-01-24 12:28,105.65,Purchase,Grocery,-3800.351738
31039,779638983,07-05-24 21:28,2450,IncomingTransfer,Salary,-1350.351738
31040,779638983,07-07-24 10:28,97.69,OutgoingTransfer,International Transfer,-1448.041738
31041,779638983,07-07-24 14:28,99.73,Deposit,Cash Deposit,-1348.311738
31042,779638983,07-09-24 16:28,188.53,IncomingTransfer,Freelance Payment,-1159.781738
31043,779638983,07-09-24 17:28,66.34,Deposit,Mobile Deposit,-1093.441738
31044,779638983,07-10-24 21:28,2100,Payment,Credit Card Payment,-3193.441738
31045,779638983,07-11-24 14:28,179.51,Payment,Loan Payment,-3372.951738
31046,779638983,7-13-24 17:28,35.48,Deposit,Cash Deposit,-3337.471738
31047,779638983,7-15-24 21:28,1400,Payment,Rent Payment,-4737.471738
31048,779638983,7-16-24 13:28,181.24,Payment,Mortgage Payment,-4918.711738
31049,779638983,7-17-24 15:28,143.74,Withdrawal,Mobile App Withdrawal,-5062.451738
31050,779656908,1-25-24 21:28,388.55,Purchase,Travel,689.4382956
31051,779656908,1-26-24 16:28,76.12,Purchase,Travel,613.3182956
31052,779656908,1-27-24 11:28,353.12,Deposit,Cash Deposit,966.4382956
31053,779656908,02-01-24 17:28,37.56,Deposit,Mobile Deposit,1003.998296
31054,779656908,02-04-24 21:28,4200,IncomingTransfer,Salary,5203.998296
31055,779656908,02-07-24 9:28,203.19,Deposit,Cash Deposit,5407.188296
31056,779656908,02-09-24 21:28,1900,Payment,Credit Card Payment,3507.188296
31057,779656908,02-12-24 21:28,1500,Payment,Rent Payment,2007.188296
31058,779656908,2-27-24 10:28,355.57,Purchase,Gas,1651.618296
31059,779656908,03-01-24 21:28,4200,IncomingTransfer,Salary,5851.618296
31060,779656908,03-02-24 14:28,183.39,Payment,Loan Payment,5668.228296
31061,779656908,03-03-24 22:28,204.96,Payment,Loan Payment,5463.268296
31062,779656908,03-04-24 14:28,370.42,OnlineShopping,Best Buy,5092.848296
31063,779656908,03-06-24 21:28,1400,Payment,Credit Card Payment,3692.848296
31064,779656908,03-07-24 17:28,301.72,Payment,Bill Payment,3391.128296
31065,779656908,03-09-24 19:28,265.09,Withdrawal,Branch Withdrawal,3126.038296
31066,779656908,03-12-24 14:28,80.67,Payment,Mortgage Payment,3045.368296
31067,779656908,3-15-24 23:28,335.12,Deposit,Check Deposit,3380.488296
31068,779656908,3-16-24 21:28,1200,Payment,Rent Payment,2180.488296
31069,779656908,04-04-24 21:28,4200,IncomingTransfer,Salary,6380.488296
31070,779656908,04-06-24 12:28,211.94,Deposit,Direct Deposit,6592.428296
31071,779656908,04-09-24 21:28,1500,Payment,Credit Card Payment,5092.428296
31072,779656908,04-11-24 15:28,103.03,OnlineShopping,eBay,4989.398296
31073,779656908,4-13-24 15:28,98.82,Purchase,Entertainment,4890.578296
31074,779656908,4-17-24 21:28,2500,Payment,Rent Payment,2390.578296
31075,779656908,4-24-24 9:28,204.9,Deposit,Check Deposit,2595.478296
31076,779656908,05-01-24 21:28,254.56,Withdrawal,Branch Withdrawal,2340.918296
31077,779656908,05-01-24 23:28,238.17,Return,AliExpress Return,2579.088296
31078,779656908,05-02-24 21:28,282.74,Purchase,Furniture,2296.348296
31079,779656908,05-03-24 21:28,4200,IncomingTransfer,Salary,6496.348296
31080,779656908,05-04-24 14:28,342.22,Withdrawal,Branch Withdrawal,6154.128296
31081,779656908,05-08-24 21:28,1800,Payment,Credit Card Payment,4354.128296
31082,779656908,5-15-24 11:28,210.03,Payment,Loan Payment,4144.098296
31083,779656908,5-17-24 21:28,1800,Payment,Rent Payment,2344.098296
31084,779656908,06-02-24 21:28,4200,IncomingTransfer,Salary,6544.098296
31085,779656908,06-07-24 21:28,2000,Payment,Credit Card Payment,4544.098296
31086,779656908,06-11-24 21:28,2700,Payment,Rent Payment,1844.098296
31087,779656908,6-20-24 12:28,29.52,Withdrawal,Mobile App Withdrawal,1814.578296
31088,779656908,6-20-24 15:28,20.69,Return,Store Return,1835.268296
31089,779656908,6-20-24 17:28,86.76,Withdrawal,Mobile App Withdrawal,1748.508296
31090,779656908,6-24-24 10:28,324.39,Withdrawal,ATM Withdrawal,1424.118296
31091,779656908,6-28-24 14:28,141.93,OutgoingTransfer,Peer-to-Peer Transfer,1282.188296
31092,779656908,6-28-24 23:28,215.12,OnlineShopping,Best Buy,1067.068296
31093,779656908,07-02-24 21:28,4200,IncomingTransfer,Salary,5267.068296
31094,779656908,07-06-24 16:28,325.05,IncomingTransfer,Freelance Payment,5592.118296
31095,779656908,07-07-24 21:28,1800,Payment,Credit Card Payment,3792.118296
31096,779656908,7-17-24 21:28,2600,Payment,Rent Payment,1192.118296
31097,779670783,1-24-24 10:28,339.17,Withdrawal,Branch Withdrawal,-339.17
31098,779670783,1-25-24 18:28,652.46,Purchase,Travel,-991.63
31099,779670783,1-26-24 14:28,646.84,OnlineShopping,eBay,-1638.47
31100,779670783,1-27-24 15:28,669.66,Withdrawal,ATM Withdrawal,-2308.13
31101,779670783,1-27-24 19:28,181.01,Deposit,Mobile Deposit,-2127.12
31102,779670783,1-27-24 22:28,281.64,IncomingTransfer,Freelance Payment,-1845.48
31103,779670783,1-28-24 11:28,490.01,Deposit,Direct Deposit,-1355.47
31104,779670783,1-28-24 15:28,478.65,Deposit,Direct Deposit,-876.82
31105,779670783,1-29-24 22:28,448.08,Withdrawal,ATM Withdrawal,-1324.9
31106,779670783,02-01-24 13:28,672.43,Withdrawal,Branch Withdrawal,-1997.33
31107,779670783,02-04-24 21:28,9150,IncomingTransfer,Salary,7152.67
31108,779670783,02-05-24 17:28,348.36,Withdrawal,Branch Withdrawal,6804.31
31109,779670783,02-09-24 9:28,346.91,OutgoingTransfer,Wire Transfer,6457.4
31110,779670783,02-12-24 12:28,675.77,Withdrawal,Mobile App Withdrawal,5781.63
31111,779670783,02-12-24 12:28,718.88,Payment,Mortgage Payment,5062.75
31112,779670783,02-12-24 15:28,694.12,Purchase,Travel,4368.63
31113,779670783,2-17-24 21:28,3300,Payment,Rent Payment,1068.63
31114,779670783,2-17-24 22:28,276.55,Deposit,Check Deposit,1345.18
31115,779670783,2-21-24 17:28,301.22,Purchase,Pharmacy,1043.96
31116,779670783,2-22-24 17:28,539.31,Withdrawal,Branch Withdrawal,504.65
31117,779670783,2-25-24 15:28,452.87,Return,Best Buy Return,957.52
31118,779670783,2-26-24 23:28,521.15,OnlineShopping,Best Buy,436.37
31119,779670783,03-02-24 21:28,9150,IncomingTransfer,Salary,9586.37
31120,779670783,03-10-24 21:28,5400,Payment,Rent Payment,4186.37
31121,779670783,03-12-24 14:28,209.63,OnlineShopping,AliExpress,3976.74
31122,779670783,3-13-24 12:28,646.42,Purchase,Travel,3330.32
31123,779670783,3-18-24 21:28,300.57,IncomingTransfer,Freelance Payment,3630.89
31124,779670783,3-19-24 19:28,221.5,OnlineShopping,Walmart,3409.39
31125,779670783,3-20-24 21:28,329.6,Purchase,Pharmacy,3079.79
31126,779670783,3-24-24 11:28,119.31,OutgoingTransfer,Peer-to-Peer Transfer,2960.48
31127,779670783,3-27-24 12:28,136.15,OnlineShopping,Best Buy,2824.33
31128,779670783,3-27-24 16:28,453.3,Deposit,Check Deposit,3277.63
31129,779670783,3-28-24 13:28,377.43,Withdrawal,Branch Withdrawal,2900.2
31130,779670783,3-28-24 14:28,373.72,Payment,Loan Payment,2526.48
31131,779670783,3-31-24 11:28,400.41,Deposit,Check Deposit,2926.89
31132,779670783,04-01-24 21:28,9150,IncomingTransfer,Salary,12076.89
31133,779670783,04-03-24 10:28,435.79,Withdrawal,ATM Withdrawal,11641.1
31134,779670783,04-05-24 21:28,581.42,Purchase,Gas,11059.68
31135,779670783,04-07-24 19:28,709.15,Purchase,Entertainment,10350.53
31136,779670783,04-08-24 23:28,288.09,Purchase,Grocery,10062.44
31137,779670783,4-15-24 21:28,2500,Payment,Rent Payment,7562.44
31138,779670783,4-16-24 22:28,385.01,Deposit,Direct Deposit,7947.45
31139,779670783,4-17-24 15:28,227.67,Return,Best Buy Return,8175.12
31140,779670783,4-20-24 13:28,397.56,Return,Store Return,8572.68
31141,779670783,4-24-24 12:28,279.69,Withdrawal,Mobile App Withdrawal,8292.99
31142,779670783,05-04-24 21:28,9150,IncomingTransfer,Salary,17442.99
31143,779670783,05-05-24 10:28,542.46,OutgoingTransfer,Wire Transfer,16900.53
31144,779670783,05-05-24 11:28,356.27,OutgoingTransfer,Wire Transfer,16544.26
31145,779670783,05-08-24 10:28,328.47,Purchase,Home Improvement,16215.79
31146,779670783,05-08-24 23:28,398.58,Payment,Loan Payment,15817.21
31147,779670783,5-15-24 21:28,2900,Payment,Rent Payment,12917.21
31148,779670783,5-21-24 16:28,723.22,Deposit,Mobile Deposit,13640.43
31149,779670783,5-26-24 13:28,319.38,Withdrawal,Branch Withdrawal,13321.05
31150,779670783,5-27-24 11:28,682.16,Withdrawal,Branch Withdrawal,12638.89
31151,779670783,5-28-24 10:28,492.01,Payment,Loan Payment,12146.88
31152,779670783,5-28-24 19:28,632.03,Purchase,Restaurant,11514.85
31153,779670783,5-31-24 16:28,238.81,Deposit,Mobile Deposit,11753.66
31154,779670783,06-02-24 21:28,9150,IncomingTransfer,Salary,20903.66
31155,779670783,06-03-24 20:28,432.45,Deposit,Cash Deposit,21336.11
31156,779670783,06-05-24 15:28,635.02,Withdrawal,Branch Withdrawal,20701.09
31157,779670783,06-05-24 22:28,361.4,Purchase,Electronics,20339.69
31158,779670783,06-08-24 13:28,369.49,Withdrawal,Branch Withdrawal,19970.2
31159,779670783,06-10-24 21:28,5200,Payment,Rent Payment,14770.2
31160,779670783,6-14-24 15:28,107.36,Payment,Loan Payment,14662.84
31161,779670783,6-16-24 16:28,507.31,Purchase,Home Improvement,14155.53
31162,779670783,6-19-24 14:28,682.2,OutgoingTransfer,Peer-to-Peer Transfer,13473.33
31163,779670783,6-24-24 9:28,329.23,Deposit,Mobile Deposit,13802.56
31164,779670783,6-24-24 23:28,208.03,OutgoingTransfer,Peer-to-Peer Transfer,13594.53
31165,779670783,6-25-24 15:28,705.08,IncomingTransfer,Freelance Payment,14299.61
31166,779670783,6-25-24 17:28,668.42,Deposit,Cash Deposit,14968.03
31167,779670783,6-27-24 17:28,526.88,OnlineShopping,Target,14441.15
31168,779670783,6-30-24 20:28,177.43,Withdrawal,Mobile App Withdrawal,14263.72
31169,779670783,6-30-24 20:28,351.63,Purchase,Gas,13912.09
31170,779670783,07-01-24 12:28,385.41,Payment,Mortgage Payment,13526.68
31171,779670783,07-03-24 21:28,9150,IncomingTransfer,Salary,22676.68
31172,779670783,07-04-24 19:28,468.66,Payment,Bill Payment,22208.02
31173,779670783,07-06-24 12:28,266.02,Deposit,Check Deposit,22474.04
31174,779670783,07-09-24 14:28,128.41,Withdrawal,Mobile App Withdrawal,22345.63
31175,779670783,07-12-24 21:28,3700,Payment,Rent Payment,18645.63
31176,779670783,7-13-24 11:28,104.8,OnlineShopping,eBay,18540.83
31177,779670783,7-13-24 12:28,581.25,OutgoingTransfer,Wire Transfer,17959.58
31178,779670783,7-17-24 22:28,413.03,Deposit,Cash Deposit,18372.61
31179,779670783,7-17-24 23:28,417.75,OnlineShopping,Walmart,17954.86
31180,779715108,1-26-24 14:28,635.67,Purchase,Grocery,94.34188847
31181,779715108,02-03-24 21:28,7300,IncomingTransfer,Salary,7394.341888
31182,779715108,02-04-24 14:28,589.29,Purchase,Travel,6805.051888
31183,779715108,02-04-24 22:28,671.57,Withdrawal,Branch Withdrawal,6133.481888
31184,779715108,02-06-24 16:28,206.14,OnlineShopping,eBay,5927.341888
31185,779715108,02-07-24 9:28,254.56,Withdrawal,ATM Withdrawal,5672.781888
31186,779715108,02-08-24 21:28,1500,Payment,Credit Card Payment,4172.781888
31187,779715108,02-10-24 11:28,297.26,Payment,Loan Payment,3875.521888
31188,779715108,2-13-24 11:28,639.58,Payment,Loan Payment,3235.941888
31189,779715108,2-13-24 21:28,3200,Payment,Rent Payment,35.94188847
31190,779715108,2-14-24 13:28,342.05,Purchase,Grocery,-306.1081115
31191,779715108,2-15-24 21:28,102.25,Payment,Loan Payment,-408.3581115
31192,779715108,2-20-24 9:28,300.44,Withdrawal,ATM Withdrawal,-708.7981115
31193,779715108,2-21-24 20:28,426.67,Deposit,Cash Deposit,-282.1281115
31194,779715108,2-26-24 17:28,748.15,Deposit,Direct Deposit,466.0218885
31195,779715108,2-29-24 13:28,218.78,OutgoingTransfer,Wire Transfer,247.2418885
31196,779715108,2-29-24 17:28,592.85,OutgoingTransfer,Peer-to-Peer Transfer,-345.6081115
31197,779715108,03-03-24 21:28,7300,IncomingTransfer,Salary,6954.391888
31198,779715108,03-05-24 13:28,286.35,Purchase,Pharmacy,6668.041888
31199,779715108,03-07-24 11:28,161.83,OutgoingTransfer,Peer-to-Peer Transfer,6506.211888
31200,779715108,03-08-24 21:28,1700,Payment,Credit Card Payment,4806.211888
31201,779715108,03-12-24 15:28,198.84,OnlineShopping,Walmart,4607.371888
31202,779715108,3-14-24 21:28,4000,Payment,Rent Payment,607.3718885
31203,779715108,3-16-24 22:28,230.37,IncomingTransfer,Freelance Payment,837.7418885
31204,779715108,3-20-24 15:28,314.74,IncomingTransfer,Freelance Payment,1152.481888
31205,779715108,3-21-24 22:28,182.32,Deposit,Cash Deposit,1334.801888
31206,779715108,3-27-24 10:28,421.37,Withdrawal,ATM Withdrawal,913.4318885
31207,779715108,3-27-24 15:28,298.56,Purchase,Grocery,614.8718885
31208,779715108,3-28-24 10:28,127.48,OutgoingTransfer,Bank Transfer,487.3918885
31209,779715108,3-28-24 13:28,223.81,OutgoingTransfer,International Transfer,263.5818885
31210,779715108,3-31-24 12:28,471.9,Purchase,Pharmacy,-208.3181115
31211,779715108,3-31-24 19:28,618.93,Return,eBay Return,410.6118885
31212,779715108,04-05-24 21:28,7300,IncomingTransfer,Salary,7710.611888
31213,779715108,04-07-24 21:28,307.94,OutgoingTransfer,Bank Transfer,7402.671888
31214,779715108,04-10-24 21:28,1600,Payment,Credit Card Payment,5802.671888
31215,779715108,4-13-24 13:28,666.98,Return,eBay Return,6469.651888
31216,779715108,4-17-24 14:28,484.51,OutgoingTransfer,International Transfer,5985.141888
31217,779715108,4-17-24 18:28,411.46,Return,Etsy Return,6396.601888
31218,779715108,4-18-24 16:28,100.81,OutgoingTransfer,Wire Transfer,6295.791888
31219,779715108,4-18-24 21:28,3500,Payment,Rent Payment,2795.791888
31220,779715108,4-21-24 19:28,333.6,IncomingTransfer,Freelance Payment,3129.391888
31221,779715108,4-25-24 22:28,645.61,OnlineShopping,Amazon,2483.781888
31222,779715108,4-25-24 23:28,395.17,Payment,Bill Payment,2088.611888
31223,779715108,4-28-24 12:28,496.91,Deposit,Direct Deposit,2585.521888
31224,779715108,05-01-24 14:28,315.48,Deposit,Mobile Deposit,2901.001888
31225,779715108,05-02-24 19:28,253.98,Deposit,Mobile Deposit,3154.981888
31226,779715108,05-04-24 21:28,7300,IncomingTransfer,Salary,10454.98189
31227,779715108,05-05-24 21:28,720.36,Deposit,Cash Deposit,11175.34189
31228,779715108,05-07-24 9:28,632,OutgoingTransfer,Peer-to-Peer Transfer,10543.34189
31229,779715108,05-09-24 13:28,665.74,Purchase,Home Improvement,9877.601888
31230,779715108,05-09-24 14:28,517.05,Payment,Mortgage Payment,9360.551888
31231,779715108,05-09-24 21:28,1900,Payment,Credit Card Payment,7460.551888
31232,779715108,05-10-24 20:28,651.09,Deposit,Direct Deposit,8111.641888
31233,779715108,05-10-24 22:28,410,Payment,Loan Payment,7701.641888
31234,779715108,05-11-24 20:28,293.15,OutgoingTransfer,International Transfer,7408.491888
31235,779715108,5-13-24 12:28,579.75,Return,Best Buy Return,7988.241888
31236,779715108,5-14-24 21:28,4100,Payment,Rent Payment,3888.241888
31237,779715108,5-15-24 9:28,451.51,Return,eBay Return,4339.751888
31238,779715108,5-16-24 15:28,702.82,Deposit,Direct Deposit,5042.571888
31239,779715108,5-17-24 18:28,160.44,Purchase,Grocery,4882.131888
31240,779715108,5-19-24 21:28,444.35,Payment,Mortgage Payment,4437.781888
31241,779715108,5-23-24 12:28,103.12,OutgoingTransfer,International Transfer,4334.661888
31242,779715108,5-25-24 18:28,160.28,OnlineShopping,Walmart,4174.381888
31243,779715108,5-26-24 13:28,513.83,OutgoingTransfer,Peer-to-Peer Transfer,3660.551888
31244,779715108,5-28-24 16:28,487.8,Withdrawal,Mobile App Withdrawal,3172.751888
31245,779715108,5-29-24 21:28,126.61,OnlineShopping,Target,3046.141888
31246,779715108,5-29-24 22:28,708.83,Deposit,Mobile Deposit,3754.971888
31247,779715108,5-31-24 12:28,293.51,Purchase,Home Improvement,3461.461888
31248,779715108,06-01-24 14:28,448.32,OnlineShopping,Walmart,3013.141888
31249,779715108,06-03-24 21:28,7300,IncomingTransfer,Salary,10313.14189
31250,779715108,06-05-24 21:28,583.7,Purchase,Electronics,9729.441888
31251,779715108,06-05-24 22:28,601.69,Withdrawal,Branch Withdrawal,9127.751888
31252,779715108,06-08-24 21:28,1800,Payment,Credit Card Payment,7327.751888
31253,779715108,06-10-24 22:28,354.9,Deposit,Check Deposit,7682.651888
31254,779715108,6-15-24 15:28,572.44,Withdrawal,Branch Withdrawal,7110.211888
31255,779715108,6-17-24 11:28,306.94,Purchase,Entertainment,6803.271888
31256,779715108,6-18-24 15:28,677.17,Purchase,Restaurant,6126.101888
31257,779715108,6-18-24 21:28,3900,Payment,Rent Payment,2226.101888
31258,779715108,6-21-24 15:28,642.98,Withdrawal,ATM Withdrawal,1583.121888
31259,779715108,6-24-24 15:28,724.12,Purchase,Pharmacy,859.0018885
31260,779715108,6-25-24 19:28,286.96,Withdrawal,Branch Withdrawal,572.0418885
31261,779715108,6-26-24 9:28,690.97,Purchase,Travel,-118.9281115
31262,779715108,6-26-24 23:28,724.05,Withdrawal,Branch Withdrawal,-842.9781115
31263,779715108,6-29-24 21:28,515.18,Deposit,Direct Deposit,-327.7981115
31264,779715108,07-03-24 21:28,7300,IncomingTransfer,Salary,6972.201888
31265,779715108,07-07-24 11:28,689.5,Withdrawal,Branch Withdrawal,6282.701888
31266,779715108,07-08-24 10:28,246.02,Deposit,Cash Deposit,6528.721888
31267,779715108,07-08-24 21:28,1600,Payment,Credit Card Payment,4928.721888
31268,779715108,07-09-24 12:28,717.08,Payment,Mortgage Payment,4211.641888
31269,779715108,07-12-24 21:28,551.02,Purchase,Furniture,3660.621888
31270,779715108,7-15-24 21:28,2100,Payment,Rent Payment,1560.621888
31271,779715108,7-17-24 19:28,571.45,Withdrawal,Branch Withdrawal,989.1718885
31272,779954658,1-20-24 16:28,514.54,Withdrawal,Branch Withdrawal,-514.54
31273,779954658,1-21-24 18:28,370.72,Purchase,Grocery,-885.26
31274,779954658,1-22-24 18:28,428,Purchase,Entertainment,-1313.26
31275,779954658,1-23-24 20:28,703.58,Return,Store Return,-609.68
31276,779954658,1-25-24 9:28,439.46,IncomingTransfer,Freelance Payment,-170.22
31277,779954658,02-03-24 20:28,573.45,Deposit,Mobile Deposit,403.23
31278,779954658,02-05-24 10:28,205.31,Return,Best Buy Return,608.54
31279,779954658,02-05-24 21:28,6750,IncomingTransfer,Salary,7358.54
31280,779954658,02-06-24 12:28,478.9,OnlineShopping,Walmart,6879.64
31281,779954658,02-07-24 9:28,369.29,OnlineShopping,AliExpress,6510.35
31282,779954658,02-08-24 15:28,588.95,Deposit,Check Deposit,7099.3
31283,779954658,02-08-24 20:28,715.52,Payment,Mortgage Payment,6383.78
31284,779954658,02-12-24 12:28,256.86,Purchase,Entertainment,6126.92
31285,779954658,2-13-24 18:28,303.69,Deposit,Direct Deposit,6430.61
31286,779954658,2-14-24 18:28,670.19,Withdrawal,Branch Withdrawal,5760.42
31287,779954658,2-15-24 20:28,202.6,IncomingTransfer,Freelance Payment,5963.02
31288,779954658,2-16-24 11:28,174.2,Purchase,Pharmacy,5788.82
31289,779954658,2-16-24 21:28,3200,Payment,Rent Payment,2588.82
31290,779954658,2-21-24 9:28,546.91,Purchase,Clothing,2041.91
31291,779954658,2-21-24 14:28,231.99,IncomingTransfer,Freelance Payment,2273.9
31292,779954658,2-25-24 15:28,592.38,Payment,Bill Payment,1681.52
31293,779954658,2-27-24 20:28,152.35,IncomingTransfer,Freelance Payment,1833.87
31294,779954658,2-28-24 11:28,626.29,OnlineShopping,eBay,1207.58
31295,779954658,2-29-24 12:28,656.52,Withdrawal,Branch Withdrawal,551.06
31296,779954658,03-01-24 21:28,6750,IncomingTransfer,Salary,7301.06
31297,779954658,03-02-24 12:28,634.67,Withdrawal,ATM Withdrawal,6666.39
31298,779954658,03-04-24 10:28,685.01,Deposit,Check Deposit,7351.4
31299,779954658,03-07-24 16:28,116.3,Deposit,Direct Deposit,7467.7
31300,779954658,03-09-24 12:28,408.66,IncomingTransfer,Freelance Payment,7876.36
31301,779954658,03-11-24 10:28,668.5,Deposit,Direct Deposit,8544.86
31302,779954658,03-12-24 15:28,321.74,Purchase,Gas,8223.12
31303,779954658,03-12-24 21:28,2800,Payment,Rent Payment,5423.12
31304,779954658,3-14-24 11:28,710.93,IncomingTransfer,Freelance Payment,6134.05
31305,779954658,3-19-24 13:28,457.41,OutgoingTransfer,Peer-to-Peer Transfer,5676.64
31306,779954658,3-25-24 9:28,184.88,OutgoingTransfer,International Transfer,5491.76
31307,779954658,3-25-24 23:28,196.31,OnlineShopping,Etsy,5295.45
31308,779954658,3-27-24 18:28,594.73,Deposit,Check Deposit,5890.18
31309,779954658,3-31-24 12:28,411.87,Purchase,Grocery,5478.31
31310,779954658,3-31-24 17:28,578.67,Deposit,Direct Deposit,6056.98
31311,779954658,3-31-24 18:28,525.53,OnlineShopping,Best Buy,5531.45
31312,779954658,04-01-24 12:28,309.44,Withdrawal,Mobile App Withdrawal,5222.01
31313,779954658,04-01-24 21:28,6750,IncomingTransfer,Salary,11972.01
31314,779954658,04-01-24 23:28,162.88,IncomingTransfer,Freelance Payment,12134.89
31315,779954658,04-02-24 9:28,159.34,Withdrawal,Branch Withdrawal,11975.55
31316,779954658,04-02-24 20:28,345.67,Withdrawal,ATM Withdrawal,11629.88
31317,779954658,04-03-24 14:28,144.95,OutgoingTransfer,Peer-to-Peer Transfer,11484.93
31318,779954658,04-06-24 11:28,468.79,OnlineShopping,eBay,11016.14
31319,779954658,04-07-24 11:28,689.77,Return,AliExpress Return,11705.91
31320,779954658,04-11-24 10:28,275.78,OutgoingTransfer,Bank Transfer,11430.13
31321,779954658,04-12-24 12:28,199.08,OutgoingTransfer,Peer-to-Peer Transfer,11231.05
31322,779954658,04-12-24 15:28,290.26,IncomingTransfer,Freelance Payment,11521.31
31323,779954658,4-15-24 22:28,621.82,OutgoingTransfer,Wire Transfer,10899.49
31324,779954658,4-18-24 21:28,4400,Payment,Rent Payment,6499.49
31325,779954658,4-19-24 9:28,426.14,Deposit,Check Deposit,6925.63
31326,779954658,4-19-24 15:28,684.65,Payment,Mortgage Payment,6240.98
31327,779954658,4-30-24 10:28,270.55,Return,Store Return,6511.53
31328,779954658,4-30-24 16:28,745.03,Deposit,Check Deposit,7256.56
31329,779954658,05-02-24 21:28,6750,IncomingTransfer,Salary,14006.56
31330,779954658,05-05-24 17:28,560.75,IncomingTransfer,Freelance Payment,14567.31
31331,779954658,05-10-24 23:28,305.75,OutgoingTransfer,International Transfer,14261.56
31332,779954658,5-13-24 12:28,435.39,Purchase,Travel,13826.17
31333,779954658,5-15-24 9:28,698.9,IncomingTransfer,Freelance Payment,14525.07
31334,779954658,5-17-24 10:28,180.06,Withdrawal,Mobile App Withdrawal,14345.01
31335,779954658,5-17-24 19:28,226.93,Purchase,Gas,14118.08
31336,779954658,5-17-24 21:28,4100,Payment,Rent Payment,10018.08
31337,779954658,5-18-24 18:28,714.45,Deposit,Mobile Deposit,10732.53
31338,779954658,5-21-24 22:28,644.76,Deposit,Cash Deposit,11377.29
31339,779954658,5-25-24 19:28,680.34,IncomingTransfer,Freelance Payment,12057.63
31340,779954658,5-29-24 13:28,422.58,OnlineShopping,Target,11635.05
31341,779954658,5-29-24 17:28,357.66,Deposit,Direct Deposit,11992.71
31342,779954658,5-30-24 13:28,310.08,Deposit,Mobile Deposit,12302.79
31343,779954658,06-01-24 21:28,6750,IncomingTransfer,Salary,19052.79
31344,779954658,06-02-24 14:28,598.9,Deposit,Direct Deposit,19651.69
31345,779954658,06-03-24 22:28,578.66,OnlineShopping,Walmart,19073.03
31346,779954658,06-06-24 18:28,299.96,Withdrawal,Branch Withdrawal,18773.07
31347,779954658,06-08-24 10:28,543.43,Deposit,Direct Deposit,19316.5
31348,779954658,06-09-24 19:28,558.96,OnlineShopping,Amazon,18757.54
31349,779954658,06-10-24 21:28,2400,Payment,Rent Payment,16357.54
31350,779954658,6-20-24 18:28,686.7,Withdrawal,Mobile App Withdrawal,15670.84
31351,779954658,6-22-24 11:28,174.43,Deposit,Cash Deposit,15845.27
31352,779954658,6-22-24 15:28,649.53,Withdrawal,ATM Withdrawal,15195.74
31353,779954658,6-26-24 20:28,569.54,Purchase,Restaurant,14626.2
31354,779954658,6-26-24 20:28,404.09,OnlineShopping,Amazon,14222.11
31355,779954658,6-26-24 23:28,555.97,Withdrawal,ATM Withdrawal,13666.14
31356,779954658,6-29-24 10:28,119.84,Payment,Loan Payment,13546.3
31357,779954658,6-30-24 22:28,177.63,Payment,Bill Payment,13368.67
31358,779954658,07-02-24 12:28,305.8,Deposit,Mobile Deposit,13674.47
31359,779954658,07-02-24 21:28,6750,IncomingTransfer,Salary,20424.47
31360,779954658,07-03-24 15:28,719.52,Deposit,Direct Deposit,21143.99
31361,779954658,07-06-24 22:28,367.54,Withdrawal,Mobile App Withdrawal,20776.45
31362,779954658,07-07-24 16:28,317.38,Deposit,Check Deposit,21093.83
31363,779954658,07-09-24 12:28,432.21,OutgoingTransfer,Peer-to-Peer Transfer,20661.62
31364,779954658,07-10-24 13:28,619.46,Purchase,Entertainment,20042.16
31365,779954658,07-12-24 21:28,2000,Payment,Rent Payment,18042.16
31366,780078333,1-21-24 11:28,162.4,Purchase,Gas,313.7425262
31367,780078333,1-24-24 9:28,130.04,Deposit,Mobile Deposit,443.7825262
31368,780078333,02-03-24 21:28,6100,IncomingTransfer,Salary,6543.782526
31369,780078333,02-03-24 22:28,348.05,Payment,Mortgage Payment,6195.732526
31370,780078333,02-08-24 21:28,1000,Payment,Credit Card Payment,5195.732526
31371,780078333,2-13-24 21:28,2600,Payment,Rent Payment,2595.732526
31372,780078333,2-21-24 16:28,71.24,Purchase,Home Improvement,2524.492526
31373,780078333,2-22-24 9:28,401.77,Deposit,Cash Deposit,2926.262526
31374,780078333,2-22-24 23:28,109.58,Payment,Loan Payment,2816.682526
31375,780078333,03-01-24 20:28,110.28,Purchase,Gas,2706.402526
31376,780078333,03-04-24 17:28,545.93,Purchase,Pharmacy,2160.472526
31377,780078333,03-05-24 21:28,6100,IncomingTransfer,Salary,8260.472526
31378,780078333,03-10-24 21:28,800,Payment,Credit Card Payment,7460.472526
31379,780078333,3-14-24 14:28,130.07,Payment,Mortgage Payment,7330.402526
31380,780078333,3-15-24 15:28,326.34,Purchase,Travel,7004.062526
31381,780078333,3-15-24 19:28,394.69,Purchase,Entertainment,6609.372526
31382,780078333,3-16-24 21:28,2700,Payment,Rent Payment,3909.372526
31383,780078333,3-23-24 20:28,546.66,Return,Walmart Return,4456.032526
31384,780078333,3-28-24 11:28,313.08,OutgoingTransfer,Bank Transfer,4142.952526
31385,780078333,04-04-24 21:28,6100,IncomingTransfer,Salary,10242.95253
31386,780078333,04-09-24 21:28,800,Payment,Credit Card Payment,9442.952526
31387,780078333,4-13-24 20:28,419.54,IncomingTransfer,Freelance Payment,9862.492526
31388,780078333,4-16-24 21:28,3500,Payment,Rent Payment,6362.492526
31389,780078333,4-20-24 14:28,494.7,OutgoingTransfer,Peer-to-Peer Transfer,5867.792526
31390,780078333,05-01-24 21:28,6100,IncomingTransfer,Salary,11967.79253
31391,780078333,05-06-24 21:28,700,Payment,Credit Card Payment,11267.79253
31392,780078333,5-15-24 21:28,4000,Payment,Rent Payment,7267.792526
31393,780078333,5-19-24 12:28,334.05,IncomingTransfer,Freelance Payment,7601.842526
31394,780078333,5-25-24 19:28,175.52,Deposit,Mobile Deposit,7777.362526
31395,780078333,5-29-24 12:28,71.37,Purchase,Electronics,7705.992526
31396,780078333,06-01-24 13:28,57.78,Deposit,Direct Deposit,7763.772526
31397,780078333,06-03-24 21:28,6100,IncomingTransfer,Salary,13863.77253
31398,780078333,06-06-24 12:28,333.09,Purchase,Travel,13530.68253
31399,780078333,06-08-24 21:28,700,Payment,Credit Card Payment,12830.68253
31400,780078333,06-09-24 19:28,412.63,OnlineShopping,Etsy,12418.05253
31401,780078333,06-12-24 13:28,218.01,Deposit,Direct Deposit,12636.06253
31402,780078333,6-18-24 21:28,2300,Payment,Rent Payment,10336.06253
31403,780078333,6-20-24 11:28,538.84,Purchase,Furniture,9797.222526
31404,780078333,6-23-24 13:28,435.95,Withdrawal,Branch Withdrawal,9361.272526
31405,780078333,6-27-24 15:28,221.41,OutgoingTransfer,Bank Transfer,9139.862526
31406,780078333,07-04-24 21:28,6100,IncomingTransfer,Salary,15239.86253
31407,780078333,07-09-24 21:28,900,Payment,Credit Card Payment,14339.86253
31408,780078333,7-16-24 10:28,214.45,Purchase,Entertainment,14125.41253
31409,780078333,7-17-24 21:28,3300,Payment,Rent Payment,10825.41253
31410,780201633,02-02-24 21:28,4900,IncomingTransfer,Salary,5793.813663
31411,780201633,02-06-24 17:28,301.17,OutgoingTransfer,Wire Transfer,5492.643663
31412,780201633,02-07-24 21:28,1300,Payment,Credit Card Payment,4192.643663
31413,780201633,2-14-24 21:28,3000,Payment,Rent Payment,1192.643663
31414,780201633,2-16-24 18:28,48.19,Deposit,Mobile Deposit,1240.833663
31415,780201633,2-20-24 15:28,85.37,OutgoingTransfer,Peer-to-Peer Transfer,1155.463663
31416,780201633,2-24-24 21:28,238.62,Return,AliExpress Return,1394.083663
31417,780201633,03-01-24 21:28,4900,IncomingTransfer,Salary,6294.083663
31418,780201633,03-03-24 19:28,43.05,Purchase,Pharmacy,6251.033663
31419,780201633,03-03-24 22:28,106.55,Deposit,Cash Deposit,6357.583663
31420,780201633,03-06-24 21:28,1400,Payment,Credit Card Payment,4957.583663
31421,780201633,03-07-24 15:28,91.23,Deposit,Direct Deposit,5048.813663
31422,780201633,03-09-24 18:28,301.77,Deposit,Mobile Deposit,5350.583663
31423,780201633,3-13-24 13:28,119.69,Return,Target Return,5470.273663
31424,780201633,3-15-24 20:28,184.75,Purchase,Entertainment,5285.523663
31425,780201633,3-16-24 21:28,1300,Payment,Rent Payment,3985.523663
31426,780201633,3-17-24 13:28,218.76,Payment,Mortgage Payment,3766.763663
31427,780201633,3-19-24 15:28,351.82,Withdrawal,Mobile App Withdrawal,3414.943663
31428,780201633,3-19-24 20:28,141.48,OutgoingTransfer,International Transfer,3273.463663
31429,780201633,3-22-24 10:28,99.15,OutgoingTransfer,Wire Transfer,3174.313663
31430,780201633,3-26-24 16:28,319.87,Return,Store Return,3494.183663
31431,780201633,3-28-24 21:28,159.77,Payment,Loan Payment,3334.413663
31432,780201633,3-28-24 22:28,160.93,Return,Target Return,3495.343663
31433,780201633,04-02-24 11:28,303.94,Return,eBay Return,3799.283663
31434,780201633,04-03-24 21:28,4900,IncomingTransfer,Salary,8699.283663
31435,780201633,04-04-24 22:28,296.32,Deposit,Direct Deposit,8995.603663
31436,780201633,04-06-24 17:28,294.09,Deposit,Check Deposit,9289.693663
31437,780201633,04-07-24 10:28,309.04,Withdrawal,Mobile App Withdrawal,8980.653663
31438,780201633,04-08-24 21:28,1600,Payment,Credit Card Payment,7380.653663
31439,780201633,04-10-24 11:28,252.6,Withdrawal,Branch Withdrawal,7128.053663
31440,780201633,04-11-24 21:28,2900,Payment,Rent Payment,4228.053663
31441,780201633,4-17-24 15:28,316.2,IncomingTransfer,Freelance Payment,4544.253663
31442,780201633,4-21-24 10:28,246.17,Withdrawal,ATM Withdrawal,4298.083663
31443,780201633,4-21-24 10:28,356.49,Return,Etsy Return,4654.573663
31444,780201633,4-21-24 21:28,370.22,Payment,Loan Payment,4284.353663
31445,780201633,4-23-24 16:28,87.93,Purchase,Travel,4196.423663
31446,780201633,05-01-24 21:28,4900,IncomingTransfer,Salary,9096.423663
31447,780201633,05-06-24 21:28,1300,Payment,Credit Card Payment,7796.423663
31448,780201633,05-08-24 17:28,80.55,Payment,Mortgage Payment,7715.873663
31449,780201633,05-10-24 16:28,349.49,Deposit,Direct Deposit,8065.363663
31450,780201633,05-11-24 21:28,2600,Payment,Rent Payment,5465.363663
31451,780201633,5-16-24 17:28,335.24,OnlineShopping,Best Buy,5130.123663
31452,780201633,5-17-24 10:28,105.23,OnlineShopping,Target,5024.893663
31453,780201633,5-19-24 18:28,61.22,Return,AliExpress Return,5086.113663
31454,780201633,5-25-24 12:28,212.96,Deposit,Cash Deposit,5299.073663
31455,780201633,5-25-24 19:28,21.93,Purchase,Home Improvement,5277.143663
31456,780201633,5-29-24 23:28,110.14,Deposit,Mobile Deposit,5387.283663
31457,780201633,06-03-24 21:28,4900,IncomingTransfer,Salary,10287.28366
31458,780201633,06-07-24 17:28,266.58,Deposit,Direct Deposit,10553.86366
31459,780201633,06-08-24 21:28,1200,Payment,Credit Card Payment,9353.863663
31460,780201633,06-10-24 21:28,3200,Payment,Rent Payment,6153.863663
31461,780201633,06-10-24 22:28,332.74,OnlineShopping,Target,5821.123663
31462,780201633,06-12-24 17:28,145.42,Purchase,Gas,5675.703663
31463,780201633,6-14-24 15:28,157.08,Purchase,Pharmacy,5518.623663
31464,780201633,6-19-24 17:28,46.7,OnlineShopping,eBay,5471.923663
31465,780201633,6-21-24 21:28,278.94,Payment,Bill Payment,5192.983663
31466,780201633,6-24-24 12:28,198.29,Deposit,Mobile Deposit,5391.273663
31467,780201633,6-24-24 17:28,273.39,IncomingTransfer,Freelance Payment,5664.663663
31468,780201633,6-28-24 9:28,329.28,Withdrawal,ATM Withdrawal,5335.383663
31469,780201633,07-03-24 17:28,313.29,Purchase,Home Improvement,5022.093663
31470,780201633,07-04-24 12:28,311.08,Withdrawal,Mobile App Withdrawal,4711.013663
31471,780201633,07-04-24 14:28,87.2,Payment,Loan Payment,4623.813663
31472,780201633,07-04-24 21:28,4900,IncomingTransfer,Salary,9523.813663
31473,780201633,07-07-24 17:28,259.38,Withdrawal,ATM Withdrawal,9264.433663
31474,780201633,07-09-24 21:28,1600,Payment,Credit Card Payment,7664.433663
31475,780201633,07-10-24 17:28,233.57,OnlineShopping,AliExpress,7430.863663
31476,780201633,7-14-24 21:28,2900,Payment,Rent Payment,4530.863663
31477,780201633,7-15-24 9:28,21.46,Return,eBay Return,4552.323663
31478,780201633,7-16-24 20:28,148.43,Deposit,Check Deposit,4700.753663
31479,780277458,1-20-24 14:28,105.44,Payment,Loan Payment,1212.058124
31480,780277458,1-22-24 10:28,77.11,Deposit,Check Deposit,1289.168124
31481,780277458,1-22-24 17:28,214.63,Withdrawal,Branch Withdrawal,1074.538124
31482,780277458,1-23-24 9:28,72.94,Payment,Mortgage Payment,1001.598124
31483,780277458,02-01-24 17:28,151.29,Purchase,Restaurant,850.3081239
31484,780277458,02-01-24 21:28,3200,IncomingTransfer,Salary,4050.308124
31485,780277458,02-04-24 11:28,11.9,Return,Amazon Return,4062.208124
31486,780277458,02-04-24 21:28,152.41,Purchase,Entertainment,3909.798124
31487,780277458,02-05-24 16:28,225.48,Return,Amazon Return,4135.278124
31488,780277458,02-06-24 20:28,210.29,Purchase,Clothing,3924.988124
31489,780277458,02-06-24 21:28,3000,Payment,Credit Card Payment,924.9881239
31490,780277458,02-09-24 22:28,224.73,Withdrawal,Mobile App Withdrawal,700.2581239
31491,780277458,02-10-24 21:28,1500,Payment,Rent Payment,-799.7418761
31492,780277458,02-12-24 20:28,180.61,Deposit,Direct Deposit,-619.1318761
31493,780277458,2-14-24 9:28,201.99,Payment,Bill Payment,-821.1218761
31494,780277458,2-16-24 16:28,148.41,Purchase,Entertainment,-969.5318761
31495,780277458,2-16-24 21:28,183.09,Purchase,Travel,-1152.621876
31496,780277458,2-17-24 11:28,243.59,OutgoingTransfer,Bank Transfer,-1396.211876
31497,780277458,2-20-24 22:28,171.79,Return,Store Return,-1224.421876
31498,780277458,2-24-24 11:28,54.38,Purchase,Pharmacy,-1278.801876
31499,780277458,2-26-24 9:28,219.66,Payment,Mortgage Payment,-1498.461876
31500,780277458,2-29-24 10:28,64.3,Return,Amazon Return,-1434.161876
31501,780277458,2-29-24 15:28,91.68,IncomingTransfer,Freelance Payment,-1342.481876
31502,780277458,03-01-24 20:28,203.72,Deposit,Check Deposit,-1138.761876
31503,780277458,03-03-24 21:28,3200,IncomingTransfer,Salary,2061.238124
31504,780277458,03-08-24 16:28,37.86,Deposit,Direct Deposit,2099.098124
31505,780277458,03-08-24 21:28,3100,Payment,Credit Card Payment,-1000.901876
31506,780277458,03-09-24 22:28,137.77,OnlineShopping,Best Buy,-1138.671876
31507,780277458,03-10-24 21:28,1700,Payment,Rent Payment,-2838.671876
31508,780277458,03-12-24 17:28,224.61,Deposit,Check Deposit,-2614.061876
31509,780277458,3-16-24 15:28,84.02,OnlineShopping,Etsy,-2698.081876
31510,780277458,3-16-24 15:28,45.66,Purchase,Furniture,-2743.741876
31511,780277458,3-19-24 13:28,29.46,Purchase,Grocery,-2773.201876
31512,780277458,3-19-24 15:28,245.3,Withdrawal,ATM Withdrawal,-3018.501876
31513,780277458,3-22-24 23:28,86.49,IncomingTransfer,Freelance Payment,-2932.011876
31514,780277458,3-23-24 13:28,173.67,Deposit,Direct Deposit,-2758.341876
31515,780277458,3-27-24 10:28,61.94,Purchase,Clothing,-2820.281876
31516,780277458,3-27-24 12:28,37.46,OutgoingTransfer,Wire Transfer,-2857.741876
31517,780277458,3-27-24 21:28,152.3,Deposit,Check Deposit,-2705.441876
31518,780277458,3-30-24 15:28,75.76,Purchase,Gas,-2781.201876
31519,780277458,3-31-24 15:28,219.52,Return,Store Return,-2561.681876
31520,780277458,04-01-24 16:28,129.7,Deposit,Mobile Deposit,-2431.981876
31521,780277458,04-03-24 21:28,3200,IncomingTransfer,Salary,768.0181239
31522,780277458,04-03-24 21:28,238.31,Deposit,Mobile Deposit,1006.328124
31523,780277458,04-07-24 12:28,144.79,Deposit,Mobile Deposit,1151.118124
31524,780277458,04-08-24 21:28,3600,Payment,Credit Card Payment,-2448.881876
31525,780277458,04-09-24 12:28,144.74,OnlineShopping,Target,-2593.621876
31526,780277458,04-09-24 15:28,104.25,Purchase,Entertainment,-2697.871876
31527,780277458,04-09-24 16:28,58.8,IncomingTransfer,Freelance Payment,-2639.071876
31528,780277458,04-10-24 20:28,217.91,Deposit,Check Deposit,-2421.161876
31529,780277458,04-11-24 13:28,104.77,Purchase,Entertainment,-2525.931876
31530,780277458,04-11-24 23:28,158.12,Return,Store Return,-2367.811876
31531,780277458,04-12-24 20:28,215.92,Withdrawal,Branch Withdrawal,-2583.731876
31532,780277458,4-14-24 21:28,1600,Payment,Rent Payment,-4183.731876
31533,780277458,4-17-24 9:28,211.15,OnlineShopping,Target,-4394.881876
31534,780277458,4-17-24 12:28,60.24,Purchase,Gas,-4455.121876
31535,780277458,4-18-24 22:28,149.97,Deposit,Direct Deposit,-4305.151876
31536,780277458,4-21-24 18:28,55.74,IncomingTransfer,Freelance Payment,-4249.411876
31537,780277458,4-30-24 20:28,154.46,OnlineShopping,Etsy,-4403.871876
31538,780277458,05-01-24 15:28,22.57,Withdrawal,Mobile App Withdrawal,-4426.441876
31539,780277458,05-02-24 21:28,3200,IncomingTransfer,Salary,-1226.441876
31540,780277458,05-04-24 16:28,126.28,OutgoingTransfer,International Transfer,-1352.721876
31541,780277458,05-05-24 13:28,150.56,Withdrawal,ATM Withdrawal,-1503.281876
31542,780277458,05-07-24 21:28,2800,Payment,Credit Card Payment,-4303.281876
31543,780277458,05-08-24 12:28,56.83,OnlineShopping,Target,-4360.111876
31544,780277458,05-11-24 12:28,202.28,Deposit,Direct Deposit,-4157.831876
31545,780277458,05-12-24 13:28,50.75,Return,Target Return,-4107.081876
31546,780277458,05-12-24 21:28,125.14,Purchase,Grocery,-4232.221876
31547,780277458,5-13-24 12:28,60.27,Payment,Bill Payment,-4292.491876
31548,780277458,5-13-24 17:28,205.43,Deposit,Mobile Deposit,-4087.061876
31549,780277458,5-13-24 21:28,900,Payment,Rent Payment,-4987.061876
31550,780277458,5-13-24 21:28,168.81,IncomingTransfer,Freelance Payment,-4818.251876
31551,780277458,5-26-24 18:28,31,IncomingTransfer,Freelance Payment,-4787.251876
31552,780277458,5-29-24 22:28,140.99,IncomingTransfer,Freelance Payment,-4646.261876
31553,780277458,5-30-24 13:28,207.59,OutgoingTransfer,International Transfer,-4853.851876
31554,780277458,5-31-24 10:28,60.18,Deposit,Mobile Deposit,-4793.671876
31555,780277458,5-31-24 13:28,161.85,Purchase,Pharmacy,-4955.521876
31556,780277458,06-03-24 13:28,74.29,OnlineShopping,Etsy,-5029.811876
31557,780277458,06-04-24 21:28,3200,IncomingTransfer,Salary,-1829.811876
31558,780277458,06-05-24 9:28,142.98,Return,eBay Return,-1686.831876
31559,780277458,06-05-24 10:28,219.37,OnlineShopping,eBay,-1906.201876
31560,780277458,06-07-24 19:28,244.55,Payment,Bill Payment,-2150.751876
31561,780277458,06-08-24 18:28,99.3,Deposit,Direct Deposit,-2051.451876
31562,780277458,06-09-24 21:28,3600,Payment,Credit Card Payment,-5651.451876
31563,780277458,06-10-24 17:28,199.79,Deposit,Direct Deposit,-5451.661876
31564,780277458,06-10-24 21:28,800,Payment,Rent Payment,-6251.661876
31565,780277458,06-11-24 23:28,226.94,Withdrawal,ATM Withdrawal,-6478.601876
31566,780277458,6-14-24 10:28,244.68,OnlineShopping,eBay,-6723.281876
31567,780277458,6-14-24 19:28,111.32,Withdrawal,ATM Withdrawal,-6834.601876
31568,780277458,6-16-24 15:28,91.73,OnlineShopping,Etsy,-6926.331876
31569,780277458,6-20-24 10:28,75.44,Withdrawal,Mobile App Withdrawal,-7001.771876
31570,780277458,6-22-24 22:28,201.79,Payment,Loan Payment,-7203.561876
31571,780277458,6-24-24 15:28,72.55,Return,Store Return,-7131.011876
31572,780277458,6-26-24 16:28,42.12,IncomingTransfer,Freelance Payment,-7088.891876
31573,780277458,6-29-24 10:28,224.63,Return,Amazon Return,-6864.261876
31574,780277458,07-03-24 16:28,63.96,Payment,Loan Payment,-6928.221876
31575,780277458,07-03-24 19:28,129.61,OnlineShopping,AliExpress,-7057.831876
31576,780277458,07-03-24 21:28,3200,IncomingTransfer,Salary,-3857.831876
31577,780277458,07-04-24 17:28,93.89,Purchase,Electronics,-3951.721876
31578,780277458,07-05-24 14:28,107.78,Deposit,Direct Deposit,-3843.941876
31579,780277458,07-05-24 18:28,179.05,Withdrawal,Branch Withdrawal,-4022.991876
31580,780277458,07-08-24 21:28,2700,Payment,Credit Card Payment,-6722.991876
31581,780277458,07-12-24 21:28,70.27,Payment,Loan Payment,-6793.261876
31582,780277458,7-16-24 16:28,174.02,Purchase,Gas,-6967.281876
31583,780277458,7-17-24 14:28,193.19,Return,eBay Return,-6774.091876
31584,780277458,7-17-24 23:28,193.27,Deposit,Direct Deposit,-6580.821876
31585,780277458,7-18-24 21:28,900,Payment,Rent Payment,-7480.821876
31586,780653208,1-26-24 17:28,54.81,Payment,Bill Payment,2081.233905
31587,780653208,1-29-24 16:28,27.83,Purchase,Furniture,2053.403905
31588,780653208,02-01-24 21:28,2150,IncomingTransfer,Salary,4203.403905
31589,780653208,02-04-24 15:28,71.15,OnlineShopping,eBay,4132.253905
31590,780653208,02-06-24 10:28,84.03,IncomingTransfer,Freelance Payment,4216.283905
31591,780653208,02-06-24 21:28,3600,Payment,Credit Card Payment,616.2839051
31592,780653208,02-08-24 10:28,220.61,Purchase,Furniture,395.6739051
31593,780653208,02-09-24 15:28,86.35,Withdrawal,ATM Withdrawal,309.3239051
31594,780653208,02-10-24 21:28,116.79,Withdrawal,ATM Withdrawal,192.5339051
31595,780653208,2-13-24 21:28,700,Payment,Rent Payment,-507.4660949
31596,780653208,2-19-24 21:28,209.91,Withdrawal,Branch Withdrawal,-717.3760949
31597,780653208,03-04-24 18:28,184.95,Return,Target Return,-532.4260949
31598,780653208,03-04-24 21:28,2150,IncomingTransfer,Salary,1617.573905
31599,780653208,03-09-24 15:28,57.03,OnlineShopping,AliExpress,1560.543905
31600,780653208,03-09-24 17:28,82.68,Purchase,Grocery,1477.863905
31601,780653208,03-09-24 20:28,128.81,Deposit,Cash Deposit,1606.673905
31602,780653208,03-09-24 21:28,3500,Payment,Credit Card Payment,-1893.326095
31603,780653208,03-12-24 14:28,145.69,Deposit,Cash Deposit,-1747.636095
31604,780653208,3-13-24 19:28,168.33,Deposit,Cash Deposit,-1579.306095
31605,780653208,3-14-24 21:28,500,Payment,Rent Payment,-2079.306095
31606,780653208,3-15-24 17:28,106.43,Return,AliExpress Return,-1972.876095
31607,780653208,3-16-24 12:28,212.23,OutgoingTransfer,International Transfer,-2185.106095
31608,780653208,3-16-24 21:28,125.34,Deposit,Cash Deposit,-2059.766095
31609,780653208,3-18-24 22:28,67.48,Purchase,Restaurant,-2127.246095
31610,780653208,3-19-24 11:28,109.62,OutgoingTransfer,International Transfer,-2236.866095
31611,780653208,3-19-24 18:28,149.45,Deposit,Check Deposit,-2087.416095
31612,780653208,3-22-24 17:28,112.48,Withdrawal,Mobile App Withdrawal,-2199.896095
31613,780653208,3-23-24 14:28,24.28,OutgoingTransfer,Bank Transfer,-2224.176095
31614,780653208,3-30-24 20:28,134.42,OutgoingTransfer,Wire Transfer,-2358.596095
31615,780653208,3-31-24 15:28,20.1,Payment,Bill Payment,-2378.696095
31616,780653208,04-03-24 20:28,19.72,Purchase,Travel,-2398.416095
31617,780653208,04-04-24 13:28,126.62,Payment,Bill Payment,-2525.036095
31618,780653208,04-05-24 21:28,2150,IncomingTransfer,Salary,-375.0360949
31619,780653208,04-10-24 21:28,3200,Payment,Credit Card Payment,-3575.036095
31620,780653208,04-11-24 21:28,1300,Payment,Rent Payment,-4875.036095
31621,780653208,4-13-24 14:28,22.03,Purchase,Furniture,-4897.066095
31622,780653208,4-14-24 13:28,102.96,Purchase,Clothing,-5000.026095
31623,780653208,4-17-24 11:28,78.74,OnlineShopping,Amazon,-5078.766095
31624,780653208,4-17-24 20:28,59.24,Return,Best Buy Return,-5019.526095
31625,780653208,4-25-24 20:28,245.41,Deposit,Check Deposit,-4774.116095
31626,780653208,4-29-24 21:28,70.97,Deposit,Check Deposit,-4703.146095
31627,780653208,05-01-24 14:28,228.36,OnlineShopping,AliExpress,-4931.506095
31628,780653208,05-04-24 21:28,2150,IncomingTransfer,Salary,-2781.506095
31629,780653208,05-06-24 20:28,184.23,OutgoingTransfer,Bank Transfer,-2965.736095
31630,780653208,05-09-24 21:28,2600,Payment,Credit Card Payment,-5565.736095
31631,780653208,05-11-24 12:28,238.21,Purchase,Furniture,-5803.946095
31632,780653208,05-12-24 18:28,163.69,Purchase,Electronics,-5967.636095
31633,780653208,5-17-24 13:28,148.63,Withdrawal,Mobile App Withdrawal,-6116.266095
31634,780653208,5-18-24 21:28,1200,Payment,Rent Payment,-7316.266095
31635,780653208,5-20-24 21:28,232.76,Deposit,Cash Deposit,-7083.506095
31636,780653208,5-28-24 9:28,119.37,Withdrawal,ATM Withdrawal,-7202.876095
31637,780653208,5-29-24 18:28,77.52,Payment,Mortgage Payment,-7280.396095
31638,780653208,06-04-24 14:28,89.18,Purchase,Travel,-7369.576095
31639,780653208,06-05-24 14:28,29.65,Payment,Bill Payment,-7399.226095
31640,780653208,06-05-24 18:28,31.59,Purchase,Electronics,-7430.816095
31641,780653208,06-05-24 21:28,2150,IncomingTransfer,Salary,-5280.816095
31642,780653208,06-06-24 12:28,180.1,Deposit,Direct Deposit,-5100.716095
31643,780653208,06-08-24 12:28,194.45,Deposit,Mobile Deposit,-4906.266095
31644,780653208,06-10-24 21:28,2600,Payment,Credit Card Payment,-7506.266095
31645,780653208,06-10-24 21:28,900,Payment,Rent Payment,-8406.266095
31646,780653208,06-12-24 11:28,99.83,Withdrawal,Branch Withdrawal,-8506.096095
31647,780653208,6-15-24 12:28,241.39,Deposit,Direct Deposit,-8264.706095
31648,780653208,6-17-24 13:28,44.32,Payment,Bill Payment,-8309.026095
31649,780653208,6-24-24 22:28,138.01,Withdrawal,ATM Withdrawal,-8447.036095
31650,780653208,6-29-24 21:28,123.49,Payment,Mortgage Payment,-8570.526095
31651,780653208,6-30-24 14:28,131.72,Return,Best Buy Return,-8438.806095
31652,780653208,07-01-24 12:28,221.33,Withdrawal,ATM Withdrawal,-8660.136095
31653,780653208,07-02-24 19:28,195.76,Withdrawal,Mobile App Withdrawal,-8855.896095
31654,780653208,07-03-24 21:28,2150,IncomingTransfer,Salary,-6705.896095
31655,780653208,07-03-24 22:28,74.82,Withdrawal,Branch Withdrawal,-6780.716095
31656,780653208,07-04-24 17:28,71.02,Payment,Bill Payment,-6851.736095
31657,780653208,07-08-24 21:28,3700,Payment,Credit Card Payment,-10551.73609
31658,780653208,07-12-24 21:28,1300,Payment,Rent Payment,-11851.73609
31659,780688383,1-23-24 9:28,155.37,Return,Store Return,155.37
31660,780688383,02-02-24 22:28,533.91,Return,Walmart Return,689.28
31661,780688383,02-04-24 21:28,8750,IncomingTransfer,Salary,9439.28
31662,780688383,2-18-24 21:28,5500,Payment,Rent Payment,3939.28
31663,780688383,2-21-24 16:28,443.66,Payment,Loan Payment,3495.62
31664,780688383,03-03-24 22:28,654.46,OutgoingTransfer,International Transfer,2841.16
31665,780688383,03-04-24 21:28,8750,IncomingTransfer,Salary,11591.16
31666,780688383,03-08-24 22:28,625.41,Deposit,Cash Deposit,12216.57
31667,780688383,03-10-24 21:28,3800,Payment,Rent Payment,8416.57
31668,780688383,3-13-24 19:28,540.83,Return,Amazon Return,8957.4
31669,780688383,3-14-24 20:28,230.41,Return,Store Return,9187.81
31670,780688383,3-17-24 19:28,307.26,Deposit,Check Deposit,9495.07
31671,780688383,3-21-24 17:28,690.88,OutgoingTransfer,International Transfer,8804.19
31672,780688383,3-26-24 14:28,556.48,Purchase,Entertainment,8247.71
31673,780688383,3-26-24 16:28,644.41,Return,Amazon Return,8892.12
31674,780688383,3-29-24 20:28,533.44,Withdrawal,Branch Withdrawal,8358.68
31675,780688383,3-30-24 18:28,359.92,OnlineShopping,AliExpress,7998.76
31676,780688383,3-31-24 12:28,192.36,Deposit,Direct Deposit,8191.12
31677,780688383,04-04-24 17:28,165.19,Return,AliExpress Return,8356.31
31678,780688383,04-04-24 18:28,107.79,Withdrawal,Mobile App Withdrawal,8248.52
31679,780688383,04-04-24 21:28,8750,IncomingTransfer,Salary,16998.52
31680,780688383,04-07-24 20:28,216.8,Deposit,Mobile Deposit,17215.32
31681,780688383,4-15-24 19:28,541.48,Purchase,Grocery,16673.84
31682,780688383,4-16-24 15:28,296.91,Deposit,Check Deposit,16970.75
31683,780688383,4-16-24 21:28,5500,Payment,Rent Payment,11470.75
31684,780688383,4-18-24 10:28,709.47,Purchase,Electronics,10761.28
31685,780688383,4-19-24 12:28,653.51,Payment,Bill Payment,10107.77
31686,780688383,4-21-24 12:28,159.2,Deposit,Mobile Deposit,10266.97
31687,780688383,4-21-24 12:28,716.48,OutgoingTransfer,Wire Transfer,9550.49
31688,780688383,4-25-24 18:28,176.7,IncomingTransfer,Freelance Payment,9727.19
31689,780688383,4-30-24 14:28,459.75,Return,Etsy Return,10186.94
31690,780688383,4-30-24 14:28,202.59,IncomingTransfer,Freelance Payment,10389.53
31691,780688383,05-01-24 15:28,165.48,Withdrawal,ATM Withdrawal,10224.05
31692,780688383,05-02-24 18:28,494.64,IncomingTransfer,Freelance Payment,10718.69
31693,780688383,05-04-24 15:28,196.77,Return,AliExpress Return,10915.46
31694,780688383,05-05-24 21:28,8750,IncomingTransfer,Salary,19665.46
31695,780688383,05-08-24 23:28,723.76,Deposit,Mobile Deposit,20389.22
31696,780688383,05-09-24 13:28,566.25,Deposit,Direct Deposit,20955.47
31697,780688383,05-09-24 17:28,296.9,Payment,Loan Payment,20658.57
31698,780688383,05-09-24 23:28,408.5,Payment,Mortgage Payment,20250.07
31699,780688383,05-11-24 20:28,109.22,Payment,Loan Payment,20140.85
31700,780688383,5-13-24 20:28,736.04,OutgoingTransfer,Wire Transfer,19404.81
31701,780688383,5-13-24 21:28,360.93,Return,Best Buy Return,19765.74
31702,780688383,5-14-24 16:28,542.98,Return,Store Return,20308.72
31703,780688383,5-14-24 21:28,251.41,OnlineShopping,AliExpress,20057.31
31704,780688383,5-15-24 17:28,352.18,IncomingTransfer,Freelance Payment,20409.49
31705,780688383,5-17-24 21:28,2500,Payment,Rent Payment,17909.49
31706,780688383,5-18-24 15:28,563.97,Return,Walmart Return,18473.46
31707,780688383,5-22-24 21:28,335.37,IncomingTransfer,Freelance Payment,18808.83
31708,780688383,06-01-24 11:28,280.24,OnlineShopping,eBay,18528.59
31709,780688383,06-02-24 12:28,619.2,OutgoingTransfer,Wire Transfer,17909.39
31710,780688383,06-04-24 21:28,8750,IncomingTransfer,Salary,26659.39
31711,780688383,06-04-24 21:28,381.7,Purchase,Grocery,26277.69
31712,780688383,06-09-24 12:28,224.11,Deposit,Mobile Deposit,26501.8
31713,780688383,06-10-24 21:28,4200,Payment,Rent Payment,22301.8
31714,780688383,6-14-24 19:28,323.41,OutgoingTransfer,Wire Transfer,21978.39
31715,780688383,6-14-24 22:28,201.67,Withdrawal,Branch Withdrawal,21776.72
31716,780688383,6-16-24 12:28,604.58,Return,Walmart Return,22381.3
31717,780688383,6-19-24 23:28,493.06,Return,AliExpress Return,22874.36
31718,780688383,6-23-24 22:28,676.6,Deposit,Direct Deposit,23550.96
31719,780688383,6-23-24 22:28,242.9,OnlineShopping,Target,23308.06
31720,780688383,6-26-24 22:28,297.07,Withdrawal,Branch Withdrawal,23010.99
31721,780688383,6-29-24 11:28,363.26,Withdrawal,Branch Withdrawal,22647.73
31722,780688383,07-05-24 21:28,8750,IncomingTransfer,Salary,31397.73
31723,780688383,07-08-24 20:28,105.09,Purchase,Home Improvement,31292.64
31724,780688383,07-10-24 21:28,2400,Payment,Rent Payment,28892.64
31725,780688383,7-16-24 15:28,424.71,Purchase,Clothing,28467.93
31726,780688383,7-17-24 21:28,134.87,Purchase,Electronics,28333.06
31727,780710433,1-24-24 22:28,679.92,OutgoingTransfer,Peer-to-Peer Transfer,-679.92
31728,780710433,1-26-24 21:28,549.87,Withdrawal,ATM Withdrawal,-1229.79
31729,780710433,1-28-24 20:28,663.39,OnlineShopping,Target,-1893.18
31730,780710433,1-30-24 21:28,724.39,Deposit,Check Deposit,-1168.79
31731,780710433,1-31-24 9:28,262.49,Deposit,Check Deposit,-906.3
31732,780710433,1-31-24 17:28,449.31,Purchase,Entertainment,-1355.61
31733,780710433,02-03-24 20:28,123.55,Withdrawal,Mobile App Withdrawal,-1479.16
31734,780710433,02-03-24 21:28,8500,IncomingTransfer,Salary,7020.84
31735,780710433,02-08-24 15:28,159.66,Return,AliExpress Return,7180.5
31736,780710433,02-11-24 15:28,103.8,Deposit,Check Deposit,7284.3
31737,780710433,2-13-24 19:28,579.01,Purchase,Electronics,6705.29
31738,780710433,2-14-24 12:28,518.63,Deposit,Check Deposit,7223.92
31739,780710433,2-14-24 19:28,418.67,Deposit,Check Deposit,7642.59
31740,780710433,2-16-24 21:28,4900,Payment,Rent Payment,2742.59
31741,780710433,2-21-24 11:28,716.75,Deposit,Direct Deposit,3459.34
31742,780710433,2-23-24 16:28,431.77,IncomingTransfer,Freelance Payment,3891.11
31743,780710433,2-24-24 10:28,581.19,OnlineShopping,Amazon,3309.92
31744,780710433,2-25-24 19:28,253.44,OutgoingTransfer,International Transfer,3056.48
31745,780710433,2-29-24 10:28,399.83,Purchase,Gas,2656.65
31746,780710433,03-02-24 18:28,695.72,Deposit,Direct Deposit,3352.37
31747,780710433,03-02-24 21:28,8500,IncomingTransfer,Salary,11852.37
31748,780710433,03-09-24 15:28,684.72,Purchase,Travel,11167.65
31749,780710433,03-10-24 18:28,716.81,Return,Target Return,11884.46
31750,780710433,03-11-24 18:28,316.73,Withdrawal,Mobile App Withdrawal,11567.73
31751,780710433,03-12-24 19:28,455.19,Return,Target Return,12022.92
31752,780710433,03-12-24 21:28,2900,Payment,Rent Payment,9122.92
31753,780710433,3-15-24 17:28,607.31,Withdrawal,Branch Withdrawal,8515.61
31754,780710433,3-19-24 17:28,589.29,Withdrawal,Branch Withdrawal,7926.32
31755,780710433,3-19-24 20:28,126.45,Withdrawal,Branch Withdrawal,7799.87
31756,780710433,3-22-24 16:28,627.36,OnlineShopping,Walmart,7172.51
31757,780710433,3-25-24 17:28,584.63,OutgoingTransfer,Peer-to-Peer Transfer,6587.88
31758,780710433,3-26-24 11:28,161.11,Purchase,Pharmacy,6426.77
31759,780710433,3-30-24 20:28,422.95,Deposit,Direct Deposit,6849.72
31760,780710433,04-01-24 21:28,8500,IncomingTransfer,Salary,15349.72
31761,780710433,04-02-24 10:28,595.39,Purchase,Pharmacy,14754.33
31762,780710433,04-03-24 20:28,165.65,Deposit,Check Deposit,14919.98
31763,780710433,04-04-24 19:28,704.95,Withdrawal,ATM Withdrawal,14215.03
31764,780710433,04-05-24 10:28,583.83,OnlineShopping,eBay,13631.2
31765,780710433,04-05-24 14:28,614.09,Withdrawal,Mobile App Withdrawal,13017.11
31766,780710433,04-07-24 11:28,170.1,Return,Best Buy Return,13187.21
31767,780710433,04-10-24 15:28,367.74,Purchase,Entertainment,12819.47
31768,780710433,04-11-24 23:28,274.12,OutgoingTransfer,Wire Transfer,12545.35
31769,780710433,04-12-24 17:28,643.33,Deposit,Cash Deposit,13188.68
31770,780710433,4-16-24 17:28,459.28,Purchase,Entertainment,12729.4
31771,780710433,4-18-24 21:28,4300,Payment,Rent Payment,8429.4
31772,780710433,4-19-24 18:28,132.21,Deposit,Mobile Deposit,8561.61
31773,780710433,4-20-24 16:28,313.49,Deposit,Cash Deposit,8875.1
31774,780710433,4-23-24 20:28,470.47,Deposit,Check Deposit,9345.57
31775,780710433,4-24-24 13:28,658.21,Payment,Bill Payment,8687.36
31776,780710433,4-26-24 11:28,139.26,Withdrawal,Branch Withdrawal,8548.1
31777,780710433,4-29-24 11:28,696.51,Deposit,Direct Deposit,9244.61
31778,780710433,05-01-24 9:28,267.5,Return,eBay Return,9512.11
31779,780710433,05-03-24 21:28,8500,IncomingTransfer,Salary,18012.11
31780,780710433,05-04-24 20:28,615.14,OutgoingTransfer,Bank Transfer,17396.97
31781,780710433,05-12-24 11:28,635.77,Return,Store Return,18032.74
31782,780710433,5-16-24 21:28,4400,Payment,Rent Payment,13632.74
31783,780710433,5-20-24 16:28,325.09,Purchase,Clothing,13307.65
31784,780710433,5-22-24 10:28,375.71,Purchase,Travel,12931.94
31785,780710433,5-31-24 12:28,707.8,Withdrawal,ATM Withdrawal,12224.14
31786,780710433,5-31-24 15:28,387.5,Purchase,Entertainment,11836.64
31787,780710433,06-04-24 20:28,665.72,Withdrawal,Branch Withdrawal,11170.92
31788,780710433,06-05-24 21:28,8500,IncomingTransfer,Salary,19670.92
31789,780710433,06-10-24 18:28,427.31,IncomingTransfer,Freelance Payment,20098.23
31790,780710433,06-11-24 12:28,609.58,Deposit,Cash Deposit,20707.81
31791,780710433,06-12-24 15:28,258.03,OutgoingTransfer,Wire Transfer,20449.78
31792,780710433,6-13-24 21:28,5400,Payment,Rent Payment,15049.78
31793,780710433,6-15-24 15:28,133.57,OutgoingTransfer,Wire Transfer,14916.21
31794,780710433,6-17-24 20:28,315.58,Purchase,Electronics,14600.63
31795,780710433,6-22-24 12:28,515.6,Purchase,Pharmacy,14085.03
31796,780710433,6-23-24 16:28,367.03,Withdrawal,ATM Withdrawal,13718
31797,780710433,6-23-24 17:28,302.29,Purchase,Clothing,13415.71
31798,780710433,6-24-24 12:28,106.14,OnlineShopping,Best Buy,13309.57
31799,780710433,6-25-24 13:28,264.3,Withdrawal,Branch Withdrawal,13045.27
31800,780710433,6-28-24 19:28,378.22,OutgoingTransfer,International Transfer,12667.05
31801,780710433,6-28-24 20:28,233.43,Return,Best Buy Return,12900.48
31802,780710433,6-29-24 13:28,724.55,Withdrawal,ATM Withdrawal,12175.93
31803,780710433,6-30-24 11:28,259.11,OutgoingTransfer,Wire Transfer,11916.82
31804,780710433,07-01-24 13:28,141.42,Purchase,Pharmacy,11775.4
31805,780710433,07-02-24 21:28,289.64,Payment,Bill Payment,11485.76
31806,780710433,07-02-24 23:28,509.03,Withdrawal,ATM Withdrawal,10976.73
31807,780710433,07-04-24 17:28,390.14,Deposit,Cash Deposit,11366.87
31808,780710433,07-05-24 21:28,8500,IncomingTransfer,Salary,19866.87
31809,780710433,07-05-24 23:28,602.35,OnlineShopping,eBay,19264.52
31810,780710433,07-06-24 18:28,735.69,Deposit,Mobile Deposit,20000.21
31811,780710433,07-07-24 12:28,116.64,Withdrawal,Branch Withdrawal,19883.57
31812,780710433,07-10-24 21:28,4200,Payment,Rent Payment,15683.57
31813,780710433,7-14-24 14:28,226.36,Payment,Loan Payment,15457.21
31814,780710433,7-14-24 17:28,701,Deposit,Check Deposit,16158.21
31815,780710433,7-15-24 14:28,649.2,Withdrawal,ATM Withdrawal,15509.01
31816,781131483,1-24-24 23:28,264.23,Deposit,Check Deposit,1480.725205
31817,781131483,1-27-24 20:28,737.4,OutgoingTransfer,International Transfer,743.3252048
31818,781131483,02-01-24 21:28,9200,IncomingTransfer,Salary,9943.325205
31819,781131483,02-06-24 11:28,536.94,Withdrawal,Branch Withdrawal,9406.385205
31820,781131483,02-06-24 21:28,2100,Payment,Credit Card Payment,7306.385205
31821,781131483,02-08-24 16:28,699.21,Payment,Mortgage Payment,6607.175205
31822,781131483,2-13-24 13:28,599.18,Deposit,Check Deposit,7206.355205
31823,781131483,2-13-24 18:28,591.73,Payment,Bill Payment,6614.625205
31824,781131483,2-17-24 21:28,2800,Payment,Installment Payment,3814.625205
31825,781131483,2-22-24 22:28,479.27,Purchase,Electronics,3335.355205
31826,781131483,2-23-24 21:28,302.07,Deposit,Check Deposit,3637.425205
31827,781131483,2-26-24 9:28,518.01,Return,Etsy Return,4155.435205
31828,781131483,2-26-24 13:28,200.32,OnlineShopping,eBay,3955.115205
31829,781131483,2-28-24 10:28,358.16,Withdrawal,ATM Withdrawal,3596.955205
31830,781131483,2-28-24 15:28,307.3,Purchase,Travel,3289.655205
31831,781131483,2-29-24 13:28,230.46,Deposit,Mobile Deposit,3520.115205
31832,781131483,2-29-24 22:28,201.28,Withdrawal,ATM Withdrawal,3318.835205
31833,781131483,03-01-24 10:28,137.23,Withdrawal,Branch Withdrawal,3181.605205
31834,781131483,03-01-24 21:28,388.05,Return,Store Return,3569.655205
31835,781131483,03-03-24 11:28,291.46,IncomingTransfer,Freelance Payment,3861.115205
31836,781131483,03-03-24 21:28,9200,IncomingTransfer,Salary,13061.1152
31837,781131483,03-04-24 18:28,620.52,Withdrawal,ATM Withdrawal,12440.5952
31838,781131483,03-05-24 20:28,414.9,Withdrawal,Mobile App Withdrawal,12025.6952
31839,781131483,03-08-24 15:28,260.77,Deposit,Check Deposit,12286.4652
31840,781131483,03-08-24 21:28,2000,Payment,Credit Card Payment,10286.4652
31841,781131483,03-12-24 17:28,366.76,OnlineShopping,Walmart,9919.705205
31842,781131483,3-13-24 20:28,606.1,Purchase,Furniture,9313.605205
31843,781131483,3-13-24 21:28,3500,Payment,Insurance Payment,5813.605205
31844,781131483,3-15-24 10:28,442.08,Deposit,Cash Deposit,6255.685205
31845,781131483,3-16-24 19:28,105.14,Deposit,Direct Deposit,6360.825205
31846,781131483,3-17-24 16:28,348.88,Payment,Loan Payment,6011.945205
31847,781131483,3-22-24 13:28,121.4,Deposit,Direct Deposit,6133.345205
31848,781131483,3-22-24 13:28,231.66,Purchase,Restaurant,5901.685205
31849,781131483,3-22-24 23:28,234.76,Deposit,Cash Deposit,6136.445205
31850,781131483,3-29-24 11:28,557.47,OutgoingTransfer,Bank Transfer,5578.975205
31851,781131483,04-01-24 11:28,185.71,Return,Best Buy Return,5764.685205
31852,781131483,04-04-24 21:28,9200,IncomingTransfer,Salary,14964.6852
31853,781131483,04-06-24 17:28,102.84,OnlineShopping,Etsy,14861.8452
31854,781131483,04-09-24 21:28,2700,Payment,Credit Card Payment,12161.8452
31855,781131483,04-09-24 23:28,467.07,Payment,Loan Payment,11694.7752
31856,781131483,04-10-24 20:28,248.14,Payment,Loan Payment,11446.6352
31857,781131483,04-12-24 21:28,3500,Payment,Subscription Payment,7946.635205
31858,781131483,4-18-24 21:28,389.48,Purchase,Home Improvement,7557.155205
31859,781131483,05-05-24 21:28,9200,IncomingTransfer,Salary,16757.1552
31860,781131483,05-08-24 13:28,498.51,OutgoingTransfer,Peer-to-Peer Transfer,16258.6452
31861,781131483,05-10-24 21:28,2200,Payment,Credit Card Payment,14058.6452
31862,781131483,5-18-24 21:28,3000,Payment,Subscription Payment,11058.6452
31863,781131483,5-18-24 21:28,624.59,Deposit,Mobile Deposit,11683.2352
31864,781131483,5-20-24 10:28,150.74,OnlineShopping,AliExpress,11532.4952
31865,781131483,5-22-24 20:28,583.41,OnlineShopping,Amazon,10949.0852
31866,781131483,5-24-24 17:28,568.71,IncomingTransfer,Freelance Payment,11517.7952
31867,781131483,5-30-24 22:28,539.87,OutgoingTransfer,Peer-to-Peer Transfer,10977.9252
31868,781131483,5-31-24 19:28,165.35,Deposit,Direct Deposit,11143.2752
31869,781131483,06-03-24 21:28,9200,IncomingTransfer,Salary,20343.2752
31870,781131483,06-06-24 14:28,566.16,Withdrawal,ATM Withdrawal,19777.1152
31871,781131483,06-08-24 21:28,2600,Payment,Credit Card Payment,17177.1152
31872,781131483,06-11-24 17:28,100.99,Withdrawal,Mobile App Withdrawal,17076.1252
31873,781131483,6-15-24 21:28,2300,Payment,Installment Payment,14776.1252
31874,781131483,6-15-24 22:28,166.3,Return,eBay Return,14942.4252
31875,781131483,6-22-24 22:28,711.36,Payment,Loan Payment,14231.0652
31876,781131483,6-25-24 12:28,700.75,Payment,Loan Payment,13530.3152
31877,781131483,6-25-24 20:28,239.63,IncomingTransfer,Freelance Payment,13769.9452
31878,781131483,6-27-24 14:28,406.86,Deposit,Mobile Deposit,14176.8052
31879,781131483,6-29-24 16:28,446.33,Payment,Bill Payment,13730.4752
31880,781131483,07-04-24 21:28,9200,IncomingTransfer,Salary,22930.4752
31881,781131483,07-06-24 16:28,746.29,Deposit,Check Deposit,23676.7652
31882,781131483,07-08-24 11:28,208.41,Withdrawal,Mobile App Withdrawal,23468.3552
31883,781131483,07-09-24 21:28,2200,Payment,Credit Card Payment,21268.3552
31884,781131483,07-10-24 21:28,3300,Payment,Insurance Payment,17968.3552
31885,784827108,1-24-24 15:28,141.63,Payment,Loan Payment,917.6872956
31886,784827108,1-24-24 21:28,113.49,Payment,Mortgage Payment,804.1972956
31887,784827108,1-25-24 10:28,163,Deposit,Direct Deposit,967.1972956
31888,784827108,1-25-24 18:28,91.71,Withdrawal,Branch Withdrawal,875.4872956
31889,784827108,1-27-24 10:28,14.92,Purchase,Travel,860.5672956
31890,784827108,1-29-24 23:28,121.06,Deposit,Mobile Deposit,981.6272956
31891,784827108,1-31-24 12:28,176.38,Return,Amazon Return,1158.007296
31892,784827108,02-03-24 21:28,2550,IncomingTransfer,Salary,3708.007296
31893,784827108,02-05-24 11:28,246.58,Purchase,Entertainment,3461.427296
31894,784827108,02-08-24 18:28,88.42,Withdrawal,Mobile App Withdrawal,3373.007296
31895,784827108,02-08-24 21:28,2300,Payment,Credit Card Payment,1073.007296
31896,784827108,02-09-24 9:28,197.78,Purchase,Entertainment,875.2272956
31897,784827108,2-13-24 22:28,140.78,OutgoingTransfer,Bank Transfer,734.4472956
31898,784827108,2-13-24 22:28,47.5,Payment,Mortgage Payment,686.9472956
31899,784827108,2-14-24 21:28,181.55,Payment,Bill Payment,505.3972956
31900,784827108,2-17-24 21:28,1400,Payment,Rent Payment,-894.6027044
31901,784827108,2-25-24 21:28,138.56,Payment,Loan Payment,-1033.162704
31902,784827108,2-26-24 15:28,85.13,Payment,Loan Payment,-1118.292704
31903,784827108,2-27-24 13:28,49.04,Withdrawal,ATM Withdrawal,-1167.332704
31904,784827108,2-28-24 12:28,176.4,OutgoingTransfer,International Transfer,-1343.732704
31905,784827108,03-04-24 21:28,2550,IncomingTransfer,Salary,1206.267296
31906,784827108,03-06-24 12:28,238.47,OnlineShopping,Etsy,967.7972956
31907,784827108,03-08-24 16:28,225.04,Deposit,Mobile Deposit,1192.837296
31908,784827108,03-09-24 21:28,2000,Payment,Credit Card Payment,-807.1627044
31909,784827108,3-18-24 21:28,900,Payment,Rent Payment,-1707.162704
31910,784827108,3-20-24 12:28,222.7,Deposit,Direct Deposit,-1484.462704
31911,784827108,3-21-24 15:28,153.94,Withdrawal,ATM Withdrawal,-1638.402704
31912,784827108,3-24-24 11:28,144.09,Return,Store Return,-1494.312704
31913,784827108,3-30-24 21:28,81.71,Deposit,Cash Deposit,-1412.602704
31914,784827108,04-04-24 12:28,85.59,OutgoingTransfer,Wire Transfer,-1498.192704
31915,784827108,04-04-24 21:28,2550,IncomingTransfer,Salary,1051.807296
31916,784827108,04-05-24 15:28,228.7,Return,Walmart Return,1280.507296
31917,784827108,04-06-24 22:28,198.04,Deposit,Direct Deposit,1478.547296
31918,784827108,04-07-24 20:28,18.52,Purchase,Electronics,1460.027296
31919,784827108,04-09-24 21:28,2300,Payment,Credit Card Payment,-839.9727044
31920,784827108,4-14-24 19:28,188.75,Purchase,Travel,-1028.722704
31921,784827108,4-16-24 21:28,77.62,IncomingTransfer,Freelance Payment,-951.1027044
31922,784827108,4-17-24 22:28,108.82,OutgoingTransfer,Peer-to-Peer Transfer,-1059.922704
31923,784827108,4-18-24 21:28,900,Payment,Rent Payment,-1959.922704
31924,784827108,4-19-24 13:28,158.52,IncomingTransfer,Freelance Payment,-1801.402704
31925,784827108,4-19-24 19:28,85.98,Deposit,Cash Deposit,-1715.422704
31926,784827108,4-22-24 11:28,206.09,OutgoingTransfer,Wire Transfer,-1921.512704
31927,784827108,4-25-24 15:28,55.4,Withdrawal,Mobile App Withdrawal,-1976.912704
31928,784827108,4-26-24 10:28,123.24,Deposit,Cash Deposit,-1853.672704
31929,784827108,05-01-24 21:28,2550,IncomingTransfer,Salary,696.3272956
31930,784827108,05-06-24 21:28,2500,Payment,Credit Card Payment,-1803.672704
31931,784827108,05-11-24 11:28,99.75,Withdrawal,ATM Withdrawal,-1903.422704
31932,784827108,05-12-24 13:28,103.5,Deposit,Mobile Deposit,-1799.922704
31933,784827108,05-12-24 18:28,198.3,Payment,Bill Payment,-1998.222704
31934,784827108,5-13-24 17:28,48.23,Deposit,Cash Deposit,-1949.992704
31935,784827108,5-13-24 21:28,700,Payment,Rent Payment,-2649.992704
31936,784827108,5-14-24 9:28,55.06,Payment,Mortgage Payment,-2705.052704
31937,784827108,5-14-24 18:28,139.41,Payment,Bill Payment,-2844.462704
31938,784827108,5-15-24 14:28,146.3,Withdrawal,Branch Withdrawal,-2990.762704
31939,784827108,5-16-24 19:28,43.38,Payment,Mortgage Payment,-3034.142704
31940,784827108,5-20-24 16:28,165.98,Deposit,Cash Deposit,-2868.162704
31941,784827108,5-20-24 17:28,174.58,Return,Etsy Return,-2693.582704
31942,784827108,5-22-24 23:28,110.16,Deposit,Mobile Deposit,-2583.422704
31943,784827108,5-27-24 10:28,147.42,Deposit,Direct Deposit,-2436.002704
31944,784827108,06-02-24 21:28,2550,IncomingTransfer,Salary,113.9972956
31945,784827108,06-04-24 15:28,84.84,Payment,Loan Payment,29.15729559
31946,784827108,06-04-24 17:28,177.81,Withdrawal,Branch Withdrawal,-148.6527044
31947,784827108,06-05-24 14:28,232.66,Withdrawal,ATM Withdrawal,-381.3127044
31948,784827108,06-06-24 16:28,107.33,Deposit,Direct Deposit,-273.9827044
31949,784827108,06-07-24 14:28,188.7,IncomingTransfer,Freelance Payment,-85.28270441
31950,784827108,06-07-24 19:28,228.47,Return,Walmart Return,143.1872956
31951,784827108,06-07-24 21:28,2400,Payment,Credit Card Payment,-2256.812704
31952,784827108,06-08-24 13:28,232.54,OutgoingTransfer,Bank Transfer,-2489.352704
31953,784827108,06-09-24 15:28,175.95,Withdrawal,Mobile App Withdrawal,-2665.302704
31954,784827108,06-12-24 21:28,1000,Payment,Rent Payment,-3665.302704
31955,784827108,6-13-24 18:28,27.34,OutgoingTransfer,Bank Transfer,-3692.642704
31956,784827108,6-14-24 20:28,25.09,Withdrawal,ATM Withdrawal,-3717.732704
31957,784827108,6-19-24 21:28,229.1,OutgoingTransfer,Wire Transfer,-3946.832704
31958,784827108,6-21-24 9:28,76.98,OutgoingTransfer,Peer-to-Peer Transfer,-4023.812704
31959,784827108,6-22-24 14:28,153.02,Purchase,Restaurant,-4176.832704
31960,784827108,6-23-24 11:28,49.19,Withdrawal,Branch Withdrawal,-4226.022704
31961,784827108,6-24-24 9:28,126.67,Return,eBay Return,-4099.352704
31962,784827108,6-25-24 10:28,23.85,Purchase,Clothing,-4123.202704
31963,784827108,6-30-24 18:28,47.16,Purchase,Grocery,-4170.362704
31964,784827108,6-30-24 20:28,141.01,OnlineShopping,Target,-4311.372704
31965,784827108,07-02-24 9:28,60.96,Purchase,Travel,-4372.332704
31966,784827108,07-02-24 21:28,2550,IncomingTransfer,Salary,-1822.332704
31967,784827108,07-04-24 12:28,81.92,Return,eBay Return,-1740.412704
31968,784827108,07-06-24 22:28,68.05,Deposit,Mobile Deposit,-1672.362704
31969,784827108,07-07-24 20:28,53.78,Deposit,Cash Deposit,-1618.582704
31970,784827108,07-07-24 21:28,2100,Payment,Credit Card Payment,-3718.582704
31971,784827108,07-10-24 23:28,130.31,Deposit,Cash Deposit,-3588.272704
31972,784827108,07-12-24 12:28,110.17,IncomingTransfer,Freelance Payment,-3478.102704
31973,784827108,7-13-24 10:28,209.68,OnlineShopping,Amazon,-3687.782704
31974,784827108,7-13-24 21:28,1500,Payment,Rent Payment,-5187.782704
31975,785038908,1-20-24 11:28,99.08,Deposit,Direct Deposit,1099.601916
31976,785038908,1-20-24 18:28,79.44,Payment,Mortgage Payment,1020.161916
31977,785038908,1-21-24 17:28,21.68,Deposit,Direct Deposit,1041.841916
31978,785038908,1-21-24 17:28,185.6,Deposit,Check Deposit,1227.441916
31979,785038908,1-21-24 18:28,194.83,Deposit,Check Deposit,1422.271916
31980,785038908,1-21-24 20:28,61.15,Withdrawal,Branch Withdrawal,1361.121916
31981,785038908,1-22-24 11:28,153.29,Purchase,Electronics,1207.831916
31982,785038908,1-28-24 13:28,17.09,Purchase,Furniture,1190.741916
31983,785038908,1-29-24 13:28,150.87,Deposit,Direct Deposit,1341.611916
31984,785038908,02-01-24 16:28,81.64,OutgoingTransfer,Wire Transfer,1259.971916
31985,785038908,02-01-24 23:28,109.37,Return,Amazon Return,1369.341916
31986,785038908,02-02-24 9:28,148.65,Deposit,Direct Deposit,1517.991916
31987,785038908,02-03-24 21:28,2300,IncomingTransfer,Salary,3817.991916
31988,785038908,02-04-24 15:28,186.54,Purchase,Gas,3631.451916
31989,785038908,02-04-24 17:28,241.61,Deposit,Check Deposit,3873.061916
31990,785038908,02-06-24 11:28,157.85,Deposit,Mobile Deposit,4030.911916
31991,785038908,02-08-24 19:28,102.67,Deposit,Cash Deposit,4133.581916
31992,785038908,02-08-24 21:28,1500,Payment,Credit Card Payment,2633.581916
31993,785038908,02-09-24 18:28,190.6,Purchase,Restaurant,2442.981916
31994,785038908,02-09-24 21:28,48.11,Withdrawal,Branch Withdrawal,2394.871916
31995,785038908,02-10-24 13:28,70.75,Payment,Mortgage Payment,2324.121916
31996,785038908,02-10-24 19:28,26.18,Withdrawal,Mobile App Withdrawal,2297.941916
31997,785038908,2-15-24 21:28,1000,Payment,Rent Payment,1297.941916
31998,785038908,2-16-24 15:28,87.49,OnlineShopping,Best Buy,1210.451916
31999,785038908,2-16-24 17:28,130.04,Deposit,Cash Deposit,1340.491916
32000,785038908,2-17-24 16:28,14.56,Deposit,Direct Deposit,1355.051916
32001,785038908,2-17-24 22:28,53.44,Return,Walmart Return,1408.491916
32002,785038908,2-18-24 12:28,120.44,IncomingTransfer,Freelance Payment,1528.931916
32003,785038908,2-18-24 13:28,98.24,Withdrawal,Branch Withdrawal,1430.691916
32004,785038908,2-19-24 11:28,200.54,OutgoingTransfer,Bank Transfer,1230.151916
32005,785038908,2-21-24 15:28,110.59,Return,Best Buy Return,1340.741916
32006,785038908,2-21-24 18:28,13.32,Payment,Bill Payment,1327.421916
32007,785038908,2-23-24 10:28,187.56,Withdrawal,Mobile App Withdrawal,1139.861916
32008,785038908,2-23-24 10:28,145.41,Deposit,Mobile Deposit,1285.271916
32009,785038908,2-23-24 16:28,121.95,Payment,Bill Payment,1163.321916
32010,785038908,2-24-24 12:28,141.3,IncomingTransfer,Freelance Payment,1304.621916
32011,785038908,2-27-24 10:28,42.04,OnlineShopping,Best Buy,1262.581916
32012,785038908,2-28-24 18:28,152.08,Deposit,Check Deposit,1414.661916
32013,785038908,03-02-24 10:28,73.86,Withdrawal,ATM Withdrawal,1340.801916
32014,785038908,03-02-24 21:28,2300,IncomingTransfer,Salary,3640.801916
32015,785038908,03-02-24 21:28,124.42,IncomingTransfer,Freelance Payment,3765.221916
32016,785038908,03-03-24 13:28,45.04,Payment,Mortgage Payment,3720.181916
32017,785038908,03-07-24 16:28,145.05,Payment,Mortgage Payment,3575.131916
32018,785038908,03-07-24 21:28,1200,Payment,Credit Card Payment,2375.131916
32019,785038908,03-12-24 19:28,216.91,IncomingTransfer,Freelance Payment,2592.041916
32020,785038908,3-15-24 9:28,25.23,Purchase,Clothing,2566.811916
32021,785038908,3-16-24 21:28,800,Payment,Rent Payment,1766.811916
32022,785038908,3-18-24 11:28,116.54,Payment,Mortgage Payment,1650.271916
32023,785038908,3-19-24 23:28,80.67,Payment,Mortgage Payment,1569.601916
32024,785038908,3-21-24 18:28,178.23,Return,Target Return,1747.831916
32025,785038908,3-24-24 10:28,221.95,Deposit,Cash Deposit,1969.781916
32026,785038908,3-24-24 13:28,109.56,OutgoingTransfer,Bank Transfer,1860.221916
32027,785038908,3-24-24 14:28,192.35,Deposit,Cash Deposit,2052.571916
32028,785038908,3-24-24 20:28,25.71,Purchase,Pharmacy,2026.861916
32029,785038908,3-25-24 13:28,41.71,OutgoingTransfer,Peer-to-Peer Transfer,1985.151916
32030,785038908,3-26-24 16:28,184.66,Payment,Mortgage Payment,1800.491916
32031,785038908,3-26-24 16:28,71.39,Purchase,Clothing,1729.101916
32032,785038908,3-28-24 13:28,45.31,Purchase,Travel,1683.791916
32033,785038908,3-28-24 17:28,83.15,Payment,Mortgage Payment,1600.641916
32034,785038908,3-30-24 13:28,33.35,Purchase,Clothing,1567.291916
32035,785038908,04-02-24 22:28,66.23,Deposit,Check Deposit,1633.521916
32036,785038908,04-03-24 13:28,21.66,Payment,Bill Payment,1611.861916
32037,785038908,04-03-24 21:28,2300,IncomingTransfer,Salary,3911.861916
32038,785038908,04-03-24 22:28,88.77,Withdrawal,Mobile App Withdrawal,3823.091916
32039,785038908,04-05-24 23:28,77.89,Withdrawal,ATM Withdrawal,3745.201916
32040,785038908,04-08-24 14:28,216.76,Payment,Loan Payment,3528.441916
32041,785038908,04-08-24 21:28,1700,Payment,Credit Card Payment,1828.441916
32042,785038908,04-09-24 20:28,10.8,IncomingTransfer,Freelance Payment,1839.241916
32043,785038908,04-11-24 21:28,79.34,OutgoingTransfer,International Transfer,1759.901916
32044,785038908,04-12-24 21:28,179.9,Deposit,Cash Deposit,1939.801916
32045,785038908,4-15-24 14:28,49.29,Withdrawal,ATM Withdrawal,1890.511916
32046,785038908,4-15-24 21:28,900,Payment,Rent Payment,990.5119163
32047,785038908,4-16-24 19:28,245.07,Withdrawal,Mobile App Withdrawal,745.4419163
32048,785038908,4-18-24 18:28,119.51,Return,Store Return,864.9519163
32049,785038908,4-18-24 23:28,49.59,Purchase,Clothing,815.3619163
32050,785038908,4-20-24 17:28,128.88,Deposit,Direct Deposit,944.2419163
32051,785038908,4-21-24 12:28,247.47,Deposit,Mobile Deposit,1191.711916
32052,785038908,4-21-24 13:28,206.14,Deposit,Mobile Deposit,1397.851916
32053,785038908,4-24-24 11:28,77.42,Deposit,Mobile Deposit,1475.271916
32054,785038908,4-25-24 23:28,84.88,OnlineShopping,Target,1390.391916
32055,785038908,4-28-24 15:28,121.98,OutgoingTransfer,International Transfer,1268.411916
32056,785038908,4-29-24 15:28,53.22,Deposit,Direct Deposit,1321.631916
32057,785038908,4-30-24 22:28,66.32,Deposit,Mobile Deposit,1387.951916
32058,785038908,05-01-24 21:28,2300,IncomingTransfer,Salary,3687.951916
32059,785038908,05-03-24 19:28,62.76,Purchase,Travel,3625.191916
32060,785038908,05-06-24 21:28,1600,Payment,Credit Card Payment,2025.191916
32061,785038908,05-07-24 21:28,147.92,Deposit,Cash Deposit,2173.111916
32062,785038908,05-09-24 22:28,135.11,OnlineShopping,Target,2038.001916
32063,785038908,05-10-24 21:28,700,Payment,Rent Payment,1338.001916
32064,785038908,05-11-24 10:28,236.25,Purchase,Pharmacy,1101.751916
32065,785038908,05-11-24 19:28,72.6,Return,Store Return,1174.351916
32066,785038908,05-11-24 19:28,154.17,OutgoingTransfer,Peer-to-Peer Transfer,1020.181916
32067,785038908,05-12-24 19:28,30.29,Deposit,Check Deposit,1050.471916
32068,785038908,5-13-24 22:28,156.16,Payment,Bill Payment,894.3119163
32069,785038908,5-14-24 13:28,161.1,OnlineShopping,Etsy,733.2119163
32070,785038908,5-15-24 11:28,246.99,OutgoingTransfer,Peer-to-Peer Transfer,486.2219163
32071,785038908,5-15-24 18:28,136.89,Withdrawal,Branch Withdrawal,349.3319163
32072,785038908,5-17-24 11:28,24.23,IncomingTransfer,Freelance Payment,373.5619163
32073,785038908,5-17-24 13:28,214.98,Purchase,Grocery,158.5819163
32074,785038908,5-18-24 17:28,211.49,Payment,Bill Payment,-52.90808374
32075,785038908,5-23-24 16:28,80.72,Deposit,Mobile Deposit,27.81191626
32076,785038908,5-24-24 14:28,229.62,Withdrawal,Mobile App Withdrawal,-201.8080837
32077,785038908,5-26-24 22:28,120.57,Deposit,Mobile Deposit,-81.23808374
32078,785038908,5-27-24 19:28,232.5,Purchase,Pharmacy,-313.7380837
32079,785038908,5-28-24 9:28,241.98,Payment,Loan Payment,-555.7180837
32080,785038908,5-28-24 14:28,47.29,Purchase,Pharmacy,-603.0080837
32081,785038908,5-29-24 14:28,87.96,Purchase,Gas,-690.9680837
32082,785038908,5-31-24 21:28,24.57,Payment,Bill Payment,-715.5380837
32083,785038908,06-01-24 13:28,162.96,OutgoingTransfer,Peer-to-Peer Transfer,-878.4980837
32084,785038908,06-02-24 12:28,147.72,Withdrawal,Branch Withdrawal,-1026.218084
32085,785038908,06-03-24 21:28,2300,IncomingTransfer,Salary,1273.781916
32086,785038908,06-04-24 22:28,149.03,OnlineShopping,Etsy,1124.751916
32087,785038908,06-06-24 9:28,225.58,Withdrawal,ATM Withdrawal,899.1719163
32088,785038908,06-07-24 11:28,60.2,Deposit,Check Deposit,959.3719163
32089,785038908,06-08-24 16:28,14.71,Purchase,Gas,944.6619163
32090,785038908,06-08-24 21:28,1400,Payment,Credit Card Payment,-455.3380837
32091,785038908,06-10-24 21:28,800,Payment,Rent Payment,-1255.338084
32092,785038908,06-10-24 23:28,96.07,Purchase,Restaurant,-1351.408084
32093,785038908,06-10-24 23:28,99.09,Deposit,Direct Deposit,-1252.318084
32094,785038908,06-11-24 13:28,92.69,OnlineShopping,Walmart,-1345.008084
32095,785038908,06-11-24 21:28,148.19,OnlineShopping,Walmart,-1493.198084
32096,785038908,06-11-24 21:28,123.77,Deposit,Direct Deposit,-1369.428084
32097,785038908,06-12-24 15:28,179.33,OnlineShopping,eBay,-1548.758084
32098,785038908,6-13-24 15:28,14.28,OnlineShopping,Target,-1563.038084
32099,785038908,6-16-24 17:28,96.54,Deposit,Cash Deposit,-1466.498084
32100,785038908,6-16-24 20:28,53.37,OutgoingTransfer,Peer-to-Peer Transfer,-1519.868084
32101,785038908,6-17-24 22:28,34.58,IncomingTransfer,Freelance Payment,-1485.288084
32102,785038908,6-18-24 16:28,186.32,Deposit,Cash Deposit,-1298.968084
32103,785038908,6-25-24 16:28,41.76,Return,Best Buy Return,-1257.208084
32104,785038908,6-25-24 17:28,164.58,OnlineShopping,Etsy,-1421.788084
32105,785038908,6-25-24 22:28,110.87,OutgoingTransfer,International Transfer,-1532.658084
32106,785038908,6-26-24 10:28,217.29,Withdrawal,Branch Withdrawal,-1749.948084
32107,785038908,6-26-24 21:28,139.43,Deposit,Check Deposit,-1610.518084
32108,785038908,6-27-24 10:28,56.76,Payment,Mortgage Payment,-1667.278084
32109,785038908,6-27-24 19:28,217.81,Deposit,Mobile Deposit,-1449.468084
32110,785038908,07-02-24 17:28,29.02,Purchase,Restaurant,-1478.488084
32111,785038908,07-02-24 21:28,138.92,OnlineShopping,Target,-1617.408084
32112,785038908,07-03-24 12:28,75.33,Purchase,Restaurant,-1692.738084
32113,785038908,07-03-24 21:28,2300,IncomingTransfer,Salary,607.2619163
32114,785038908,07-08-24 21:28,1500,Payment,Credit Card Payment,-892.7380837
32115,785038908,7-14-24 21:28,800,Payment,Rent Payment,-1692.738084
32116,785038908,7-16-24 15:28,60.68,IncomingTransfer,Freelance Payment,-1632.058084
32117,785106933,1-24-24 12:28,116.48,Return,Walmart Return,2025.662034
32118,785106933,1-24-24 15:28,364.99,Return,Walmart Return,2390.652034
32119,785106933,1-25-24 22:28,389.07,OutgoingTransfer,Bank Transfer,2001.582034
32120,785106933,1-26-24 9:28,210.22,Purchase,Home Improvement,1791.362034
32121,785106933,1-27-24 21:28,440.8,Deposit,Mobile Deposit,2232.162034
32122,785106933,02-02-24 21:28,3650,IncomingTransfer,Salary,5882.162034
32123,785106933,02-04-24 22:28,301.03,OnlineShopping,AliExpress,5581.132034
32124,785106933,02-07-24 21:28,3200,Payment,Credit Card Payment,2381.132034
32125,785106933,02-08-24 16:28,309.7,Deposit,Direct Deposit,2690.832034
32126,785106933,2-18-24 21:28,1000,Payment,Installment Payment,1690.832034
32127,785106933,2-22-24 18:28,411.82,Withdrawal,ATM Withdrawal,1279.012034
32128,785106933,2-22-24 21:28,279.63,Return,Walmart Return,1558.642034
32129,785106933,03-04-24 21:28,3650,IncomingTransfer,Salary,5208.642034
32130,785106933,03-05-24 21:28,120.88,Payment,Mortgage Payment,5087.762034
32131,785106933,03-07-24 14:28,413.02,Deposit,Check Deposit,5500.782034
32132,785106933,03-07-24 23:28,420.12,OnlineShopping,Amazon,5080.662034
32133,785106933,03-08-24 9:28,402.84,Payment,Loan Payment,4677.822034
32134,785106933,03-08-24 16:28,349.38,Return,eBay Return,5027.202034
32135,785106933,03-08-24 18:28,147.01,Return,eBay Return,5174.212034
32136,785106933,03-09-24 10:28,400.08,Return,Amazon Return,5574.292034
32137,785106933,03-09-24 13:28,49.24,Purchase,Gas,5525.052034
32138,785106933,03-09-24 21:28,3200,Payment,Credit Card Payment,2325.052034
32139,785106933,03-12-24 13:28,295.62,Withdrawal,Mobile App Withdrawal,2029.432034
32140,785106933,3-14-24 12:28,399.24,Purchase,Restaurant,1630.192034
32141,785106933,3-15-24 21:28,1600,Payment,Installment Payment,30.19203368
32142,785106933,3-16-24 12:28,449.21,Payment,Loan Payment,-419.0179663
32143,785106933,3-16-24 20:28,273.47,OutgoingTransfer,International Transfer,-692.4879663
32144,785106933,3-21-24 15:28,451.1,Deposit,Mobile Deposit,-241.3879663
32145,785106933,3-22-24 13:28,136.9,Deposit,Cash Deposit,-104.4879663
32146,785106933,3-24-24 16:28,388.11,Payment,Loan Payment,-492.5979663
32147,785106933,3-24-24 17:28,42.43,Purchase,Home Improvement,-535.0279663
32148,785106933,3-24-24 19:28,63.77,Deposit,Cash Deposit,-471.2579663
32149,785106933,3-24-24 22:28,121.72,Deposit,Cash Deposit,-349.5379663
32150,785106933,3-26-24 9:28,439.74,Deposit,Cash Deposit,90.20203368
32151,785106933,3-26-24 18:28,354.42,Deposit,Check Deposit,444.6220337
32152,785106933,3-28-24 15:28,95.99,Payment,Mortgage Payment,348.6320337
32153,785106933,3-28-24 18:28,429.98,Return,Target Return,778.6120337
32154,785106933,3-30-24 12:28,263.54,Deposit,Mobile Deposit,1042.152034
32155,785106933,3-31-24 20:28,72.37,Purchase,Grocery,969.7820337
32156,785106933,3-31-24 22:28,121.18,Withdrawal,Branch Withdrawal,848.6020337
32157,785106933,04-01-24 21:28,3650,IncomingTransfer,Salary,4498.602034
32158,785106933,04-05-24 15:28,423.77,Payment,Loan Payment,4074.832034
32159,785106933,04-06-24 21:28,2800,Payment,Credit Card Payment,1274.832034
32160,785106933,04-06-24 22:28,362.16,Payment,Loan Payment,912.6720337
32161,785106933,4-13-24 12:28,117.84,Return,Target Return,1030.512034
32162,785106933,4-14-24 17:28,19.02,OnlineShopping,AliExpress,1011.492034
32163,785106933,4-15-24 21:28,1300,Payment,Installment Payment,-288.5079663
32164,785106933,4-18-24 9:28,41.21,Deposit,Direct Deposit,-247.2979663
32165,785106933,4-20-24 18:28,81.88,OutgoingTransfer,International Transfer,-329.1779663
32166,785106933,4-23-24 14:28,478.02,Deposit,Check Deposit,148.8420337
32167,785106933,4-27-24 13:28,492.91,Payment,Loan Payment,-344.0679663
32168,785106933,05-02-24 18:28,27.41,Payment,Bill Payment,-371.4779663
32169,785106933,05-04-24 21:28,3650,IncomingTransfer,Salary,3278.522034
32170,785106933,05-09-24 21:28,3200,Payment,Credit Card Payment,78.52203368
32171,785106933,05-09-24 22:28,160.57,Return,eBay Return,239.0920337
32172,785106933,05-10-24 21:28,1600,Payment,Subscription Payment,-1360.907966
32173,785106933,05-12-24 22:28,341.51,Purchase,Entertainment,-1702.417966
32174,785106933,5-15-24 12:28,482.19,Deposit,Check Deposit,-1220.227966
32175,785106933,5-15-24 13:28,231.38,Payment,Bill Payment,-1451.607966
32176,785106933,5-16-24 9:28,441.06,Payment,Bill Payment,-1892.667966
32177,785106933,5-16-24 10:28,12.26,Deposit,Check Deposit,-1880.407966
32178,785106933,5-17-24 10:28,318.57,Deposit,Check Deposit,-1561.837966
32179,785106933,5-18-24 16:28,110.05,Withdrawal,Branch Withdrawal,-1671.887966
32180,785106933,5-19-24 16:28,398.81,Purchase,Restaurant,-2070.697966
32181,785106933,5-20-24 19:28,351.24,Purchase,Entertainment,-2421.937966
32182,785106933,5-22-24 14:28,367.5,Purchase,Entertainment,-2789.437966
32183,785106933,5-26-24 20:28,301.97,Withdrawal,Mobile App Withdrawal,-3091.407966
32184,785106933,06-01-24 10:28,220.54,Withdrawal,Branch Withdrawal,-3311.947966
32185,785106933,06-02-24 15:28,86.01,Purchase,Restaurant,-3397.957966
32186,785106933,06-04-24 21:28,3650,IncomingTransfer,Salary,252.0420337
32187,785106933,06-05-24 9:28,70.83,Deposit,Direct Deposit,322.8720337
32188,785106933,06-05-24 10:28,139.41,Deposit,Direct Deposit,462.2820337
32189,785106933,06-09-24 21:28,2400,Payment,Credit Card Payment,-1937.717966
32190,785106933,06-12-24 22:28,332.38,IncomingTransfer,Freelance Payment,-1605.337966
32191,785106933,6-13-24 21:28,1500,Payment,Insurance Payment,-3105.337966
32192,785106933,6-17-24 21:28,154.18,Payment,Bill Payment,-3259.517966
32193,785106933,6-22-24 12:28,197.43,IncomingTransfer,Freelance Payment,-3062.087966
32194,785106933,6-23-24 10:28,121.82,Withdrawal,Branch Withdrawal,-3183.907966
32195,785106933,6-26-24 13:28,107.63,Deposit,Cash Deposit,-3076.277966
32196,785106933,6-28-24 16:28,469.24,Purchase,Clothing,-3545.517966
32197,785106933,07-01-24 21:28,3650,IncomingTransfer,Salary,104.4820337
32198,785106933,07-02-24 16:28,431.85,Purchase,Gas,-327.3679663
32199,785106933,07-06-24 21:28,2700,Payment,Credit Card Payment,-3027.367966
32200,785106933,07-07-24 12:28,267.13,Return,eBay Return,-2760.237966
32201,785106933,07-07-24 13:28,184.64,Payment,Loan Payment,-2944.877966
32202,785106933,07-10-24 20:28,17.93,Deposit,Cash Deposit,-2926.947966
32203,785106933,07-12-24 19:28,267.32,OutgoingTransfer,International Transfer,-3194.267966
32204,785106933,7-13-24 17:28,46.25,OutgoingTransfer,Bank Transfer,-3240.517966
32205,785106933,7-18-24 21:28,1000,Payment,Installment Payment,-4240.517966
32206,786480183,1-26-24 20:28,486.98,Payment,Mortgage Payment,-486.98
32207,786480183,1-29-24 12:28,54.05,Return,AliExpress Return,-432.93
32208,786480183,1-30-24 9:28,184.61,Return,AliExpress Return,-248.32
32209,786480183,1-30-24 19:28,457.19,OnlineShopping,Walmart,-705.51
32210,786480183,02-02-24 21:28,13.92,IncomingTransfer,Freelance Payment,-691.59
32211,786480183,02-04-24 15:28,107.93,OnlineShopping,Walmart,-799.52
32212,786480183,02-04-24 21:28,4300,IncomingTransfer,Salary,3500.48
32213,786480183,02-06-24 11:28,343.35,OnlineShopping,AliExpress,3157.13
32214,786480183,02-06-24 14:28,233.61,Payment,Bill Payment,2923.52
32215,786480183,02-07-24 14:28,153.48,Purchase,Pharmacy,2770.04
32216,786480183,02-10-24 21:28,1100,Payment,Rent Payment,1670.04
32217,786480183,02-11-24 14:28,477.79,Withdrawal,Branch Withdrawal,1192.25
32218,786480183,02-11-24 22:28,35.88,Deposit,Mobile Deposit,1228.13
32219,786480183,02-12-24 11:28,74.09,Deposit,Direct Deposit,1302.22
32220,786480183,02-12-24 17:28,342.09,Return,eBay Return,1644.31
32221,786480183,03-02-24 10:28,433.67,Deposit,Mobile Deposit,2077.98
32222,786480183,03-05-24 15:28,479.74,Deposit,Cash Deposit,2557.72
32223,786480183,03-05-24 21:28,4300,IncomingTransfer,Salary,6857.72
32224,786480183,03-06-24 22:28,283.05,OutgoingTransfer,Peer-to-Peer Transfer,6574.67
32225,786480183,03-11-24 21:28,295.2,Purchase,Pharmacy,6279.47
32226,786480183,03-12-24 21:28,2200,Payment,Rent Payment,4079.47
32227,786480183,3-20-24 11:28,48.34,Return,Best Buy Return,4127.81
32228,786480183,3-20-24 14:28,137.61,Deposit,Direct Deposit,4265.42
32229,786480183,3-20-24 14:28,410.39,Purchase,Restaurant,3855.03
32230,786480183,3-23-24 13:28,55.92,OnlineShopping,Best Buy,3799.11
32231,786480183,3-26-24 16:28,21.85,Purchase,Furniture,3777.26
32232,786480183,3-27-24 15:28,114.23,Purchase,Entertainment,3663.03
32233,786480183,3-27-24 21:28,163.19,Purchase,Clothing,3499.84
32234,786480183,3-28-24 16:28,20.48,Purchase,Gas,3479.36
32235,786480183,3-29-24 10:28,233.45,Deposit,Direct Deposit,3712.81
32236,786480183,04-03-24 12:28,324.4,Return,Target Return,4037.21
32237,786480183,04-03-24 13:28,458.01,Withdrawal,Branch Withdrawal,3579.2
32238,786480183,04-04-24 21:28,4300,IncomingTransfer,Salary,7879.2
32239,786480183,04-06-24 14:28,145.17,OutgoingTransfer,Bank Transfer,7734.03
32240,786480183,04-09-24 11:28,199.34,Payment,Mortgage Payment,7534.69
32241,786480183,4-18-24 21:28,2400,Payment,Rent Payment,5134.69
32242,786480183,4-24-24 10:28,101.95,Deposit,Check Deposit,5236.64
32243,786480183,4-27-24 10:28,26.54,Deposit,Check Deposit,5263.18
32244,786480183,4-27-24 21:28,341.52,OnlineShopping,Amazon,4921.66
32245,786480183,4-27-24 22:28,131.59,Deposit,Check Deposit,5053.25
32246,786480183,4-28-24 20:28,332.72,Purchase,Grocery,4720.53
32247,786480183,4-29-24 13:28,152.13,Withdrawal,Mobile App Withdrawal,4568.4
32248,786480183,4-30-24 18:28,206.23,Payment,Mortgage Payment,4362.17
32249,786480183,05-01-24 10:28,314.19,Purchase,Restaurant,4047.98
32250,786480183,05-02-24 9:28,49.64,Return,Target Return,4097.62
32251,786480183,05-03-24 21:28,4300,IncomingTransfer,Salary,8397.62
32252,786480183,05-04-24 10:28,453.22,Withdrawal,Mobile App Withdrawal,7944.4
32253,786480183,05-06-24 13:28,409.05,Withdrawal,Mobile App Withdrawal,7535.35
32254,786480183,05-06-24 14:28,270.62,Deposit,Direct Deposit,7805.97
32255,786480183,05-08-24 19:28,345.71,Deposit,Direct Deposit,8151.68
32256,786480183,05-11-24 10:28,300.93,IncomingTransfer,Freelance Payment,8452.61
32257,786480183,05-11-24 18:28,278.83,Withdrawal,ATM Withdrawal,8173.78
32258,786480183,5-14-24 12:28,370.78,Deposit,Check Deposit,8544.56
32259,786480183,5-14-24 21:28,1900,Payment,Rent Payment,6644.56
32260,786480183,5-15-24 16:28,473.49,Deposit,Check Deposit,7118.05
32261,786480183,5-15-24 22:28,69.13,OutgoingTransfer,Wire Transfer,7048.92
32262,786480183,5-18-24 12:28,211.6,OnlineShopping,Best Buy,6837.32
32263,786480183,5-23-24 17:28,321.61,Payment,Mortgage Payment,6515.71
32264,786480183,5-25-24 14:28,21.51,Deposit,Check Deposit,6537.22
32265,786480183,5-26-24 21:28,467.08,OutgoingTransfer,Wire Transfer,6070.14
32266,786480183,5-27-24 9:28,129.59,Purchase,Restaurant,5940.55
32267,786480183,06-01-24 21:28,4300,IncomingTransfer,Salary,10240.55
32268,786480183,06-04-24 21:28,270.3,Purchase,Clothing,9970.25
32269,786480183,06-05-24 17:28,493.25,Purchase,Pharmacy,9477
32270,786480183,06-07-24 22:28,124.56,OnlineShopping,Target,9352.44
32271,786480183,6-14-24 14:28,116.99,Purchase,Grocery,9235.45
32272,786480183,6-16-24 16:28,254.83,Purchase,Furniture,8980.62
32273,786480183,6-16-24 21:28,458.94,Withdrawal,ATM Withdrawal,8521.68
32274,786480183,6-18-24 21:28,2400,Payment,Rent Payment,6121.68
32275,786480183,6-18-24 22:28,102.21,OutgoingTransfer,Peer-to-Peer Transfer,6019.47
32276,786480183,6-20-24 10:28,53.98,OnlineShopping,eBay,5965.49
32277,786480183,6-22-24 15:28,351.3,OnlineShopping,eBay,5614.19
32278,786480183,6-26-24 22:28,169.71,OutgoingTransfer,Wire Transfer,5444.48
32279,786480183,6-26-24 22:28,448.82,Deposit,Direct Deposit,5893.3
32280,786480183,07-01-24 21:28,4300,IncomingTransfer,Salary,10193.3
32281,786480183,07-02-24 21:28,211.72,OutgoingTransfer,Wire Transfer,9981.58
32282,786480183,07-03-24 12:28,111.64,Deposit,Direct Deposit,10093.22
32283,786480183,7-14-24 12:28,68.52,Deposit,Mobile Deposit,10161.74
32284,786480183,7-15-24 9:28,36.7,OnlineShopping,AliExpress,10125.04
32285,786480183,7-15-24 13:28,173.84,Deposit,Direct Deposit,10298.88
32286,786480183,7-15-24 21:28,2700,Payment,Rent Payment,7598.88
32287,787493808,1-23-24 17:28,237.68,Purchase,Entertainment,1344.008236
32288,787493808,1-25-24 21:28,82.83,Purchase,Home Improvement,1261.178236
32289,787493808,02-01-24 15:28,157.34,Payment,Loan Payment,1103.838236
32290,787493808,02-02-24 20:28,139.01,OutgoingTransfer,Bank Transfer,964.828236
32291,787493808,02-03-24 10:28,183.05,OnlineShopping,eBay,781.778236
32292,787493808,02-04-24 21:28,3050,IncomingTransfer,Salary,3831.778236
32293,787493808,02-05-24 20:28,43.23,Deposit,Cash Deposit,3875.008236
32294,787493808,02-06-24 21:28,191.51,OutgoingTransfer,Wire Transfer,3683.498236
32295,787493808,02-08-24 15:28,58.37,Deposit,Mobile Deposit,3741.868236
32296,787493808,02-09-24 21:28,2600,Payment,Credit Card Payment,1141.868236
32297,787493808,02-10-24 21:28,1400,Payment,Rent Payment,-258.131764
32298,787493808,2-13-24 13:28,153.52,Withdrawal,Branch Withdrawal,-411.651764
32299,787493808,2-20-24 11:28,15.19,Deposit,Direct Deposit,-396.461764
32300,787493808,2-20-24 12:28,129.38,Deposit,Cash Deposit,-267.081764
32301,787493808,2-23-24 22:28,68.31,Deposit,Check Deposit,-198.771764
32302,787493808,03-02-24 21:28,3050,IncomingTransfer,Salary,2851.228236
32303,787493808,03-05-24 23:28,39.31,Withdrawal,Branch Withdrawal,2811.918236
32304,787493808,03-07-24 21:28,3000,Payment,Credit Card Payment,-188.081764
32305,787493808,03-09-24 12:28,153.85,OutgoingTransfer,International Transfer,-341.931764
32306,787493808,3-13-24 13:28,176.42,OnlineShopping,Walmart,-518.351764
32307,787493808,3-16-24 21:28,1600,Payment,Rent Payment,-2118.351764
32308,787493808,3-17-24 15:28,208.64,Purchase,Restaurant,-2326.991764
32309,787493808,3-27-24 17:28,14.97,OnlineShopping,Target,-2341.961764
32310,787493808,3-27-24 18:28,188.5,Payment,Mortgage Payment,-2530.461764
32311,787493808,3-31-24 11:28,159.04,OnlineShopping,Walmart,-2689.501764
32312,787493808,04-01-24 14:28,39.37,Deposit,Check Deposit,-2650.131764
32313,787493808,04-05-24 21:28,3050,IncomingTransfer,Salary,399.868236
32314,787493808,04-10-24 21:28,3300,Payment,Credit Card Payment,-2900.131764
32315,787493808,04-11-24 13:28,154.64,OutgoingTransfer,Wire Transfer,-3054.771764
32316,787493808,4-13-24 21:28,900,Payment,Rent Payment,-3954.771764
32317,787493808,4-14-24 10:28,28.66,Withdrawal,ATM Withdrawal,-3983.431764
32318,787493808,4-15-24 20:28,237.57,Purchase,Gas,-4221.001764
32319,787493808,4-15-24 21:28,74.81,Withdrawal,ATM Withdrawal,-4295.811764
32320,787493808,4-16-24 9:28,125.08,Payment,Mortgage Payment,-4420.891764
32321,787493808,4-16-24 17:28,35.79,Purchase,Electronics,-4456.681764
32322,787493808,4-16-24 19:28,168.11,Deposit,Cash Deposit,-4288.571764
32323,787493808,4-24-24 21:28,33.14,Return,Best Buy Return,-4255.431764
32324,787493808,05-04-24 21:28,3050,IncomingTransfer,Salary,-1205.431764
32325,787493808,05-09-24 13:28,212.79,Purchase,Furniture,-1418.221764
32326,787493808,05-09-24 21:28,3600,Payment,Credit Card Payment,-5018.221764
32327,787493808,05-11-24 10:28,82.02,Payment,Mortgage Payment,-5100.241764
32328,787493808,05-12-24 21:28,1200,Payment,Rent Payment,-6300.241764
32329,787493808,5-13-24 13:28,191.43,Purchase,Travel,-6491.671764
32330,787493808,5-13-24 21:28,98.17,OutgoingTransfer,Bank Transfer,-6589.841764
32331,787493808,5-20-24 17:28,13.08,Deposit,Mobile Deposit,-6576.761764
32332,787493808,5-23-24 13:28,110.94,Withdrawal,Mobile App Withdrawal,-6687.701764
32333,787493808,5-23-24 21:28,190.36,Purchase,Restaurant,-6878.061764
32334,787493808,5-24-24 14:28,218.36,OnlineShopping,eBay,-7096.421764
32335,787493808,5-24-24 23:28,157.94,OnlineShopping,eBay,-7254.361764
32336,787493808,5-25-24 10:28,28.42,OutgoingTransfer,Bank Transfer,-7282.781764
32337,787493808,5-28-24 19:28,126.6,OnlineShopping,Amazon,-7409.381764
32338,787493808,06-05-24 21:28,3050,IncomingTransfer,Salary,-4359.381764
32339,787493808,06-10-24 21:28,2700,Payment,Credit Card Payment,-7059.381764
32340,787493808,06-12-24 13:28,109.47,Withdrawal,Mobile App Withdrawal,-7168.851764
32341,787493808,06-12-24 23:28,236.42,Purchase,Furniture,-7405.271764
32342,787493808,6-13-24 22:28,123.32,Return,AliExpress Return,-7281.951764
32343,787493808,6-16-24 15:28,233.67,Withdrawal,Mobile App Withdrawal,-7515.621764
32344,787493808,6-16-24 21:28,1300,Payment,Rent Payment,-8815.621764
32345,787493808,6-24-24 22:28,94.3,Payment,Loan Payment,-8909.921764
32346,787493808,07-02-24 16:28,56.78,Deposit,Check Deposit,-8853.141764
32347,787493808,07-03-24 9:28,10.03,Withdrawal,Mobile App Withdrawal,-8863.171764
32348,787493808,07-05-24 12:28,239.67,Deposit,Cash Deposit,-8623.501764
32349,787493808,07-05-24 21:28,3050,IncomingTransfer,Salary,-5573.501764
32350,787493808,07-10-24 21:28,3200,Payment,Credit Card Payment,-8773.501764
32351,787493808,7-15-24 18:28,54.99,OnlineShopping,AliExpress,-8828.491764
32352,787493808,7-17-24 16:28,130.52,Payment,Loan Payment,-8959.011764
32353,787493808,7-18-24 21:28,1200,Payment,Rent Payment,-10159.01176
32354,787655058,1-23-24 10:28,126.41,Withdrawal,Branch Withdrawal,1536.849185
32355,787655058,1-24-24 21:28,164.2,Deposit,Direct Deposit,1701.049185
32356,787655058,1-27-24 10:28,34.04,Deposit,Mobile Deposit,1735.089185
32357,787655058,1-31-24 10:28,37.76,OnlineShopping,Walmart,1697.329185
32358,787655058,02-01-24 15:28,106.02,Deposit,Check Deposit,1803.349185
32359,787655058,02-02-24 15:28,37.04,OutgoingTransfer,Wire Transfer,1766.309185
32360,787655058,02-05-24 21:28,3100,IncomingTransfer,Salary,4866.309185
32361,787655058,02-07-24 14:28,71.63,Deposit,Cash Deposit,4937.939185
32362,787655058,02-08-24 21:28,147.53,Purchase,Electronics,4790.409185
32363,787655058,02-09-24 19:28,137.49,OutgoingTransfer,Wire Transfer,4652.919185
32364,787655058,02-10-24 21:28,2300,Payment,Credit Card Payment,2352.919185
32365,787655058,02-10-24 22:28,174.65,Purchase,Restaurant,2178.269185
32366,787655058,02-12-24 21:28,1300,Payment,Subscription Payment,878.269185
32367,787655058,2-13-24 14:28,90.7,Deposit,Cash Deposit,968.969185
32368,787655058,2-19-24 11:28,102.63,OutgoingTransfer,Peer-to-Peer Transfer,866.339185
32369,787655058,2-24-24 13:28,175.99,Payment,Bill Payment,690.349185
32370,787655058,2-25-24 10:28,150.15,Return,Amazon Return,840.499185
32371,787655058,2-25-24 22:28,45.59,OnlineShopping,Best Buy,794.909185
32372,787655058,2-28-24 11:28,27.23,OutgoingTransfer,International Transfer,767.679185
32373,787655058,03-01-24 9:28,16.5,Purchase,Electronics,751.179185
32374,787655058,03-02-24 10:28,86.78,Purchase,Furniture,664.399185
32375,787655058,03-03-24 11:28,156.85,Withdrawal,ATM Withdrawal,507.549185
32376,787655058,03-03-24 21:28,3100,IncomingTransfer,Salary,3607.549185
32377,787655058,03-05-24 14:28,118.18,Deposit,Mobile Deposit,3725.729185
32378,787655058,03-07-24 13:28,26.96,Deposit,Check Deposit,3752.689185
32379,787655058,03-07-24 17:28,107.54,Deposit,Check Deposit,3860.229185
32380,787655058,03-08-24 14:28,146.4,OnlineShopping,Walmart,3713.829185
32381,787655058,03-08-24 21:28,2300,Payment,Credit Card Payment,1413.829185
32382,787655058,03-12-24 20:28,63.58,OnlineShopping,Amazon,1350.249185
32383,787655058,3-13-24 21:28,900,Payment,Installment Payment,450.249185
32384,787655058,3-16-24 12:28,60.55,Return,Walmart Return,510.799185
32385,787655058,3-18-24 13:28,158.56,Withdrawal,Branch Withdrawal,352.239185
32386,787655058,3-20-24 12:28,68.39,Deposit,Cash Deposit,420.629185
32387,787655058,3-21-24 12:28,79.04,Return,Best Buy Return,499.669185
32388,787655058,3-24-24 19:28,212.04,Withdrawal,ATM Withdrawal,287.629185
32389,787655058,3-25-24 10:28,30.72,Payment,Loan Payment,256.909185
32390,787655058,3-26-24 22:28,186.05,Payment,Bill Payment,70.85918498
32391,787655058,3-28-24 17:28,126.72,OutgoingTransfer,Bank Transfer,-55.86081502
32392,787655058,3-29-24 17:28,118.99,Deposit,Cash Deposit,63.12918498
32393,787655058,3-30-24 21:28,140.6,Return,Walmart Return,203.729185
32394,787655058,3-31-24 18:28,204.54,Return,AliExpress Return,408.269185
32395,787655058,04-02-24 22:28,206.7,Deposit,Direct Deposit,614.969185
32396,787655058,04-03-24 10:28,62.84,Purchase,Restaurant,552.129185
32397,787655058,04-04-24 12:28,165.7,Purchase,Entertainment,386.429185
32398,787655058,04-04-24 21:28,3100,IncomingTransfer,Salary,3486.429185
32399,787655058,04-05-24 12:28,182.21,OutgoingTransfer,Wire Transfer,3304.219185
32400,787655058,04-09-24 21:28,2500,Payment,Credit Card Payment,804.219185
32401,787655058,04-10-24 10:28,213.48,OnlineShopping,Amazon,590.739185
32402,787655058,04-12-24 13:28,164.07,Purchase,Travel,426.669185
32403,787655058,04-12-24 17:28,34.35,Withdrawal,Mobile App Withdrawal,392.319185
32404,787655058,04-12-24 21:28,1300,Payment,Insurance Payment,-907.680815
32405,787655058,4-14-24 13:28,235.53,OutgoingTransfer,International Transfer,-1143.210815
32406,787655058,4-15-24 17:28,44.35,Purchase,Home Improvement,-1187.560815
32407,787655058,4-17-24 12:28,159.61,Withdrawal,Branch Withdrawal,-1347.170815
32408,787655058,4-19-24 18:28,46.06,Purchase,Entertainment,-1393.230815
32409,787655058,4-30-24 13:28,182.06,OutgoingTransfer,Peer-to-Peer Transfer,-1575.290815
32410,787655058,4-30-24 13:28,210.27,Purchase,Pharmacy,-1785.560815
32411,787655058,05-03-24 17:28,53.21,Payment,Bill Payment,-1838.770815
32412,787655058,05-04-24 10:28,229.01,OnlineShopping,AliExpress,-2067.780815
32413,787655058,05-04-24 22:28,150.25,IncomingTransfer,Freelance Payment,-1917.530815
32414,787655058,05-05-24 21:28,3100,IncomingTransfer,Salary,1182.469185
32415,787655058,05-06-24 16:28,158.99,Withdrawal,ATM Withdrawal,1023.479185
32416,787655058,05-10-24 18:28,118.02,Purchase,Restaurant,905.459185
32417,787655058,05-10-24 21:28,2600,Payment,Credit Card Payment,-1694.540815
32418,787655058,05-12-24 14:28,40.08,Deposit,Cash Deposit,-1654.460815
32419,787655058,05-12-24 15:28,66.29,Withdrawal,ATM Withdrawal,-1720.750815
32420,787655058,5-14-24 21:28,126.48,Payment,Bill Payment,-1847.230815
32421,787655058,5-15-24 21:28,1000,Payment,Installment Payment,-2847.230815
32422,787655058,5-17-24 19:28,33.55,OutgoingTransfer,Bank Transfer,-2880.780815
32423,787655058,5-19-24 17:28,136.01,OutgoingTransfer,Bank Transfer,-3016.790815
32424,787655058,5-27-24 13:28,91.36,Payment,Mortgage Payment,-3108.150815
32425,787655058,5-30-24 21:28,88.27,Purchase,Grocery,-3196.420815
32426,787655058,06-01-24 17:28,177.15,OnlineShopping,Best Buy,-3373.570815
32427,787655058,06-03-24 10:28,106.01,Deposit,Mobile Deposit,-3267.560815
32428,787655058,06-03-24 14:28,103.44,Withdrawal,Branch Withdrawal,-3371.000815
32429,787655058,06-04-24 21:28,3100,IncomingTransfer,Salary,-271.000815
32430,787655058,06-06-24 12:28,47.41,OnlineShopping,AliExpress,-318.410815
32431,787655058,06-06-24 17:28,101.78,OutgoingTransfer,Peer-to-Peer Transfer,-420.190815
32432,787655058,06-08-24 14:28,118.24,Return,Best Buy Return,-301.950815
32433,787655058,06-09-24 12:28,158.33,Withdrawal,Branch Withdrawal,-460.280815
32434,787655058,06-09-24 21:28,2700,Payment,Credit Card Payment,-3160.280815
32435,787655058,06-11-24 18:28,138.11,OnlineShopping,Best Buy,-3298.390815
32436,787655058,06-11-24 21:28,900,Payment,Subscription Payment,-4198.390815
32437,787655058,6-14-24 23:28,79.77,Purchase,Pharmacy,-4278.160815
32438,787655058,6-16-24 14:28,55.01,OutgoingTransfer,Bank Transfer,-4333.170815
32439,787655058,6-16-24 20:28,111.7,Deposit,Direct Deposit,-4221.470815
32440,787655058,6-18-24 13:28,201.74,OnlineShopping,Best Buy,-4423.210815
32441,787655058,6-19-24 20:28,227.83,OutgoingTransfer,Wire Transfer,-4651.040815
32442,787655058,6-20-24 14:28,111.25,IncomingTransfer,Freelance Payment,-4539.790815
32443,787655058,6-20-24 16:28,214.19,OnlineShopping,Walmart,-4753.980815
32444,787655058,6-20-24 22:28,48.77,Return,Store Return,-4705.210815
32445,787655058,6-23-24 13:28,179.04,Payment,Bill Payment,-4884.250815
32446,787655058,6-23-24 19:28,89.39,Deposit,Cash Deposit,-4794.860815
32447,787655058,6-27-24 12:28,137.11,Purchase,Pharmacy,-4931.970815
32448,787655058,07-02-24 21:28,3100,IncomingTransfer,Salary,-1831.970815
32449,787655058,07-04-24 14:28,57.35,Withdrawal,Branch Withdrawal,-1889.320815
32450,787655058,07-05-24 9:28,244.26,IncomingTransfer,Freelance Payment,-1645.060815
32451,787655058,07-07-24 21:28,2100,Payment,Credit Card Payment,-3745.060815
32452,787655058,07-08-24 12:28,51.21,Withdrawal,Mobile App Withdrawal,-3796.270815
32453,787655058,07-09-24 21:28,226.95,Purchase,Furniture,-4023.220815
32454,787655058,07-12-24 18:28,108.54,Return,Target Return,-3914.680815
32455,787655058,07-12-24 21:28,1000,Payment,Installment Payment,-4914.680815
32456,787655058,7-16-24 22:28,161.05,IncomingTransfer,Freelance Payment,-4753.630815
32457,787723758,1-21-24 13:28,65.6,OnlineShopping,Best Buy,748.9089875
32458,787723758,1-26-24 22:28,45.21,Withdrawal,Branch Withdrawal,703.6989875
32459,787723758,1-27-24 19:28,133.77,Return,Walmart Return,837.4689875
32460,787723758,1-30-24 12:28,79.22,Purchase,Home Improvement,758.2489875
32461,787723758,1-30-24 20:28,39.24,Withdrawal,Branch Withdrawal,719.0089875
32462,787723758,1-30-24 20:28,104.65,Purchase,Furniture,614.3589875
32463,787723758,1-31-24 12:28,238.69,Payment,Loan Payment,375.6689875
32464,787723758,1-31-24 17:28,176.68,Purchase,Clothing,198.9889875
32465,787723758,02-01-24 21:28,2000,IncomingTransfer,Salary,2198.988988
32466,787723758,02-02-24 15:28,139.88,Deposit,Mobile Deposit,2338.868988
32467,787723758,02-03-24 10:28,46.41,Deposit,Mobile Deposit,2385.278988
32468,787723758,02-03-24 18:28,52.5,Purchase,Home Improvement,2332.778988
32469,787723758,02-04-24 19:28,184.37,Withdrawal,Mobile App Withdrawal,2148.408988
32470,787723758,02-04-24 19:28,247.02,Withdrawal,Mobile App Withdrawal,1901.388988
32471,787723758,02-05-24 16:28,116.36,Return,eBay Return,2017.748988
32472,787723758,02-06-24 21:28,1800,Payment,Credit Card Payment,217.7489875
32473,787723758,02-06-24 21:28,160.51,OnlineShopping,AliExpress,57.23898752
32474,787723758,02-07-24 14:28,126.28,Purchase,Grocery,-69.04101248
32475,787723758,02-10-24 10:28,134.76,Withdrawal,Branch Withdrawal,-203.8010125
32476,787723758,2-14-24 21:28,1100,Payment,Rent Payment,-1303.801012
32477,787723758,2-15-24 20:28,181.46,Return,AliExpress Return,-1122.341012
32478,787723758,2-16-24 9:28,168.37,OnlineShopping,Amazon,-1290.711012
32479,787723758,2-18-24 15:28,36.02,Purchase,Clothing,-1326.731012
32480,787723758,2-19-24 16:28,106.86,Deposit,Mobile Deposit,-1219.871012
32481,787723758,2-21-24 9:28,173.99,Deposit,Cash Deposit,-1045.881012
32482,787723758,2-23-24 14:28,12.71,Purchase,Grocery,-1058.591012
32483,787723758,2-25-24 19:28,80.85,Withdrawal,ATM Withdrawal,-1139.441012
32484,787723758,2-25-24 21:28,80.03,Deposit,Mobile Deposit,-1059.411012
32485,787723758,2-26-24 14:28,184.82,Deposit,Mobile Deposit,-874.5910125
32486,787723758,03-01-24 17:28,25.87,OutgoingTransfer,International Transfer,-900.4610125
32487,787723758,03-02-24 20:28,26.73,Withdrawal,Mobile App Withdrawal,-927.1910125
32488,787723758,03-05-24 20:28,230.55,Return,Best Buy Return,-696.6410125
32489,787723758,03-05-24 21:28,2000,IncomingTransfer,Salary,1303.358988
32490,787723758,03-05-24 23:28,238.31,Purchase,Gas,1065.048988
32491,787723758,03-06-24 21:28,154.26,Deposit,Direct Deposit,1219.308988
32492,787723758,03-07-24 12:28,18.28,Return,Store Return,1237.588988
32493,787723758,03-08-24 20:28,33.2,Deposit,Mobile Deposit,1270.788988
32494,787723758,03-09-24 10:28,45.17,Return,Target Return,1315.958988
32495,787723758,03-10-24 17:28,130.93,Purchase,Home Improvement,1185.028988
32496,787723758,03-10-24 21:28,2000,Payment,Credit Card Payment,-814.9710125
32497,787723758,03-12-24 13:28,161.57,IncomingTransfer,Freelance Payment,-653.4010125
32498,787723758,03-12-24 13:28,245.32,OnlineShopping,Amazon,-898.7210125
32499,787723758,3-14-24 10:28,32.11,OutgoingTransfer,Bank Transfer,-930.8310125
32500,787723758,3-15-24 16:28,112.2,Deposit,Direct Deposit,-818.6310125
32501,787723758,3-17-24 11:28,23.38,OnlineShopping,Walmart,-842.0110125
32502,787723758,3-17-24 21:28,900,Payment,Rent Payment,-1742.011012
32503,787723758,3-18-24 11:28,81.6,Payment,Bill Payment,-1823.611012
32504,787723758,3-20-24 23:28,207.17,IncomingTransfer,Freelance Payment,-1616.441012
32505,787723758,3-21-24 20:28,174.16,Payment,Loan Payment,-1790.601012
32506,787723758,3-22-24 22:28,50.59,Payment,Bill Payment,-1841.191012
32507,787723758,3-23-24 17:28,136.22,Purchase,Clothing,-1977.411012
32508,787723758,3-23-24 18:28,10.17,Return,Amazon Return,-1967.241012
32509,787723758,3-26-24 21:28,214.73,OnlineShopping,Best Buy,-2181.971012
32510,787723758,3-28-24 23:28,86.88,Withdrawal,Mobile App Withdrawal,-2268.851012
32511,787723758,3-29-24 23:28,144.92,Deposit,Check Deposit,-2123.931012
32512,787723758,3-30-24 13:28,33.89,Payment,Bill Payment,-2157.821012
32513,787723758,3-31-24 20:28,43.88,Deposit,Check Deposit,-2113.941012
32514,787723758,04-02-24 21:28,2000,IncomingTransfer,Salary,-113.9410125
32515,787723758,04-03-24 15:28,169.07,Deposit,Check Deposit,55.12898752
32516,787723758,04-04-24 18:28,130.42,OnlineShopping,Target,-75.29101248
32517,787723758,04-04-24 21:28,51.61,Deposit,Direct Deposit,-23.68101248
32518,787723758,04-05-24 11:28,224.99,OnlineShopping,eBay,-248.6710125
32519,787723758,04-05-24 15:28,177.13,Withdrawal,ATM Withdrawal,-425.8010125
32520,787723758,04-07-24 21:28,1700,Payment,Credit Card Payment,-2125.801012
32521,787723758,04-10-24 21:28,1300,Payment,Rent Payment,-3425.801012
32522,787723758,04-11-24 11:28,37.27,Withdrawal,Branch Withdrawal,-3463.071012
32523,787723758,4-20-24 18:28,221.59,Return,Best Buy Return,-3241.481012
32524,787723758,4-23-24 22:28,218.41,OnlineShopping,Target,-3459.891012
32525,787723758,4-25-24 17:28,194.25,Deposit,Direct Deposit,-3265.641012
32526,787723758,4-28-24 20:28,24.78,OutgoingTransfer,International Transfer,-3290.421012
32527,787723758,05-01-24 18:28,76.7,OnlineShopping,Target,-3367.121012
32528,787723758,05-01-24 21:28,2000,IncomingTransfer,Salary,-1367.121012
32529,787723758,05-02-24 10:28,14.96,Return,Amazon Return,-1352.161012
32530,787723758,05-03-24 10:28,222.49,Deposit,Check Deposit,-1129.671012
32531,787723758,05-03-24 14:28,114.29,Payment,Bill Payment,-1243.961012
32532,787723758,05-03-24 14:28,121.6,Payment,Mortgage Payment,-1365.561012
32533,787723758,05-04-24 16:28,60.18,IncomingTransfer,Freelance Payment,-1305.381012
32534,787723758,05-06-24 16:28,57.69,Deposit,Cash Deposit,-1247.691012
32535,787723758,05-06-24 21:28,1600,Payment,Credit Card Payment,-2847.691012
32536,787723758,05-08-24 20:28,240.31,Return,Etsy Return,-2607.381012
32537,787723758,05-09-24 10:28,193.06,Purchase,Grocery,-2800.441012
32538,787723758,05-10-24 13:28,27.58,Return,Amazon Return,-2772.861012
32539,787723758,05-10-24 13:28,141.01,Purchase,Electronics,-2913.871012
32540,787723758,05-12-24 17:28,91.58,Return,Store Return,-2822.291012
32541,787723758,05-12-24 21:28,1200,Payment,Rent Payment,-4022.291012
32542,787723758,5-13-24 9:28,24.16,Withdrawal,Branch Withdrawal,-4046.451012
32543,787723758,5-15-24 13:28,214.39,OutgoingTransfer,Bank Transfer,-4260.841012
32544,787723758,5-24-24 23:28,94.26,OnlineShopping,Etsy,-4355.101012
32545,787723758,5-25-24 17:28,75.7,Deposit,Check Deposit,-4279.401012
32546,787723758,5-28-24 23:28,73.51,Deposit,Cash Deposit,-4205.891012
32547,787723758,5-29-24 9:28,97.37,Purchase,Grocery,-4303.261012
32548,787723758,06-02-24 17:28,193.35,OutgoingTransfer,International Transfer,-4496.611012
32549,787723758,06-02-24 21:28,2000,IncomingTransfer,Salary,-2496.611012
32550,787723758,06-06-24 10:28,185,Deposit,Check Deposit,-2311.611012
32551,787723758,06-07-24 21:28,1900,Payment,Credit Card Payment,-4211.611012
32552,787723758,06-09-24 11:28,72.29,Deposit,Direct Deposit,-4139.321012
32553,787723758,6-13-24 21:28,1300,Payment,Rent Payment,-5439.321012
32554,787723758,6-13-24 21:28,16.56,OutgoingTransfer,International Transfer,-5455.881012
32555,787723758,6-16-24 18:28,199.71,Withdrawal,ATM Withdrawal,-5655.591012
32556,787723758,6-18-24 10:28,188.99,OnlineShopping,Amazon,-5844.581012
32557,787723758,6-18-24 15:28,135.91,Payment,Bill Payment,-5980.491012
32558,787723758,6-18-24 15:28,24.5,Withdrawal,Branch Withdrawal,-6004.991012
32559,787723758,6-18-24 17:28,225.33,OutgoingTransfer,Bank Transfer,-6230.321012
32560,787723758,6-20-24 12:28,85.16,Withdrawal,ATM Withdrawal,-6315.481012
32561,787723758,6-22-24 21:28,52.85,Purchase,Grocery,-6368.331012
32562,787723758,6-23-24 18:28,112.99,Deposit,Mobile Deposit,-6255.341012
32563,787723758,6-23-24 19:28,208.64,Deposit,Check Deposit,-6046.701012
32564,787723758,6-24-24 14:28,133.52,Return,AliExpress Return,-5913.181012
32565,787723758,6-28-24 15:28,114.66,Purchase,Restaurant,-6027.841012
32566,787723758,6-30-24 21:28,216.04,OnlineShopping,Target,-6243.881012
32567,787723758,07-02-24 21:28,2000,IncomingTransfer,Salary,-4243.881012
32568,787723758,07-03-24 15:28,67.1,Purchase,Clothing,-4310.981012
32569,787723758,07-07-24 13:28,208.12,Purchase,Entertainment,-4519.101012
32570,787723758,07-07-24 14:28,209.49,Return,Etsy Return,-4309.611012
32571,787723758,07-07-24 14:28,55.32,Deposit,Direct Deposit,-4254.291012
32572,787723758,07-07-24 21:28,1500,Payment,Credit Card Payment,-5754.291012
32573,787723758,07-10-24 16:28,222.52,IncomingTransfer,Freelance Payment,-5531.771012
32574,787723758,07-11-24 16:28,223.14,Withdrawal,ATM Withdrawal,-5754.911012
32575,787723758,07-11-24 21:28,1300,Payment,Rent Payment,-7054.911012
32576,787921383,1-23-24 9:28,809.71,Payment,Loan Payment,405.9819586
32577,787921383,02-02-24 10:28,824.17,IncomingTransfer,Freelance Payment,1230.151959
32578,787921383,02-05-24 21:28,16200,IncomingTransfer,Salary,17430.15196
32579,787921383,02-09-24 11:28,632.16,OnlineShopping,Walmart,16797.99196
32580,787921383,02-10-24 21:28,3000,Payment,Credit Card Payment,13797.99196
32581,787921383,2-16-24 21:28,5200,Payment,Installment Payment,8597.991959
32582,787921383,2-21-24 9:28,750.96,OutgoingTransfer,International Transfer,7847.031959
32583,787921383,2-28-24 10:28,458.14,Deposit,Mobile Deposit,8305.171959
32584,787921383,2-28-24 15:28,916.28,Purchase,Clothing,7388.891959
32585,787921383,03-05-24 21:28,16200,IncomingTransfer,Salary,23588.89196
32586,787921383,03-10-24 21:28,2900,Payment,Credit Card Payment,20688.89196
32587,787921383,3-13-24 21:28,5400,Payment,Installment Payment,15288.89196
32588,787921383,3-19-24 15:28,506.11,Return,Store Return,15795.00196
32589,787921383,3-21-24 11:28,323.95,OnlineShopping,eBay,15471.05196
32590,787921383,3-23-24 12:28,745.71,Purchase,Grocery,14725.34196
32591,787921383,3-24-24 12:28,507.09,Payment,Mortgage Payment,14218.25196
32592,787921383,3-25-24 22:28,528.58,Purchase,Grocery,13689.67196
32593,787921383,3-27-24 17:28,806.95,OutgoingTransfer,International Transfer,12882.72196
32594,787921383,04-01-24 12:28,749.24,Purchase,Restaurant,12133.48196
32595,787921383,04-02-24 23:28,203.84,Return,eBay Return,12337.32196
32596,787921383,04-04-24 21:28,16200,IncomingTransfer,Salary,28537.32196
32597,787921383,04-05-24 23:28,907.65,Deposit,Direct Deposit,29444.97196
32598,787921383,04-06-24 12:28,905.36,Payment,Mortgage Payment,28539.61196
32599,787921383,04-08-24 10:28,504.1,OnlineShopping,Amazon,28035.51196
32600,787921383,04-09-24 21:28,3200,Payment,Credit Card Payment,24835.51196
32601,787921383,4-13-24 21:28,7000,Payment,Installment Payment,17835.51196
32602,787921383,4-19-24 15:28,455.88,Payment,Bill Payment,17379.63196
32603,787921383,4-19-24 20:28,854.33,IncomingTransfer,Freelance Payment,18233.96196
32604,787921383,4-26-24 12:28,737.47,OnlineShopping,eBay,17496.49196
32605,787921383,4-27-24 17:28,836.67,Return,eBay Return,18333.16196
32606,787921383,4-29-24 17:28,879.8,Return,Target Return,19212.96196
32607,787921383,05-03-24 14:28,267.45,Deposit,Check Deposit,19480.41196
32608,787921383,05-05-24 21:28,16200,IncomingTransfer,Salary,35680.41196
32609,787921383,05-08-24 22:28,772.07,OnlineShopping,AliExpress,34908.34196
32610,787921383,05-10-24 21:28,2600,Payment,Credit Card Payment,32308.34196
32611,787921383,05-10-24 23:28,792.56,Return,AliExpress Return,33100.90196
32612,787921383,05-11-24 16:28,894.35,Payment,Bill Payment,32206.55196
32613,787921383,5-14-24 21:28,6000,Payment,Subscription Payment,26206.55196
32614,787921383,5-20-24 17:28,239.32,Deposit,Cash Deposit,26445.87196
32615,787921383,5-27-24 20:28,819.3,Purchase,Electronics,25626.57196
32616,787921383,5-29-24 19:28,241.7,Deposit,Mobile Deposit,25868.27196
32617,787921383,5-29-24 22:28,896.71,Withdrawal,Mobile App Withdrawal,24971.56196
32618,787921383,06-01-24 11:28,772.94,Return,Store Return,25744.50196
32619,787921383,06-02-24 21:28,16200,IncomingTransfer,Salary,41944.50196
32620,787921383,06-07-24 21:28,2400,Payment,Credit Card Payment,39544.50196
32621,787921383,6-17-24 15:28,711.53,Deposit,Direct Deposit,40256.03196
32622,787921383,6-17-24 21:28,6600,Payment,Insurance Payment,33656.03196
32623,787921383,6-18-24 23:28,534.95,OutgoingTransfer,International Transfer,33121.08196
32624,787921383,6-19-24 23:28,757.6,Return,Etsy Return,33878.68196
32625,787921383,6-25-24 23:28,687.05,Purchase,Travel,33191.63196
32626,787921383,6-28-24 17:28,338.97,Return,Store Return,33530.60196
32627,787921383,07-01-24 22:28,601.3,IncomingTransfer,Freelance Payment,34131.90196
32628,787921383,07-03-24 10:28,363.47,Deposit,Direct Deposit,34495.37196
32629,787921383,07-04-24 21:28,16200,IncomingTransfer,Salary,50695.37196
32630,787921383,07-05-24 22:28,490.53,Withdrawal,ATM Withdrawal,50204.84196
32631,787921383,07-06-24 10:28,344.16,Purchase,Gas,49860.68196
32632,787921383,07-09-24 21:28,2400,Payment,Credit Card Payment,47460.68196
32633,787921383,07-12-24 15:28,924.28,Return,Store Return,48384.96196
32634,787921383,7-13-24 21:28,574.95,Withdrawal,ATM Withdrawal,47810.01196
32635,787921383,7-16-24 21:28,6300,Payment,Subscription Payment,41510.01196
32636,787921383,7-17-24 13:28,811.04,Return,Amazon Return,42321.05196
32637,787983633,1-26-24 17:28,248.58,OutgoingTransfer,Bank Transfer,1943.951545
32638,787983633,1-31-24 20:28,196.88,Deposit,Cash Deposit,2140.831545
32639,787983633,02-04-24 21:28,2450,IncomingTransfer,Salary,4590.831545
32640,787983633,02-09-24 21:28,3100,Payment,Credit Card Payment,1490.831545
32641,787983633,02-12-24 19:28,42.63,IncomingTransfer,Freelance Payment,1533.461545
32642,787983633,2-14-24 15:28,155.93,Deposit,Direct Deposit,1689.391545
32643,787983633,2-17-24 16:28,166.21,Payment,Mortgage Payment,1523.181545
32644,787983633,2-18-24 21:28,1000,Payment,Rent Payment,523.1815453
32645,787983633,2-22-24 14:28,92.35,Deposit,Check Deposit,615.5315453
32646,787983633,2-27-24 20:28,147.61,OnlineShopping,Etsy,467.9215453
32647,787983633,03-01-24 21:28,2450,IncomingTransfer,Salary,2917.921545
32648,787983633,03-02-24 14:28,219.88,Deposit,Cash Deposit,3137.801545
32649,787983633,03-06-24 21:28,3200,Payment,Credit Card Payment,-62.1984547
32650,787983633,03-07-24 18:28,37.36,Withdrawal,ATM Withdrawal,-99.5584547
32651,787983633,03-12-24 16:28,82.06,Withdrawal,Branch Withdrawal,-181.6184547
32652,787983633,3-14-24 21:28,1500,Payment,Rent Payment,-1681.618455
32653,787983633,3-21-24 15:28,93.84,Deposit,Mobile Deposit,-1587.778455
32654,787983633,3-24-24 10:28,222.34,OutgoingTransfer,Peer-to-Peer Transfer,-1810.118455
32655,787983633,3-30-24 22:28,24.18,Withdrawal,Mobile App Withdrawal,-1834.298455
32656,787983633,04-02-24 22:28,196.1,Deposit,Mobile Deposit,-1638.198455
32657,787983633,04-03-24 21:28,2450,IncomingTransfer,Salary,811.8015453
32658,787983633,04-06-24 16:28,110.52,OnlineShopping,eBay,701.2815453
32659,787983633,04-08-24 21:28,3000,Payment,Credit Card Payment,-2298.718455
32660,787983633,4-14-24 21:28,1300,Payment,Rent Payment,-3598.718455
32661,787983633,4-19-24 21:28,233.73,Payment,Bill Payment,-3832.448455
32662,787983633,4-23-24 15:28,201.25,Deposit,Check Deposit,-3631.198455
32663,787983633,4-29-24 17:28,195.02,Deposit,Mobile Deposit,-3436.178455
32664,787983633,05-01-24 21:28,2450,IncomingTransfer,Salary,-986.1784547
32665,787983633,05-06-24 21:28,3300,Payment,Credit Card Payment,-4286.178455
32666,787983633,05-10-24 12:28,56.48,Withdrawal,ATM Withdrawal,-4342.658455
32667,787983633,05-11-24 11:28,234.04,OnlineShopping,Etsy,-4576.698455
32668,787983633,05-11-24 22:28,125.26,Withdrawal,Branch Withdrawal,-4701.958455
32669,787983633,5-18-24 21:28,900,Payment,Rent Payment,-5601.958455
32670,787983633,5-28-24 17:28,100.38,IncomingTransfer,Freelance Payment,-5501.578455
32671,787983633,5-31-24 23:28,74.32,Deposit,Check Deposit,-5427.258455
32672,787983633,06-03-24 16:28,84.61,OnlineShopping,Target,-5511.868455
32673,787983633,06-04-24 21:28,2450,IncomingTransfer,Salary,-3061.868455
32674,787983633,06-06-24 22:28,137.2,OutgoingTransfer,Wire Transfer,-3199.068455
32675,787983633,06-07-24 15:28,228.66,Deposit,Direct Deposit,-2970.408455
32676,787983633,06-09-24 21:28,2800,Payment,Credit Card Payment,-5770.408455
32677,787983633,06-12-24 10:28,232.86,Deposit,Check Deposit,-5537.548455
32678,787983633,06-12-24 18:28,160.62,Withdrawal,ATM Withdrawal,-5698.168455
32679,787983633,06-12-24 21:28,1200,Payment,Rent Payment,-6898.168455
32680,787983633,6-13-24 11:28,198.96,Purchase,Furniture,-7097.128455
32681,787983633,6-16-24 19:28,11.64,OnlineShopping,Walmart,-7108.768455
32682,787983633,07-01-24 15:28,72.41,Purchase,Entertainment,-7181.178455
32683,787983633,07-04-24 21:28,2450,IncomingTransfer,Salary,-4731.178455
32684,787983633,07-09-24 21:28,3300,Payment,Credit Card Payment,-8031.178455
32685,787983633,7-15-24 20:28,125.39,OutgoingTransfer,Wire Transfer,-8156.568455
32686,787983633,7-15-24 21:28,800,Payment,Rent Payment,-8956.568455
32687,787983633,7-16-24 13:28,171.37,Return,Etsy Return,-8785.198455
32688,788107683,1-21-24 12:28,45.82,Payment,Loan Payment,730.1462182
32689,788107683,1-21-24 17:28,238.15,Withdrawal,ATM Withdrawal,491.9962182
32690,788107683,1-28-24 13:28,22.52,Withdrawal,Mobile App Withdrawal,469.4762182
32691,788107683,02-03-24 22:28,102.09,Deposit,Mobile Deposit,571.5662182
32692,788107683,02-05-24 21:28,4700,IncomingTransfer,Salary,5271.566218
32693,788107683,02-10-24 21:28,1400,Payment,Credit Card Payment,3871.566218
32694,788107683,2-14-24 21:28,1800,Payment,Rent Payment,2071.566218
32695,788107683,2-19-24 14:28,394.17,OutgoingTransfer,Wire Transfer,1677.396218
32696,788107683,2-23-24 10:28,169.8,OutgoingTransfer,International Transfer,1507.596218
32697,788107683,2-27-24 9:28,321.19,Withdrawal,ATM Withdrawal,1186.406218
32698,788107683,03-03-24 21:28,4700,IncomingTransfer,Salary,5886.406218
32699,788107683,03-03-24 21:28,219.21,Payment,Mortgage Payment,5667.196218
32700,788107683,03-08-24 21:28,1800,Payment,Credit Card Payment,3867.196218
32701,788107683,03-10-24 21:28,2500,Payment,Rent Payment,1367.196218
32702,788107683,3-15-24 12:28,52.41,IncomingTransfer,Freelance Payment,1419.606218
32703,788107683,3-23-24 16:28,191.11,OutgoingTransfer,Wire Transfer,1228.496218
32704,788107683,3-24-24 20:28,215.78,Deposit,Mobile Deposit,1444.276218
32705,788107683,3-28-24 16:28,218.19,OutgoingTransfer,Bank Transfer,1226.086218
32706,788107683,3-29-24 13:28,165.33,Deposit,Direct Deposit,1391.416218
32707,788107683,3-31-24 21:28,169.78,Purchase,Grocery,1221.636218
32708,788107683,04-02-24 21:28,4700,IncomingTransfer,Salary,5921.636218
32709,788107683,04-07-24 13:28,264.51,Purchase,Electronics,5657.126218
32710,788107683,04-07-24 21:28,1800,Payment,Credit Card Payment,3857.126218
32711,788107683,04-11-24 21:28,2900,Payment,Rent Payment,957.1262182
32712,788107683,4-13-24 15:28,310.76,OutgoingTransfer,Peer-to-Peer Transfer,646.3662182
32713,788107683,4-20-24 21:28,321.99,Return,Walmart Return,968.3562182
32714,788107683,4-24-24 11:28,96.73,Withdrawal,ATM Withdrawal,871.6262182
32715,788107683,05-01-24 21:28,4700,IncomingTransfer,Salary,5571.626218
32716,788107683,05-03-24 10:28,312.11,Deposit,Direct Deposit,5883.736218
32717,788107683,05-04-24 13:28,160.19,Purchase,Entertainment,5723.546218
32718,788107683,05-05-24 12:28,229.13,Deposit,Direct Deposit,5952.676218
32719,788107683,05-06-24 14:28,23.81,OnlineShopping,Walmart,5928.866218
32720,788107683,05-06-24 21:28,1600,Payment,Credit Card Payment,4328.866218
32721,788107683,05-09-24 11:28,70.81,OutgoingTransfer,Bank Transfer,4258.056218
32722,788107683,05-10-24 21:28,2400,Payment,Rent Payment,1858.056218
32723,788107683,5-23-24 18:28,374.46,OutgoingTransfer,Peer-to-Peer Transfer,1483.596218
32724,788107683,5-28-24 17:28,223.39,Payment,Loan Payment,1260.206218
32725,788107683,5-31-24 20:28,330.52,Deposit,Check Deposit,1590.726218
32726,788107683,06-02-24 21:28,4700,IncomingTransfer,Salary,6290.726218
32727,788107683,06-04-24 11:28,381.88,Return,Target Return,6672.606218
32728,788107683,06-07-24 21:28,1800,Payment,Credit Card Payment,4872.606218
32729,788107683,06-12-24 21:28,1600,Payment,Rent Payment,3272.606218
32730,788107683,6-17-24 20:28,237.7,Deposit,Mobile Deposit,3510.306218
32731,788107683,6-19-24 11:28,223.56,Deposit,Mobile Deposit,3733.866218
32732,788107683,6-24-24 15:28,180.3,Return,Target Return,3914.166218
32733,788107683,6-25-24 15:28,105.61,Return,Amazon Return,4019.776218
32734,788107683,6-25-24 22:28,359.86,OnlineShopping,eBay,3659.916218
32735,788107683,6-26-24 23:28,28.63,Return,AliExpress Return,3688.546218
32736,788107683,6-27-24 19:28,219.34,Deposit,Mobile Deposit,3907.886218
32737,788107683,07-01-24 21:28,234.28,Purchase,Electronics,3673.606218
32738,788107683,07-04-24 9:28,355.23,Deposit,Check Deposit,4028.836218
32739,788107683,07-04-24 21:28,4700,IncomingTransfer,Salary,8728.836218
32740,788107683,07-07-24 16:28,114.34,Purchase,Furniture,8614.496218
32741,788107683,07-08-24 17:28,260.06,Return,Etsy Return,8874.556218
32742,788107683,07-08-24 19:28,131.02,Payment,Mortgage Payment,8743.536218
32743,788107683,07-09-24 21:28,1700,Payment,Credit Card Payment,7043.536218
32744,788107683,07-10-24 18:28,280.93,Purchase,Electronics,6762.606218
32745,788107683,7-14-24 10:28,147.46,Purchase,Furniture,6615.146218
32746,788107683,7-16-24 12:28,184.75,OutgoingTransfer,Peer-to-Peer Transfer,6430.396218
32747,788107683,7-17-24 16:28,162.83,Withdrawal,Branch Withdrawal,6267.566218
32748,788107683,7-17-24 21:28,1500,Payment,Rent Payment,4767.566218
32749,788132208,1-23-24 15:28,84.38,OutgoingTransfer,Wire Transfer,719.6426371
32750,788132208,1-25-24 11:28,50.44,OutgoingTransfer,Wire Transfer,669.2026371
32751,788132208,1-26-24 18:28,253.57,Return,Target Return,922.7726371
32752,788132208,1-31-24 9:28,380,Return,Best Buy Return,1302.772637
32753,788132208,02-01-24 14:28,212.46,Deposit,Check Deposit,1515.232637
32754,788132208,02-03-24 11:28,360.62,Purchase,Gas,1154.612637
32755,788132208,02-03-24 13:28,323.3,Return,eBay Return,1477.912637
32756,788132208,02-03-24 21:28,4950,IncomingTransfer,Salary,6427.912637
32757,788132208,02-03-24 21:28,85.57,OnlineShopping,Etsy,6342.342637
32758,788132208,02-04-24 18:28,257.61,Withdrawal,Branch Withdrawal,6084.732637
32759,788132208,02-05-24 17:28,113.05,OnlineShopping,Walmart,5971.682637
32760,788132208,02-07-24 21:28,221.88,OnlineShopping,Target,5749.802637
32761,788132208,02-08-24 9:28,109.19,Deposit,Direct Deposit,5858.992637
32762,788132208,02-08-24 21:28,1500,Payment,Credit Card Payment,4358.992637
32763,788132208,02-12-24 14:28,242.14,Withdrawal,ATM Withdrawal,4116.852637
32764,788132208,2-14-24 18:28,85.59,OutgoingTransfer,Wire Transfer,4031.262637
32765,788132208,2-15-24 19:28,22.98,Return,Target Return,4054.242637
32766,788132208,2-15-24 21:28,1300,Payment,Rent Payment,2754.242637
32767,788132208,2-17-24 13:28,24.28,Purchase,Entertainment,2729.962637
32768,788132208,2-23-24 17:28,257.17,Purchase,Gas,2472.792637
32769,788132208,2-27-24 9:28,178.82,Deposit,Cash Deposit,2651.612637
32770,788132208,2-27-24 14:28,30.21,Purchase,Electronics,2621.402637
32771,788132208,2-29-24 15:28,315.39,Return,Etsy Return,2936.792637
32772,788132208,2-29-24 20:28,39.24,OnlineShopping,Amazon,2897.552637
32773,788132208,2-29-24 21:28,185.53,OutgoingTransfer,Bank Transfer,2712.022637
32774,788132208,03-03-24 14:28,155.95,Withdrawal,ATM Withdrawal,2556.072637
32775,788132208,03-03-24 21:28,4950,IncomingTransfer,Salary,7506.072637
32776,788132208,03-04-24 23:28,180.27,OutgoingTransfer,Wire Transfer,7325.802637
32777,788132208,03-07-24 9:28,390.88,OutgoingTransfer,Wire Transfer,6934.922637
32778,788132208,03-08-24 21:28,1500,Payment,Credit Card Payment,5434.922637
32779,788132208,03-08-24 22:28,69.23,Deposit,Cash Deposit,5504.152637
32780,788132208,3-15-24 10:28,227.61,Return,Etsy Return,5731.762637
32781,788132208,3-16-24 21:28,1600,Payment,Rent Payment,4131.762637
32782,788132208,3-17-24 20:28,291.19,Purchase,Entertainment,3840.572637
32783,788132208,3-18-24 19:28,28.13,Purchase,Furniture,3812.442637
32784,788132208,3-21-24 12:28,224.1,Deposit,Mobile Deposit,4036.542637
32785,788132208,3-25-24 13:28,269.34,Deposit,Check Deposit,4305.882637
32786,788132208,3-28-24 12:28,274.95,Withdrawal,ATM Withdrawal,4030.932637
32787,788132208,3-29-24 11:28,272.98,Purchase,Restaurant,3757.952637
32788,788132208,3-31-24 17:28,127.71,Deposit,Cash Deposit,3885.662637
32789,788132208,04-01-24 21:28,4950,IncomingTransfer,Salary,8835.662637
32790,788132208,04-03-24 17:28,302.89,Payment,Bill Payment,8532.772637
32791,788132208,04-04-24 19:28,396.13,IncomingTransfer,Freelance Payment,8928.902637
32792,788132208,04-05-24 22:28,216.37,Withdrawal,ATM Withdrawal,8712.532637
32793,788132208,04-06-24 14:28,202.38,Purchase,Electronics,8510.152637
32794,788132208,04-06-24 21:28,1100,Payment,Credit Card Payment,7410.152637
32795,788132208,04-11-24 12:28,219.04,Purchase,Home Improvement,7191.112637
32796,788132208,04-12-24 16:28,361.14,Purchase,Restaurant,6829.972637
32797,788132208,4-16-24 21:28,1800,Payment,Rent Payment,5029.972637
32798,788132208,4-17-24 17:28,222.3,Purchase,Home Improvement,4807.672637
32799,788132208,4-19-24 18:28,96.85,Deposit,Check Deposit,4904.522637
32800,788132208,4-20-24 14:28,195.38,Return,Walmart Return,5099.902637
32801,788132208,4-24-24 18:28,264.8,Deposit,Direct Deposit,5364.702637
32802,788132208,4-25-24 13:28,59.64,Purchase,Pharmacy,5305.062637
32803,788132208,4-25-24 15:28,395.51,Deposit,Cash Deposit,5700.572637
32804,788132208,4-26-24 10:28,49.39,Purchase,Travel,5651.182637
32805,788132208,4-27-24 14:28,138.29,Withdrawal,ATM Withdrawal,5512.892637
32806,788132208,05-02-24 18:28,245.46,Deposit,Cash Deposit,5758.352637
32807,788132208,05-04-24 11:28,177.35,Deposit,Cash Deposit,5935.702637
32808,788132208,05-05-24 21:28,4950,IncomingTransfer,Salary,10885.70264
32809,788132208,05-10-24 21:28,1000,Payment,Credit Card Payment,9885.702637
32810,788132208,05-11-24 21:28,2400,Payment,Rent Payment,7485.702637
32811,788132208,5-13-24 23:28,177.25,Payment,Mortgage Payment,7308.452637
32812,788132208,5-15-24 15:28,182.87,IncomingTransfer,Freelance Payment,7491.322637
32813,788132208,5-15-24 19:28,217.08,Purchase,Clothing,7274.242637
32814,788132208,5-18-24 11:28,348.92,Payment,Mortgage Payment,6925.322637
32815,788132208,5-20-24 16:28,60.06,Return,Walmart Return,6985.382637
32816,788132208,5-21-24 16:28,145.21,OutgoingTransfer,Bank Transfer,6840.172637
32817,788132208,5-23-24 17:28,237.21,Purchase,Grocery,6602.962637
32818,788132208,5-24-24 11:28,82.83,Deposit,Check Deposit,6685.792637
32819,788132208,5-25-24 19:28,182.92,Return,Store Return,6868.712637
32820,788132208,5-29-24 15:28,298.62,Purchase,Electronics,6570.092637
32821,788132208,06-05-24 10:28,28.52,Return,Best Buy Return,6598.612637
32822,788132208,06-05-24 21:28,4950,IncomingTransfer,Salary,11548.61264
32823,788132208,06-05-24 21:28,220.27,Deposit,Cash Deposit,11768.88264
32824,788132208,06-10-24 21:28,1300,Payment,Credit Card Payment,10468.88264
32825,788132208,06-12-24 21:28,1800,Payment,Rent Payment,8668.882637
32826,788132208,6-14-24 22:28,269.31,Deposit,Mobile Deposit,8938.192637
32827,788132208,6-17-24 11:28,291.34,Payment,Mortgage Payment,8646.852637
32828,788132208,6-21-24 9:28,227.25,Deposit,Cash Deposit,8874.102637
32829,788132208,6-28-24 10:28,224.43,Purchase,Clothing,8649.672637
32830,788132208,6-29-24 22:28,189.52,Return,Amazon Return,8839.192637
32831,788132208,07-03-24 21:28,4950,IncomingTransfer,Salary,13789.19264
32832,788132208,07-06-24 10:28,272.12,Deposit,Mobile Deposit,14061.31264
32833,788132208,07-08-24 21:28,1300,Payment,Credit Card Payment,12761.31264
32834,788132208,07-09-24 10:28,54.1,Purchase,Pharmacy,12707.21264
32835,788132208,07-09-24 20:28,334.17,IncomingTransfer,Freelance Payment,13041.38264
32836,788132208,07-11-24 21:28,1900,Payment,Rent Payment,11141.38264
32837,788667408,1-22-24 20:28,94.69,Purchase,Gas,996.2237647
32838,788667408,1-29-24 13:28,65.08,OutgoingTransfer,Wire Transfer,931.1437647
32839,788667408,1-30-24 15:28,68.79,OutgoingTransfer,Wire Transfer,862.3537647
32840,788667408,02-01-24 13:28,40.6,Deposit,Mobile Deposit,902.9537647
32841,788667408,02-03-24 17:28,215.73,OnlineShopping,Amazon,687.2237647
32842,788667408,02-04-24 21:28,1850,IncomingTransfer,Salary,2537.223765
32843,788667408,02-06-24 22:28,117.98,OnlineShopping,Target,2419.243765
32844,788667408,02-07-24 20:28,109.58,Return,Store Return,2528.823765
32845,788667408,02-08-24 16:28,220.57,Purchase,Furniture,2308.253765
32846,788667408,02-09-24 21:28,2500,Payment,Credit Card Payment,-191.7462353
32847,788667408,02-11-24 20:28,177.32,OutgoingTransfer,Peer-to-Peer Transfer,-369.0662353
32848,788667408,02-12-24 17:28,173.8,Deposit,Check Deposit,-195.2662353
32849,788667408,02-12-24 21:28,133.64,Purchase,Travel,-328.9062353
32850,788667408,2-13-24 15:28,186.31,Purchase,Electronics,-515.2162353
32851,788667408,2-14-24 15:28,34.74,Deposit,Cash Deposit,-480.4762353
32852,788667408,2-16-24 23:28,66.52,Purchase,Clothing,-546.9962353
32853,788667408,2-17-24 21:28,700,Payment,Rent Payment,-1246.996235
32854,788667408,2-21-24 22:28,67.2,Return,Target Return,-1179.796235
32855,788667408,03-02-24 21:28,1850,IncomingTransfer,Salary,670.2037647
32856,788667408,03-04-24 14:28,228.9,Purchase,Grocery,441.3037647
32857,788667408,03-07-24 21:28,2000,Payment,Credit Card Payment,-1558.696235
32858,788667408,03-10-24 21:28,500,Payment,Rent Payment,-2058.696235
32859,788667408,03-11-24 12:28,132.83,Withdrawal,Branch Withdrawal,-2191.526235
32860,788667408,03-11-24 15:28,64.17,Payment,Loan Payment,-2255.696235
32861,788667408,3-14-24 9:28,129.52,Payment,Bill Payment,-2385.216235
32862,788667408,3-15-24 22:28,153.93,Purchase,Furniture,-2539.146235
32863,788667408,3-16-24 18:28,41.52,Return,AliExpress Return,-2497.626235
32864,788667408,3-20-24 17:28,150.79,Deposit,Direct Deposit,-2346.836235
32865,788667408,3-21-24 23:28,71.17,Deposit,Check Deposit,-2275.666235
32866,788667408,3-30-24 12:28,62.96,Purchase,Electronics,-2338.626235
32867,788667408,04-02-24 9:28,202.34,OnlineShopping,eBay,-2540.966235
32868,788667408,04-04-24 22:28,120.98,Payment,Loan Payment,-2661.946235
32869,788667408,04-05-24 21:28,1850,IncomingTransfer,Salary,-811.9462353
32870,788667408,04-05-24 21:28,135.98,Return,eBay Return,-675.9662353
32871,788667408,04-10-24 21:28,2200,Payment,Credit Card Payment,-2875.966235
32872,788667408,04-10-24 21:28,1100,Payment,Rent Payment,-3975.966235
32873,788667408,4-14-24 13:28,237.3,IncomingTransfer,Freelance Payment,-3738.666235
32874,788667408,4-15-24 14:28,150.68,Deposit,Cash Deposit,-3587.986235
32875,788667408,4-16-24 9:28,45.9,Withdrawal,Branch Withdrawal,-3633.886235
32876,788667408,4-16-24 17:28,108.97,Purchase,Furniture,-3742.856235
32877,788667408,4-16-24 20:28,133.58,Return,AliExpress Return,-3609.276235
32878,788667408,4-21-24 10:28,153.77,Purchase,Furniture,-3763.046235
32879,788667408,4-23-24 16:28,16.24,Purchase,Home Improvement,-3779.286235
32880,788667408,4-25-24 10:28,109.44,IncomingTransfer,Freelance Payment,-3669.846235
32881,788667408,4-26-24 18:28,157.88,Withdrawal,ATM Withdrawal,-3827.726235
32882,788667408,4-26-24 18:28,34.82,Withdrawal,Branch Withdrawal,-3862.546235
32883,788667408,05-01-24 17:28,185.66,OutgoingTransfer,International Transfer,-4048.206235
32884,788667408,05-02-24 21:28,1850,IncomingTransfer,Salary,-2198.206235
32885,788667408,05-06-24 12:28,107.33,Deposit,Cash Deposit,-2090.876235
32886,788667408,05-07-24 10:28,154.07,Purchase,Entertainment,-2244.946235
32887,788667408,05-07-24 12:28,52.91,OutgoingTransfer,International Transfer,-2297.856235
32888,788667408,05-07-24 21:28,2600,Payment,Credit Card Payment,-4897.856235
32889,788667408,05-10-24 11:28,104.01,Purchase,Restaurant,-5001.866235
32890,788667408,05-10-24 19:28,248.63,Withdrawal,Mobile App Withdrawal,-5250.496235
32891,788667408,05-10-24 21:28,800,Payment,Rent Payment,-6050.496235
32892,788667408,05-11-24 10:28,127.32,Withdrawal,ATM Withdrawal,-6177.816235
32893,788667408,05-11-24 11:28,58.02,Deposit,Mobile Deposit,-6119.796235
32894,788667408,05-12-24 10:28,135.57,Payment,Bill Payment,-6255.366235
32895,788667408,05-12-24 14:28,136.62,OnlineShopping,eBay,-6391.986235
32896,788667408,5-14-24 23:28,70.59,Withdrawal,ATM Withdrawal,-6462.576235
32897,788667408,5-17-24 22:28,23.45,Payment,Loan Payment,-6486.026235
32898,788667408,5-21-24 11:28,85.71,OutgoingTransfer,Bank Transfer,-6571.736235
32899,788667408,5-22-24 13:28,183.87,Return,eBay Return,-6387.866235
32900,788667408,5-30-24 22:28,96.41,OnlineShopping,Best Buy,-6484.276235
32901,788667408,5-31-24 11:28,194.88,Payment,Mortgage Payment,-6679.156235
32902,788667408,06-02-24 21:28,1850,IncomingTransfer,Salary,-4829.156235
32903,788667408,06-07-24 9:28,90.6,Return,Amazon Return,-4738.556235
32904,788667408,06-07-24 21:28,2400,Payment,Credit Card Payment,-7138.556235
32905,788667408,06-08-24 17:28,186.91,Return,Best Buy Return,-6951.646235
32906,788667408,06-11-24 21:28,1000,Payment,Rent Payment,-7951.646235
32907,788667408,6-15-24 11:28,45.87,Purchase,Home Improvement,-7997.516235
32908,788667408,6-16-24 22:28,225.42,Payment,Bill Payment,-8222.936235
32909,788667408,6-21-24 16:28,12.22,Payment,Mortgage Payment,-8235.156235
32910,788667408,6-23-24 21:28,127.63,Payment,Mortgage Payment,-8362.786235
32911,788667408,6-27-24 20:28,155.43,Deposit,Check Deposit,-8207.356235
32912,788667408,6-29-24 15:28,89.78,Return,Etsy Return,-8117.576235
32913,788667408,6-30-24 18:28,51.51,Purchase,Furniture,-8169.086235
32914,788667408,07-04-24 21:28,1850,IncomingTransfer,Salary,-6319.086235
32915,788667408,07-06-24 13:28,58.46,Purchase,Clothing,-6377.546235
32916,788667408,07-09-24 21:28,2100,Payment,Credit Card Payment,-8477.546235
32917,788667408,7-14-24 16:28,46.5,Payment,Bill Payment,-8524.046235
32918,788667408,7-16-24 15:28,151.77,Purchase,Entertainment,-8675.816235
32919,788667408,7-17-24 21:28,170.44,Deposit,Cash Deposit,-8505.376235
32920,788667408,7-18-24 21:28,600,Payment,Rent Payment,-9105.376235
32921,788719533,1-20-24 14:28,215.95,Withdrawal,ATM Withdrawal,-215.95
32922,788719533,1-20-24 20:28,298.51,OutgoingTransfer,International Transfer,-514.46
32923,788719533,1-22-24 22:28,173.53,Withdrawal,ATM Withdrawal,-687.99
32924,788719533,1-29-24 10:28,229.66,Payment,Bill Payment,-917.65
32925,788719533,1-29-24 15:28,452.05,Return,Walmart Return,-465.6
32926,788719533,1-30-24 13:28,197.03,OutgoingTransfer,International Transfer,-662.63
32927,788719533,1-30-24 18:28,459.35,Withdrawal,Mobile App Withdrawal,-1121.98
32928,788719533,02-03-24 17:28,600.24,OutgoingTransfer,Peer-to-Peer Transfer,-1722.22
32929,788719533,02-05-24 21:28,8550,IncomingTransfer,Salary,6827.78
32930,788719533,02-12-24 21:28,2600,Payment,Rent Payment,4227.78
32931,788719533,2-20-24 20:28,160.97,Return,Target Return,4388.75
32932,788719533,2-24-24 18:28,309.3,OutgoingTransfer,Wire Transfer,4079.45
32933,788719533,2-29-24 16:28,393.79,OnlineShopping,AliExpress,3685.66
32934,788719533,2-29-24 21:28,352.13,Purchase,Travel,3333.53
32935,788719533,03-02-24 21:28,8550,IncomingTransfer,Salary,11883.53
32936,788719533,3-14-24 21:28,5100,Payment,Rent Payment,6783.53
32937,788719533,3-16-24 12:28,321.82,IncomingTransfer,Freelance Payment,7105.35
32938,788719533,3-20-24 17:28,328.7,OnlineShopping,Target,6776.65
32939,788719533,3-25-24 11:28,418.29,Return,Etsy Return,7194.94
32940,788719533,3-25-24 23:28,301.17,Return,AliExpress Return,7496.11
32941,788719533,3-26-24 11:28,603.15,OnlineShopping,Etsy,6892.96
32942,788719533,3-26-24 11:28,599.21,Return,AliExpress Return,7492.17
32943,788719533,3-26-24 19:28,325.3,Deposit,Mobile Deposit,7817.47
32944,788719533,3-28-24 20:28,382.99,Withdrawal,Branch Withdrawal,7434.48
32945,788719533,3-31-24 15:28,208.64,Withdrawal,ATM Withdrawal,7225.84
32946,788719533,04-02-24 11:28,635.88,Payment,Mortgage Payment,6589.96
32947,788719533,04-05-24 18:28,204.08,Withdrawal,ATM Withdrawal,6385.88
32948,788719533,04-05-24 21:28,8550,IncomingTransfer,Salary,14935.88
32949,788719533,4-13-24 13:28,114.01,Payment,Mortgage Payment,14821.87
32950,788719533,4-14-24 16:28,500.06,OnlineShopping,Etsy,14321.81
32951,788719533,4-15-24 14:28,117.69,OnlineShopping,Target,14204.12
32952,788719533,4-16-24 18:28,557.85,Deposit,Direct Deposit,14761.97
32953,788719533,4-18-24 21:28,5100,Payment,Rent Payment,9661.97
32954,788719533,4-23-24 18:28,644.54,Withdrawal,Branch Withdrawal,9017.43
32955,788719533,4-23-24 21:28,493.28,Payment,Loan Payment,8524.15
32956,788719533,05-01-24 21:28,8550,IncomingTransfer,Salary,17074.15
32957,788719533,05-02-24 9:28,644.69,Withdrawal,ATM Withdrawal,16429.46
32958,788719533,05-02-24 16:28,336.89,IncomingTransfer,Freelance Payment,16766.35
32959,788719533,05-02-24 23:28,615.77,Deposit,Cash Deposit,17382.12
32960,788719533,05-10-24 19:28,328.22,Purchase,Grocery,17053.9
32961,788719533,5-13-24 13:28,576.24,Payment,Bill Payment,16477.66
32962,788719533,5-13-24 21:28,5000,Payment,Rent Payment,11477.66
32963,788719533,5-14-24 14:28,401.94,Purchase,Home Improvement,11075.72
32964,788719533,5-16-24 9:28,629.91,Deposit,Check Deposit,11705.63
32965,788719533,5-22-24 22:28,386.01,Payment,Loan Payment,11319.62
32966,788719533,5-31-24 22:28,424.5,OutgoingTransfer,International Transfer,10895.12
32967,788719533,06-03-24 19:28,707.04,Purchase,Furniture,10188.08
32968,788719533,06-04-24 21:28,8550,IncomingTransfer,Salary,18738.08
32969,788719533,06-06-24 9:28,333.9,Deposit,Direct Deposit,19071.98
32970,788719533,06-06-24 15:28,315.34,Purchase,Travel,18756.64
32971,788719533,06-06-24 18:28,144.25,Purchase,Clothing,18612.39
32972,788719533,06-09-24 13:28,429.26,Payment,Mortgage Payment,18183.13
32973,788719533,06-12-24 11:28,417.82,Deposit,Mobile Deposit,18600.95
32974,788719533,6-13-24 19:28,279.91,Return,Walmart Return,18880.86
32975,788719533,6-15-24 14:28,543.95,Purchase,Entertainment,18336.91
32976,788719533,6-15-24 21:28,134.49,Return,Target Return,18471.4
32977,788719533,6-16-24 12:28,734.05,IncomingTransfer,Freelance Payment,19205.45
32978,788719533,6-16-24 21:28,5100,Payment,Rent Payment,14105.45
32979,788719533,6-18-24 23:28,335.64,Deposit,Cash Deposit,14441.09
32980,788719533,6-19-24 12:28,578.51,Withdrawal,Branch Withdrawal,13862.58
32981,788719533,6-20-24 22:28,735.95,OutgoingTransfer,Wire Transfer,13126.63
32982,788719533,6-22-24 21:28,552.48,Purchase,Travel,12574.15
32983,788719533,6-27-24 20:28,342.9,Withdrawal,ATM Withdrawal,12231.25
32984,788719533,6-28-24 15:28,162.43,Withdrawal,ATM Withdrawal,12068.82
32985,788719533,6-28-24 16:28,341.89,IncomingTransfer,Freelance Payment,12410.71
32986,788719533,6-28-24 22:28,354.47,Payment,Bill Payment,12056.24
32987,788719533,6-30-24 21:28,114.51,Payment,Bill Payment,11941.73
32988,788719533,07-01-24 21:28,8550,IncomingTransfer,Salary,20491.73
32989,788719533,07-01-24 21:28,289.53,Withdrawal,Branch Withdrawal,20202.2
32990,788719533,07-09-24 10:28,281.93,Purchase,Pharmacy,19920.27
32991,788719533,07-12-24 21:28,3100,Payment,Rent Payment,16820.27
32992,788719533,7-16-24 22:28,467.23,Deposit,Cash Deposit,17287.5
32993,788719533,7-17-24 17:28,317.02,Payment,Bill Payment,16970.48
32994,788769783,1-22-24 21:28,179.7,Withdrawal,ATM Withdrawal,630.28475
32995,788769783,1-30-24 18:28,35.55,Withdrawal,Branch Withdrawal,594.73475
32996,788769783,02-02-24 11:28,102.67,Purchase,Pharmacy,492.06475
32997,788769783,02-03-24 13:28,120.85,Deposit,Direct Deposit,612.91475
32998,788769783,02-03-24 21:28,2600,IncomingTransfer,Salary,3212.91475
32999,788769783,02-05-24 14:28,222.22,Withdrawal,ATM Withdrawal,2990.69475
33000,788769783,02-06-24 21:28,233.64,IncomingTransfer,Freelance Payment,3224.33475
33001,788769783,02-08-24 10:28,186.69,Deposit,Direct Deposit,3411.02475
33002,788769783,02-08-24 21:28,1500,Payment,Credit Card Payment,1911.02475
33003,788769783,2-15-24 12:28,46.36,Purchase,Gas,1864.66475
33004,788769783,2-17-24 21:28,900,Payment,Rent Payment,964.66475
33005,788769783,2-19-24 21:28,117.16,Payment,Loan Payment,847.50475
33006,788769783,2-22-24 11:28,143.31,Withdrawal,Mobile App Withdrawal,704.19475
33007,788769783,2-23-24 16:28,240.66,Return,AliExpress Return,944.85475
33008,788769783,2-24-24 18:28,135.13,IncomingTransfer,Freelance Payment,1079.98475
33009,788769783,2-27-24 15:28,199.48,Deposit,Direct Deposit,1279.46475
33010,788769783,2-29-24 15:28,92.08,Deposit,Mobile Deposit,1371.54475
33011,788769783,03-02-24 11:28,172.94,OnlineShopping,Walmart,1198.60475
33012,788769783,03-03-24 20:28,247.16,OutgoingTransfer,Peer-to-Peer Transfer,951.44475
33013,788769783,03-04-24 21:28,2600,IncomingTransfer,Salary,3551.44475
33014,788769783,03-04-24 21:28,222.08,Purchase,Pharmacy,3329.36475
33015,788769783,03-04-24 21:28,91.78,OutgoingTransfer,Bank Transfer,3237.58475
33016,788769783,03-05-24 23:28,200.91,Deposit,Check Deposit,3438.49475
33017,788769783,03-09-24 21:28,1400,Payment,Credit Card Payment,2038.49475
33018,788769783,03-11-24 17:28,88.23,OnlineShopping,Best Buy,1950.26475
33019,788769783,03-11-24 17:28,225.84,Purchase,Home Improvement,1724.42475
33020,788769783,03-11-24 21:28,700,Payment,Rent Payment,1024.42475
33021,788769783,3-13-24 11:28,187.84,OnlineShopping,AliExpress,836.58475
33022,788769783,3-20-24 15:28,193.94,Withdrawal,Branch Withdrawal,642.64475
33023,788769783,3-20-24 16:28,128.9,Payment,Mortgage Payment,513.74475
33024,788769783,3-20-24 16:28,186.87,Deposit,Mobile Deposit,700.61475
33025,788769783,3-20-24 19:28,134.29,Purchase,Clothing,566.32475
33026,788769783,3-25-24 10:28,193.94,OutgoingTransfer,Bank Transfer,372.38475
33027,788769783,3-28-24 10:28,109.29,Payment,Bill Payment,263.09475
33028,788769783,3-28-24 16:28,229.14,Payment,Loan Payment,33.95475001
33029,788769783,04-01-24 21:28,2600,IncomingTransfer,Salary,2633.95475
33030,788769783,04-02-24 18:28,216.03,Withdrawal,ATM Withdrawal,2417.92475
33031,788769783,04-03-24 11:28,149.35,OutgoingTransfer,Peer-to-Peer Transfer,2268.57475
33032,788769783,04-04-24 17:28,36.25,OutgoingTransfer,Peer-to-Peer Transfer,2232.32475
33033,788769783,04-06-24 15:28,129.18,Return,eBay Return,2361.50475
33034,788769783,04-06-24 21:28,1500,Payment,Credit Card Payment,861.50475
33035,788769783,04-08-24 11:28,45.24,Deposit,Check Deposit,906.74475
33036,788769783,4-15-24 13:28,25.29,Deposit,Mobile Deposit,932.03475
33037,788769783,4-16-24 23:28,31.5,Purchase,Furniture,900.53475
33038,788769783,4-17-24 21:28,1700,Payment,Rent Payment,-799.46525
33039,788769783,4-19-24 16:28,174.45,OutgoingTransfer,Wire Transfer,-973.91525
33040,788769783,4-21-24 19:28,174.33,OnlineShopping,Walmart,-1148.24525
33041,788769783,4-23-24 22:28,21.86,Withdrawal,Branch Withdrawal,-1170.10525
33042,788769783,4-24-24 15:28,97.11,IncomingTransfer,Freelance Payment,-1072.99525
33043,788769783,4-25-24 20:28,168.64,OutgoingTransfer,Peer-to-Peer Transfer,-1241.63525
33044,788769783,4-29-24 19:28,99.37,Purchase,Grocery,-1341.00525
33045,788769783,4-30-24 18:28,15.24,Purchase,Clothing,-1356.24525
33046,788769783,05-02-24 12:28,232.64,Return,Target Return,-1123.60525
33047,788769783,05-05-24 21:28,2600,IncomingTransfer,Salary,1476.39475
33048,788769783,05-08-24 20:28,55.94,OutgoingTransfer,International Transfer,1420.45475
33049,788769783,05-09-24 11:28,85.61,Purchase,Clothing,1334.84475
33050,788769783,05-10-24 13:28,117.22,IncomingTransfer,Freelance Payment,1452.06475
33051,788769783,05-10-24 21:28,1200,Payment,Credit Card Payment,252.06475
33052,788769783,5-14-24 21:28,1700,Payment,Rent Payment,-1447.93525
33053,788769783,5-18-24 22:28,90.78,Payment,Bill Payment,-1538.71525
33054,788769783,5-19-24 17:28,126.36,OutgoingTransfer,Wire Transfer,-1665.07525
33055,788769783,5-23-24 10:28,26.9,Purchase,Pharmacy,-1691.97525
33056,788769783,5-24-24 19:28,44.25,OnlineShopping,Target,-1736.22525
33057,788769783,5-25-24 18:28,49.94,Return,Store Return,-1686.28525
33058,788769783,5-26-24 17:28,184.48,Deposit,Cash Deposit,-1501.80525
33059,788769783,5-29-24 15:28,216.06,Withdrawal,ATM Withdrawal,-1717.86525
33060,788769783,5-30-24 14:28,168.46,Purchase,Pharmacy,-1886.32525
33061,788769783,5-30-24 14:28,71.91,Payment,Mortgage Payment,-1958.23525
33062,788769783,06-01-24 15:28,137.21,Return,AliExpress Return,-1821.02525
33063,788769783,06-02-24 18:28,192.99,Withdrawal,Mobile App Withdrawal,-2014.01525
33064,788769783,06-04-24 21:28,2600,IncomingTransfer,Salary,585.98475
33065,788769783,06-08-24 22:28,178.54,Deposit,Check Deposit,764.52475
33066,788769783,06-09-24 21:28,1100,Payment,Credit Card Payment,-335.47525
33067,788769783,06-09-24 21:28,102.82,Purchase,Gas,-438.29525
33068,788769783,06-11-24 18:28,127.45,Purchase,Entertainment,-565.74525
33069,788769783,06-11-24 21:28,1200,Payment,Rent Payment,-1765.74525
33070,788769783,6-13-24 19:28,199.53,Deposit,Mobile Deposit,-1566.21525
33071,788769783,6-14-24 23:28,35.2,Deposit,Check Deposit,-1531.01525
33072,788769783,6-18-24 18:28,204.72,OutgoingTransfer,Bank Transfer,-1735.73525
33073,788769783,6-19-24 17:28,95.2,Return,Best Buy Return,-1640.53525
33074,788769783,6-22-24 12:28,182.31,Withdrawal,Branch Withdrawal,-1822.84525
33075,788769783,6-23-24 11:28,55.49,Payment,Loan Payment,-1878.33525
33076,788769783,6-24-24 14:28,115.08,OutgoingTransfer,Wire Transfer,-1993.41525
33077,788769783,6-24-24 21:28,24.79,Purchase,Electronics,-2018.20525
33078,788769783,07-02-24 21:28,2600,IncomingTransfer,Salary,581.79475
33079,788769783,07-07-24 21:28,1500,Payment,Credit Card Payment,-918.20525
33080,788769783,07-08-24 20:28,84.18,Purchase,Grocery,-1002.38525
33081,788769783,07-09-24 10:28,43.77,Withdrawal,Mobile App Withdrawal,-1046.15525
33082,788769783,07-11-24 14:28,31.09,Withdrawal,ATM Withdrawal,-1077.24525
33083,788769783,07-11-24 21:28,1100,Payment,Rent Payment,-2177.24525
33084,788769783,7-13-24 12:28,173.37,OnlineShopping,Amazon,-2350.61525
33085,788769783,7-14-24 20:28,244.99,Payment,Bill Payment,-2595.60525
33086,788786208,1-20-24 18:28,357.62,Purchase,Electronics,977.945606
33087,788786208,1-23-24 18:28,481.76,Purchase,Restaurant,496.185606
33088,788786208,1-25-24 18:28,23.33,Return,Walmart Return,519.515606
33089,788786208,1-26-24 16:28,226.44,OutgoingTransfer,Peer-to-Peer Transfer,293.075606
33090,788786208,1-31-24 11:28,145.6,Deposit,Direct Deposit,438.675606
33091,788786208,1-31-24 13:28,154.14,Withdrawal,ATM Withdrawal,284.535606
33092,788786208,02-01-24 12:28,13.78,Payment,Mortgage Payment,270.755606
33093,788786208,02-01-24 14:28,156.96,Payment,Bill Payment,113.795606
33094,788786208,02-01-24 23:28,176.49,OnlineShopping,Best Buy,-62.69439399
33095,788786208,02-03-24 21:28,3800,IncomingTransfer,Salary,3737.305606
33096,788786208,02-05-24 12:28,193.74,Payment,Mortgage Payment,3543.565606
33097,788786208,02-06-24 15:28,242.6,Payment,Mortgage Payment,3300.965606
33098,788786208,02-08-24 21:28,2300,Payment,Credit Card Payment,1000.965606
33099,788786208,02-12-24 20:28,18.41,Withdrawal,Branch Withdrawal,982.555606
33100,788786208,2-13-24 14:28,185.39,OutgoingTransfer,Wire Transfer,797.165606
33101,788786208,2-13-24 14:28,452.81,IncomingTransfer,Freelance Payment,1249.975606
33102,788786208,2-13-24 21:28,1300,Payment,Installment Payment,-50.02439399
33103,788786208,2-14-24 16:28,43.33,Purchase,Furniture,-93.35439399
33104,788786208,2-15-24 11:28,214.56,Withdrawal,Mobile App Withdrawal,-307.914394
33105,788786208,2-18-24 12:28,361.46,Purchase,Gas,-669.374394
33106,788786208,2-18-24 14:28,135.1,Purchase,Electronics,-804.474394
33107,788786208,2-20-24 9:28,437.03,Payment,Loan Payment,-1241.504394
33108,788786208,2-20-24 12:28,466.76,Purchase,Pharmacy,-1708.264394
33109,788786208,2-20-24 15:28,469.71,OnlineShopping,Target,-2177.974394
33110,788786208,2-20-24 17:28,212.34,Deposit,Check Deposit,-1965.634394
33111,788786208,2-21-24 9:28,281.88,Withdrawal,Branch Withdrawal,-2247.514394
33112,788786208,2-23-24 11:28,280.25,Deposit,Check Deposit,-1967.264394
33113,788786208,2-26-24 13:28,190.91,Payment,Bill Payment,-2158.174394
33114,788786208,03-01-24 18:28,12.07,Return,Walmart Return,-2146.104394
33115,788786208,03-03-24 12:28,406.82,Deposit,Check Deposit,-1739.284394
33116,788786208,03-03-24 18:28,333.23,Purchase,Entertainment,-2072.514394
33117,788786208,03-03-24 19:28,45.45,Purchase,Gas,-2117.964394
33118,788786208,03-03-24 21:28,3800,IncomingTransfer,Salary,1682.035606
33119,788786208,03-05-24 20:28,420.57,Deposit,Cash Deposit,2102.605606
33120,788786208,03-08-24 21:28,1900,Payment,Credit Card Payment,202.605606
33121,788786208,03-09-24 19:28,472.79,Deposit,Cash Deposit,675.395606
33122,788786208,03-10-24 20:28,245.66,OutgoingTransfer,Wire Transfer,429.735606
33123,788786208,03-11-24 21:28,1300,Payment,Subscription Payment,-870.264394
33124,788786208,3-14-24 21:28,470.15,Withdrawal,Mobile App Withdrawal,-1340.414394
33125,788786208,3-16-24 13:28,127.81,Payment,Loan Payment,-1468.224394
33126,788786208,3-17-24 16:28,450.6,Withdrawal,Mobile App Withdrawal,-1918.824394
33127,788786208,3-21-24 11:28,339.98,Payment,Loan Payment,-2258.804394
33128,788786208,3-21-24 19:28,275,Return,AliExpress Return,-1983.804394
33129,788786208,3-27-24 20:28,110.58,Withdrawal,Branch Withdrawal,-2094.384394
33130,788786208,3-28-24 12:28,339.37,Purchase,Restaurant,-2433.754394
33131,788786208,3-30-24 13:28,472.97,Deposit,Direct Deposit,-1960.784394
33132,788786208,04-01-24 17:28,54.03,Return,Store Return,-1906.754394
33133,788786208,04-01-24 21:28,3800,IncomingTransfer,Salary,1893.245606
33134,788786208,04-02-24 12:28,145.69,Withdrawal,ATM Withdrawal,1747.555606
33135,788786208,04-02-24 21:28,400.98,Deposit,Mobile Deposit,2148.535606
33136,788786208,04-03-24 14:28,427.48,OutgoingTransfer,International Transfer,1721.055606
33137,788786208,04-06-24 21:28,2100,Payment,Credit Card Payment,-378.944394
33138,788786208,04-07-24 10:28,223.4,Return,Amazon Return,-155.544394
33139,788786208,04-07-24 13:28,145.3,Return,Best Buy Return,-10.24439399
33140,788786208,04-07-24 15:28,276.25,Deposit,Mobile Deposit,266.005606
33141,788786208,04-08-24 15:28,15.37,OnlineShopping,Etsy,250.635606
33142,788786208,4-13-24 10:28,45.15,Purchase,Gas,205.485606
33143,788786208,4-16-24 9:28,285.81,Withdrawal,ATM Withdrawal,-80.32439399
33144,788786208,4-16-24 20:28,313.22,Withdrawal,Branch Withdrawal,-393.544394
33145,788786208,4-16-24 21:28,1200,Payment,Subscription Payment,-1593.544394
33146,788786208,4-17-24 18:28,173.53,Withdrawal,Mobile App Withdrawal,-1767.074394
33147,788786208,4-18-24 23:28,345.84,Deposit,Direct Deposit,-1421.234394
33148,788786208,4-21-24 13:28,244.44,OutgoingTransfer,Peer-to-Peer Transfer,-1665.674394
33149,788786208,4-24-24 12:28,311.63,OnlineShopping,eBay,-1977.304394
33150,788786208,4-24-24 17:28,223.92,Purchase,Furniture,-2201.224394
33151,788786208,4-24-24 21:28,74.75,Deposit,Cash Deposit,-2126.474394
33152,788786208,4-27-24 10:28,39.35,OnlineShopping,AliExpress,-2165.824394
33153,788786208,05-01-24 21:28,387.39,OutgoingTransfer,Peer-to-Peer Transfer,-2553.214394
33154,788786208,05-03-24 21:28,3800,IncomingTransfer,Salary,1246.785606
33155,788786208,05-07-24 15:28,62.56,Deposit,Mobile Deposit,1309.345606
33156,788786208,05-08-24 21:28,2500,Payment,Credit Card Payment,-1190.654394
33157,788786208,05-11-24 15:28,42.23,IncomingTransfer,Freelance Payment,-1148.424394
33158,788786208,05-12-24 11:28,33.72,Deposit,Check Deposit,-1114.704394
33159,788786208,5-14-24 9:28,257.7,Purchase,Gas,-1372.404394
33160,788786208,5-17-24 10:28,371.21,OnlineShopping,Target,-1743.614394
33161,788786208,5-18-24 21:28,1100,Payment,Subscription Payment,-2843.614394
33162,788786208,5-20-24 19:28,166.23,Return,Store Return,-2677.384394
33163,788786208,5-23-24 20:28,148.71,OutgoingTransfer,International Transfer,-2826.094394
33164,788786208,5-25-24 15:28,327.42,Payment,Bill Payment,-3153.514394
33165,788786208,5-29-24 11:28,331.12,Withdrawal,Branch Withdrawal,-3484.634394
33166,788786208,5-30-24 13:28,178.02,Return,Amazon Return,-3306.614394
33167,788786208,06-05-24 20:28,409.68,Deposit,Cash Deposit,-2896.934394
33168,788786208,06-05-24 21:28,3800,IncomingTransfer,Salary,903.065606
33169,788786208,06-06-24 10:28,76.28,Deposit,Cash Deposit,979.345606
33170,788786208,06-09-24 16:28,366.34,Purchase,Entertainment,613.005606
33171,788786208,06-10-24 21:28,2400,Payment,Credit Card Payment,-1786.994394
33172,788786208,06-12-24 20:28,446.79,Return,Walmart Return,-1340.204394
33173,788786208,6-13-24 21:28,1300,Payment,Installment Payment,-2640.204394
33174,788786208,6-15-24 22:28,400.04,IncomingTransfer,Freelance Payment,-2240.164394
33175,788786208,6-19-24 14:28,482.39,Purchase,Travel,-2722.554394
33176,788786208,6-19-24 16:28,246.16,Deposit,Check Deposit,-2476.394394
33177,788786208,6-22-24 12:28,267.57,Deposit,Mobile Deposit,-2208.824394
33178,788786208,6-22-24 22:28,412.18,OnlineShopping,eBay,-2621.004394
33179,788786208,6-25-24 23:28,89.23,Deposit,Direct Deposit,-2531.774394
33180,788786208,6-30-24 17:28,174.97,Payment,Loan Payment,-2706.744394
33181,788786208,6-30-24 18:28,386.44,Return,Best Buy Return,-2320.304394
33182,788786208,07-04-24 20:28,376.96,Purchase,Pharmacy,-2697.264394
33183,788786208,07-05-24 21:28,3800,IncomingTransfer,Salary,1102.735606
33184,788786208,07-09-24 23:28,281.21,Purchase,Home Improvement,821.525606
33185,788786208,07-10-24 21:28,2700,Payment,Credit Card Payment,-1878.474394
33186,788786208,07-11-24 22:28,14.61,Return,Store Return,-1863.864394
33187,788786208,07-11-24 22:28,22.16,Payment,Bill Payment,-1886.024394
33188,788786208,7-14-24 21:28,1200,Payment,Subscription Payment,-3086.024394
33189,788959758,1-20-24 15:28,314.24,Deposit,Check Deposit,666.1166584
33190,788959758,1-20-24 16:28,32.62,Deposit,Direct Deposit,698.7366584
33191,788959758,1-29-24 13:28,211.15,Purchase,Travel,487.5866584
33192,788959758,1-31-24 13:28,373.85,Return,AliExpress Return,861.4366584
33193,788959758,02-04-24 21:28,4650,IncomingTransfer,Salary,5511.436658
33194,788959758,02-05-24 15:28,52.62,OutgoingTransfer,International Transfer,5458.816658
33195,788959758,02-09-24 21:28,700,Payment,Credit Card Payment,4758.816658
33196,788959758,02-12-24 11:28,341.22,Purchase,Electronics,4417.596658
33197,788959758,2-17-24 21:28,2200,Payment,Rent Payment,2217.596658
33198,788959758,2-26-24 10:28,310.75,Withdrawal,Branch Withdrawal,1906.846658
33199,788959758,2-27-24 18:28,218.2,OutgoingTransfer,Bank Transfer,1688.646658
33200,788959758,2-27-24 21:28,306.84,Deposit,Cash Deposit,1995.486658
33201,788959758,2-28-24 18:28,331.44,Withdrawal,Branch Withdrawal,1664.046658
33202,788959758,03-02-24 14:28,93.1,Purchase,Clothing,1570.946658
33203,788959758,03-03-24 11:28,247.56,IncomingTransfer,Freelance Payment,1818.506658
33204,788959758,03-03-24 21:28,4650,IncomingTransfer,Salary,6468.506658
33205,788959758,03-08-24 9:28,70.28,OnlineShopping,Etsy,6398.226658
33206,788959758,03-08-24 21:28,700,Payment,Credit Card Payment,5698.226658
33207,788959758,3-14-24 12:28,28.15,Purchase,Travel,5670.076658
33208,788959758,3-14-24 14:28,222.26,Purchase,Travel,5447.816658
33209,788959758,3-14-24 18:28,326.14,Return,eBay Return,5773.956658
33210,788959758,3-16-24 21:28,1600,Payment,Rent Payment,4173.956658
33211,788959758,3-19-24 17:28,240.72,Purchase,Grocery,3933.236658
33212,788959758,3-20-24 17:28,77.72,Payment,Bill Payment,3855.516658
33213,788959758,3-20-24 18:28,225.45,IncomingTransfer,Freelance Payment,4080.966658
33214,788959758,3-20-24 23:28,327.66,Payment,Mortgage Payment,3753.306658
33215,788959758,3-23-24 17:28,247.66,Return,Best Buy Return,4000.966658
33216,788959758,3-26-24 16:28,282.02,Payment,Loan Payment,3718.946658
33217,788959758,04-02-24 20:28,319.61,Withdrawal,Branch Withdrawal,3399.336658
33218,788959758,04-03-24 21:28,4650,IncomingTransfer,Salary,8049.336658
33219,788959758,04-04-24 14:28,47.52,Withdrawal,ATM Withdrawal,8001.816658
33220,788959758,04-08-24 15:28,194.67,Return,Etsy Return,8196.486658
33221,788959758,04-08-24 21:28,700,Payment,Credit Card Payment,7496.486658
33222,788959758,04-10-24 22:28,50.84,Deposit,Mobile Deposit,7547.326658
33223,788959758,4-15-24 21:28,1600,Payment,Rent Payment,5947.326658
33224,788959758,4-18-24 22:28,164.95,Return,Etsy Return,6112.276658
33225,788959758,4-25-24 20:28,398.42,Return,Etsy Return,6510.696658
33226,788959758,4-30-24 22:28,288.9,OnlineShopping,AliExpress,6221.796658
33227,788959758,05-04-24 16:28,365.17,Withdrawal,Branch Withdrawal,5856.626658
33228,788959758,05-04-24 21:28,4650,IncomingTransfer,Salary,10506.62666
33229,788959758,05-05-24 18:28,353.79,Purchase,Clothing,10152.83666
33230,788959758,05-05-24 18:28,107.25,Withdrawal,Mobile App Withdrawal,10045.58666
33231,788959758,05-07-24 21:28,299.84,OnlineShopping,Target,9745.746658
33232,788959758,05-09-24 21:28,800,Payment,Credit Card Payment,8945.746658
33233,788959758,5-16-24 21:28,2800,Payment,Rent Payment,6145.746658
33234,788959758,5-17-24 23:28,349.01,OnlineShopping,Etsy,5796.736658
33235,788959758,5-18-24 16:28,154.5,IncomingTransfer,Freelance Payment,5951.236658
33236,788959758,5-25-24 20:28,307.15,Deposit,Check Deposit,6258.386658
33237,788959758,5-29-24 10:28,359.78,Purchase,Restaurant,5898.606658
33238,788959758,5-29-24 12:28,309.62,OnlineShopping,AliExpress,5588.986658
33239,788959758,06-01-24 14:28,146.76,Deposit,Cash Deposit,5735.746658
33240,788959758,06-01-24 21:28,4650,IncomingTransfer,Salary,10385.74666
33241,788959758,06-03-24 17:28,137.35,Purchase,Restaurant,10248.39666
33242,788959758,06-06-24 21:28,700,Payment,Credit Card Payment,9548.396658
33243,788959758,06-08-24 22:28,214.41,Deposit,Mobile Deposit,9762.806658
33244,788959758,06-09-24 11:28,95.02,OnlineShopping,Amazon,9667.786658
33245,788959758,06-10-24 9:28,279.03,Return,Amazon Return,9946.816658
33246,788959758,06-10-24 23:28,340.38,Deposit,Cash Deposit,10287.19666
33247,788959758,6-13-24 12:28,196.98,OnlineShopping,eBay,10090.21666
33248,788959758,6-16-24 21:28,2900,Payment,Rent Payment,7190.216658
33249,788959758,6-17-24 17:28,235.91,OutgoingTransfer,Peer-to-Peer Transfer,6954.306658
33250,788959758,6-19-24 20:28,190.22,Payment,Loan Payment,6764.086658
33251,788959758,6-19-24 20:28,300.47,Purchase,Grocery,6463.616658
33252,788959758,6-21-24 10:28,84.67,Withdrawal,Branch Withdrawal,6378.946658
33253,788959758,6-21-24 22:28,65.26,Deposit,Check Deposit,6444.206658
33254,788959758,6-22-24 17:28,54.04,IncomingTransfer,Freelance Payment,6498.246658
33255,788959758,6-24-24 12:28,354.82,Payment,Bill Payment,6143.426658
33256,788959758,6-29-24 17:28,83.34,Purchase,Electronics,6060.086658
33257,788959758,07-01-24 16:28,245.97,Withdrawal,Mobile App Withdrawal,5814.116658
33258,788959758,07-01-24 21:28,4650,IncomingTransfer,Salary,10464.11666
33259,788959758,07-03-24 11:28,268.31,Return,Best Buy Return,10732.42666
33260,788959758,07-03-24 11:28,390.26,Purchase,Travel,10342.16666
33261,788959758,07-06-24 21:28,800,Payment,Credit Card Payment,9542.166658
33262,788959758,07-07-24 10:28,22.35,Withdrawal,ATM Withdrawal,9519.816658
33263,788959758,7-14-24 17:28,196.85,IncomingTransfer,Freelance Payment,9716.666658
33264,788959758,7-15-24 9:28,292.73,Purchase,Entertainment,9423.936658
33265,788959758,7-18-24 21:28,3000,Payment,Rent Payment,6423.936658
33266,788965683,1-29-24 14:28,65.13,IncomingTransfer,Freelance Payment,65.13
33267,788965683,02-01-24 9:28,222.22,Withdrawal,Branch Withdrawal,-157.09
33268,788965683,02-03-24 16:28,209.01,Withdrawal,ATM Withdrawal,-366.1
33269,788965683,02-04-24 21:28,2150,IncomingTransfer,Salary,1783.9
33270,788965683,02-07-24 23:28,183.8,Purchase,Clothing,1600.1
33271,788965683,02-11-24 22:28,25.45,OnlineShopping,AliExpress,1574.65
33272,788965683,2-13-24 23:28,87.7,OutgoingTransfer,Bank Transfer,1486.95
33273,788965683,2-15-24 16:28,56.18,Purchase,Entertainment,1430.77
33274,788965683,2-15-24 21:28,700,Payment,Rent Payment,730.77
33275,788965683,2-26-24 20:28,148.29,OutgoingTransfer,Bank Transfer,582.48
33276,788965683,2-27-24 23:28,176.68,Payment,Bill Payment,405.8
33277,788965683,03-04-24 21:28,2150,IncomingTransfer,Salary,2555.8
33278,788965683,03-07-24 21:28,76.4,Purchase,Electronics,2479.4
33279,788965683,03-11-24 9:28,65.27,Deposit,Cash Deposit,2544.67
33280,788965683,3-15-24 21:28,800,Payment,Rent Payment,1744.67
33281,788965683,3-22-24 12:28,138.89,Purchase,Restaurant,1605.78
33282,788965683,3-28-24 20:28,249.26,Purchase,Furniture,1356.52
33283,788965683,04-01-24 21:28,2150,IncomingTransfer,Salary,3506.52
33284,788965683,04-02-24 16:28,45.51,OnlineShopping,Target,3461.01
33285,788965683,04-08-24 14:28,61.36,Payment,Bill Payment,3399.65
33286,788965683,04-11-24 19:28,229.42,Purchase,Restaurant,3170.23
33287,788965683,04-12-24 18:28,225.07,Purchase,Grocery,2945.16
33288,788965683,4-15-24 12:28,42.68,Deposit,Direct Deposit,2987.84
33289,788965683,4-16-24 22:28,160.96,Payment,Bill Payment,2826.88
33290,788965683,4-17-24 18:28,157.32,Payment,Mortgage Payment,2669.56
33291,788965683,4-17-24 21:28,1100,Payment,Rent Payment,1569.56
33292,788965683,4-18-24 22:28,11.45,Deposit,Direct Deposit,1581.01
33293,788965683,4-22-24 17:28,18.55,Purchase,Travel,1562.46
33294,788965683,4-27-24 20:28,219.49,OutgoingTransfer,Peer-to-Peer Transfer,1342.97
33295,788965683,05-02-24 21:28,132.91,Purchase,Home Improvement,1210.06
33296,788965683,05-03-24 21:28,2150,IncomingTransfer,Salary,3360.06
33297,788965683,05-04-24 11:28,174.21,Purchase,Electronics,3185.85
33298,788965683,05-07-24 11:28,39.83,OutgoingTransfer,International Transfer,3146.02
33299,788965683,5-13-24 22:28,156.68,Return,Amazon Return,3302.7
33300,788965683,5-15-24 21:28,1300,Payment,Rent Payment,2002.7
33301,788965683,5-17-24 17:28,150.81,Deposit,Mobile Deposit,2153.51
33302,788965683,5-20-24 21:28,35.22,Deposit,Direct Deposit,2188.73
33303,788965683,5-23-24 11:28,128.53,OnlineShopping,eBay,2060.2
33304,788965683,5-23-24 18:28,227.59,Return,Store Return,2287.79
33305,788965683,06-05-24 21:28,2150,IncomingTransfer,Salary,4437.79
33306,788965683,06-09-24 22:28,11.85,OnlineShopping,Walmart,4425.94
33307,788965683,6-14-24 21:28,1300,Payment,Rent Payment,3125.94
33308,788965683,6-19-24 22:28,189.06,OutgoingTransfer,Bank Transfer,2936.88
33309,788965683,6-21-24 12:28,210.43,Return,AliExpress Return,3147.31
33310,788965683,6-25-24 15:28,41.81,Deposit,Direct Deposit,3189.12
33311,788965683,07-01-24 21:28,2150,IncomingTransfer,Salary,5339.12
33312,788965683,07-03-24 20:28,247.61,Purchase,Pharmacy,5091.51
33313,788965683,07-06-24 14:28,41.92,Purchase,Entertainment,5049.59
33314,788965683,07-08-24 11:28,203.13,Deposit,Mobile Deposit,5252.72
33315,788965683,07-08-24 12:28,10.77,OnlineShopping,Amazon,5241.95
33316,788965683,07-12-24 14:28,218.26,OnlineShopping,Walmart,5023.69
33317,788965683,07-12-24 16:28,157.45,Deposit,Mobile Deposit,5181.14
33318,788965683,7-14-24 21:28,600,Payment,Rent Payment,4581.14
33319,789016983,1-20-24 17:28,135.03,Withdrawal,Branch Withdrawal,354.690878
33320,789016983,1-22-24 17:28,64.7,Purchase,Electronics,289.990878
33321,789016983,1-22-24 20:28,118.95,Deposit,Check Deposit,408.940878
33322,789016983,1-25-24 13:28,37.25,Purchase,Restaurant,371.690878
33323,789016983,1-28-24 12:28,155.47,Return,eBay Return,527.160878
33324,789016983,1-31-24 9:28,84.87,Purchase,Pharmacy,442.290878
33325,789016983,1-31-24 13:28,71.45,Deposit,Check Deposit,513.740878
33326,789016983,1-31-24 21:28,50.12,OnlineShopping,Etsy,463.620878
33327,789016983,02-02-24 21:28,3150,IncomingTransfer,Salary,3613.620878
33328,789016983,02-03-24 10:28,180.61,OnlineShopping,Best Buy,3433.010878
33329,789016983,02-03-24 13:28,140.93,IncomingTransfer,Freelance Payment,3573.940878
33330,789016983,02-07-24 21:28,1300,Payment,Credit Card Payment,2273.940878
33331,789016983,02-10-24 10:28,149.11,Purchase,Gas,2124.830878
33332,789016983,02-10-24 18:28,84.05,Withdrawal,Branch Withdrawal,2040.780878
33333,789016983,02-10-24 22:28,104.58,Deposit,Check Deposit,2145.360878
33334,789016983,2-13-24 9:28,184.75,Purchase,Electronics,1960.610878
33335,789016983,2-14-24 19:28,78.39,Return,Best Buy Return,2039.000878
33336,789016983,2-17-24 13:28,122.91,Deposit,Cash Deposit,2161.910878
33337,789016983,2-17-24 14:28,186.47,Return,Store Return,2348.380878
33338,789016983,2-18-24 21:28,1200,Payment,Rent Payment,1148.380878
33339,789016983,2-19-24 9:28,95.28,Return,Walmart Return,1243.660878
33340,789016983,2-24-24 21:28,99.65,Deposit,Check Deposit,1343.310878
33341,789016983,2-24-24 22:28,74.82,Return,Amazon Return,1418.130878
33342,789016983,2-26-24 20:28,174.31,OutgoingTransfer,Bank Transfer,1243.820878
33343,789016983,2-26-24 23:28,124.32,Purchase,Home Improvement,1119.500878
33344,789016983,2-27-24 16:28,182.47,OnlineShopping,AliExpress,937.030878
33345,789016983,2-27-24 18:28,14.63,Deposit,Mobile Deposit,951.660878
33346,789016983,2-29-24 18:28,133.29,Deposit,Check Deposit,1084.950878
33347,789016983,03-02-24 21:28,30.82,Deposit,Check Deposit,1115.770878
33348,789016983,03-03-24 15:28,217.56,IncomingTransfer,Freelance Payment,1333.330878
33349,789016983,03-05-24 21:28,3150,IncomingTransfer,Salary,4483.330878
33350,789016983,03-09-24 18:28,164.2,Deposit,Cash Deposit,4647.530878
33351,789016983,03-10-24 14:28,114.86,Deposit,Check Deposit,4762.390878
33352,789016983,03-10-24 21:28,1200,Payment,Credit Card Payment,3562.390878
33353,789016983,03-12-24 9:28,174.04,OnlineShopping,Amazon,3388.350878
33354,789016983,03-12-24 19:28,217.51,Deposit,Check Deposit,3605.860878
33355,789016983,03-12-24 21:28,156.35,Return,Store Return,3762.210878
33356,789016983,3-13-24 21:28,164.55,Payment,Bill Payment,3597.660878
33357,789016983,3-15-24 18:28,247.33,Withdrawal,ATM Withdrawal,3350.330878
33358,789016983,3-15-24 21:28,1200,Payment,Rent Payment,2150.330878
33359,789016983,3-22-24 10:28,17.33,Purchase,Home Improvement,2133.000878
33360,789016983,3-22-24 17:28,213.99,Return,Etsy Return,2346.990878
33361,789016983,3-26-24 19:28,181.13,Deposit,Cash Deposit,2528.120878
33362,789016983,04-03-24 10:28,153.78,Deposit,Direct Deposit,2681.900878
33363,789016983,04-03-24 19:28,13.3,Purchase,Gas,2668.600878
33364,789016983,04-04-24 17:28,96.16,Purchase,Entertainment,2572.440878
33365,789016983,04-04-24 21:28,3150,IncomingTransfer,Salary,5722.440878
33366,789016983,04-09-24 21:28,1300,Payment,Credit Card Payment,4422.440878
33367,789016983,04-09-24 21:28,222.89,OutgoingTransfer,International Transfer,4199.550878
33368,789016983,04-12-24 20:28,27.82,OnlineShopping,Target,4171.730878
33369,789016983,4-14-24 12:28,92.32,OutgoingTransfer,Peer-to-Peer Transfer,4079.410878
33370,789016983,4-14-24 21:28,1600,Payment,Rent Payment,2479.410878
33371,789016983,4-16-24 14:28,55.6,Withdrawal,Mobile App Withdrawal,2423.810878
33372,789016983,4-16-24 19:28,34.83,Return,eBay Return,2458.640878
33373,789016983,4-18-24 18:28,183.98,Deposit,Check Deposit,2642.620878
33374,789016983,4-19-24 22:28,89.11,Return,Etsy Return,2731.730878
33375,789016983,4-28-24 11:28,174.77,Withdrawal,Branch Withdrawal,2556.960878
33376,789016983,4-28-24 16:28,131.41,OnlineShopping,Etsy,2425.550878
33377,789016983,05-02-24 18:28,187.34,Return,Store Return,2612.890878
33378,789016983,05-03-24 12:28,29.93,OnlineShopping,AliExpress,2582.960878
33379,789016983,05-03-24 21:28,3150,IncomingTransfer,Salary,5732.960878
33380,789016983,05-05-24 10:28,87.34,IncomingTransfer,Freelance Payment,5820.300878
33381,789016983,05-08-24 10:28,95.41,Withdrawal,Mobile App Withdrawal,5724.890878
33382,789016983,05-08-24 12:28,244.15,Withdrawal,ATM Withdrawal,5480.740878
33383,789016983,05-08-24 21:28,1200,Payment,Credit Card Payment,4280.740878
33384,789016983,05-11-24 21:28,67.63,OnlineShopping,Amazon,4213.110878
33385,789016983,5-13-24 9:28,155.2,OnlineShopping,eBay,4057.910878
33386,789016983,5-14-24 22:28,41.11,Return,eBay Return,4099.020878
33387,789016983,5-15-24 23:28,147.46,OnlineShopping,Amazon,3951.560878
33388,789016983,5-16-24 21:28,1300,Payment,Rent Payment,2651.560878
33389,789016983,5-20-24 14:28,181.17,OnlineShopping,Etsy,2470.390878
33390,789016983,5-26-24 11:28,61.44,OutgoingTransfer,Bank Transfer,2408.950878
33391,789016983,5-27-24 16:28,233.12,Purchase,Gas,2175.830878
33392,789016983,5-29-24 9:28,100.74,OnlineShopping,AliExpress,2075.090878
33393,789016983,5-31-24 15:28,99.22,OnlineShopping,eBay,1975.870878
33394,789016983,06-01-24 17:28,185.22,Payment,Loan Payment,1790.650878
33395,789016983,06-01-24 21:28,3150,IncomingTransfer,Salary,4940.650878
33396,789016983,06-05-24 17:28,124.1,Payment,Bill Payment,4816.550878
33397,789016983,06-06-24 16:28,129.57,OnlineShopping,AliExpress,4686.980878
33398,789016983,06-06-24 19:28,86.02,IncomingTransfer,Freelance Payment,4773.000878
33399,789016983,06-06-24 21:28,1300,Payment,Credit Card Payment,3473.000878
33400,789016983,06-07-24 14:28,86.73,Purchase,Restaurant,3386.270878
33401,789016983,6-14-24 21:28,1500,Payment,Rent Payment,1886.270878
33402,789016983,6-16-24 13:28,49.57,Return,eBay Return,1935.840878
33403,789016983,6-16-24 22:28,119.88,Return,Etsy Return,2055.720878
33404,789016983,6-18-24 11:28,188.57,Payment,Mortgage Payment,1867.150878
33405,789016983,6-21-24 18:28,143.22,Withdrawal,Mobile App Withdrawal,1723.930878
33406,789016983,6-22-24 13:28,233.99,OnlineShopping,AliExpress,1489.940878
33407,789016983,6-29-24 11:28,132.19,OutgoingTransfer,Bank Transfer,1357.750878
33408,789016983,6-29-24 13:28,149.02,Return,AliExpress Return,1506.770878
33409,789016983,07-01-24 9:28,242.55,OutgoingTransfer,Bank Transfer,1264.220878
33410,789016983,07-02-24 21:28,3150,IncomingTransfer,Salary,4414.220878
33411,789016983,07-05-24 9:28,146.73,Withdrawal,Branch Withdrawal,4267.490878
33412,789016983,07-05-24 9:28,37.51,Deposit,Mobile Deposit,4305.000878
33413,789016983,07-06-24 15:28,26.73,OutgoingTransfer,Bank Transfer,4278.270878
33414,789016983,07-06-24 20:28,247.79,Deposit,Direct Deposit,4526.060878
33415,789016983,07-07-24 19:28,246.11,Withdrawal,Branch Withdrawal,4279.950878
33416,789016983,07-07-24 21:28,1000,Payment,Credit Card Payment,3279.950878
33417,789016983,07-10-24 9:28,68.75,Deposit,Mobile Deposit,3348.700878
33418,789016983,07-11-24 16:28,26.96,Purchase,Clothing,3321.740878
33419,789016983,7-13-24 10:28,102.9,Deposit,Direct Deposit,3424.640878
33420,789016983,7-14-24 21:28,1400,Payment,Rent Payment,2024.640878
33421,789016983,7-15-24 13:28,221.87,Payment,Bill Payment,1802.770878
33422,789016983,7-17-24 15:28,132.86,OutgoingTransfer,Bank Transfer,1669.910878
33423,789122808,1-20-24 14:28,61.3,OutgoingTransfer,Bank Transfer,-61.3
33424,789122808,1-20-24 22:28,241.07,Withdrawal,Branch Withdrawal,-302.37
33425,789122808,1-26-24 23:28,254.89,OutgoingTransfer,Bank Transfer,-557.26
33426,789122808,1-29-24 22:28,143.42,OutgoingTransfer,International Transfer,-700.68
33427,789122808,02-03-24 21:28,4850,IncomingTransfer,Salary,4149.32
33428,789122808,02-04-24 22:28,160.33,Deposit,Check Deposit,4309.65
33429,789122808,02-08-24 14:28,157.04,Deposit,Mobile Deposit,4466.69
33430,789122808,02-11-24 21:28,2500,Payment,Rent Payment,1966.69
33431,789122808,2-14-24 11:28,54.85,OutgoingTransfer,Bank Transfer,1911.84
33432,789122808,2-17-24 17:28,392.51,Withdrawal,Branch Withdrawal,1519.33
33433,789122808,2-18-24 20:28,342.4,Deposit,Direct Deposit,1861.73
33434,789122808,2-19-24 16:28,117.34,Purchase,Home Improvement,1744.39
33435,789122808,2-23-24 18:28,276.41,OnlineShopping,Etsy,1467.98
33436,789122808,2-23-24 20:28,300.16,IncomingTransfer,Freelance Payment,1768.14
33437,789122808,2-26-24 17:28,65.85,Deposit,Mobile Deposit,1833.99
33438,789122808,2-27-24 9:28,97.23,Deposit,Check Deposit,1931.22
33439,789122808,2-28-24 17:28,393.47,Withdrawal,Mobile App Withdrawal,1537.75
33440,789122808,03-01-24 23:28,167.67,OnlineShopping,eBay,1370.08
33441,789122808,03-03-24 22:28,397.98,Payment,Mortgage Payment,972.1
33442,789122808,03-05-24 21:28,4850,IncomingTransfer,Salary,5822.1
33443,789122808,03-06-24 15:28,234.81,Purchase,Gas,5587.29
33444,789122808,03-09-24 19:28,253.67,Purchase,Home Improvement,5333.62
33445,789122808,03-10-24 21:28,91.4,Purchase,Home Improvement,5242.22
33446,789122808,03-11-24 16:28,203.77,Payment,Mortgage Payment,5038.45
33447,789122808,03-12-24 10:28,270.9,Deposit,Check Deposit,5309.35
33448,789122808,3-15-24 20:28,399.66,Deposit,Direct Deposit,5709.01
33449,789122808,3-17-24 11:28,65.14,Purchase,Entertainment,5643.87
33450,789122808,3-17-24 21:28,1500,Payment,Rent Payment,4143.87
33451,789122808,3-19-24 12:28,109.09,Deposit,Mobile Deposit,4252.96
33452,789122808,04-01-24 11:28,277.93,Purchase,Grocery,3975.03
33453,789122808,04-05-24 21:28,4850,IncomingTransfer,Salary,8825.03
33454,789122808,04-09-24 18:28,107.4,Withdrawal,Branch Withdrawal,8717.63
33455,789122808,04-11-24 21:28,1600,Payment,Rent Payment,7117.63
33456,789122808,4-25-24 14:28,75.81,Payment,Loan Payment,7041.82
33457,789122808,4-25-24 18:28,357.56,Withdrawal,ATM Withdrawal,6684.26
33458,789122808,4-27-24 22:28,69.17,OnlineShopping,AliExpress,6615.09
33459,789122808,05-04-24 21:28,4850,IncomingTransfer,Salary,11465.09
33460,789122808,5-13-24 19:28,23.08,Withdrawal,ATM Withdrawal,11442.01
33461,789122808,5-14-24 13:28,308.93,Return,Target Return,11750.94
33462,789122808,5-14-24 23:28,182.34,OnlineShopping,AliExpress,11568.6
33463,789122808,5-18-24 21:28,1500,Payment,Rent Payment,10068.6
33464,789122808,5-22-24 11:28,80.97,Deposit,Direct Deposit,10149.57
33465,789122808,5-24-24 14:28,85.05,Purchase,Travel,10064.52
33466,789122808,5-25-24 13:28,250.13,Withdrawal,Branch Withdrawal,9814.39
33467,789122808,5-30-24 18:28,91.57,Return,Store Return,9905.96
33468,789122808,5-31-24 9:28,238.56,Return,Etsy Return,10144.52
33469,789122808,06-03-24 21:28,4850,IncomingTransfer,Salary,14994.52
33470,789122808,06-07-24 17:28,65.17,Return,Walmart Return,15059.69
33471,789122808,06-10-24 21:28,1700,Payment,Rent Payment,13359.69
33472,789122808,6-25-24 17:28,332.02,Return,Best Buy Return,13691.71
33473,789122808,6-28-24 13:28,33.06,Withdrawal,ATM Withdrawal,13658.65
33474,789122808,6-30-24 21:28,24.63,OutgoingTransfer,Wire Transfer,13634.02
33475,789122808,07-01-24 21:28,4850,IncomingTransfer,Salary,18484.02
33476,789122808,07-05-24 16:28,242.18,IncomingTransfer,Freelance Payment,18726.2
33477,789122808,07-12-24 20:28,349.33,OutgoingTransfer,Peer-to-Peer Transfer,18376.87
33478,789122808,7-15-24 14:28,158.13,OutgoingTransfer,Wire Transfer,18218.74
33479,789122808,7-17-24 21:28,3100,Payment,Rent Payment,15118.74
33480,789170283,1-21-24 19:28,583.56,Deposit,Mobile Deposit,1162.728321
33481,789170283,1-28-24 22:28,503.6,OnlineShopping,Walmart,659.1283207
33482,789170283,1-30-24 11:28,373.29,OutgoingTransfer,Bank Transfer,285.8383207
33483,789170283,1-31-24 17:28,636.33,Withdrawal,Mobile App Withdrawal,-350.4916793
33484,789170283,02-01-24 21:28,716.42,Return,eBay Return,365.9283207
33485,789170283,02-04-24 10:28,711.06,OnlineShopping,Etsy,-345.1316793
33486,789170283,02-04-24 21:28,9650,IncomingTransfer,Salary,9304.868321
33487,789170283,02-05-24 20:28,740.27,OutgoingTransfer,Wire Transfer,8564.598321
33488,789170283,02-06-24 13:28,642.03,OnlineShopping,Etsy,7922.568321
33489,789170283,02-09-24 21:28,1200,Payment,Credit Card Payment,6722.568321
33490,789170283,2-13-24 21:28,3700,Payment,Insurance Payment,3022.568321
33491,789170283,2-16-24 9:28,579.96,OnlineShopping,Target,2442.608321
33492,789170283,2-18-24 18:28,468.3,Purchase,Grocery,1974.308321
33493,789170283,2-21-24 15:28,421.64,Return,Amazon Return,2395.948321
33494,789170283,2-21-24 16:28,655.46,Withdrawal,ATM Withdrawal,1740.488321
33495,789170283,2-29-24 12:28,635.87,OutgoingTransfer,Peer-to-Peer Transfer,1104.618321
33496,789170283,03-01-24 12:28,158.84,Return,Etsy Return,1263.458321
33497,789170283,03-01-24 21:28,9650,IncomingTransfer,Salary,10913.45832
33498,789170283,03-02-24 19:28,660.25,Deposit,Check Deposit,11573.70832
33499,789170283,03-02-24 20:28,373.34,Withdrawal,Mobile App Withdrawal,11200.36832
33500,789170283,03-05-24 22:28,143.69,OnlineShopping,Etsy,11056.67832
33501,789170283,03-06-24 21:28,1100,Payment,Credit Card Payment,9956.678321
33502,789170283,03-08-24 9:28,532.25,Purchase,Pharmacy,9424.428321
33503,789170283,03-08-24 20:28,711.44,Deposit,Check Deposit,10135.86832
33504,789170283,03-12-24 21:28,3700,Payment,Installment Payment,6435.868321
33505,789170283,3-13-24 11:28,698.74,Deposit,Check Deposit,7134.608321
33506,789170283,3-17-24 17:28,393.37,OnlineShopping,Target,6741.238321
33507,789170283,3-17-24 20:28,572.13,Withdrawal,Mobile App Withdrawal,6169.108321
33508,789170283,3-17-24 22:28,564.49,Deposit,Check Deposit,6733.598321
33509,789170283,3-18-24 17:28,490.68,Return,Etsy Return,7224.278321
33510,789170283,3-21-24 22:28,157.48,OutgoingTransfer,Wire Transfer,7066.798321
33511,789170283,3-23-24 22:28,108.69,Deposit,Direct Deposit,7175.488321
33512,789170283,3-28-24 15:28,538.36,Purchase,Pharmacy,6637.128321
33513,789170283,3-31-24 11:28,649.25,Purchase,Pharmacy,5987.878321
33514,789170283,04-03-24 12:28,706.05,Return,Store Return,6693.928321
33515,789170283,04-04-24 14:28,523.76,Payment,Loan Payment,6170.168321
33516,789170283,04-05-24 21:28,9650,IncomingTransfer,Salary,15820.16832
33517,789170283,04-06-24 10:28,154.99,Deposit,Cash Deposit,15975.15832
33518,789170283,04-07-24 11:28,152.32,Purchase,Clothing,15822.83832
33519,789170283,04-08-24 16:28,517.47,Deposit,Direct Deposit,16340.30832
33520,789170283,04-10-24 14:28,708.78,Purchase,Home Improvement,15631.52832
33521,789170283,04-10-24 21:28,1200,Payment,Credit Card Payment,14431.52832
33522,789170283,04-12-24 17:28,208.19,Withdrawal,ATM Withdrawal,14223.33832
33523,789170283,4-17-24 21:28,3100,Payment,Subscription Payment,11123.33832
33524,789170283,4-23-24 11:28,561.73,OutgoingTransfer,Wire Transfer,10561.60832
33525,789170283,4-28-24 22:28,112.8,Return,Walmart Return,10674.40832
33526,789170283,4-29-24 12:28,181.61,Deposit,Check Deposit,10856.01832
33527,789170283,4-30-24 9:28,164.95,Purchase,Travel,10691.06832
33528,789170283,05-01-24 10:28,320.65,Return,Store Return,11011.71832
33529,789170283,05-01-24 11:28,565.11,Deposit,Mobile Deposit,11576.82832
33530,789170283,05-01-24 21:28,9650,IncomingTransfer,Salary,21226.82832
33531,789170283,05-06-24 19:28,548.59,Withdrawal,Branch Withdrawal,20678.23832
33532,789170283,05-06-24 21:28,1300,Payment,Credit Card Payment,19378.23832
33533,789170283,05-09-24 17:28,612.41,Purchase,Pharmacy,18765.82832
33534,789170283,05-10-24 21:28,3000,Payment,Subscription Payment,15765.82832
33535,789170283,05-12-24 13:28,553.89,IncomingTransfer,Freelance Payment,16319.71832
33536,789170283,5-16-24 19:28,631.94,Purchase,Gas,15687.77832
33537,789170283,5-18-24 14:28,739.97,OnlineShopping,Best Buy,14947.80832
33538,789170283,5-18-24 19:28,116.39,OutgoingTransfer,Wire Transfer,14831.41832
33539,789170283,5-26-24 16:28,335.84,Payment,Mortgage Payment,14495.57832
33540,789170283,5-26-24 20:28,217.46,Purchase,Travel,14278.11832
33541,789170283,5-27-24 20:28,112.59,Return,eBay Return,14390.70832
33542,789170283,5-31-24 13:28,385.62,Withdrawal,Mobile App Withdrawal,14005.08832
33543,789170283,06-04-24 21:28,9650,IncomingTransfer,Salary,23655.08832
33544,789170283,06-06-24 19:28,386.16,Deposit,Direct Deposit,24041.24832
33545,789170283,06-06-24 23:28,371.44,Purchase,Entertainment,23669.80832
33546,789170283,06-08-24 19:28,366.72,Purchase,Pharmacy,23303.08832
33547,789170283,06-09-24 21:28,1200,Payment,Credit Card Payment,22103.08832
33548,789170283,6-13-24 21:28,3900,Payment,Installment Payment,18203.08832
33549,789170283,6-28-24 12:28,538.03,Withdrawal,Mobile App Withdrawal,17665.05832
33550,789170283,6-28-24 17:28,743.49,Withdrawal,Branch Withdrawal,16921.56832
33551,789170283,07-02-24 14:28,118.41,Deposit,Direct Deposit,17039.97832
33552,789170283,07-04-24 21:28,9650,IncomingTransfer,Salary,26689.97832
33553,789170283,07-04-24 23:28,713.63,Payment,Bill Payment,25976.34832
33554,789170283,07-07-24 22:28,127.71,Deposit,Mobile Deposit,26104.05832
33555,789170283,07-09-24 21:28,1200,Payment,Credit Card Payment,24904.05832
33556,789170283,07-11-24 18:28,675.5,OnlineShopping,Etsy,24228.55832
33557,789170283,07-12-24 13:28,560.45,Deposit,Direct Deposit,24789.00832
33558,789170283,7-13-24 12:28,737.69,Return,Walmart Return,25526.69832
33559,789170283,7-15-24 21:28,446.16,OutgoingTransfer,Bank Transfer,25080.53832
33560,789170283,7-16-24 21:28,3200,Payment,Installment Payment,21880.53832
33561,789182358,1-23-24 20:28,639.3,Return,eBay Return,1802.024111
33562,789182358,1-28-24 16:28,715.33,Purchase,Entertainment,1086.694111
33563,789182358,02-05-24 21:28,8850,IncomingTransfer,Salary,9936.694111
33564,789182358,02-10-24 21:28,1900,Payment,Credit Card Payment,8036.694111
33565,789182358,02-11-24 15:28,623.15,OutgoingTransfer,Bank Transfer,7413.544111
33566,789182358,2-14-24 21:28,2600,Payment,Insurance Payment,4813.544111
33567,789182358,2-19-24 12:28,513.09,Return,Target Return,5326.634111
33568,789182358,2-23-24 14:28,120.82,OnlineShopping,Best Buy,5205.814111
33569,789182358,2-24-24 15:28,676.75,Return,AliExpress Return,5882.564111
33570,789182358,2-26-24 19:28,526.71,Payment,Loan Payment,5355.854111
33571,789182358,2-26-24 20:28,290.09,OutgoingTransfer,Peer-to-Peer Transfer,5065.764111
33572,789182358,03-02-24 11:28,327.17,OutgoingTransfer,International Transfer,4738.594111
33573,789182358,03-03-24 14:28,332.85,Withdrawal,ATM Withdrawal,4405.744111
33574,789182358,03-03-24 20:28,413.79,Withdrawal,ATM Withdrawal,3991.954111
33575,789182358,03-03-24 21:28,8850,IncomingTransfer,Salary,12841.95411
33576,789182358,03-04-24 21:28,132.7,Withdrawal,Branch Withdrawal,12709.25411
33577,789182358,03-06-24 10:28,577.87,Return,AliExpress Return,13287.12411
33578,789182358,03-08-24 21:28,1900,Payment,Credit Card Payment,11387.12411
33579,789182358,03-12-24 11:28,363.37,Deposit,Mobile Deposit,11750.49411
33580,789182358,3-14-24 9:28,641.31,Return,Walmart Return,12391.80411
33581,789182358,3-18-24 21:28,3600,Payment,Subscription Payment,8791.804111
33582,789182358,3-21-24 10:28,215.88,Purchase,Furniture,8575.924111
33583,789182358,3-21-24 19:28,712.44,IncomingTransfer,Freelance Payment,9288.364111
33584,789182358,3-23-24 14:28,192.78,OnlineShopping,Target,9095.584111
33585,789182358,3-24-24 21:28,172.33,Deposit,Check Deposit,9267.914111
33586,789182358,3-24-24 22:28,313.55,Payment,Mortgage Payment,8954.364111
33587,789182358,3-25-24 23:28,270.39,Return,eBay Return,9224.754111
33588,789182358,3-31-24 22:28,713.94,Purchase,Pharmacy,8510.814111
33589,789182358,04-04-24 21:28,8850,IncomingTransfer,Salary,17360.81411
33590,789182358,04-05-24 19:28,332.08,Deposit,Direct Deposit,17692.89411
33591,789182358,04-06-24 14:28,108.91,Purchase,Entertainment,17583.98411
33592,789182358,04-07-24 19:28,246.35,OutgoingTransfer,Wire Transfer,17337.63411
33593,789182358,04-07-24 22:28,298.24,OnlineShopping,Target,17039.39411
33594,789182358,04-09-24 17:28,427.15,Withdrawal,ATM Withdrawal,16612.24411
33595,789182358,04-09-24 21:28,1800,Payment,Credit Card Payment,14812.24411
33596,789182358,04-10-24 21:28,3500,Payment,Installment Payment,11312.24411
33597,789182358,4-13-24 19:28,170.99,IncomingTransfer,Freelance Payment,11483.23411
33598,789182358,4-15-24 13:28,712.87,Payment,Mortgage Payment,10770.36411
33599,789182358,4-21-24 17:28,408.69,OutgoingTransfer,Wire Transfer,10361.67411
33600,789182358,4-24-24 11:28,671.14,Deposit,Cash Deposit,11032.81411
33601,789182358,4-24-24 19:28,741.85,Deposit,Mobile Deposit,11774.66411
33602,789182358,4-25-24 11:28,507.61,Withdrawal,Mobile App Withdrawal,11267.05411
33603,789182358,4-29-24 10:28,660.43,OnlineShopping,Walmart,10606.62411
33604,789182358,4-30-24 10:28,708.57,Deposit,Mobile Deposit,11315.19411
33605,789182358,05-01-24 20:28,500.48,Return,AliExpress Return,11815.67411
33606,789182358,05-03-24 22:28,529.85,Payment,Mortgage Payment,11285.82411
33607,789182358,05-04-24 21:28,8850,IncomingTransfer,Salary,20135.82411
33608,789182358,05-07-24 20:28,731.28,Return,AliExpress Return,20867.10411
33609,789182358,05-09-24 21:28,1700,Payment,Credit Card Payment,19167.10411
33610,789182358,05-11-24 14:28,439.45,Purchase,Home Improvement,18727.65411
33611,789182358,5-15-24 21:28,3900,Payment,Installment Payment,14827.65411
33612,789182358,5-17-24 14:28,306.04,Purchase,Clothing,14521.61411
33613,789182358,5-18-24 13:28,566.74,Purchase,Grocery,13954.87411
33614,789182358,5-21-24 16:28,523.57,Return,Store Return,14478.44411
33615,789182358,5-23-24 12:28,457.7,Deposit,Direct Deposit,14936.14411
33616,789182358,5-23-24 22:28,477.19,OnlineShopping,eBay,14458.95411
33617,789182358,5-25-24 15:28,696.64,Return,Etsy Return,15155.59411
33618,789182358,5-29-24 21:28,736.03,Deposit,Direct Deposit,15891.62411
33619,789182358,5-30-24 9:28,455.66,Purchase,Furniture,15435.96411
33620,789182358,5-31-24 14:28,563.53,Withdrawal,ATM Withdrawal,14872.43411
33621,789182358,06-03-24 21:28,8850,IncomingTransfer,Salary,23722.43411
33622,789182358,06-04-24 15:28,448.86,Payment,Bill Payment,23273.57411
33623,789182358,06-05-24 9:28,357.6,Deposit,Direct Deposit,23631.17411
33624,789182358,06-08-24 21:28,1900,Payment,Credit Card Payment,21731.17411
33625,789182358,06-08-24 21:28,573.93,Purchase,Furniture,21157.24411
33626,789182358,06-09-24 20:28,283.74,Deposit,Cash Deposit,21440.98411
33627,789182358,06-09-24 22:28,382.37,Withdrawal,Branch Withdrawal,21058.61411
33628,789182358,06-12-24 9:28,480.97,Deposit,Check Deposit,21539.58411
33629,789182358,06-12-24 11:28,638.65,OnlineShopping,eBay,20900.93411
33630,789182358,06-12-24 15:28,355.17,Deposit,Cash Deposit,21256.10411
33631,789182358,06-12-24 21:28,325.69,Deposit,Check Deposit,21581.79411
33632,789182358,6-13-24 13:28,187.33,Purchase,Grocery,21394.46411
33633,789182358,6-14-24 9:28,442.1,Purchase,Home Improvement,20952.36411
33634,789182358,6-14-24 21:28,3100,Payment,Subscription Payment,17852.36411
33635,789182358,6-15-24 20:28,454.49,Withdrawal,Branch Withdrawal,17397.87411
33636,789182358,6-16-24 21:28,746.66,Deposit,Check Deposit,18144.53411
33637,789182358,6-19-24 20:28,281.85,Withdrawal,Mobile App Withdrawal,17862.68411
33638,789182358,6-24-24 17:28,493.99,Withdrawal,Branch Withdrawal,17368.69411
33639,789182358,6-24-24 22:28,191.19,IncomingTransfer,Freelance Payment,17559.88411
33640,789182358,6-26-24 18:28,503.77,Deposit,Mobile Deposit,18063.65411
33641,789182358,6-29-24 21:28,263.91,Deposit,Direct Deposit,18327.56411
33642,789182358,07-01-24 12:28,117.32,OutgoingTransfer,Bank Transfer,18210.24411
33643,789182358,07-02-24 15:28,561.34,Deposit,Direct Deposit,18771.58411
33644,789182358,07-02-24 17:28,674.99,Payment,Loan Payment,18096.59411
33645,789182358,07-03-24 21:28,8850,IncomingTransfer,Salary,26946.59411
33646,789182358,07-05-24 13:28,177.22,Withdrawal,Branch Withdrawal,26769.37411
33647,789182358,07-06-24 15:28,574.69,OnlineShopping,Target,26194.68411
33648,789182358,07-06-24 22:28,525.11,Return,Walmart Return,26719.79411
33649,789182358,07-08-24 14:28,180.56,Purchase,Grocery,26539.23411
33650,789182358,07-08-24 21:28,1700,Payment,Credit Card Payment,24839.23411
33651,789182358,07-09-24 23:28,429.27,Deposit,Direct Deposit,25268.50411
33652,789182358,07-10-24 20:28,598.56,Payment,Loan Payment,24669.94411
33653,789182358,07-11-24 21:28,3000,Payment,Subscription Payment,21669.94411
33654,789182358,07-12-24 19:28,346.42,OnlineShopping,Amazon,21323.52411
33655,789209283,1-22-24 13:28,148.97,Payment,Mortgage Payment,294.9235282
33656,789209283,1-27-24 11:28,94.21,Deposit,Mobile Deposit,389.1335282
33657,789209283,1-27-24 12:28,99.82,Deposit,Mobile Deposit,488.9535282
33658,789209283,02-01-24 19:28,53.75,Purchase,Restaurant,435.2035282
33659,789209283,02-02-24 21:28,2850,IncomingTransfer,Salary,3285.203528
33660,789209283,02-06-24 10:28,47.92,Withdrawal,Branch Withdrawal,3237.283528
33661,789209283,02-07-24 21:28,800,Payment,Credit Card Payment,2437.283528
33662,789209283,2-13-24 16:28,201.59,Withdrawal,Mobile App Withdrawal,2235.693528
33663,789209283,2-13-24 21:28,1100,Payment,Insurance Payment,1135.693528
33664,789209283,2-20-24 9:28,93.35,Purchase,Clothing,1042.343528
33665,789209283,2-20-24 10:28,181.52,Deposit,Cash Deposit,1223.863528
33666,789209283,2-20-24 18:28,127.19,OnlineShopping,Etsy,1096.673528
33667,789209283,2-20-24 19:28,30.98,Withdrawal,ATM Withdrawal,1065.693528
33668,789209283,2-20-24 19:28,196.93,Payment,Loan Payment,868.7635282
33669,789209283,2-25-24 11:28,29.61,IncomingTransfer,Freelance Payment,898.3735282
33670,789209283,2-28-24 18:28,214.29,OnlineShopping,AliExpress,684.0835282
33671,789209283,03-01-24 17:28,143.21,Withdrawal,Branch Withdrawal,540.8735282
33672,789209283,03-03-24 21:28,2850,IncomingTransfer,Salary,3390.873528
33673,789209283,03-06-24 10:28,72.01,Purchase,Clothing,3318.863528
33674,789209283,03-07-24 21:28,169.3,Payment,Bill Payment,3149.563528
33675,789209283,03-08-24 21:28,900,Payment,Credit Card Payment,2249.563528
33676,789209283,03-11-24 20:28,64.69,Purchase,Electronics,2184.873528
33677,789209283,03-12-24 21:28,900,Payment,Subscription Payment,1284.873528
33678,789209283,3-14-24 9:28,235.28,Withdrawal,Mobile App Withdrawal,1049.593528
33679,789209283,3-16-24 16:28,165.34,Payment,Mortgage Payment,884.2535282
33680,789209283,3-18-24 18:28,107.86,Deposit,Cash Deposit,992.1135282
33681,789209283,3-20-24 23:28,162.81,Purchase,Restaurant,829.3035282
33682,789209283,3-25-24 18:28,211.27,Return,Best Buy Return,1040.573528
33683,789209283,3-25-24 23:28,211.02,OutgoingTransfer,Peer-to-Peer Transfer,829.5535282
33684,789209283,3-26-24 17:28,235.61,Payment,Loan Payment,593.9435282
33685,789209283,3-27-24 12:28,126.29,Deposit,Direct Deposit,720.2335282
33686,789209283,3-28-24 10:28,32.32,Purchase,Grocery,687.9135282
33687,789209283,3-29-24 17:28,191.2,Withdrawal,Branch Withdrawal,496.7135282
33688,789209283,3-29-24 19:28,242.48,Withdrawal,ATM Withdrawal,254.2335282
33689,789209283,3-30-24 21:28,137.01,Deposit,Direct Deposit,391.2435282
33690,789209283,3-31-24 17:28,212.56,Purchase,Restaurant,178.6835282
33691,789209283,04-01-24 14:28,45.73,OnlineShopping,Amazon,132.9535282
33692,789209283,04-04-24 10:28,18.06,IncomingTransfer,Freelance Payment,151.0135282
33693,789209283,04-04-24 14:28,71.55,IncomingTransfer,Freelance Payment,222.5635282
33694,789209283,04-04-24 21:28,2850,IncomingTransfer,Salary,3072.563528
33695,789209283,04-06-24 17:28,76.49,Return,eBay Return,3149.053528
33696,789209283,04-08-24 10:28,139.66,Payment,Mortgage Payment,3009.393528
33697,789209283,04-09-24 21:28,1200,Payment,Credit Card Payment,1809.393528
33698,789209283,04-11-24 11:28,147.96,Payment,Bill Payment,1661.433528
33699,789209283,04-12-24 19:28,21.11,IncomingTransfer,Freelance Payment,1682.543528
33700,789209283,04-12-24 21:28,800,Payment,Installment Payment,882.5435282
33701,789209283,04-12-24 21:28,157.3,Purchase,Electronics,725.2435282
33702,789209283,04-12-24 22:28,110.82,Purchase,Electronics,614.4235282
33703,789209283,4-14-24 14:28,226.61,IncomingTransfer,Freelance Payment,841.0335282
33704,789209283,4-15-24 22:28,188.84,Purchase,Entertainment,652.1935282
33705,789209283,4-20-24 21:28,178.87,Deposit,Cash Deposit,831.0635282
33706,789209283,4-21-24 13:28,94.41,Withdrawal,ATM Withdrawal,736.6535282
33707,789209283,4-23-24 11:28,82.85,Withdrawal,Branch Withdrawal,653.8035282
33708,789209283,4-27-24 22:28,14.66,Purchase,Home Improvement,639.1435282
33709,789209283,05-02-24 13:28,131.35,Deposit,Cash Deposit,770.4935282
33710,789209283,05-05-24 21:28,2850,IncomingTransfer,Salary,3620.493528
33711,789209283,05-07-24 13:28,187.98,Deposit,Direct Deposit,3808.473528
33712,789209283,05-07-24 16:28,139.02,Withdrawal,ATM Withdrawal,3669.453528
33713,789209283,05-08-24 16:28,68.52,OutgoingTransfer,Peer-to-Peer Transfer,3600.933528
33714,789209283,05-10-24 21:28,900,Payment,Credit Card Payment,2700.933528
33715,789209283,05-11-24 12:28,82.48,Withdrawal,Mobile App Withdrawal,2618.453528
33716,789209283,5-13-24 12:28,74.14,Withdrawal,Mobile App Withdrawal,2544.313528
33717,789209283,5-13-24 15:28,129.91,IncomingTransfer,Freelance Payment,2674.223528
33718,789209283,5-17-24 21:28,1300,Payment,Insurance Payment,1374.223528
33719,789209283,5-24-24 23:28,193.38,Return,Amazon Return,1567.603528
33720,789209283,5-25-24 11:28,136.3,Payment,Mortgage Payment,1431.303528
33721,789209283,5-26-24 20:28,15.75,Withdrawal,ATM Withdrawal,1415.553528
33722,789209283,5-28-24 16:28,228.73,Deposit,Direct Deposit,1644.283528
33723,789209283,5-28-24 19:28,29,Return,Store Return,1673.283528
33724,789209283,06-03-24 16:28,230.23,OutgoingTransfer,Wire Transfer,1443.053528
33725,789209283,06-03-24 21:28,2850,IncomingTransfer,Salary,4293.053528
33726,789209283,06-06-24 15:28,71.16,Purchase,Electronics,4221.893528
33727,789209283,06-08-24 21:28,800,Payment,Credit Card Payment,3421.893528
33728,789209283,06-09-24 12:28,43.68,Return,Amazon Return,3465.573528
33729,789209283,06-10-24 20:28,80.13,OnlineShopping,Amazon,3385.443528
33730,789209283,06-11-24 13:28,48.47,Deposit,Direct Deposit,3433.913528
33731,789209283,6-13-24 14:28,237.95,Withdrawal,ATM Withdrawal,3195.963528
33732,789209283,6-13-24 20:28,217.38,Return,eBay Return,3413.343528
33733,789209283,6-14-24 15:28,63.01,Purchase,Pharmacy,3350.333528
33734,789209283,6-16-24 14:28,246.55,Return,Store Return,3596.883528
33735,789209283,6-17-24 21:28,800,Payment,Insurance Payment,2796.883528
33736,789209283,6-18-24 21:28,10.85,IncomingTransfer,Freelance Payment,2807.733528
33737,789209283,6-19-24 15:28,215.75,Deposit,Check Deposit,3023.483528
33738,789209283,6-19-24 16:28,139.97,OutgoingTransfer,Bank Transfer,2883.513528
33739,789209283,6-20-24 23:28,11.79,Withdrawal,Mobile App Withdrawal,2871.723528
33740,789209283,6-21-24 9:28,52,Deposit,Direct Deposit,2923.723528
33741,789209283,6-21-24 12:28,13.18,Purchase,Electronics,2910.543528
33742,789209283,6-23-24 11:28,72.3,Withdrawal,Branch Withdrawal,2838.243528
33743,789209283,6-27-24 13:28,84.56,Payment,Mortgage Payment,2753.683528
33744,789209283,6-30-24 11:28,11.17,Withdrawal,Branch Withdrawal,2742.513528
33745,789209283,6-30-24 11:28,137.04,Purchase,Gas,2605.473528
33746,789209283,07-01-24 21:28,2850,IncomingTransfer,Salary,5455.473528
33747,789209283,07-03-24 12:28,38.39,OnlineShopping,Etsy,5417.083528
33748,789209283,07-04-24 11:28,237,Return,Store Return,5654.083528
33749,789209283,07-06-24 21:28,1000,Payment,Credit Card Payment,4654.083528
33750,789209283,07-10-24 21:28,43.55,Return,Amazon Return,4697.633528
33751,789209283,07-11-24 10:28,37.75,Purchase,Grocery,4659.883528
33752,789209283,07-11-24 15:28,112.42,OnlineShopping,Best Buy,4547.463528
33753,789209283,07-11-24 21:28,1000,Payment,Insurance Payment,3547.463528
33754,789209283,07-11-24 21:28,170.5,Return,Best Buy Return,3717.963528
33755,789209283,7-15-24 20:28,223.39,Purchase,Electronics,3494.573528
33756,789209283,7-17-24 19:28,149.7,Return,Etsy Return,3644.273528
33757,789241308,1-24-24 13:28,138.91,Payment,Loan Payment,-138.91
33758,789241308,1-29-24 19:28,185.83,Withdrawal,ATM Withdrawal,-324.74
33759,789241308,1-31-24 9:28,59.45,Deposit,Check Deposit,-265.29
33760,789241308,02-02-24 19:28,216.44,Withdrawal,Mobile App Withdrawal,-481.73
33761,789241308,02-05-24 21:28,2500,IncomingTransfer,Salary,2018.27
33762,789241308,02-08-24 13:28,179.3,Payment,Mortgage Payment,1838.97
33763,789241308,02-10-24 20:28,228.15,Purchase,Pharmacy,1610.82
33764,789241308,02-12-24 19:28,179.15,Deposit,Direct Deposit,1789.97
33765,789241308,2-14-24 9:28,11.14,Purchase,Electronics,1778.83
33766,789241308,2-14-24 15:28,56.99,OnlineShopping,eBay,1721.84
33767,789241308,2-15-24 21:28,1200,Payment,Rent Payment,521.84
33768,789241308,2-19-24 21:28,211.67,Purchase,Gas,310.17
33769,789241308,2-24-24 15:28,22.81,Payment,Mortgage Payment,287.36
33770,789241308,2-27-24 21:28,28.64,Return,AliExpress Return,316
33771,789241308,03-04-24 21:28,2500,IncomingTransfer,Salary,2816
33772,789241308,03-06-24 19:28,161.4,IncomingTransfer,Freelance Payment,2977.4
33773,789241308,03-07-24 22:28,11.31,OutgoingTransfer,International Transfer,2966.09
33774,789241308,03-10-24 21:28,1000,Payment,Rent Payment,1966.09
33775,789241308,3-17-24 15:28,188.13,OnlineShopping,Target,1777.96
33776,789241308,3-20-24 11:28,179.83,IncomingTransfer,Freelance Payment,1957.79
33777,789241308,04-01-24 21:28,2500,IncomingTransfer,Salary,4457.79
33778,789241308,04-08-24 21:28,143.12,OutgoingTransfer,International Transfer,4314.67
33779,789241308,04-10-24 21:28,700,Payment,Rent Payment,3614.67
33780,789241308,04-10-24 21:28,129.56,Deposit,Direct Deposit,3744.23
33781,789241308,4-15-24 9:28,231.6,Return,AliExpress Return,3975.83
33782,789241308,4-15-24 10:28,126.33,Return,Walmart Return,4102.16
33783,789241308,4-17-24 11:28,36.97,IncomingTransfer,Freelance Payment,4139.13
33784,789241308,4-20-24 16:28,84.28,Return,Best Buy Return,4223.41
33785,789241308,4-27-24 18:28,82.01,Purchase,Furniture,4141.4
33786,789241308,4-28-24 17:28,63.51,Withdrawal,Branch Withdrawal,4077.89
33787,789241308,05-02-24 18:28,175.94,Purchase,Entertainment,3901.95
33788,789241308,05-02-24 21:28,2500,IncomingTransfer,Salary,6401.95
33789,789241308,05-11-24 10:28,228.05,Return,Etsy Return,6630
33790,789241308,05-11-24 22:28,232.04,Deposit,Direct Deposit,6862.04
33791,789241308,5-13-24 22:28,72.79,OnlineShopping,Walmart,6789.25
33792,789241308,5-14-24 21:28,1200,Payment,Rent Payment,5589.25
33793,789241308,5-15-24 22:28,196.45,IncomingTransfer,Freelance Payment,5785.7
33794,789241308,5-19-24 21:28,52.38,IncomingTransfer,Freelance Payment,5838.08
33795,789241308,5-22-24 21:28,76.92,Payment,Bill Payment,5761.16
33796,789241308,5-24-24 13:28,48.94,Withdrawal,Branch Withdrawal,5712.22
33797,789241308,06-02-24 21:28,180.98,Withdrawal,Branch Withdrawal,5531.24
33798,789241308,06-03-24 21:28,2500,IncomingTransfer,Salary,8031.24
33799,789241308,06-08-24 12:28,233.62,OutgoingTransfer,International Transfer,7797.62
33800,789241308,06-11-24 15:28,63.17,Withdrawal,Branch Withdrawal,7734.45
33801,789241308,6-14-24 15:28,43.62,Deposit,Direct Deposit,7778.07
33802,789241308,6-17-24 21:28,700,Payment,Rent Payment,7078.07
33803,789241308,6-19-24 9:28,112.43,Purchase,Home Improvement,6965.64
33804,789241308,6-27-24 22:28,207.33,OutgoingTransfer,Peer-to-Peer Transfer,6758.31
33805,789241308,07-02-24 21:28,2500,IncomingTransfer,Salary,9258.31
33806,789241308,07-04-24 21:28,210.77,Return,Walmart Return,9469.08
33807,789241308,7-15-24 16:28,170.04,Return,Walmart Return,9639.12
33808,789241308,7-15-24 21:28,1400,Payment,Rent Payment,8239.12
33809,789241308,7-15-24 22:28,248.03,Payment,Loan Payment,7991.09
33810,789248958,1-20-24 19:28,32.33,OutgoingTransfer,Peer-to-Peer Transfer,1937.489338
33811,789248958,1-23-24 21:28,125.77,Withdrawal,Mobile App Withdrawal,1811.719338
33812,789248958,1-24-24 19:28,331.28,Withdrawal,Branch Withdrawal,1480.439338
33813,789248958,1-27-24 14:28,192.51,Withdrawal,Branch Withdrawal,1287.929338
33814,789248958,1-28-24 11:28,294.82,Purchase,Restaurant,993.1093385
33815,789248958,02-02-24 14:28,279.73,Purchase,Gas,713.3793385
33816,789248958,02-04-24 15:28,377.89,Return,Amazon Return,1091.269338
33817,789248958,02-05-24 21:28,3750,IncomingTransfer,Salary,4841.269338
33818,789248958,02-06-24 18:28,172.42,Purchase,Clothing,4668.849338
33819,789248958,02-06-24 20:28,388.46,Withdrawal,ATM Withdrawal,4280.389338
33820,789248958,02-08-24 21:28,309.21,Purchase,Entertainment,3971.179338
33821,789248958,02-08-24 22:28,245.11,OnlineShopping,Walmart,3726.069338
33822,789248958,02-10-24 13:28,369.15,Withdrawal,Mobile App Withdrawal,3356.919338
33823,789248958,02-10-24 18:28,272.24,Deposit,Check Deposit,3629.159338
33824,789248958,02-10-24 21:28,3700,Payment,Credit Card Payment,-70.84066152
33825,789248958,02-11-24 10:28,104.9,OutgoingTransfer,Bank Transfer,-175.7406615
33826,789248958,02-12-24 10:28,396.66,Withdrawal,Branch Withdrawal,-572.4006615
33827,789248958,02-12-24 21:28,74.94,Deposit,Direct Deposit,-497.4606615
33828,789248958,2-13-24 12:28,67.74,OutgoingTransfer,Wire Transfer,-565.2006615
33829,789248958,2-13-24 15:28,394.02,Return,Amazon Return,-171.1806615
33830,789248958,2-13-24 21:28,1200,Payment,Insurance Payment,-1371.180662
33831,789248958,2-14-24 16:28,219.97,OutgoingTransfer,Wire Transfer,-1591.150662
33832,789248958,2-16-24 20:28,288.52,Purchase,Travel,-1879.670662
33833,789248958,2-22-24 11:28,354.07,Deposit,Direct Deposit,-1525.600662
33834,789248958,2-23-24 22:28,398.74,Purchase,Pharmacy,-1924.340662
33835,789248958,2-27-24 17:28,91.39,OnlineShopping,Best Buy,-2015.730662
33836,789248958,03-01-24 15:28,59.95,Deposit,Direct Deposit,-1955.780662
33837,789248958,03-05-24 14:28,110.89,Deposit,Mobile Deposit,-1844.890662
33838,789248958,03-05-24 21:28,3750,IncomingTransfer,Salary,1905.109338
33839,789248958,03-07-24 15:28,60.1,OutgoingTransfer,Wire Transfer,1845.009338
33840,789248958,03-09-24 14:28,91.12,OnlineShopping,Amazon,1753.889338
33841,789248958,03-10-24 21:28,2800,Payment,Credit Card Payment,-1046.110662
33842,789248958,03-10-24 21:28,240.6,Purchase,Restaurant,-1286.710662
33843,789248958,3-14-24 23:28,142.98,OutgoingTransfer,International Transfer,-1429.690662
33844,789248958,3-18-24 21:28,1200,Payment,Installment Payment,-2629.690662
33845,789248958,3-21-24 13:28,325.94,OutgoingTransfer,Peer-to-Peer Transfer,-2955.630662
33846,789248958,3-21-24 20:28,188.33,Return,Store Return,-2767.300662
33847,789248958,3-24-24 12:28,36.64,Purchase,Pharmacy,-2803.940662
33848,789248958,3-24-24 13:28,325.93,Deposit,Check Deposit,-2478.010662
33849,789248958,3-27-24 19:28,127.16,Withdrawal,Mobile App Withdrawal,-2605.170662
33850,789248958,3-28-24 10:28,255.18,OnlineShopping,AliExpress,-2860.350662
33851,789248958,3-28-24 11:28,54.7,IncomingTransfer,Freelance Payment,-2805.650662
33852,789248958,04-02-24 21:28,3750,IncomingTransfer,Salary,944.3493385
33853,789248958,04-07-24 21:28,3700,Payment,Credit Card Payment,-2755.650662
33854,789248958,04-08-24 10:28,204.62,Purchase,Home Improvement,-2960.270662
33855,789248958,04-08-24 18:28,283.26,Deposit,Mobile Deposit,-2677.010662
33856,789248958,04-09-24 15:28,168.92,OutgoingTransfer,Wire Transfer,-2845.930662
33857,789248958,04-12-24 9:28,305.35,Withdrawal,Mobile App Withdrawal,-3151.280662
33858,789248958,4-13-24 12:28,399.63,Deposit,Direct Deposit,-2751.650662
33859,789248958,4-13-24 17:28,395.88,Withdrawal,Branch Withdrawal,-3147.530662
33860,789248958,4-13-24 19:28,327.5,Purchase,Travel,-3475.030662
33861,789248958,4-14-24 21:28,1400,Payment,Subscription Payment,-4875.030662
33862,789248958,4-15-24 22:28,164.47,IncomingTransfer,Freelance Payment,-4710.560662
33863,789248958,4-22-24 12:28,325.25,Purchase,Furniture,-5035.810662
33864,789248958,4-25-24 14:28,137.57,Withdrawal,Branch Withdrawal,-5173.380662
33865,789248958,4-25-24 23:28,192.51,Payment,Bill Payment,-5365.890662
33866,789248958,4-26-24 23:28,397.88,OutgoingTransfer,Peer-to-Peer Transfer,-5763.770662
33867,789248958,4-27-24 12:28,27.77,IncomingTransfer,Freelance Payment,-5736.000662
33868,789248958,4-30-24 15:28,80.98,Purchase,Restaurant,-5816.980662
33869,789248958,05-03-24 21:28,3750,IncomingTransfer,Salary,-2066.980662
33870,789248958,05-08-24 21:28,3700,Payment,Credit Card Payment,-5766.980662
33871,789248958,05-08-24 23:28,32.15,Purchase,Pharmacy,-5799.130662
33872,789248958,05-09-24 23:28,219.72,Deposit,Mobile Deposit,-5579.410662
33873,789248958,05-10-24 13:28,206.78,Purchase,Restaurant,-5786.190662
33874,789248958,05-12-24 16:28,209.89,Deposit,Check Deposit,-5576.300662
33875,789248958,5-14-24 15:28,380.38,Withdrawal,Branch Withdrawal,-5956.680662
33876,789248958,5-17-24 21:28,1200,Payment,Insurance Payment,-7156.680662
33877,789248958,5-20-24 10:28,310.17,Payment,Mortgage Payment,-7466.850662
33878,789248958,5-24-24 16:28,90.72,Purchase,Entertainment,-7557.570662
33879,789248958,5-26-24 10:28,334.75,Purchase,Clothing,-7892.320662
33880,789248958,5-26-24 13:28,69.68,Payment,Mortgage Payment,-7962.000662
33881,789248958,5-29-24 11:28,375.69,Return,eBay Return,-7586.310662
33882,789248958,5-29-24 18:28,160.77,Purchase,Travel,-7747.080662
33883,789248958,5-31-24 21:28,111.34,Deposit,Cash Deposit,-7635.740662
33884,789248958,06-04-24 15:28,131.8,Return,Target Return,-7503.940662
33885,789248958,06-05-24 9:28,271.8,Withdrawal,ATM Withdrawal,-7775.740662
33886,789248958,06-05-24 21:28,3750,IncomingTransfer,Salary,-4025.740662
33887,789248958,06-05-24 23:28,305.69,OutgoingTransfer,Bank Transfer,-4331.430662
33888,789248958,06-06-24 17:28,55.27,Withdrawal,Mobile App Withdrawal,-4386.700662
33889,789248958,06-10-24 21:28,2900,Payment,Credit Card Payment,-7286.700662
33890,789248958,06-10-24 21:28,155.99,Purchase,Travel,-7442.690662
33891,789248958,06-12-24 11:28,208.89,Purchase,Entertainment,-7651.580662
33892,789248958,06-12-24 23:28,54.93,Deposit,Check Deposit,-7596.650662
33893,789248958,6-16-24 21:28,1000,Payment,Insurance Payment,-8596.650662
33894,789248958,6-20-24 11:28,73.17,Return,Store Return,-8523.480662
33895,789248958,6-20-24 13:28,21.58,OutgoingTransfer,International Transfer,-8545.060662
33896,789248958,6-25-24 14:28,149.52,Deposit,Direct Deposit,-8395.540662
33897,789248958,6-25-24 22:28,385.64,Deposit,Cash Deposit,-8009.900662
33898,789248958,6-27-24 15:28,290.09,Deposit,Check Deposit,-7719.810662
33899,789248958,6-29-24 13:28,78.86,Deposit,Cash Deposit,-7640.950662
33900,789248958,6-30-24 17:28,44.45,Deposit,Direct Deposit,-7596.500662
33901,789248958,07-02-24 18:28,184.87,OnlineShopping,AliExpress,-7781.370662
33902,789248958,07-02-24 22:28,199.64,Withdrawal,Branch Withdrawal,-7981.010662
33903,789248958,07-04-24 17:28,314.25,Deposit,Cash Deposit,-7666.760662
33904,789248958,07-05-24 21:28,3750,IncomingTransfer,Salary,-3916.760662
33905,789248958,07-06-24 17:28,63.77,IncomingTransfer,Freelance Payment,-3852.990662
33906,789248958,07-06-24 17:28,202.42,OutgoingTransfer,Wire Transfer,-4055.410662
33907,789248958,07-06-24 20:28,135.98,OnlineShopping,Walmart,-4191.390662
33908,789248958,07-08-24 19:28,260.51,Deposit,Direct Deposit,-3930.880662
33909,789248958,07-09-24 21:28,314.09,Purchase,Clothing,-4244.970662
33910,789248958,07-10-24 21:28,2700,Payment,Credit Card Payment,-6944.970662
33911,789248958,07-11-24 21:28,51.53,Return,Best Buy Return,-6893.440662
33912,789248958,7-13-24 15:28,374.54,Purchase,Home Improvement,-7267.980662
33913,789248958,7-14-24 12:28,302.7,Withdrawal,Mobile App Withdrawal,-7570.680662
33914,789248958,7-14-24 13:28,250.33,Payment,Bill Payment,-7821.010662
33915,789248958,7-15-24 21:28,1300,Payment,Insurance Payment,-9121.010662
33916,789248958,7-17-24 17:28,277.7,OutgoingTransfer,International Transfer,-9398.710662
33917,789271533,1-20-24 20:28,63.73,Payment,Mortgage Payment,613.5779756
33918,789271533,1-20-24 22:28,11.67,Deposit,Mobile Deposit,625.2479756
33919,789271533,1-26-24 22:28,59.17,OnlineShopping,Best Buy,566.0779756
33920,789271533,1-28-24 17:28,165.84,Deposit,Mobile Deposit,731.9179756
33921,789271533,1-28-24 21:28,202.36,Withdrawal,ATM Withdrawal,529.5579756
33922,789271533,1-29-24 10:28,79.83,Deposit,Direct Deposit,609.3879756
33923,789271533,1-30-24 10:28,173.6,Purchase,Restaurant,435.7879756
33924,789271533,1-30-24 19:28,116.82,Purchase,Gas,318.9679756
33925,789271533,02-02-24 21:28,2200,IncomingTransfer,Salary,2518.967976
33926,789271533,02-04-24 19:28,202.95,Return,Amazon Return,2721.917976
33927,789271533,02-07-24 21:28,1300,Payment,Credit Card Payment,1421.917976
33928,789271533,02-11-24 22:28,155.73,OnlineShopping,Etsy,1266.187976
33929,789271533,2-13-24 12:28,138.34,Withdrawal,ATM Withdrawal,1127.847976
33930,789271533,2-17-24 20:28,211.45,Withdrawal,Branch Withdrawal,916.3979756
33931,789271533,2-18-24 21:28,700,Payment,Installment Payment,216.3979756
33932,789271533,2-19-24 11:28,73.14,Purchase,Restaurant,143.2579756
33933,789271533,2-19-24 23:28,52.54,OutgoingTransfer,Peer-to-Peer Transfer,90.71797559
33934,789271533,2-21-24 20:28,153.25,OnlineShopping,eBay,-62.53202441
33935,789271533,2-21-24 23:28,75.78,Withdrawal,ATM Withdrawal,-138.3120244
33936,789271533,2-22-24 13:28,34.7,Deposit,Mobile Deposit,-103.6120244
33937,789271533,2-24-24 16:28,150.36,Withdrawal,ATM Withdrawal,-253.9720244
33938,789271533,2-25-24 19:28,20.14,OutgoingTransfer,International Transfer,-274.1120244
33939,789271533,2-27-24 9:28,28.82,Purchase,Electronics,-302.9320244
33940,789271533,2-28-24 11:28,124.84,Withdrawal,Mobile App Withdrawal,-427.7720244
33941,789271533,2-29-24 14:28,202.31,Payment,Mortgage Payment,-630.0820244
33942,789271533,03-01-24 9:28,18.29,Withdrawal,ATM Withdrawal,-648.3720244
33943,789271533,03-02-24 21:28,153.08,Return,AliExpress Return,-495.2920244
33944,789271533,03-04-24 21:28,2200,IncomingTransfer,Salary,1704.707976
33945,789271533,03-06-24 10:28,133.58,Deposit,Direct Deposit,1838.287976
33946,789271533,03-06-24 12:28,178.05,Withdrawal,Branch Withdrawal,1660.237976
33947,789271533,03-09-24 21:28,1300,Payment,Credit Card Payment,360.2379756
33948,789271533,03-12-24 9:28,33.71,Deposit,Check Deposit,393.9479756
33949,789271533,3-15-24 10:28,57.04,Deposit,Check Deposit,450.9879756
33950,789271533,3-15-24 21:28,900,Payment,Insurance Payment,-449.0120244
33951,789271533,3-19-24 18:28,116.25,Deposit,Check Deposit,-332.7620244
33952,789271533,3-21-24 21:28,227.4,Withdrawal,Mobile App Withdrawal,-560.1620244
33953,789271533,3-25-24 12:28,123.45,Purchase,Gas,-683.6120244
33954,789271533,3-28-24 20:28,134.2,Return,Amazon Return,-549.4120244
33955,789271533,3-29-24 23:28,97.67,Purchase,Pharmacy,-647.0820244
33956,789271533,3-30-24 15:28,10.19,Purchase,Gas,-657.2720244
33957,789271533,3-31-24 15:28,223.17,Purchase,Home Improvement,-880.4420244
33958,789271533,04-02-24 13:28,99.07,Deposit,Direct Deposit,-781.3720244
33959,789271533,04-02-24 21:28,2200,IncomingTransfer,Salary,1418.627976
33960,789271533,04-03-24 13:28,124.22,OnlineShopping,AliExpress,1294.407976
33961,789271533,04-03-24 14:28,117.48,Deposit,Direct Deposit,1411.887976
33962,789271533,04-03-24 22:28,179.61,Withdrawal,Mobile App Withdrawal,1232.277976
33963,789271533,04-05-24 17:28,66.42,OutgoingTransfer,Wire Transfer,1165.857976
33964,789271533,04-07-24 21:28,1100,Payment,Credit Card Payment,65.85797559
33965,789271533,04-10-24 9:28,248.32,Deposit,Mobile Deposit,314.1779756
33966,789271533,04-10-24 22:28,186.97,Purchase,Furniture,127.2079756
33967,789271533,04-12-24 21:28,159.95,Deposit,Direct Deposit,287.1579756
33968,789271533,4-16-24 14:28,103.99,IncomingTransfer,Freelance Payment,391.1479756
33969,789271533,4-18-24 21:28,1000,Payment,Installment Payment,-608.8520244
33970,789271533,4-19-24 9:28,87.23,Deposit,Direct Deposit,-521.6220244
33971,789271533,4-21-24 21:28,247.21,OutgoingTransfer,Wire Transfer,-768.8320244
33972,789271533,4-22-24 17:28,144.5,Purchase,Pharmacy,-913.3320244
33973,789271533,05-01-24 15:28,185.52,OnlineShopping,eBay,-1098.852024
33974,789271533,05-03-24 10:28,202.72,Deposit,Cash Deposit,-896.1320244
33975,789271533,05-04-24 21:28,2200,IncomingTransfer,Salary,1303.867976
33976,789271533,05-05-24 20:28,97.44,Withdrawal,ATM Withdrawal,1206.427976
33977,789271533,05-09-24 21:28,1300,Payment,Credit Card Payment,-93.57202441
33978,789271533,05-09-24 21:28,226.13,Deposit,Check Deposit,132.5579756
33979,789271533,05-11-24 11:28,215.46,OutgoingTransfer,Bank Transfer,-82.90202441
33980,789271533,05-11-24 21:28,800,Payment,Subscription Payment,-882.9020244
33981,789271533,5-13-24 11:28,132.29,Withdrawal,Mobile App Withdrawal,-1015.192024
33982,789271533,5-15-24 11:28,100.87,Withdrawal,ATM Withdrawal,-1116.062024
33983,789271533,5-15-24 11:28,38.49,Deposit,Mobile Deposit,-1077.572024
33984,789271533,5-24-24 19:28,141.35,Return,Amazon Return,-936.2220244
33985,789271533,5-29-24 17:28,135.05,Purchase,Clothing,-1071.272024
33986,789271533,5-30-24 10:28,174.05,OutgoingTransfer,Peer-to-Peer Transfer,-1245.322024
33987,789271533,06-02-24 21:28,2200,IncomingTransfer,Salary,954.6779756
33988,789271533,06-03-24 21:28,25.58,Deposit,Mobile Deposit,980.2579756
33989,789271533,06-07-24 21:28,1200,Payment,Credit Card Payment,-219.7420244
33990,789271533,06-07-24 23:28,87.51,Deposit,Direct Deposit,-132.2320244
33991,789271533,06-12-24 23:28,109.61,IncomingTransfer,Freelance Payment,-22.62202441
33992,789271533,6-13-24 22:28,229.72,Deposit,Check Deposit,207.0979756
33993,789271533,6-14-24 9:28,13.01,OnlineShopping,AliExpress,194.0879756
33994,789271533,6-14-24 21:28,700,Payment,Installment Payment,-505.9120244
33995,789271533,6-21-24 21:28,57.01,Deposit,Direct Deposit,-448.9020244
33996,789271533,6-22-24 10:28,198.9,Deposit,Check Deposit,-250.0020244
33997,789271533,6-22-24 20:28,26.85,Purchase,Travel,-276.8520244
33998,789271533,07-04-24 13:28,28.46,Purchase,Furniture,-305.3120244
33999,789271533,07-05-24 21:28,2200,IncomingTransfer,Salary,1894.687976
34000,789271533,07-07-24 21:28,195.51,OutgoingTransfer,Bank Transfer,1699.177976
34001,789271533,07-08-24 18:28,247.92,Deposit,Cash Deposit,1947.097976
34002,789271533,07-10-24 21:28,1200,Payment,Credit Card Payment,747.0979756
34003,789271533,07-10-24 21:28,900,Payment,Installment Payment,-152.9020244
34004,789271533,07-10-24 21:28,168.53,Deposit,Direct Deposit,15.62797559
34005,789271533,07-12-24 20:28,46.53,Purchase,Grocery,-30.90202441
34006,789271533,7-15-24 15:28,17.03,Purchase,Electronics,-47.93202441
34007,789271533,7-16-24 9:28,231.85,Deposit,Check Deposit,183.9179756
34008,789271533,7-16-24 9:28,10.33,IncomingTransfer,Freelance Payment,194.2479756
34009,789280683,1-23-24 10:28,893.91,OutgoingTransfer,Peer-to-Peer Transfer,-302.9157111
34010,789280683,1-23-24 12:28,372.91,IncomingTransfer,Freelance Payment,69.99428889
34011,789280683,1-23-24 21:28,615.2,Payment,Mortgage Payment,-545.2057111
34012,789280683,1-24-24 14:28,796.78,OutgoingTransfer,Peer-to-Peer Transfer,-1341.985711
34013,789280683,1-24-24 23:28,305.89,OnlineShopping,Amazon,-1647.875711
34014,789280683,1-25-24 15:28,269.88,Withdrawal,ATM Withdrawal,-1917.755711
34015,789280683,1-26-24 22:28,917.13,IncomingTransfer,Freelance Payment,-1000.625711
34016,789280683,1-26-24 22:28,839.62,Deposit,Check Deposit,-161.0057111
34017,789280683,1-27-24 13:28,677.18,Return,Etsy Return,516.1742889
34018,789280683,1-27-24 14:28,794.76,Return,Target Return,1310.934289
34019,789280683,1-28-24 22:28,743.37,OutgoingTransfer,Bank Transfer,567.5642889
34020,789280683,1-29-24 10:28,414.5,Deposit,Mobile Deposit,982.0642889
34021,789280683,1-30-24 13:28,462.17,Payment,Bill Payment,519.8942889
34022,789280683,1-31-24 15:28,448.39,Purchase,Furniture,71.50428889
34023,789280683,1-31-24 19:28,379.46,OutgoingTransfer,Peer-to-Peer Transfer,-307.9557111
34024,789280683,02-01-24 21:28,16650,IncomingTransfer,Salary,16342.04429
34025,789280683,02-02-24 13:28,749.51,Deposit,Mobile Deposit,17091.55429
34026,789280683,02-02-24 23:28,695.67,Purchase,Restaurant,16395.88429
34027,789280683,02-03-24 13:28,300.14,Purchase,Furniture,16095.74429
34028,789280683,02-05-24 11:28,303.18,Deposit,Cash Deposit,16398.92429
34029,789280683,02-05-24 13:28,546.42,OnlineShopping,Amazon,15852.50429
34030,789280683,02-06-24 21:28,1100,Payment,Credit Card Payment,14752.50429
34031,789280683,02-07-24 13:28,947.62,Purchase,Restaurant,13804.88429
34032,789280683,02-08-24 18:28,249.02,Payment,Loan Payment,13555.86429
34033,789280683,02-10-24 21:28,292.3,OutgoingTransfer,Peer-to-Peer Transfer,13263.56429
34034,789280683,2-13-24 21:28,706.22,Withdrawal,Branch Withdrawal,12557.34429
34035,789280683,2-13-24 22:28,709.78,Deposit,Cash Deposit,13267.12429
34036,789280683,2-14-24 9:28,807.92,OnlineShopping,Etsy,12459.20429
34037,789280683,2-18-24 11:28,518.67,OnlineShopping,Amazon,11940.53429
34038,789280683,2-18-24 21:28,5400,Payment,Installment Payment,6540.534289
34039,789280683,2-20-24 18:28,237.27,Deposit,Check Deposit,6777.804289
34040,789280683,2-20-24 22:28,759.48,Return,Walmart Return,7537.284289
34041,789280683,2-21-24 22:28,588.34,Deposit,Direct Deposit,8125.624289
34042,789280683,2-22-24 9:28,667.09,Deposit,Cash Deposit,8792.714289
34043,789280683,2-22-24 19:28,459.91,Purchase,Entertainment,8332.804289
34044,789280683,2-23-24 17:28,307.41,Purchase,Furniture,8025.394289
34045,789280683,2-24-24 10:28,327.01,IncomingTransfer,Freelance Payment,8352.404289
34046,789280683,2-24-24 12:28,248.68,Return,Store Return,8601.084289
34047,789280683,2-25-24 17:28,680.45,OnlineShopping,Target,7920.634289
34048,789280683,2-26-24 17:28,340.48,Purchase,Entertainment,7580.154289
34049,789280683,2-26-24 20:28,761.91,Return,Etsy Return,8342.064289
34050,789280683,2-27-24 19:28,469.52,Deposit,Cash Deposit,8811.584289
34051,789280683,2-28-24 16:28,751.49,Return,Store Return,9563.074289
34052,789280683,03-01-24 9:28,293.6,Purchase,Travel,9269.474289
34053,789280683,03-01-24 21:28,16650,IncomingTransfer,Salary,25919.47429
34054,789280683,03-02-24 17:28,779.85,Return,Store Return,26699.32429
34055,789280683,03-03-24 17:28,343.06,OutgoingTransfer,Wire Transfer,26356.26429
34056,789280683,03-04-24 15:28,297.25,Purchase,Pharmacy,26059.01429
34057,789280683,03-06-24 10:28,538.06,Withdrawal,Mobile App Withdrawal,25520.95429
34058,789280683,03-06-24 21:28,1200,Payment,Credit Card Payment,24320.95429
34059,789280683,03-10-24 21:28,4900,Payment,Insurance Payment,19420.95429
34060,789280683,3-15-24 9:28,499.68,Withdrawal,ATM Withdrawal,18921.27429
34061,789280683,3-21-24 17:28,839.19,Purchase,Gas,18082.08429
34062,789280683,3-21-24 18:28,265.77,Withdrawal,Branch Withdrawal,17816.31429
34063,789280683,3-22-24 9:28,884.92,OnlineShopping,Amazon,16931.39429
34064,789280683,3-22-24 20:28,549.47,Payment,Loan Payment,16381.92429
34065,789280683,3-27-24 14:28,388.04,Withdrawal,Mobile App Withdrawal,15993.88429
34066,789280683,3-30-24 21:28,912.22,Deposit,Check Deposit,16906.10429
34067,789280683,04-01-24 22:28,791.98,Return,Best Buy Return,17698.08429
34068,789280683,04-02-24 19:28,477.65,Payment,Bill Payment,17220.43429
34069,789280683,04-02-24 21:28,16650,IncomingTransfer,Salary,33870.43429
34070,789280683,04-04-24 17:28,689.32,OnlineShopping,Etsy,33181.11429
34071,789280683,04-05-24 18:28,600.43,Withdrawal,Mobile App Withdrawal,32580.68429
34072,789280683,04-07-24 19:28,606.69,Deposit,Check Deposit,33187.37429
34073,789280683,04-07-24 21:28,1100,Payment,Credit Card Payment,32087.37429
34074,789280683,04-08-24 16:28,541.5,Deposit,Mobile Deposit,32628.87429
34075,789280683,04-08-24 17:28,813.93,Withdrawal,Branch Withdrawal,31814.94429
34076,789280683,04-08-24 17:28,757.33,OnlineShopping,Etsy,31057.61429
34077,789280683,04-10-24 13:28,242.15,Deposit,Mobile Deposit,31299.76429
34078,789280683,04-10-24 19:28,418.35,Purchase,Furniture,30881.41429
34079,789280683,04-11-24 9:28,649.66,Payment,Mortgage Payment,30231.75429
34080,789280683,04-11-24 9:28,331.11,Deposit,Check Deposit,30562.86429
34081,789280683,04-11-24 15:28,230.98,Purchase,Restaurant,30331.88429
34082,789280683,4-13-24 15:28,896.98,Withdrawal,Mobile App Withdrawal,29434.90429
34083,789280683,4-14-24 21:28,5800,Payment,Insurance Payment,23634.90429
34084,789280683,4-16-24 13:28,708.86,Return,AliExpress Return,24343.76429
34085,789280683,4-20-24 11:28,906.64,Withdrawal,Mobile App Withdrawal,23437.12429
34086,789280683,4-21-24 10:28,605.37,OutgoingTransfer,International Transfer,22831.75429
34087,789280683,4-21-24 18:28,418.41,Withdrawal,ATM Withdrawal,22413.34429
34088,789280683,4-23-24 12:28,388.29,Deposit,Direct Deposit,22801.63429
34089,789280683,4-24-24 18:28,240.35,Deposit,Cash Deposit,23041.98429
34090,789280683,4-27-24 12:28,811.52,OutgoingTransfer,Peer-to-Peer Transfer,22230.46429
34091,789280683,4-27-24 17:28,764.3,Purchase,Entertainment,21466.16429
34092,789280683,05-01-24 10:28,738.53,Return,Etsy Return,22204.69429
34093,789280683,05-01-24 10:28,863.61,Deposit,Mobile Deposit,23068.30429
34094,789280683,05-03-24 21:28,16650,IncomingTransfer,Salary,39718.30429
34095,789280683,05-06-24 19:28,919.32,Payment,Bill Payment,38798.98429
34096,789280683,05-08-24 21:28,900,Payment,Credit Card Payment,37898.98429
34097,789280683,05-10-24 15:28,726.34,Purchase,Entertainment,37172.64429
34098,789280683,05-10-24 21:28,5200,Payment,Installment Payment,31972.64429
34099,789280683,05-11-24 15:28,916.27,OutgoingTransfer,International Transfer,31056.37429
34100,789280683,05-11-24 21:28,448.84,Withdrawal,Mobile App Withdrawal,30607.53429
34101,789280683,5-13-24 13:28,390.81,IncomingTransfer,Freelance Payment,30998.34429
34102,789280683,5-15-24 17:28,485.53,Deposit,Mobile Deposit,31483.87429
34103,789280683,5-15-24 23:28,521.77,Deposit,Mobile Deposit,32005.64429
34104,789280683,5-16-24 20:28,874.46,Deposit,Check Deposit,32880.10429
34105,789280683,5-17-24 20:28,799.9,OnlineShopping,Amazon,32080.20429
34106,789280683,5-21-24 23:28,785.89,Withdrawal,Branch Withdrawal,31294.31429
34107,789280683,5-22-24 14:28,757.77,OnlineShopping,eBay,30536.54429
34108,789280683,5-22-24 15:28,402.46,Return,Etsy Return,30939.00429
34109,789280683,06-01-24 21:28,16650,IncomingTransfer,Salary,47589.00429
34110,789280683,06-03-24 13:28,834.82,OutgoingTransfer,Wire Transfer,46754.18429
34111,789280683,06-03-24 17:28,598.4,Purchase,Restaurant,46155.78429
34112,789280683,06-05-24 11:28,798.01,Purchase,Entertainment,45357.77429
34113,789280683,06-06-24 21:28,1200,Payment,Credit Card Payment,44157.77429
34114,789280683,06-08-24 14:28,870.61,Purchase,Restaurant,43287.16429
34115,789280683,06-08-24 20:28,615.17,Deposit,Direct Deposit,43902.33429
34116,789280683,06-08-24 21:28,644.58,Return,Amazon Return,44546.91429
34117,789280683,06-09-24 20:28,325.15,Purchase,Clothing,44221.76429
34118,789280683,06-10-24 23:28,600.59,Purchase,Gas,43621.17429
34119,789280683,06-11-24 21:28,592.6,Deposit,Mobile Deposit,44213.77429
34120,789280683,06-12-24 21:28,4600,Payment,Subscription Payment,39613.77429
34121,789280683,6-13-24 10:28,726.44,Payment,Loan Payment,38887.33429
34122,789280683,6-18-24 10:28,657.06,Purchase,Grocery,38230.27429
34123,789280683,6-19-24 13:28,900.96,Return,Target Return,39131.23429
34124,789280683,6-21-24 13:28,368.59,Withdrawal,ATM Withdrawal,38762.64429
34125,789280683,6-22-24 12:28,937.69,Purchase,Clothing,37824.95429
34126,789280683,6-22-24 18:28,596.93,Withdrawal,Branch Withdrawal,37228.02429
34127,789280683,6-23-24 13:28,810.18,Withdrawal,ATM Withdrawal,36417.84429
34128,789280683,6-23-24 18:28,469.63,Return,Amazon Return,36887.47429
34129,789280683,6-24-24 10:28,622.58,Purchase,Restaurant,36264.89429
34130,789280683,6-25-24 16:28,247.63,Purchase,Travel,36017.26429
34131,789280683,6-26-24 21:28,856.58,Deposit,Check Deposit,36873.84429
34132,789280683,07-01-24 21:28,16650,IncomingTransfer,Salary,53523.84429
34133,789280683,07-02-24 9:28,661.71,Purchase,Electronics,52862.13429
34134,789280683,07-02-24 21:28,818.15,Withdrawal,Branch Withdrawal,52043.98429
34135,789280683,07-03-24 20:28,878.38,Payment,Loan Payment,51165.60429
34136,789280683,07-05-24 9:28,878.25,Purchase,Pharmacy,50287.35429
34137,789280683,07-06-24 19:28,606.84,Deposit,Direct Deposit,50894.19429
34138,789280683,07-06-24 21:28,1100,Payment,Credit Card Payment,49794.19429
34139,789280683,07-08-24 17:28,684.01,Purchase,Electronics,49110.18429
34140,789280683,07-10-24 12:28,691.88,Purchase,Restaurant,48418.30429
34141,789280683,7-14-24 13:28,567.12,Return,AliExpress Return,48985.42429
34142,789280683,7-14-24 15:28,641.36,Payment,Loan Payment,48344.06429
34143,789280683,7-14-24 20:28,708.77,Deposit,Direct Deposit,49052.83429
34144,789280683,7-15-24 15:28,582.09,Deposit,Mobile Deposit,49634.92429
34145,789280683,7-16-24 18:28,484.22,Purchase,Furniture,49150.70429
34146,789280683,7-16-24 19:28,895.13,Deposit,Check Deposit,50045.83429
34147,789280683,7-16-24 23:28,712.73,Purchase,Pharmacy,49333.10429
34148,789280683,7-18-24 21:28,7100,Payment,Insurance Payment,42233.10429
34149,789319458,1-20-24 17:28,543.69,Purchase,Travel,783.0070036
34150,789319458,1-29-24 23:28,428.22,Purchase,Electronics,354.7870036
34151,789319458,02-01-24 14:28,229.05,Withdrawal,Branch Withdrawal,125.7370036
34152,789319458,02-01-24 21:28,5500,IncomingTransfer,Salary,5625.737004
34153,789319458,02-02-24 12:28,397.3,OnlineShopping,Amazon,5228.437004
34154,789319458,02-03-24 10:28,463.3,Payment,Bill Payment,4765.137004
34155,789319458,02-06-24 21:28,1600,Payment,Credit Card Payment,3165.137004
34156,789319458,02-07-24 23:28,171.06,Payment,Bill Payment,2994.077004
34157,789319458,02-09-24 11:28,380.92,Deposit,Direct Deposit,3374.997004
34158,789319458,02-11-24 14:28,56.64,Payment,Loan Payment,3318.357004
34159,789319458,2-14-24 12:28,424.34,Purchase,Grocery,2894.017004
34160,789319458,2-16-24 13:28,63.11,Return,Etsy Return,2957.127004
34161,789319458,2-18-24 21:28,2300,Payment,Subscription Payment,657.1270036
34162,789319458,2-19-24 14:28,240.61,Deposit,Mobile Deposit,897.7370036
34163,789319458,2-20-24 10:28,237.11,Withdrawal,Mobile App Withdrawal,660.6270036
34164,789319458,2-28-24 16:28,370.47,Deposit,Cash Deposit,1031.097004
34165,789319458,03-02-24 21:28,5500,IncomingTransfer,Salary,6531.097004
34166,789319458,03-06-24 14:28,439.07,IncomingTransfer,Freelance Payment,6970.167004
34167,789319458,03-07-24 12:28,488.68,Purchase,Restaurant,6481.487004
34168,789319458,03-07-24 21:28,1800,Payment,Credit Card Payment,4681.487004
34169,789319458,03-10-24 21:28,1400,Payment,Insurance Payment,3281.487004
34170,789319458,3-19-24 13:28,69.26,Withdrawal,ATM Withdrawal,3212.227004
34171,789319458,3-21-24 15:28,139.3,Withdrawal,ATM Withdrawal,3072.927004
34172,789319458,3-22-24 11:28,273.12,Purchase,Electronics,2799.807004
34173,789319458,3-25-24 14:28,149.16,Deposit,Mobile Deposit,2948.967004
34174,789319458,3-26-24 16:28,524.35,IncomingTransfer,Freelance Payment,3473.317004
34175,789319458,3-30-24 13:28,468.78,Return,Best Buy Return,3942.097004
34176,789319458,3-30-24 17:28,246.79,OnlineShopping,Target,3695.307004
34177,789319458,04-01-24 12:28,449.66,OnlineShopping,Amazon,3245.647004
34178,789319458,04-03-24 21:28,5500,IncomingTransfer,Salary,8745.647004
34179,789319458,04-06-24 19:28,143.23,Deposit,Mobile Deposit,8888.877004
34180,789319458,04-08-24 18:28,535.62,Deposit,Mobile Deposit,9424.497004
34181,789319458,04-08-24 21:28,2100,Payment,Credit Card Payment,7324.497004
34182,789319458,4-13-24 11:28,271.57,OnlineShopping,AliExpress,7052.927004
34183,789319458,4-13-24 21:28,2200,Payment,Subscription Payment,4852.927004
34184,789319458,4-15-24 18:28,54.04,Deposit,Direct Deposit,4906.967004
34185,789319458,4-20-24 17:28,400.11,Payment,Loan Payment,4506.857004
34186,789319458,4-22-24 16:28,427.17,OutgoingTransfer,Bank Transfer,4079.687004
34187,789319458,4-23-24 12:28,261.73,IncomingTransfer,Freelance Payment,4341.417004
34188,789319458,4-23-24 18:28,496.81,Withdrawal,Mobile App Withdrawal,3844.607004
34189,789319458,4-26-24 9:28,229.88,Purchase,Restaurant,3614.727004
34190,789319458,4-29-24 10:28,281.41,Payment,Bill Payment,3333.317004
34191,789319458,05-04-24 17:28,145.85,IncomingTransfer,Freelance Payment,3479.167004
34192,789319458,05-05-24 13:28,176.88,Withdrawal,Mobile App Withdrawal,3302.287004
34193,789319458,05-05-24 17:28,267.01,Deposit,Mobile Deposit,3569.297004
34194,789319458,05-05-24 21:28,5500,IncomingTransfer,Salary,9069.297004
34195,789319458,05-05-24 22:28,534.67,OutgoingTransfer,International Transfer,8534.627004
34196,789319458,05-06-24 13:28,309.16,Withdrawal,Mobile App Withdrawal,8225.467004
34197,789319458,05-07-24 12:28,336.7,Payment,Mortgage Payment,7888.767004
34198,789319458,05-10-24 21:28,2000,Payment,Credit Card Payment,5888.767004
34199,789319458,05-12-24 22:28,374.36,Deposit,Check Deposit,6263.127004
34200,789319458,5-13-24 16:28,199.95,Withdrawal,Branch Withdrawal,6063.177004
34201,789319458,5-14-24 9:28,343.9,IncomingTransfer,Freelance Payment,6407.077004
34202,789319458,5-17-24 21:28,2400,Payment,Insurance Payment,4007.077004
34203,789319458,5-24-24 15:28,471.92,Purchase,Electronics,3535.157004
34204,789319458,5-24-24 17:28,284.17,OnlineShopping,Target,3250.987004
34205,789319458,5-25-24 14:28,291.95,OutgoingTransfer,Peer-to-Peer Transfer,2959.037004
34206,789319458,5-26-24 13:28,227.99,Deposit,Cash Deposit,3187.027004
34207,789319458,06-02-24 21:28,5500,IncomingTransfer,Salary,8687.027004
34208,789319458,06-06-24 20:28,348.16,Deposit,Mobile Deposit,9035.187004
34209,789319458,06-07-24 15:28,352.59,Payment,Bill Payment,8682.597004
34210,789319458,06-07-24 21:28,1700,Payment,Credit Card Payment,6982.597004
34211,789319458,06-08-24 15:28,255.42,Payment,Mortgage Payment,6727.177004
34212,789319458,06-08-24 17:28,270.28,Deposit,Check Deposit,6997.457004
34213,789319458,06-10-24 21:28,201.58,Deposit,Cash Deposit,7199.037004
34214,789319458,6-17-24 21:28,1400,Payment,Installment Payment,5799.037004
34215,789319458,6-20-24 9:28,118.18,Purchase,Furniture,5680.857004
34216,789319458,6-22-24 11:28,116.76,Return,Best Buy Return,5797.617004
34217,789319458,6-23-24 18:28,303.74,Payment,Mortgage Payment,5493.877004
34218,789319458,6-28-24 17:28,304.34,OnlineShopping,Etsy,5189.537004
34219,789319458,6-30-24 10:28,345.24,Payment,Mortgage Payment,4844.297004
34220,789319458,07-01-24 9:28,488.24,Withdrawal,Mobile App Withdrawal,4356.057004
34221,789319458,07-05-24 21:28,5500,IncomingTransfer,Salary,9856.057004
34222,789319458,07-06-24 16:28,485.18,Deposit,Cash Deposit,10341.237
34223,789319458,07-07-24 22:28,175.71,Withdrawal,Branch Withdrawal,10165.527
34224,789319458,07-08-24 12:28,513.3,Purchase,Grocery,9652.227004
34225,789319458,07-10-24 15:28,467.89,Deposit,Check Deposit,10120.117
34226,789319458,07-10-24 16:28,82.09,Payment,Bill Payment,10038.027
34227,789319458,07-10-24 21:28,1800,Payment,Credit Card Payment,8238.027004
34228,789319458,7-13-24 12:28,214.23,OnlineShopping,Etsy,8023.797004
34229,789319458,7-13-24 20:28,270.53,Deposit,Cash Deposit,8294.327004
34230,789319458,7-16-24 17:28,212.49,Purchase,Gas,8081.837004
34231,789319458,7-17-24 21:28,1700,Payment,Insurance Payment,6381.837004
34232,789382758,1-23-24 18:28,102.51,Return,Best Buy Return,102.51
34233,789382758,1-25-24 11:28,155.9,OutgoingTransfer,Wire Transfer,-53.39
34234,789382758,1-25-24 23:28,377.29,Purchase,Furniture,-430.68
34235,789382758,1-28-24 14:28,219.66,Purchase,Restaurant,-650.34
34236,789382758,1-29-24 19:28,164.12,Purchase,Home Improvement,-814.46
34237,789382758,1-30-24 15:28,378.4,IncomingTransfer,Freelance Payment,-436.06
34238,789382758,1-31-24 23:28,247.28,Purchase,Grocery,-683.34
34239,789382758,02-01-24 21:28,4200,IncomingTransfer,Salary,3516.66
34240,789382758,02-02-24 20:28,267.32,OnlineShopping,Best Buy,3249.34
34241,789382758,02-12-24 17:28,306.48,Purchase,Restaurant,2942.86
34242,789382758,02-12-24 21:28,1500,Payment,Rent Payment,1442.86
34243,789382758,2-14-24 11:28,291.16,OutgoingTransfer,Wire Transfer,1151.7
34244,789382758,2-16-24 13:28,36.72,Payment,Bill Payment,1114.98
34245,789382758,2-21-24 14:28,98.96,Purchase,Pharmacy,1016.02
34246,789382758,2-21-24 16:28,275.05,Withdrawal,Branch Withdrawal,740.97
34247,789382758,2-22-24 18:28,110.3,Withdrawal,Mobile App Withdrawal,630.67
34248,789382758,2-25-24 17:28,393.25,Purchase,Pharmacy,237.42
34249,789382758,2-25-24 17:28,321.74,OutgoingTransfer,Wire Transfer,-84.32
34250,789382758,03-01-24 21:28,4200,IncomingTransfer,Salary,4115.68
34251,789382758,03-10-24 21:28,1200,Payment,Rent Payment,2915.68
34252,789382758,03-11-24 13:28,233.76,Payment,Bill Payment,2681.92
34253,789382758,03-12-24 21:28,115.1,Withdrawal,ATM Withdrawal,2566.82
34254,789382758,3-14-24 17:28,66.57,Withdrawal,ATM Withdrawal,2500.25
34255,789382758,3-16-24 11:28,367.39,Deposit,Mobile Deposit,2867.64
34256,789382758,3-18-24 21:28,74.04,OutgoingTransfer,Wire Transfer,2793.6
34257,789382758,3-20-24 22:28,277.72,Purchase,Travel,2515.88
34258,789382758,3-22-24 10:28,287.2,Payment,Loan Payment,2228.68
34259,789382758,3-24-24 17:28,285.49,OnlineShopping,Best Buy,1943.19
34260,789382758,3-25-24 23:28,234.38,Deposit,Check Deposit,2177.57
34261,789382758,3-27-24 17:28,53.83,Payment,Loan Payment,2123.74
34262,789382758,3-30-24 11:28,290.59,Payment,Loan Payment,1833.15
34263,789382758,3-30-24 21:28,61.83,Payment,Bill Payment,1771.32
34264,789382758,04-04-24 21:28,4200,IncomingTransfer,Salary,5971.32
34265,789382758,04-08-24 16:28,296.4,OutgoingTransfer,Bank Transfer,5674.92
34266,789382758,04-09-24 10:28,194.82,Purchase,Travel,5480.1
34267,789382758,04-10-24 19:28,211.4,Deposit,Cash Deposit,5691.5
34268,789382758,04-12-24 18:28,87.34,Payment,Bill Payment,5604.16
34269,789382758,4-14-24 15:28,349.63,OutgoingTransfer,International Transfer,5254.53
34270,789382758,4-16-24 21:28,2700,Payment,Rent Payment,2554.53
34271,789382758,4-22-24 11:28,357.44,Withdrawal,ATM Withdrawal,2197.09
34272,789382758,4-25-24 17:28,198.43,Withdrawal,Branch Withdrawal,1998.66
34273,789382758,4-28-24 20:28,242.44,OutgoingTransfer,Wire Transfer,1756.22
34274,789382758,05-02-24 21:28,4200,IncomingTransfer,Salary,5956.22
34275,789382758,05-06-24 22:28,184.14,Withdrawal,Branch Withdrawal,5772.08
34276,789382758,05-10-24 11:28,40.19,Purchase,Clothing,5731.89
34277,789382758,05-11-24 21:28,2100,Payment,Rent Payment,3631.89
34278,789382758,5-25-24 15:28,337.37,Return,Walmart Return,3969.26
34279,789382758,5-30-24 11:28,394.39,Deposit,Direct Deposit,4363.65
34280,789382758,06-04-24 21:28,4200,IncomingTransfer,Salary,8563.65
34281,789382758,06-08-24 19:28,68.44,Withdrawal,Branch Withdrawal,8495.21
34282,789382758,06-11-24 21:28,2500,Payment,Rent Payment,5995.21
34283,789382758,6-13-24 23:28,221.45,OutgoingTransfer,Peer-to-Peer Transfer,5773.76
34284,789382758,6-18-24 12:28,284.87,Purchase,Pharmacy,5488.89
34285,789382758,6-20-24 22:28,275.78,Deposit,Direct Deposit,5764.67
34286,789382758,6-26-24 14:28,205.57,OutgoingTransfer,Peer-to-Peer Transfer,5559.1
34287,789382758,6-29-24 17:28,306.6,IncomingTransfer,Freelance Payment,5865.7
34288,789382758,6-30-24 17:28,122.31,Return,Walmart Return,5988.01
34289,789382758,07-04-24 21:28,4200,IncomingTransfer,Salary,10188.01
34290,789382758,07-09-24 15:28,376.36,OnlineShopping,Amazon,9811.65
34291,789382758,07-09-24 19:28,157.15,Withdrawal,Branch Withdrawal,9654.5
34292,789382758,07-11-24 9:28,347.61,OutgoingTransfer,International Transfer,9306.89
34293,789382758,07-12-24 21:28,1300,Payment,Rent Payment,8006.89
34294,789382758,7-14-24 16:28,279.85,Deposit,Check Deposit,8286.74
34295,789407958,1-22-24 15:28,144.64,Purchase,Furniture,491.0922005
34296,789407958,1-22-24 23:28,226.49,Return,Store Return,717.5822005
34297,789407958,1-23-24 18:28,131.92,Purchase,Home Improvement,585.6622005
34298,789407958,1-27-24 22:28,466.12,Purchase,Furniture,119.5422005
34299,789407958,1-29-24 17:28,135.14,Withdrawal,Mobile App Withdrawal,-15.59779951
34300,789407958,1-29-24 19:28,462.18,Purchase,Electronics,-477.7777995
34301,789407958,1-30-24 13:28,432.79,Deposit,Cash Deposit,-44.98779951
34302,789407958,02-01-24 20:28,364.81,OutgoingTransfer,Bank Transfer,-409.7977995
34303,789407958,02-02-24 18:28,52.13,Payment,Loan Payment,-461.9277995
34304,789407958,02-02-24 20:28,66.39,Purchase,Pharmacy,-528.3177995
34305,789407958,02-04-24 10:28,213.69,Deposit,Direct Deposit,-314.6277995
34306,789407958,02-04-24 22:28,430.28,Deposit,Direct Deposit,115.6522005
34307,789407958,02-05-24 12:28,269.61,Deposit,Cash Deposit,385.2622005
34308,789407958,02-05-24 21:28,6500,IncomingTransfer,Salary,6885.2622
34309,789407958,02-10-24 20:28,446.68,Deposit,Check Deposit,7331.9422
34310,789407958,02-10-24 21:28,1300,Payment,Credit Card Payment,6031.9422
34311,789407958,2-14-24 20:28,120.85,Purchase,Clothing,5911.0922
34312,789407958,2-14-24 21:28,1800,Payment,Installment Payment,4111.0922
34313,789407958,2-15-24 9:28,490.49,IncomingTransfer,Freelance Payment,4601.5822
34314,789407958,2-16-24 13:28,405.5,Deposit,Mobile Deposit,5007.0822
34315,789407958,2-19-24 13:28,228.8,OnlineShopping,Etsy,4778.2822
34316,789407958,2-24-24 19:28,387.56,OnlineShopping,Amazon,4390.7222
34317,789407958,2-26-24 21:28,139,OutgoingTransfer,Peer-to-Peer Transfer,4251.7222
34318,789407958,2-29-24 9:28,292.31,OnlineShopping,AliExpress,3959.4122
34319,789407958,03-05-24 21:28,6500,IncomingTransfer,Salary,10459.4122
34320,789407958,03-06-24 15:28,146.24,OnlineShopping,Amazon,10313.1722
34321,789407958,03-08-24 17:28,126.33,Deposit,Direct Deposit,10439.5022
34322,789407958,03-10-24 21:28,1600,Payment,Credit Card Payment,8839.5022
34323,789407958,3-13-24 12:28,179.51,Return,Best Buy Return,9019.0122
34324,789407958,3-13-24 21:28,2000,Payment,Subscription Payment,7019.0122
34325,789407958,3-20-24 19:28,398.8,OutgoingTransfer,International Transfer,6620.2122
34326,789407958,3-25-24 23:28,510.99,Return,Amazon Return,7131.2022
34327,789407958,04-01-24 21:28,6500,IncomingTransfer,Salary,13631.2022
34328,789407958,04-04-24 19:28,409.17,OutgoingTransfer,International Transfer,13222.0322
34329,789407958,04-06-24 21:28,1600,Payment,Credit Card Payment,11622.0322
34330,789407958,04-07-24 16:28,173.54,IncomingTransfer,Freelance Payment,11795.5722
34331,789407958,04-10-24 21:28,2700,Payment,Subscription Payment,9095.5722
34332,789407958,04-11-24 18:28,486.12,Payment,Bill Payment,8609.4522
34333,789407958,4-15-24 12:28,158.49,Withdrawal,ATM Withdrawal,8450.9622
34334,789407958,4-18-24 9:28,57.28,OnlineShopping,Walmart,8393.6822
34335,789407958,4-20-24 12:28,214.21,Return,Store Return,8607.8922
34336,789407958,4-22-24 11:28,487.68,OutgoingTransfer,International Transfer,8120.2122
34337,789407958,4-25-24 18:28,545.89,Withdrawal,Mobile App Withdrawal,7574.3222
34338,789407958,4-25-24 18:28,173.3,Deposit,Mobile Deposit,7747.6222
34339,789407958,4-28-24 20:28,429.48,Return,Walmart Return,8177.1022
34340,789407958,4-30-24 10:28,486.34,Deposit,Check Deposit,8663.4422
34341,789407958,4-30-24 21:28,100.09,Deposit,Check Deposit,8763.5322
34342,789407958,05-01-24 23:28,249.99,Payment,Mortgage Payment,8513.5422
34343,789407958,05-02-24 21:28,6500,IncomingTransfer,Salary,15013.5422
34344,789407958,05-07-24 21:28,1300,Payment,Credit Card Payment,13713.5422
34345,789407958,05-08-24 19:28,164.43,Payment,Bill Payment,13549.1122
34346,789407958,05-11-24 21:28,244.65,IncomingTransfer,Freelance Payment,13793.7622
34347,789407958,05-12-24 16:28,356.94,Purchase,Entertainment,13436.8222
34348,789407958,05-12-24 20:28,368.41,Withdrawal,Branch Withdrawal,13068.4122
34349,789407958,05-12-24 20:28,295.15,Return,AliExpress Return,13363.5622
34350,789407958,5-17-24 21:28,2200,Payment,Installment Payment,11163.5622
34351,789407958,5-18-24 22:28,93.62,Deposit,Cash Deposit,11257.1822
34352,789407958,5-22-24 19:28,493.76,Return,eBay Return,11750.9422
34353,789407958,5-23-24 23:28,404.46,Deposit,Cash Deposit,12155.4022
34354,789407958,5-27-24 20:28,181.06,Return,Etsy Return,12336.4622
34355,789407958,5-28-24 9:28,90.4,Deposit,Cash Deposit,12426.8622
34356,789407958,5-29-24 18:28,190.7,Withdrawal,ATM Withdrawal,12236.1622
34357,789407958,06-01-24 11:28,400.38,Withdrawal,Branch Withdrawal,11835.7822
34358,789407958,06-02-24 21:28,6500,IncomingTransfer,Salary,18335.7822
34359,789407958,06-05-24 14:28,394.12,Purchase,Travel,17941.6622
34360,789407958,06-07-24 19:28,321.6,Payment,Mortgage Payment,17620.0622
34361,789407958,06-07-24 21:28,1700,Payment,Credit Card Payment,15920.0622
34362,789407958,06-10-24 21:28,515.7,Payment,Mortgage Payment,15404.3622
34363,789407958,6-17-24 21:28,1600,Payment,Subscription Payment,13804.3622
34364,789407958,6-18-24 20:28,276.65,Payment,Loan Payment,13527.7122
34365,789407958,6-21-24 19:28,57.22,Purchase,Restaurant,13470.4922
34366,789407958,6-23-24 17:28,249.66,Return,Amazon Return,13720.1522
34367,789407958,6-24-24 17:28,325.13,Purchase,Pharmacy,13395.0222
34368,789407958,6-29-24 11:28,422.49,OutgoingTransfer,Bank Transfer,12972.5322
34369,789407958,6-30-24 14:28,480.91,Withdrawal,Branch Withdrawal,12491.6222
34370,789407958,07-04-24 21:28,6500,IncomingTransfer,Salary,18991.6222
34371,789407958,07-05-24 17:28,460.55,Deposit,Check Deposit,19452.1722
34372,789407958,07-09-24 21:28,1700,Payment,Credit Card Payment,17752.1722
34373,789407958,07-11-24 21:28,2300,Payment,Subscription Payment,15452.1722
34374,789407958,7-15-24 12:28,192.89,Return,AliExpress Return,15645.0622
34375,789433758,1-22-24 18:28,568.64,Return,Best Buy Return,1841.965724
34376,789433758,1-28-24 15:28,707.67,Purchase,Electronics,1134.295724
34377,789433758,02-02-24 11:28,541.81,Withdrawal,Mobile App Withdrawal,592.4857245
34378,789433758,02-04-24 21:28,7800,IncomingTransfer,Salary,8392.485724
34379,789433758,02-09-24 21:28,3200,Payment,Credit Card Payment,5192.485724
34380,789433758,02-11-24 13:28,229.33,Purchase,Clothing,4963.155724
34381,789433758,02-12-24 21:28,4100,Payment,Rent Payment,863.1557245
34382,789433758,2-14-24 16:28,513.1,Withdrawal,Branch Withdrawal,350.0557245
34383,789433758,2-16-24 22:28,167.36,OutgoingTransfer,Peer-to-Peer Transfer,182.6957245
34384,789433758,03-04-24 21:28,7800,IncomingTransfer,Salary,7982.695724
34385,789433758,03-06-24 14:28,688.76,Withdrawal,Branch Withdrawal,7293.935724
34386,789433758,03-09-24 21:28,3200,Payment,Credit Card Payment,4093.935724
34387,789433758,03-11-24 11:28,481.25,OutgoingTransfer,Bank Transfer,3612.685724
34388,789433758,3-13-24 15:28,657.34,Return,Walmart Return,4270.025724
34389,789433758,3-15-24 21:28,3500,Payment,Rent Payment,770.0257245
34390,789433758,3-21-24 21:28,523.91,OutgoingTransfer,Peer-to-Peer Transfer,246.1157245
34391,789433758,3-25-24 22:28,602.93,OutgoingTransfer,Wire Transfer,-356.8142755
34392,789433758,3-30-24 14:28,293.72,Purchase,Restaurant,-650.5342755
34393,789433758,04-03-24 21:28,7800,IncomingTransfer,Salary,7149.465724
34394,789433758,04-08-24 20:28,504.51,OnlineShopping,Walmart,6644.955724
34395,789433758,04-08-24 21:28,2500,Payment,Credit Card Payment,4144.955724
34396,789433758,04-10-24 20:28,271.48,Payment,Loan Payment,3873.475724
34397,789433758,4-13-24 15:28,412.93,Deposit,Mobile Deposit,4286.405724
34398,789433758,4-15-24 12:28,147.91,Deposit,Cash Deposit,4434.315724
34399,789433758,4-15-24 21:28,2900,Payment,Rent Payment,1534.315724
34400,789433758,4-21-24 17:28,123.43,Purchase,Entertainment,1410.885724
34401,789433758,4-21-24 20:28,255.57,Withdrawal,ATM Withdrawal,1155.315724
34402,789433758,4-22-24 10:28,639.76,Return,Target Return,1795.075724
34403,789433758,4-22-24 18:28,498.37,Payment,Mortgage Payment,1296.705724
34404,789433758,4-28-24 12:28,651.53,Deposit,Cash Deposit,1948.235724
34405,789433758,4-30-24 15:28,252.17,OnlineShopping,Best Buy,1696.065724
34406,789433758,05-05-24 21:28,7800,IncomingTransfer,Salary,9496.065724
34407,789433758,05-09-24 11:28,467.98,OnlineShopping,AliExpress,9028.085724
34408,789433758,05-09-24 21:28,561.01,Purchase,Electronics,8467.075724
34409,789433758,05-10-24 21:28,2400,Payment,Credit Card Payment,6067.075724
34410,789433758,05-11-24 21:28,4500,Payment,Rent Payment,1567.075724
34411,789433758,5-16-24 10:28,579.01,Deposit,Direct Deposit,2146.085724
34412,789433758,5-21-24 20:28,653.47,Purchase,Pharmacy,1492.615724
34413,789433758,5-23-24 11:28,453.69,Purchase,Travel,1038.925724
34414,789433758,06-01-24 21:28,7800,IncomingTransfer,Salary,8838.925724
34415,789433758,06-06-24 14:28,481.31,OnlineShopping,eBay,8357.615724
34416,789433758,06-06-24 21:28,2600,Payment,Credit Card Payment,5757.615724
34417,789433758,06-12-24 9:28,706.34,Withdrawal,Mobile App Withdrawal,5051.275724
34418,789433758,06-12-24 21:28,2400,Payment,Rent Payment,2651.275724
34419,789433758,6-13-24 9:28,319.9,Withdrawal,Branch Withdrawal,2331.375724
34420,789433758,6-17-24 19:28,525.4,Payment,Bill Payment,1805.975724
34421,789433758,6-18-24 16:28,418.71,Return,Etsy Return,2224.685724
34422,789433758,6-20-24 16:28,485.82,OutgoingTransfer,Wire Transfer,1738.865724
34423,789433758,6-20-24 18:28,697.32,IncomingTransfer,Freelance Payment,2436.185724
34424,789433758,6-22-24 12:28,236.72,Return,Target Return,2672.905724
34425,789433758,07-04-24 21:28,7800,IncomingTransfer,Salary,10472.90572
34426,789433758,07-05-24 23:28,684.83,OnlineShopping,Etsy,9788.075724
34427,789433758,07-09-24 21:28,2900,Payment,Credit Card Payment,6888.075724
34428,789433758,07-12-24 10:28,397.48,OutgoingTransfer,International Transfer,6490.595724
34429,789433758,07-12-24 18:28,552.76,Payment,Loan Payment,5937.835724
34430,789433758,07-12-24 21:28,3800,Payment,Rent Payment,2137.835724
34431,789433758,7-17-24 17:28,184.11,Withdrawal,Mobile App Withdrawal,1953.725724
34432,789467508,1-22-24 23:28,103.35,Deposit,Direct Deposit,1236.083962
34433,789467508,1-25-24 13:28,358.2,Deposit,Mobile Deposit,1594.283962
34434,789467508,1-27-24 14:28,392.9,Withdrawal,Branch Withdrawal,1201.383962
34435,789467508,1-28-24 15:28,149.97,Deposit,Direct Deposit,1351.353962
34436,789467508,02-02-24 16:28,213.55,Purchase,Furniture,1137.803962
34437,789467508,02-04-24 17:28,327.66,Payment,Mortgage Payment,810.143962
34438,789467508,02-04-24 21:28,4650,IncomingTransfer,Salary,5460.143962
34439,789467508,02-09-24 21:28,2200,Payment,Credit Card Payment,3260.143962
34440,789467508,02-10-24 11:28,384.76,Deposit,Mobile Deposit,3644.903962
34441,789467508,02-12-24 17:28,257.71,Deposit,Cash Deposit,3902.613962
34442,789467508,2-17-24 10:28,197.29,Purchase,Home Improvement,3705.323962
34443,789467508,2-18-24 13:28,37.48,IncomingTransfer,Freelance Payment,3742.803962
34444,789467508,2-18-24 20:28,92.17,Deposit,Cash Deposit,3834.973962
34445,789467508,2-18-24 21:28,2100,Payment,Rent Payment,1734.973962
34446,789467508,2-21-24 21:28,110.84,Deposit,Cash Deposit,1845.813962
34447,789467508,2-25-24 12:28,172.5,Withdrawal,Branch Withdrawal,1673.313962
34448,789467508,2-26-24 18:28,173.67,OnlineShopping,Amazon,1499.643962
34449,789467508,03-03-24 21:28,4650,IncomingTransfer,Salary,6149.643962
34450,789467508,03-07-24 20:28,91.08,Purchase,Gas,6058.563962
34451,789467508,03-08-24 21:28,1800,Payment,Credit Card Payment,4258.563962
34452,789467508,03-09-24 16:28,392.86,Return,AliExpress Return,4651.423962
34453,789467508,3-13-24 18:28,74.85,OnlineShopping,AliExpress,4576.573962
34454,789467508,3-15-24 14:28,238.18,Return,Amazon Return,4814.753962
34455,789467508,3-17-24 19:28,240.05,Payment,Bill Payment,4574.703962
34456,789467508,3-18-24 16:28,281.29,Withdrawal,Branch Withdrawal,4293.413962
34457,789467508,3-18-24 21:28,2200,Payment,Rent Payment,2093.413962
34458,789467508,3-22-24 9:28,339.52,Return,Store Return,2432.933962
34459,789467508,3-24-24 11:28,27.72,Deposit,Check Deposit,2460.653962
34460,789467508,3-28-24 19:28,217.78,Deposit,Cash Deposit,2678.433962
34461,789467508,04-04-24 21:28,4650,IncomingTransfer,Salary,7328.433962
34462,789467508,04-09-24 21:28,2000,Payment,Credit Card Payment,5328.433962
34463,789467508,04-11-24 16:28,260.66,Withdrawal,Mobile App Withdrawal,5067.773962
34464,789467508,04-11-24 21:28,1900,Payment,Rent Payment,3167.773962
34465,789467508,04-11-24 21:28,251.77,IncomingTransfer,Freelance Payment,3419.543962
34466,789467508,04-11-24 21:28,98.19,OnlineShopping,Best Buy,3321.353962
34467,789467508,04-12-24 11:28,167.8,Purchase,Pharmacy,3153.553962
34468,789467508,4-15-24 16:28,176.72,IncomingTransfer,Freelance Payment,3330.273962
34469,789467508,4-18-24 14:28,345.38,OnlineShopping,AliExpress,2984.893962
34470,789467508,4-22-24 10:28,78.89,OutgoingTransfer,International Transfer,2906.003962
34471,789467508,4-24-24 17:28,35.81,Return,Store Return,2941.813962
34472,789467508,4-26-24 22:28,30.73,Deposit,Cash Deposit,2972.543962
34473,789467508,05-01-24 22:28,347.74,Purchase,Home Improvement,2624.803962
34474,789467508,05-02-24 21:28,4650,IncomingTransfer,Salary,7274.803962
34475,789467508,05-06-24 21:28,98.51,Purchase,Furniture,7176.293962
34476,789467508,05-07-24 21:28,1800,Payment,Credit Card Payment,5376.293962
34477,789467508,05-08-24 16:28,260.66,Purchase,Furniture,5115.633962
34478,789467508,05-11-24 20:28,291.08,Withdrawal,Branch Withdrawal,4824.553962
34479,789467508,5-13-24 10:28,170.39,OnlineShopping,Best Buy,4654.163962
34480,789467508,5-14-24 17:28,315.89,Return,Amazon Return,4970.053962
34481,789467508,5-14-24 21:28,1900,Payment,Rent Payment,3070.053962
34482,789467508,5-14-24 23:28,57.92,OutgoingTransfer,Bank Transfer,3012.133962
34483,789467508,5-16-24 19:28,96.42,Withdrawal,Mobile App Withdrawal,2915.713962
34484,789467508,5-17-24 17:28,91.41,Deposit,Cash Deposit,3007.123962
34485,789467508,5-18-24 15:28,220.83,Deposit,Mobile Deposit,3227.953962
34486,789467508,5-23-24 9:28,289.28,OutgoingTransfer,Wire Transfer,2938.673962
34487,789467508,5-24-24 14:28,195.93,Payment,Bill Payment,2742.743962
34488,789467508,5-31-24 10:28,365.47,Deposit,Mobile Deposit,3108.213962
34489,789467508,5-31-24 12:28,161.49,Return,Etsy Return,3269.703962
34490,789467508,06-03-24 21:28,4650,IncomingTransfer,Salary,7919.703962
34491,789467508,06-04-24 11:28,183.45,OutgoingTransfer,International Transfer,7736.253962
34492,789467508,06-08-24 21:28,1900,Payment,Credit Card Payment,5836.253962
34493,789467508,6-13-24 22:28,80.67,Purchase,Restaurant,5755.583962
34494,789467508,6-17-24 21:28,2800,Payment,Rent Payment,2955.583962
34495,789467508,6-18-24 15:28,247.87,Return,Best Buy Return,3203.453962
34496,789467508,6-21-24 21:28,394.19,Return,Store Return,3597.643962
34497,789467508,6-22-24 12:28,39.91,Deposit,Direct Deposit,3637.553962
34498,789467508,07-03-24 21:28,4650,IncomingTransfer,Salary,8287.553962
34499,789467508,07-04-24 20:28,37.79,Deposit,Direct Deposit,8325.343962
34500,789467508,07-04-24 23:28,67.12,Withdrawal,Branch Withdrawal,8258.223962
34501,789467508,07-08-24 21:28,1800,Payment,Credit Card Payment,6458.223962
34502,789467508,07-10-24 20:28,176.87,Purchase,Clothing,6281.353962
34503,789467508,07-11-24 21:28,2400,Payment,Rent Payment,3881.353962
34504,789467508,7-13-24 21:28,214.69,Withdrawal,ATM Withdrawal,3666.663962
34505,789467508,7-13-24 21:28,367.84,Withdrawal,ATM Withdrawal,3298.823962
34506,789467508,7-14-24 14:28,388.79,OutgoingTransfer,Bank Transfer,2910.033962
34507,789497283,1-22-24 10:28,767.92,Withdrawal,Mobile App Withdrawal,496.0753535
34508,789497283,1-23-24 9:28,576.11,Deposit,Mobile Deposit,1072.185354
34509,789497283,1-23-24 23:28,316.6,Withdrawal,ATM Withdrawal,755.5853535
34510,789497283,1-28-24 19:28,732.07,OutgoingTransfer,Wire Transfer,23.51535353
34511,789497283,1-29-24 16:28,273.66,IncomingTransfer,Freelance Payment,297.1753535
34512,789497283,02-01-24 19:28,932.31,Payment,Loan Payment,-635.1346465
34513,789497283,02-01-24 21:28,14400,IncomingTransfer,Salary,13764.86535
34514,789497283,02-06-24 12:28,653.25,OnlineShopping,Target,13111.61535
34515,789497283,02-06-24 21:28,1800,Payment,Credit Card Payment,11311.61535
34516,789497283,02-07-24 13:28,268.91,Withdrawal,Mobile App Withdrawal,11042.70535
34517,789497283,02-08-24 22:28,322.51,Purchase,Entertainment,10720.19535
34518,789497283,02-11-24 15:28,754.55,Deposit,Cash Deposit,11474.74535
34519,789497283,02-12-24 21:28,5600,Payment,Subscription Payment,5874.745354
34520,789497283,02-12-24 21:28,837.73,Payment,Bill Payment,5037.015354
34521,789497283,2-13-24 23:28,351.85,Deposit,Direct Deposit,5388.865354
34522,789497283,2-19-24 22:28,804.76,Withdrawal,ATM Withdrawal,4584.105354
34523,789497283,2-22-24 21:28,556.42,Return,Etsy Return,5140.525354
34524,789497283,2-24-24 16:28,308.57,Deposit,Cash Deposit,5449.095354
34525,789497283,2-29-24 22:28,751.39,Return,Etsy Return,6200.485354
34526,789497283,03-05-24 21:28,14400,IncomingTransfer,Salary,20600.48535
34527,789497283,03-10-24 18:28,455.05,Withdrawal,Branch Withdrawal,20145.43535
34528,789497283,03-10-24 21:28,2500,Payment,Credit Card Payment,17645.43535
34529,789497283,03-11-24 15:28,767.42,IncomingTransfer,Freelance Payment,18412.85535
34530,789497283,3-13-24 13:28,457.29,OutgoingTransfer,Bank Transfer,17955.56535
34531,789497283,3-14-24 16:28,370.82,Purchase,Pharmacy,17584.74535
34532,789497283,3-15-24 11:28,239.53,Purchase,Entertainment,17345.21535
34533,789497283,3-17-24 21:28,5000,Payment,Insurance Payment,12345.21535
34534,789497283,3-21-24 9:28,902.41,OutgoingTransfer,Bank Transfer,11442.80535
34535,789497283,3-21-24 18:28,470.86,Deposit,Direct Deposit,11913.66535
34536,789497283,3-22-24 21:28,200.58,IncomingTransfer,Freelance Payment,12114.24535
34537,789497283,3-28-24 16:28,317.73,OnlineShopping,eBay,11796.51535
34538,789497283,3-28-24 19:28,391.18,Payment,Bill Payment,11405.33535
34539,789497283,3-31-24 19:28,723.33,Deposit,Direct Deposit,12128.66535
34540,789497283,04-02-24 22:28,835.87,Deposit,Cash Deposit,12964.53535
34541,789497283,04-03-24 20:28,502.38,Deposit,Direct Deposit,13466.91535
34542,789497283,04-03-24 21:28,14400,IncomingTransfer,Salary,27866.91535
34543,789497283,04-07-24 12:28,850.75,Withdrawal,Mobile App Withdrawal,27016.16535
34544,789497283,04-08-24 21:28,2100,Payment,Credit Card Payment,24916.16535
34545,789497283,04-10-24 21:28,6000,Payment,Subscription Payment,18916.16535
34546,789497283,04-11-24 22:28,549.89,Return,Store Return,19466.05535
34547,789497283,4-14-24 13:28,463.02,OnlineShopping,Amazon,19003.03535
34548,789497283,4-16-24 17:28,208.15,OnlineShopping,Best Buy,18794.88535
34549,789497283,4-22-24 13:28,685.5,Purchase,Home Improvement,18109.38535
34550,789497283,4-23-24 19:28,237.58,Payment,Mortgage Payment,17871.80535
34551,789497283,4-27-24 12:28,495.6,OutgoingTransfer,International Transfer,17376.20535
34552,789497283,05-04-24 21:28,14400,IncomingTransfer,Salary,31776.20535
34553,789497283,05-09-24 21:28,1800,Payment,Credit Card Payment,29976.20535
34554,789497283,05-12-24 21:28,4800,Payment,Insurance Payment,25176.20535
34555,789497283,5-17-24 12:28,257.36,Purchase,Grocery,24918.84535
34556,789497283,5-18-24 11:28,484.98,Deposit,Cash Deposit,25403.82535
34557,789497283,5-19-24 19:28,812.05,Deposit,Direct Deposit,26215.87535
34558,789497283,5-22-24 12:28,545.2,Withdrawal,Mobile App Withdrawal,25670.67535
34559,789497283,5-24-24 10:28,378.98,OnlineShopping,Amazon,25291.69535
34560,789497283,5-24-24 15:28,927.93,Deposit,Cash Deposit,26219.62535
34561,789497283,5-30-24 18:28,804.52,Return,Target Return,27024.14535
34562,789497283,06-01-24 21:28,14400,IncomingTransfer,Salary,41424.14535
34563,789497283,06-06-24 21:28,2200,Payment,Credit Card Payment,39224.14535
34564,789497283,06-07-24 21:28,230.91,Return,Walmart Return,39455.05535
34565,789497283,06-10-24 21:28,5500,Payment,Subscription Payment,33955.05535
34566,789497283,06-12-24 12:28,590.72,Withdrawal,Mobile App Withdrawal,33364.33535
34567,789497283,06-12-24 23:28,299.4,Purchase,Grocery,33064.93535
34568,789497283,6-14-24 15:28,776.74,Deposit,Direct Deposit,33841.67535
34569,789497283,6-14-24 17:28,697.71,OnlineShopping,Best Buy,33143.96535
34570,789497283,6-17-24 18:28,388.33,Deposit,Cash Deposit,33532.29535
34571,789497283,6-21-24 17:28,937.65,OnlineShopping,Etsy,32594.64535
34572,789497283,6-26-24 17:28,411.62,Payment,Loan Payment,32183.02535
34573,789497283,07-01-24 11:28,484.3,Withdrawal,ATM Withdrawal,31698.72535
34574,789497283,07-02-24 21:28,14400,IncomingTransfer,Salary,46098.72535
34575,789497283,07-06-24 22:28,677.16,OnlineShopping,Walmart,45421.56535
34576,789497283,07-07-24 21:28,2500,Payment,Credit Card Payment,42921.56535
34577,789497283,7-14-24 14:28,461.01,Deposit,Check Deposit,43382.57535
34578,789497283,7-14-24 22:28,714.28,Withdrawal,ATM Withdrawal,42668.29535
34579,789497283,7-16-24 14:28,507.79,Purchase,Pharmacy,42160.50535
34580,789497283,7-16-24 21:28,4900,Payment,Installment Payment,37260.50535
34581,789535233,1-23-24 14:28,132.81,Deposit,Mobile Deposit,1445.562018
34582,789535233,1-26-24 14:28,207.19,Payment,Loan Payment,1238.372018
34583,789535233,1-28-24 17:28,522.24,Withdrawal,ATM Withdrawal,716.1320176
34584,789535233,1-30-24 15:28,600.07,OnlineShopping,Walmart,116.0620176
34585,789535233,02-01-24 22:28,587.13,Return,AliExpress Return,703.1920176
34586,789535233,02-02-24 15:28,621.5,Withdrawal,Mobile App Withdrawal,81.69201758
34587,789535233,02-03-24 21:28,8900,IncomingTransfer,Salary,8981.692018
34588,789535233,02-07-24 23:28,587.43,OnlineShopping,Best Buy,8394.262018
34589,789535233,02-08-24 17:28,727.96,Withdrawal,Mobile App Withdrawal,7666.302018
34590,789535233,02-08-24 21:28,2400,Payment,Credit Card Payment,5266.302018
34591,789535233,02-10-24 14:28,144.33,OutgoingTransfer,Bank Transfer,5121.972018
34592,789535233,02-10-24 15:28,656.07,Purchase,Gas,4465.902018
34593,789535233,02-11-24 16:28,244.62,Payment,Loan Payment,4221.282018
34594,789535233,02-11-24 19:28,610.31,OutgoingTransfer,Peer-to-Peer Transfer,3610.972018
34595,789535233,02-11-24 19:28,704.63,OnlineShopping,Best Buy,2906.342018
34596,789535233,02-11-24 21:28,4600,Payment,Rent Payment,-1693.657982
34597,789535233,2-13-24 14:28,469.21,Return,Amazon Return,-1224.447982
34598,789535233,2-13-24 21:28,305.35,Purchase,Electronics,-1529.797982
34599,789535233,2-14-24 12:28,609.88,Purchase,Furniture,-2139.677982
34600,789535233,2-15-24 17:28,273.31,Return,Best Buy Return,-1866.367982
34601,789535233,2-15-24 21:28,161.96,Withdrawal,Branch Withdrawal,-2028.327982
34602,789535233,2-16-24 11:28,228.28,Purchase,Entertainment,-2256.607982
34603,789535233,2-16-24 22:28,420.86,OutgoingTransfer,Bank Transfer,-2677.467982
34604,789535233,2-17-24 17:28,410.59,Purchase,Restaurant,-3088.057982
34605,789535233,2-19-24 19:28,637.49,OnlineShopping,Best Buy,-3725.547982
34606,789535233,2-20-24 15:28,500.46,OutgoingTransfer,Bank Transfer,-4226.007982
34607,789535233,2-22-24 15:28,654.9,Purchase,Electronics,-4880.907982
34608,789535233,03-02-24 21:28,8900,IncomingTransfer,Salary,4019.092018
34609,789535233,03-03-24 13:28,352.76,OnlineShopping,Etsy,3666.332018
34610,789535233,03-04-24 14:28,646.22,OutgoingTransfer,Wire Transfer,3020.112018
34611,789535233,03-07-24 13:28,536.92,Deposit,Cash Deposit,3557.032018
34612,789535233,03-07-24 21:28,1600,Payment,Credit Card Payment,1957.032018
34613,789535233,03-08-24 12:28,690.31,OutgoingTransfer,International Transfer,1266.722018
34614,789535233,03-08-24 17:28,224.26,Purchase,Pharmacy,1042.462018
34615,789535233,03-10-24 18:28,452.72,Payment,Loan Payment,589.7420176
34616,789535233,03-10-24 21:28,406.98,Purchase,Furniture,182.7620176
34617,789535233,03-11-24 19:28,705.85,Return,Etsy Return,888.6120176
34618,789535233,03-11-24 20:28,368.08,Withdrawal,Mobile App Withdrawal,520.5320176
34619,789535233,03-12-24 14:28,704.23,Purchase,Home Improvement,-183.6979824
34620,789535233,3-18-24 21:28,3900,Payment,Rent Payment,-4083.697982
34621,789535233,3-19-24 10:28,291.34,Deposit,Cash Deposit,-3792.357982
34622,789535233,3-19-24 21:28,506.11,Purchase,Furniture,-4298.467982
34623,789535233,3-20-24 22:28,443.3,Purchase,Furniture,-4741.767982
34624,789535233,3-21-24 21:28,408.25,Withdrawal,Mobile App Withdrawal,-5150.017982
34625,789535233,3-21-24 23:28,726.03,OutgoingTransfer,Peer-to-Peer Transfer,-5876.047982
34626,789535233,3-22-24 12:28,372.95,OnlineShopping,Best Buy,-6248.997982
34627,789535233,3-24-24 19:28,327.45,Deposit,Cash Deposit,-5921.547982
34628,789535233,3-26-24 22:28,552.26,Deposit,Check Deposit,-5369.287982
34629,789535233,3-28-24 10:28,738.98,Payment,Loan Payment,-6108.267982
34630,789535233,3-29-24 21:28,413.38,Withdrawal,Branch Withdrawal,-6521.647982
34631,789535233,3-30-24 20:28,722.09,OutgoingTransfer,Wire Transfer,-7243.737982
34632,789535233,04-01-24 14:28,695.88,Deposit,Check Deposit,-6547.857982
34633,789535233,04-01-24 14:28,358.51,Purchase,Furniture,-6906.367982
34634,789535233,04-01-24 20:28,727.83,Purchase,Clothing,-7634.197982
34635,789535233,04-01-24 21:28,8900,IncomingTransfer,Salary,1265.802018
34636,789535233,04-02-24 13:28,367.87,Deposit,Direct Deposit,1633.672018
34637,789535233,04-06-24 21:28,2400,Payment,Credit Card Payment,-766.3279824
34638,789535233,04-11-24 21:28,4100,Payment,Rent Payment,-4866.327982
34639,789535233,04-12-24 9:28,746.52,Deposit,Mobile Deposit,-4119.807982
34640,789535233,4-13-24 20:28,368.02,OutgoingTransfer,International Transfer,-4487.827982
34641,789535233,4-14-24 16:28,554.82,Purchase,Clothing,-5042.647982
34642,789535233,4-15-24 17:28,547.89,Purchase,Furniture,-5590.537982
34643,789535233,4-17-24 9:28,381.81,Deposit,Direct Deposit,-5208.727982
34644,789535233,4-19-24 12:28,339.07,OnlineShopping,eBay,-5547.797982
34645,789535233,4-21-24 18:28,150.05,Return,AliExpress Return,-5397.747982
34646,789535233,4-24-24 22:28,655.15,Payment,Mortgage Payment,-6052.897982
34647,789535233,4-26-24 10:28,559.22,Payment,Bill Payment,-6612.117982
34648,789535233,4-28-24 18:28,138.54,Withdrawal,Mobile App Withdrawal,-6750.657982
34649,789535233,4-29-24 16:28,255.47,Withdrawal,Mobile App Withdrawal,-7006.127982
34650,789535233,4-29-24 22:28,292.96,Purchase,Restaurant,-7299.087982
34651,789535233,4-30-24 16:28,749.03,Return,Store Return,-6550.057982
34652,789535233,05-01-24 21:28,8900,IncomingTransfer,Salary,2349.942018
34653,789535233,05-01-24 23:28,694.28,Return,Best Buy Return,3044.222018
34654,789535233,05-04-24 10:28,678.4,Payment,Bill Payment,2365.822018
34655,789535233,05-04-24 11:28,563.05,Deposit,Direct Deposit,2928.872018
34656,789535233,05-04-24 13:28,482.4,OnlineShopping,Best Buy,2446.472018
34657,789535233,05-05-24 10:28,504.32,Return,Target Return,2950.792018
34658,789535233,05-05-24 17:28,355.52,Return,Best Buy Return,3306.312018
34659,789535233,05-06-24 21:28,1800,Payment,Credit Card Payment,1506.312018
34660,789535233,05-07-24 20:28,450.64,Deposit,Cash Deposit,1956.952018
34661,789535233,05-09-24 12:28,216.63,Deposit,Check Deposit,2173.582018
34662,789535233,05-10-24 15:28,714.54,Withdrawal,Mobile App Withdrawal,1459.042018
34663,789535233,5-13-24 21:28,3300,Payment,Rent Payment,-1840.957982
34664,789535233,5-15-24 10:28,119.63,Payment,Loan Payment,-1960.587982
34665,789535233,5-15-24 21:28,557.73,Purchase,Entertainment,-2518.317982
34666,789535233,5-18-24 15:28,111.89,Payment,Mortgage Payment,-2630.207982
34667,789535233,5-18-24 20:28,533.02,Payment,Mortgage Payment,-3163.227982
34668,789535233,5-20-24 15:28,277.52,Purchase,Home Improvement,-3440.747982
34669,789535233,5-20-24 18:28,358.83,Payment,Mortgage Payment,-3799.577982
34670,789535233,5-21-24 21:28,675.12,Deposit,Check Deposit,-3124.457982
34671,789535233,5-22-24 9:28,722.88,Purchase,Electronics,-3847.337982
34672,789535233,5-22-24 12:28,641.76,Purchase,Furniture,-4489.097982
34673,789535233,5-22-24 14:28,541.05,Purchase,Restaurant,-5030.147982
34674,789535233,5-26-24 13:28,709.12,Return,Best Buy Return,-4321.027982
34675,789535233,5-27-24 13:28,396.16,Withdrawal,Branch Withdrawal,-4717.187982
34676,789535233,5-28-24 10:28,448.28,Return,AliExpress Return,-4268.907982
34677,789535233,5-29-24 12:28,367.29,IncomingTransfer,Freelance Payment,-3901.617982
34678,789535233,5-30-24 13:28,498.57,Deposit,Check Deposit,-3403.047982
34679,789535233,5-30-24 15:28,649.08,Deposit,Check Deposit,-2753.967982
34680,789535233,5-31-24 14:28,277.8,OutgoingTransfer,International Transfer,-3031.767982
34681,789535233,06-03-24 21:28,8900,IncomingTransfer,Salary,5868.232018
34682,789535233,06-07-24 16:28,639.16,Payment,Loan Payment,5229.072018
34683,789535233,06-08-24 21:28,2200,Payment,Credit Card Payment,3029.072018
34684,789535233,06-10-24 21:28,2300,Payment,Rent Payment,729.0720176
34685,789535233,6-13-24 12:28,652.37,IncomingTransfer,Freelance Payment,1381.442018
34686,789535233,6-21-24 9:28,259.97,Purchase,Home Improvement,1121.472018
34687,789535233,6-21-24 20:28,514.62,Purchase,Pharmacy,606.8520176
34688,789535233,6-21-24 21:28,214.89,Purchase,Electronics,391.9620176
34689,789535233,6-22-24 10:28,423.65,Purchase,Travel,-31.68798242
34690,789535233,6-23-24 21:28,616.9,Return,Etsy Return,585.2120176
34691,789535233,6-23-24 22:28,603.79,Deposit,Direct Deposit,1189.002018
34692,789535233,6-24-24 18:28,227.69,Payment,Loan Payment,961.3120176
34693,789535233,6-28-24 12:28,521.05,OnlineShopping,Best Buy,440.2620176
34694,789535233,6-28-24 20:28,678.89,OnlineShopping,AliExpress,-238.6279824
34695,789535233,6-29-24 10:28,715.17,Deposit,Direct Deposit,476.5420176
34696,789535233,6-30-24 17:28,593.12,Purchase,Electronics,-116.5779824
34697,789535233,07-04-24 21:28,8900,IncomingTransfer,Salary,8783.422018
34698,789535233,07-04-24 21:28,346.32,Deposit,Direct Deposit,9129.742018
34699,789535233,07-06-24 22:28,112.99,Purchase,Travel,9016.752018
34700,789535233,07-08-24 11:28,533.76,Withdrawal,ATM Withdrawal,8482.992018
34701,789535233,07-08-24 12:28,101.98,OnlineShopping,Etsy,8381.012018
34702,789535233,07-08-24 20:28,247.25,Withdrawal,Mobile App Withdrawal,8133.762018
34703,789535233,07-09-24 13:28,170.87,OutgoingTransfer,Peer-to-Peer Transfer,7962.892018
34704,789535233,07-09-24 21:28,1900,Payment,Credit Card Payment,6062.892018
34705,789535233,07-12-24 9:28,368.59,Withdrawal,Branch Withdrawal,5694.302018
34706,789535233,7-14-24 21:28,5400,Payment,Rent Payment,294.3020176
34707,789535233,7-15-24 9:28,309.91,Deposit,Direct Deposit,604.2120176
34708,789643383,1-21-24 13:28,419.96,IncomingTransfer,Freelance Payment,419.96
34709,789643383,1-26-24 12:28,266.48,Deposit,Cash Deposit,686.44
34710,789643383,1-27-24 10:28,168.86,OutgoingTransfer,Bank Transfer,517.58
34711,789643383,1-30-24 13:28,364.61,Purchase,Grocery,152.97
34712,789643383,02-01-24 21:28,5200,IncomingTransfer,Salary,5352.97
34713,789643383,02-08-24 23:28,223.43,OutgoingTransfer,Bank Transfer,5129.54
34714,789643383,02-09-24 22:28,76.16,Deposit,Cash Deposit,5205.7
34715,789643383,2-13-24 13:28,196.1,Withdrawal,Branch Withdrawal,5009.6
34716,789643383,2-13-24 22:28,123.56,Purchase,Grocery,4886.04
34717,789643383,2-17-24 10:28,416.46,IncomingTransfer,Freelance Payment,5302.5
34718,789643383,2-17-24 11:28,512.71,Payment,Bill Payment,4789.79
34719,789643383,2-17-24 21:28,1800,Payment,Rent Payment,2989.79
34720,789643383,2-21-24 11:28,93.94,Purchase,Electronics,2895.85
34721,789643383,2-21-24 18:28,211.21,Withdrawal,ATM Withdrawal,2684.64
34722,789643383,2-22-24 11:28,495.48,Payment,Mortgage Payment,2189.16
34723,789643383,2-22-24 16:28,120.69,Withdrawal,ATM Withdrawal,2068.47
34724,789643383,2-23-24 21:28,544.11,Withdrawal,ATM Withdrawal,1524.36
34725,789643383,03-02-24 11:28,503.49,OnlineShopping,eBay,1020.87
34726,789643383,03-03-24 21:28,5200,IncomingTransfer,Salary,6220.87
34727,789643383,03-10-24 16:28,374.88,Deposit,Direct Deposit,6595.75
34728,789643383,03-10-24 20:28,116.74,Deposit,Check Deposit,6712.49
34729,789643383,03-11-24 11:28,506.64,Purchase,Furniture,6205.85
34730,789643383,3-13-24 14:28,332.16,Payment,Loan Payment,5873.69
34731,789643383,3-15-24 18:28,402.41,IncomingTransfer,Freelance Payment,6276.1
34732,789643383,3-17-24 21:28,3000,Payment,Rent Payment,3276.1
34733,789643383,3-18-24 18:28,312.2,OutgoingTransfer,Peer-to-Peer Transfer,2963.9
34734,789643383,3-21-24 19:28,407.47,Deposit,Check Deposit,3371.37
34735,789643383,3-26-24 9:28,261.09,Deposit,Cash Deposit,3632.46
34736,789643383,04-02-24 11:28,263.91,Purchase,Grocery,3368.55
34737,789643383,04-02-24 12:28,200.34,Payment,Loan Payment,3168.21
34738,789643383,04-05-24 21:28,5200,IncomingTransfer,Salary,8368.21
34739,789643383,04-09-24 20:28,72.7,OutgoingTransfer,Peer-to-Peer Transfer,8295.51
34740,789643383,04-09-24 20:28,398.31,Purchase,Restaurant,7897.2
34741,789643383,4-13-24 21:28,2900,Payment,Rent Payment,4997.2
34742,789643383,4-15-24 14:28,441.37,OnlineShopping,Target,4555.83
34743,789643383,4-16-24 20:28,543.42,OnlineShopping,Target,4012.41
34744,789643383,4-19-24 9:28,266.99,Deposit,Direct Deposit,4279.4
34745,789643383,4-21-24 19:28,439.19,Withdrawal,Branch Withdrawal,3840.21
34746,789643383,4-30-24 9:28,543.22,OutgoingTransfer,International Transfer,3296.99
34747,789643383,05-03-24 19:28,511.91,IncomingTransfer,Freelance Payment,3808.9
34748,789643383,05-03-24 21:28,5200,IncomingTransfer,Salary,9008.9
34749,789643383,05-05-24 12:28,178.06,Deposit,Cash Deposit,9186.96
34750,789643383,05-11-24 21:28,2400,Payment,Rent Payment,6786.96
34751,789643383,5-18-24 22:28,375.8,OutgoingTransfer,Bank Transfer,6411.16
34752,789643383,5-23-24 9:28,101.96,Withdrawal,Branch Withdrawal,6309.2
34753,789643383,5-24-24 23:28,492.34,Purchase,Furniture,5816.86
34754,789643383,5-28-24 22:28,175.21,Deposit,Check Deposit,5992.07
34755,789643383,06-01-24 10:28,332,Withdrawal,ATM Withdrawal,5660.07
34756,789643383,06-02-24 21:28,5200,IncomingTransfer,Salary,10860.07
34757,789643383,06-07-24 12:28,449.55,Purchase,Clothing,10410.52
34758,789643383,06-10-24 13:28,218.81,OnlineShopping,AliExpress,10191.71
34759,789643383,06-11-24 13:28,85.48,OutgoingTransfer,Wire Transfer,10106.23
34760,789643383,6-15-24 21:28,1600,Payment,Rent Payment,8506.23
34761,789643383,6-18-24 9:28,539.6,OnlineShopping,eBay,7966.63
34762,789643383,6-20-24 21:28,307.39,Deposit,Cash Deposit,8274.02
34763,789643383,6-30-24 10:28,387.98,Deposit,Mobile Deposit,8662
34764,789643383,07-01-24 12:28,119.16,OnlineShopping,Walmart,8542.84
34765,789643383,07-01-24 21:28,5200,IncomingTransfer,Salary,13742.84
34766,789643383,07-05-24 11:28,388.47,Purchase,Entertainment,13354.37
34767,789643383,07-07-24 18:28,400.31,Return,eBay Return,13754.68
34768,789643383,07-09-24 22:28,464.77,Purchase,Clothing,13289.91
34769,789643383,07-10-24 10:28,461.26,Deposit,Direct Deposit,13751.17
34770,789643383,07-10-24 20:28,447.03,IncomingTransfer,Freelance Payment,14198.2
34771,789643383,07-10-24 23:28,356.2,Purchase,Grocery,13842
34772,789643383,7-13-24 15:28,117.8,OutgoingTransfer,International Transfer,13724.2
34773,789643383,7-13-24 21:28,2300,Payment,Rent Payment,11424.2
34774,789643383,7-15-24 9:28,520.67,OutgoingTransfer,Bank Transfer,10903.53
34775,789643383,7-15-24 11:28,475.23,Deposit,Cash Deposit,11378.76
34776,789681708,1-21-24 10:28,429.58,OnlineShopping,Best Buy,169.2820654
34777,789681708,1-21-24 12:28,337.2,Purchase,Restaurant,-167.9179346
34778,789681708,1-26-24 20:28,434,Deposit,Cash Deposit,266.0820654
34779,789681708,1-30-24 9:28,287.59,Purchase,Gas,-21.50793459
34780,789681708,02-05-24 21:28,5900,IncomingTransfer,Salary,5878.492065
34781,789681708,02-06-24 11:28,356.09,Withdrawal,Mobile App Withdrawal,5522.402065
34782,789681708,02-07-24 11:28,138.12,Purchase,Pharmacy,5384.282065
34783,789681708,02-07-24 13:28,259.26,Deposit,Cash Deposit,5643.542065
34784,789681708,02-09-24 19:28,73.87,OutgoingTransfer,Peer-to-Peer Transfer,5569.672065
34785,789681708,02-10-24 20:28,502.87,Purchase,Travel,5066.802065
34786,789681708,02-10-24 21:28,800,Payment,Credit Card Payment,4266.802065
34787,789681708,02-10-24 22:28,66.05,OutgoingTransfer,Peer-to-Peer Transfer,4200.752065
34788,789681708,02-11-24 17:28,316.43,Deposit,Cash Deposit,4517.182065
34789,789681708,02-12-24 22:28,286.74,Payment,Mortgage Payment,4230.442065
34790,789681708,2-15-24 21:28,3800,Payment,Rent Payment,430.4420654
34791,789681708,2-16-24 16:28,188.87,Withdrawal,ATM Withdrawal,241.5720654
34792,789681708,2-17-24 19:28,128.5,OutgoingTransfer,International Transfer,113.0720654
34793,789681708,2-22-24 11:28,420.14,Withdrawal,Branch Withdrawal,-307.0679346
34794,789681708,2-23-24 16:28,342.13,Purchase,Travel,-649.1979346
34795,789681708,2-26-24 13:28,399.59,Purchase,Clothing,-1048.787935
34796,789681708,2-27-24 12:28,119.39,Deposit,Mobile Deposit,-929.3979346
34797,789681708,2-29-24 11:28,469.13,OnlineShopping,Best Buy,-1398.527935
34798,789681708,03-04-24 19:28,417.82,Purchase,Travel,-1816.347935
34799,789681708,03-05-24 21:28,5900,IncomingTransfer,Salary,4083.652065
34800,789681708,03-09-24 13:28,536.07,Withdrawal,ATM Withdrawal,3547.582065
34801,789681708,03-10-24 21:28,900,Payment,Credit Card Payment,2647.582065
34802,789681708,03-12-24 21:28,300.61,OutgoingTransfer,International Transfer,2346.972065
34803,789681708,03-12-24 22:28,387.63,OnlineShopping,Walmart,1959.342065
34804,789681708,3-13-24 15:28,383.03,Purchase,Clothing,1576.312065
34805,789681708,3-13-24 20:28,236.58,Return,AliExpress Return,1812.892065
34806,789681708,3-14-24 19:28,374.88,Deposit,Cash Deposit,2187.772065
34807,789681708,3-14-24 21:28,1700,Payment,Rent Payment,487.7720654
34808,789681708,3-15-24 19:28,104.19,OutgoingTransfer,Bank Transfer,383.5820654
34809,789681708,3-16-24 10:28,211.63,Deposit,Check Deposit,595.2120654
34810,789681708,3-17-24 21:28,341.82,Deposit,Mobile Deposit,937.0320654
34811,789681708,3-19-24 15:28,449.32,IncomingTransfer,Freelance Payment,1386.352065
34812,789681708,3-19-24 20:28,221.53,Payment,Loan Payment,1164.822065
34813,789681708,3-21-24 11:28,317.05,Purchase,Clothing,847.7720654
34814,789681708,3-22-24 23:28,530.33,Deposit,Check Deposit,1378.102065
34815,789681708,3-26-24 15:28,433.58,Purchase,Electronics,944.5220654
34816,789681708,3-27-24 12:28,189.55,OnlineShopping,AliExpress,754.9720654
34817,789681708,3-30-24 15:28,539.14,OnlineShopping,eBay,215.8320654
34818,789681708,04-02-24 19:28,357.64,Withdrawal,Branch Withdrawal,-141.8079346
34819,789681708,04-05-24 10:28,371.66,Purchase,Electronics,-513.4679346
34820,789681708,04-05-24 21:28,5900,IncomingTransfer,Salary,5386.532065
34821,789681708,04-10-24 21:28,800,Payment,Credit Card Payment,4586.532065
34822,789681708,04-11-24 15:28,316.08,Purchase,Grocery,4270.452065
34823,789681708,04-11-24 19:28,179.38,IncomingTransfer,Freelance Payment,4449.832065
34824,789681708,04-11-24 21:28,3200,Payment,Rent Payment,1249.832065
34825,789681708,4-14-24 16:28,247.66,Withdrawal,Branch Withdrawal,1002.172065
34826,789681708,4-17-24 15:28,484.46,Withdrawal,Branch Withdrawal,517.7120654
34827,789681708,4-18-24 16:28,185.57,Payment,Bill Payment,332.1420654
34828,789681708,4-20-24 12:28,101.05,Purchase,Gas,231.0920654
34829,789681708,4-21-24 14:28,430.72,Withdrawal,ATM Withdrawal,-199.6279346
34830,789681708,4-26-24 16:28,515.34,Return,Best Buy Return,315.7120654
34831,789681708,4-30-24 12:28,319.6,Deposit,Cash Deposit,635.3120654
34832,789681708,4-30-24 21:28,76.93,Purchase,Clothing,558.3820654
34833,789681708,05-01-24 15:28,272.93,Withdrawal,ATM Withdrawal,285.4520654
34834,789681708,05-03-24 20:28,446.51,OutgoingTransfer,International Transfer,-161.0579346
34835,789681708,05-05-24 19:28,280.99,Payment,Loan Payment,-442.0479346
34836,789681708,05-05-24 21:28,5900,IncomingTransfer,Salary,5457.952065
34837,789681708,05-08-24 23:28,120.68,Deposit,Mobile Deposit,5578.632065
34838,789681708,05-09-24 9:28,349.4,OnlineShopping,Etsy,5229.232065
34839,789681708,05-10-24 21:28,800,Payment,Credit Card Payment,4429.232065
34840,789681708,05-11-24 14:28,322.59,OutgoingTransfer,International Transfer,4106.642065
34841,789681708,05-12-24 18:28,378.58,Purchase,Furniture,3728.062065
34842,789681708,5-13-24 16:28,309.13,Withdrawal,Mobile App Withdrawal,3418.932065
34843,789681708,5-13-24 21:28,2300,Payment,Rent Payment,1118.932065
34844,789681708,5-16-24 17:28,278.81,Return,AliExpress Return,1397.742065
34845,789681708,5-23-24 11:28,459.94,Purchase,Furniture,937.8020654
34846,789681708,5-26-24 12:28,134.09,OutgoingTransfer,International Transfer,803.7120654
34847,789681708,5-29-24 12:28,323.16,Payment,Loan Payment,480.5520654
34848,789681708,5-31-24 15:28,146.87,Withdrawal,ATM Withdrawal,333.6820654
34849,789681708,5-31-24 17:28,461.99,Purchase,Clothing,-128.3079346
34850,789681708,06-01-24 21:28,5900,IncomingTransfer,Salary,5771.692065
34851,789681708,06-05-24 10:28,281.39,Return,Amazon Return,6053.082065
34852,789681708,06-06-24 21:28,800,Payment,Credit Card Payment,5253.082065
34853,789681708,06-06-24 21:28,536.81,OutgoingTransfer,Wire Transfer,4716.272065
34854,789681708,06-08-24 17:28,494.98,Deposit,Check Deposit,5211.252065
34855,789681708,06-09-24 14:28,52.81,Purchase,Travel,5158.442065
34856,789681708,06-10-24 20:28,164.54,Return,Etsy Return,5322.982065
34857,789681708,06-11-24 19:28,383.64,IncomingTransfer,Freelance Payment,5706.622065
34858,789681708,6-13-24 23:28,391.23,OnlineShopping,AliExpress,5315.392065
34859,789681708,6-14-24 21:28,3500,Payment,Rent Payment,1815.392065
34860,789681708,6-15-24 15:28,427.58,Purchase,Electronics,1387.812065
34861,789681708,6-15-24 19:28,69.33,Purchase,Pharmacy,1318.482065
34862,789681708,6-16-24 11:28,528.01,OnlineShopping,Target,790.4720654
34863,789681708,6-16-24 20:28,232.06,Deposit,Check Deposit,1022.532065
34864,789681708,6-22-24 20:28,366.58,Withdrawal,Branch Withdrawal,655.9520654
34865,789681708,6-26-24 15:28,183.36,OnlineShopping,Target,472.5920654
34866,789681708,6-27-24 12:28,286.11,Deposit,Mobile Deposit,758.7020654
34867,789681708,6-28-24 9:28,218.63,Purchase,Restaurant,540.0720654
34868,789681708,07-02-24 21:28,5900,IncomingTransfer,Salary,6440.072065
34869,789681708,07-07-24 19:28,414.78,Payment,Mortgage Payment,6025.292065
34870,789681708,07-07-24 21:28,700,Payment,Credit Card Payment,5325.292065
34871,789681708,07-11-24 21:28,2400,Payment,Rent Payment,2925.292065
34872,789681708,7-15-24 9:28,240.74,Purchase,Gas,2684.552065
34873,789681708,7-15-24 14:28,183.42,Withdrawal,Mobile App Withdrawal,2501.132065
34874,789681708,7-15-24 15:28,197.92,IncomingTransfer,Freelance Payment,2699.052065
34875,789681708,7-17-24 21:28,106.33,Withdrawal,Mobile App Withdrawal,2592.722065
34876,789692283,1-20-24 13:28,162.27,OutgoingTransfer,International Transfer,-162.27
34877,789692283,1-22-24 18:28,82.87,Purchase,Entertainment,-245.14
34878,789692283,1-22-24 19:28,183.23,Deposit,Mobile Deposit,-61.91
34879,789692283,1-24-24 17:28,213.59,OutgoingTransfer,International Transfer,-275.5
34880,789692283,1-31-24 21:28,108.49,Deposit,Direct Deposit,-167.01
34881,789692283,02-03-24 21:28,1800,IncomingTransfer,Salary,1632.99
34882,789692283,02-04-24 18:28,233.27,IncomingTransfer,Freelance Payment,1866.26
34883,789692283,02-04-24 22:28,213.75,Purchase,Travel,1652.51
34884,789692283,02-09-24 12:28,243.15,Deposit,Cash Deposit,1895.66
34885,789692283,2-13-24 21:28,1200,Payment,Rent Payment,695.66
34886,789692283,2-14-24 11:28,226.82,OutgoingTransfer,Peer-to-Peer Transfer,468.84
34887,789692283,2-15-24 20:28,89.55,Withdrawal,Branch Withdrawal,379.29
34888,789692283,2-24-24 19:28,212.2,Payment,Mortgage Payment,167.09
34889,789692283,2-26-24 10:28,217.42,Deposit,Cash Deposit,384.51
34890,789692283,2-29-24 11:28,31,OnlineShopping,eBay,353.51
34891,789692283,2-29-24 21:28,247.11,OutgoingTransfer,Bank Transfer,106.4
34892,789692283,03-01-24 22:28,124.12,IncomingTransfer,Freelance Payment,230.52
34893,789692283,03-02-24 10:28,188.99,Return,Best Buy Return,419.51
34894,789692283,03-04-24 21:28,1800,IncomingTransfer,Salary,2219.51
34895,789692283,03-06-24 9:28,107.33,Deposit,Direct Deposit,2326.84
34896,789692283,03-08-24 13:28,56.79,Purchase,Gas,2270.05
34897,789692283,03-12-24 21:28,800,Payment,Rent Payment,1470.05
34898,789692283,3-16-24 15:28,154.86,Payment,Bill Payment,1315.19
34899,789692283,3-17-24 14:28,54.75,Withdrawal,Branch Withdrawal,1260.44
34900,789692283,3-17-24 17:28,35.48,Deposit,Check Deposit,1295.92
34901,789692283,3-20-24 12:28,119.57,Deposit,Cash Deposit,1415.49
34902,789692283,3-20-24 15:28,188.94,OnlineShopping,AliExpress,1226.55
34903,789692283,3-21-24 9:28,224.67,Purchase,Clothing,1001.88
34904,789692283,3-24-24 11:28,121.2,Purchase,Grocery,880.68
34905,789692283,3-27-24 12:28,237.38,Deposit,Mobile Deposit,1118.06
34906,789692283,3-30-24 12:28,73.29,Purchase,Furniture,1044.77
34907,789692283,04-01-24 15:28,158.49,Return,Walmart Return,1203.26
34908,789692283,04-01-24 21:28,1800,IncomingTransfer,Salary,3003.26
34909,789692283,04-07-24 19:28,95.15,Withdrawal,Branch Withdrawal,2908.11
34910,789692283,04-10-24 14:28,150.14,OnlineShopping,AliExpress,2757.97
34911,789692283,04-10-24 14:28,115.3,OnlineShopping,Amazon,2642.67
34912,789692283,4-13-24 21:28,1100,Payment,Rent Payment,1542.67
34913,789692283,4-15-24 9:28,240.44,Payment,Mortgage Payment,1302.23
34914,789692283,4-15-24 13:28,93.98,Return,Best Buy Return,1396.21
34915,789692283,4-20-24 15:28,196.45,Payment,Bill Payment,1199.76
34916,789692283,4-24-24 14:28,134.36,Purchase,Travel,1065.4
34917,789692283,4-28-24 13:28,119.48,OnlineShopping,Amazon,945.92
34918,789692283,4-29-24 18:28,121.68,OutgoingTransfer,Peer-to-Peer Transfer,824.24
34919,789692283,4-30-24 13:28,173.12,Deposit,Check Deposit,997.36
34920,789692283,4-30-24 19:28,115.64,OutgoingTransfer,Peer-to-Peer Transfer,881.72
34921,789692283,05-01-24 9:28,78.97,OnlineShopping,Walmart,802.75
34922,789692283,05-01-24 21:28,1800,IncomingTransfer,Salary,2602.75
34923,789692283,05-02-24 19:28,68.25,Withdrawal,Mobile App Withdrawal,2534.5
34924,789692283,05-04-24 19:28,47.16,Withdrawal,ATM Withdrawal,2487.34
34925,789692283,05-05-24 18:28,141.63,OutgoingTransfer,Wire Transfer,2345.71
34926,789692283,05-07-24 9:28,98.32,Return,Best Buy Return,2444.03
34927,789692283,5-13-24 23:28,195.8,Deposit,Cash Deposit,2639.83
34928,789692283,5-15-24 11:28,65.82,Payment,Loan Payment,2574.01
34929,789692283,5-15-24 12:28,135.9,Deposit,Check Deposit,2709.91
34930,789692283,5-15-24 22:28,143.46,OutgoingTransfer,International Transfer,2566.45
34931,789692283,5-18-24 21:28,500,Payment,Rent Payment,2066.45
34932,789692283,5-28-24 19:28,75.96,Return,AliExpress Return,2142.41
34933,789692283,06-01-24 21:28,1800,IncomingTransfer,Salary,3942.41
34934,789692283,06-03-24 11:28,140.9,Return,Amazon Return,4083.31
34935,789692283,06-03-24 12:28,243.36,OnlineShopping,eBay,3839.95
34936,789692283,06-07-24 20:28,15.4,Payment,Loan Payment,3824.55
34937,789692283,06-08-24 14:28,228.15,Payment,Bill Payment,3596.4
34938,789692283,06-10-24 11:28,211.54,Purchase,Travel,3384.86
34939,789692283,06-10-24 21:28,45.57,Payment,Mortgage Payment,3339.29
34940,789692283,06-12-24 21:28,800,Payment,Rent Payment,2539.29
34941,789692283,6-15-24 11:28,33.39,Purchase,Clothing,2505.9
34942,789692283,6-15-24 22:28,10.94,Return,eBay Return,2516.84
34943,789692283,6-17-24 20:28,17.66,OutgoingTransfer,International Transfer,2499.18
34944,789692283,6-21-24 23:28,152.42,Purchase,Electronics,2346.76
34945,789692283,6-22-24 21:28,185.08,Deposit,Check Deposit,2531.84
34946,789692283,6-25-24 16:28,234.58,Withdrawal,Mobile App Withdrawal,2297.26
34947,789692283,6-27-24 22:28,38.78,OnlineShopping,Etsy,2258.48
34948,789692283,07-03-24 14:28,14.07,Purchase,Electronics,2244.41
34949,789692283,07-04-24 21:28,1800,IncomingTransfer,Salary,4044.41
34950,789692283,07-05-24 17:28,37.48,Deposit,Mobile Deposit,4081.89
34951,789692283,07-07-24 10:28,135.91,Withdrawal,Branch Withdrawal,3945.98
34952,789692283,7-13-24 21:28,800,Payment,Rent Payment,3145.98
34953,789692283,7-16-24 16:28,185.68,Purchase,Electronics,2960.3
34954,793616883,1-20-24 17:28,230.55,Purchase,Restaurant,195.2286121
34955,793616883,1-23-24 13:28,215.88,IncomingTransfer,Freelance Payment,411.1086121
34956,793616883,1-23-24 21:28,62.86,Deposit,Mobile Deposit,473.9686121
34957,793616883,1-27-24 16:28,131.7,OutgoingTransfer,International Transfer,342.2686121
34958,793616883,1-27-24 20:28,148.37,Return,Store Return,490.6386121
34959,793616883,1-29-24 20:28,110.25,Withdrawal,Branch Withdrawal,380.3886121
34960,793616883,1-30-24 12:28,46.04,Return,Store Return,426.4286121
34961,793616883,1-30-24 13:28,233.66,Withdrawal,Branch Withdrawal,192.7686121
34962,793616883,02-01-24 23:28,183.39,Purchase,Entertainment,9.378612055
34963,793616883,02-02-24 17:28,160.24,OnlineShopping,AliExpress,-150.8613879
34964,793616883,02-03-24 16:28,232.27,Purchase,Home Improvement,-383.1313879
34965,793616883,02-05-24 19:28,236.06,Withdrawal,Branch Withdrawal,-619.1913879
34966,793616883,02-10-24 15:28,34.95,Purchase,Clothing,-654.1413879
34967,793616883,02-12-24 16:28,171.81,Deposit,Cash Deposit,-482.3313879
34968,793616883,2-22-24 16:28,180.02,Deposit,Check Deposit,-302.3113879
34969,793616883,2-23-24 20:28,226.39,Purchase,Restaurant,-528.7013879
34970,793616883,2-27-24 11:28,231.65,Return,Etsy Return,-297.0513879
34971,793616883,2-28-24 9:28,26.03,OnlineShopping,Etsy,-323.0813879
34972,793616883,2-28-24 16:28,59.99,OutgoingTransfer,International Transfer,-383.0713879
34973,793616883,03-03-24 22:28,171.11,OnlineShopping,eBay,-554.1813879
34974,793616883,03-06-24 12:28,31.97,Withdrawal,Mobile App Withdrawal,-586.1513879
34975,793616883,03-06-24 15:28,232.01,Purchase,Home Improvement,-818.1613879
34976,793616883,03-06-24 17:28,110.85,IncomingTransfer,Freelance Payment,-707.3113879
34977,793616883,03-06-24 20:28,34.58,Payment,Loan Payment,-741.8913879
34978,793616883,03-08-24 13:28,97.66,Withdrawal,Mobile App Withdrawal,-839.5513879
34979,793616883,03-10-24 19:28,76.81,Purchase,Entertainment,-916.3613879
34980,793616883,3-15-24 12:28,226.9,Deposit,Direct Deposit,-689.4613879
34981,793616883,3-15-24 13:28,52.11,IncomingTransfer,Freelance Payment,-637.3513879
34982,793616883,3-17-24 15:28,229.02,IncomingTransfer,Freelance Payment,-408.3313879
34983,793616883,3-18-24 15:28,203.47,Deposit,Mobile Deposit,-204.8613879
34984,793616883,3-18-24 17:28,65.24,Return,Etsy Return,-139.6213879
34985,793616883,3-19-24 20:28,86.64,Payment,Mortgage Payment,-226.2613879
34986,793616883,3-22-24 19:28,159.18,Withdrawal,ATM Withdrawal,-385.4413879
34987,793616883,3-23-24 15:28,190.21,Purchase,Electronics,-575.6513879
34988,793616883,3-28-24 10:28,207.17,Return,Store Return,-368.4813879
34989,793616883,04-01-24 22:28,66.49,Return,Amazon Return,-301.9913879
34990,793616883,04-05-24 12:28,206.44,OnlineShopping,Target,-508.4313879
34991,793616883,04-05-24 18:28,199.22,Withdrawal,ATM Withdrawal,-707.6513879
34992,793616883,04-05-24 18:28,12.2,OutgoingTransfer,Peer-to-Peer Transfer,-719.8513879
34993,793616883,04-09-24 10:28,25.95,Return,Store Return,-693.9013879
34994,793616883,04-09-24 20:28,37.45,Purchase,Furniture,-731.3513879
34995,793616883,04-10-24 15:28,235.1,OnlineShopping,Walmart,-966.4513879
34996,793616883,04-12-24 9:28,220.54,Payment,Bill Payment,-1186.991388
34997,793616883,04-12-24 11:28,15.15,Deposit,Check Deposit,-1171.841388
34998,793616883,04-12-24 13:28,58.38,IncomingTransfer,Freelance Payment,-1113.461388
34999,793616883,4-13-24 15:28,193.78,Deposit,Check Deposit,-919.6813879
35000,793616883,4-16-24 23:28,76.57,Deposit,Direct Deposit,-843.1113879
35001,793616883,4-17-24 13:28,19.63,Deposit,Direct Deposit,-823.4813879
35002,793616883,4-21-24 18:28,118.09,Deposit,Direct Deposit,-705.3913879
35003,793616883,4-27-24 14:28,109.82,Withdrawal,Branch Withdrawal,-815.2113879
35004,793616883,4-30-24 19:28,228.85,Deposit,Cash Deposit,-586.3613879
35005,793616883,05-01-24 17:28,63.13,Return,AliExpress Return,-523.2313879
35006,793616883,05-05-24 10:28,44.35,Deposit,Mobile Deposit,-478.8813879
35007,793616883,05-05-24 16:28,50.56,Purchase,Furniture,-529.4413879
35008,793616883,05-06-24 14:28,244.37,Purchase,Pharmacy,-773.8113879
35009,793616883,05-09-24 15:28,39.6,OutgoingTransfer,Wire Transfer,-813.4113879
35010,793616883,05-11-24 19:28,228.16,Purchase,Electronics,-1041.571388
35011,793616883,05-12-24 14:28,185.26,OutgoingTransfer,Peer-to-Peer Transfer,-1226.831388
35012,793616883,5-14-24 13:28,51.48,Payment,Bill Payment,-1278.311388
35013,793616883,5-18-24 16:28,144.22,Payment,Loan Payment,-1422.531388
35014,793616883,5-22-24 11:28,244.23,Return,Store Return,-1178.301388
35015,793616883,5-23-24 20:28,98.35,Withdrawal,ATM Withdrawal,-1276.651388
35016,793616883,5-24-24 18:28,198.62,Payment,Loan Payment,-1475.271388
35017,793616883,5-25-24 11:28,225.19,OnlineShopping,AliExpress,-1700.461388
35018,793616883,5-31-24 12:28,11.95,Purchase,Home Improvement,-1712.411388
35019,793616883,5-31-24 17:28,193.36,Payment,Mortgage Payment,-1905.771388
35020,793616883,06-01-24 21:28,135.28,Withdrawal,Mobile App Withdrawal,-2041.051388
35021,793616883,06-02-24 22:28,211.21,Deposit,Cash Deposit,-1829.841388
35022,793616883,06-04-24 20:28,71.99,Purchase,Home Improvement,-1901.831388
35023,793616883,06-07-24 17:28,134.49,Deposit,Check Deposit,-1767.341388
35024,793616883,06-09-24 21:28,199.1,Purchase,Home Improvement,-1966.441388
35025,793616883,6-24-24 9:28,142.6,Return,Etsy Return,-1823.841388
35026,793616883,6-29-24 17:28,106.01,Return,eBay Return,-1717.831388
35027,793616883,07-02-24 15:28,80.52,Purchase,Entertainment,-1798.351388
35028,793616883,07-06-24 13:28,153.3,Purchase,Entertainment,-1951.651388
35029,793616883,07-12-24 22:28,138.21,Purchase,Grocery,-2089.861388
35030,793616883,7-13-24 16:28,209.8,Return,Best Buy Return,-1880.061388
35031,793616883,7-13-24 17:28,36.01,Deposit,Direct Deposit,-1844.051388
35032,794124708,1-23-24 16:28,424.94,Purchase,Furniture,902.9115399
35033,794124708,1-23-24 20:28,216.09,Return,Target Return,1119.00154
35034,794124708,1-27-24 15:28,172.86,Deposit,Direct Deposit,1291.86154
35035,794124708,1-27-24 19:28,658.59,Return,AliExpress Return,1950.45154
35036,794124708,1-29-24 14:28,313.47,IncomingTransfer,Freelance Payment,2263.92154
35037,794124708,02-03-24 18:28,560.78,Return,Walmart Return,2824.70154
35038,794124708,02-04-24 21:28,7500,IncomingTransfer,Salary,10324.70154
35039,794124708,02-09-24 21:28,3200,Payment,Credit Card Payment,7124.70154
35040,794124708,02-12-24 11:28,531.15,OnlineShopping,Amazon,6593.55154
35041,794124708,2-13-24 15:28,168.5,Payment,Bill Payment,6425.05154
35042,794124708,2-15-24 18:28,110.73,IncomingTransfer,Freelance Payment,6535.78154
35043,794124708,2-16-24 11:28,476.36,Deposit,Cash Deposit,7012.14154
35044,794124708,2-18-24 15:28,185.05,Payment,Bill Payment,6827.09154
35045,794124708,2-18-24 18:28,695.21,Return,Etsy Return,7522.30154
35046,794124708,2-18-24 21:28,2500,Payment,Rent Payment,5022.30154
35047,794124708,2-23-24 21:28,550.1,OutgoingTransfer,Peer-to-Peer Transfer,4472.20154
35048,794124708,2-25-24 13:28,140.09,Payment,Mortgage Payment,4332.11154
35049,794124708,2-25-24 17:28,465.59,Deposit,Check Deposit,4797.70154
35050,794124708,2-28-24 21:28,545.81,Purchase,Clothing,4251.89154
35051,794124708,2-29-24 12:28,267.83,Purchase,Pharmacy,3984.06154
35052,794124708,03-01-24 21:28,7500,IncomingTransfer,Salary,11484.06154
35053,794124708,03-04-24 13:28,121.12,OnlineShopping,Etsy,11362.94154
35054,794124708,03-06-24 20:28,735.83,Return,Best Buy Return,12098.77154
35055,794124708,03-06-24 21:28,2600,Payment,Credit Card Payment,9498.77154
35056,794124708,03-07-24 14:28,238.06,OutgoingTransfer,International Transfer,9260.71154
35057,794124708,03-08-24 9:28,598,Return,Store Return,9858.71154
35058,794124708,03-09-24 19:28,696.45,Withdrawal,Mobile App Withdrawal,9162.26154
35059,794124708,03-10-24 11:28,101.99,OutgoingTransfer,Wire Transfer,9060.27154
35060,794124708,03-11-24 22:28,548.35,Return,Target Return,9608.62154
35061,794124708,03-12-24 12:28,532.37,Purchase,Travel,9076.25154
35062,794124708,3-14-24 21:28,2500,Payment,Rent Payment,6576.25154
35063,794124708,3-21-24 17:28,573.07,Purchase,Pharmacy,6003.18154
35064,794124708,3-22-24 17:28,482.65,Deposit,Direct Deposit,6485.83154
35065,794124708,3-29-24 22:28,212,OutgoingTransfer,Wire Transfer,6273.83154
35066,794124708,3-30-24 15:28,478.62,Payment,Loan Payment,5795.21154
35067,794124708,04-01-24 23:28,444.48,Purchase,Pharmacy,5350.73154
35068,794124708,04-04-24 14:28,640.1,Payment,Loan Payment,4710.63154
35069,794124708,04-04-24 21:28,7500,IncomingTransfer,Salary,12210.63154
35070,794124708,04-09-24 21:28,3100,Payment,Credit Card Payment,9110.63154
35071,794124708,04-11-24 21:28,2600,Payment,Rent Payment,6510.63154
35072,794124708,4-13-24 12:28,333.09,OnlineShopping,Amazon,6177.54154
35073,794124708,4-14-24 18:28,411.22,Payment,Mortgage Payment,5766.32154
35074,794124708,4-20-24 19:28,314.84,Purchase,Gas,5451.48154
35075,794124708,4-21-24 18:28,674.57,Payment,Mortgage Payment,4776.91154
35076,794124708,4-24-24 22:28,571.84,Return,Best Buy Return,5348.75154
35077,794124708,05-01-24 22:28,360.95,Deposit,Mobile Deposit,5709.70154
35078,794124708,05-02-24 9:28,333.82,OutgoingTransfer,Bank Transfer,5375.88154
35079,794124708,05-03-24 21:28,7500,IncomingTransfer,Salary,12875.88154
35080,794124708,05-05-24 13:28,656,OnlineShopping,AliExpress,12219.88154
35081,794124708,05-06-24 10:28,334.84,OutgoingTransfer,Peer-to-Peer Transfer,11885.04154
35082,794124708,05-08-24 19:28,565.14,Purchase,Travel,11319.90154
35083,794124708,05-08-24 21:28,2600,Payment,Credit Card Payment,8719.90154
35084,794124708,05-10-24 23:28,112.8,Payment,Bill Payment,8607.10154
35085,794124708,05-11-24 22:28,514.31,Withdrawal,Branch Withdrawal,8092.79154
35086,794124708,5-16-24 21:28,3100,Payment,Rent Payment,4992.79154
35087,794124708,5-21-24 15:28,664.41,OnlineShopping,AliExpress,4328.38154
35088,794124708,5-22-24 9:28,511.28,Deposit,Check Deposit,4839.66154
35089,794124708,5-24-24 9:28,734.32,OnlineShopping,Best Buy,4105.34154
35090,794124708,5-28-24 12:28,466.24,OutgoingTransfer,Bank Transfer,3639.10154
35091,794124708,5-30-24 19:28,130.6,Payment,Mortgage Payment,3508.50154
35092,794124708,06-02-24 16:28,605.93,Purchase,Electronics,2902.57154
35093,794124708,06-02-24 21:28,7500,IncomingTransfer,Salary,10402.57154
35094,794124708,06-04-24 20:28,251.97,Purchase,Pharmacy,10150.60154
35095,794124708,06-05-24 13:28,197.5,Purchase,Clothing,9953.10154
35096,794124708,06-07-24 21:28,2500,Payment,Credit Card Payment,7453.10154
35097,794124708,06-09-24 13:28,148.24,OnlineShopping,AliExpress,7304.86154
35098,794124708,06-10-24 13:28,119.87,Payment,Loan Payment,7184.99154
35099,794124708,06-10-24 17:28,466.46,Deposit,Mobile Deposit,7651.45154
35100,794124708,06-11-24 14:28,709.88,IncomingTransfer,Freelance Payment,8361.33154
35101,794124708,06-12-24 19:28,109.68,Return,Walmart Return,8471.01154
35102,794124708,6-15-24 14:28,610.42,Return,Amazon Return,9081.43154
35103,794124708,6-16-24 12:28,160.21,Deposit,Direct Deposit,9241.64154
35104,794124708,6-16-24 18:28,457.61,Payment,Loan Payment,8784.03154
35105,794124708,6-17-24 21:28,4200,Payment,Rent Payment,4584.03154
35106,794124708,6-23-24 12:28,696.11,Return,eBay Return,5280.14154
35107,794124708,07-03-24 13:28,168.91,Payment,Loan Payment,5111.23154
35108,794124708,07-04-24 21:28,7500,IncomingTransfer,Salary,12611.23154
35109,794124708,07-07-24 10:28,437.08,Payment,Bill Payment,12174.15154
35110,794124708,07-08-24 19:28,268.47,OnlineShopping,Amazon,11905.68154
35111,794124708,07-09-24 21:28,3100,Payment,Credit Card Payment,8805.68154
35112,794124708,07-11-24 15:28,285.86,OutgoingTransfer,International Transfer,8519.82154
35113,794124708,7-13-24 19:28,600.34,Purchase,Entertainment,7919.48154
35114,794124708,7-15-24 15:28,742.5,Withdrawal,Branch Withdrawal,7176.98154
35115,794124708,7-15-24 18:28,442.12,Withdrawal,Branch Withdrawal,6734.86154
35116,794124708,7-16-24 17:28,381.7,Payment,Mortgage Payment,6353.16154
35117,794124708,7-16-24 21:28,3200,Payment,Rent Payment,3153.16154
35118,794124708,7-17-24 13:28,359.49,Deposit,Cash Deposit,3512.65154
35119,794172033,1-29-24 14:28,130.42,Deposit,Mobile Deposit,130.42
35120,794172033,1-31-24 18:28,34.94,Purchase,Pharmacy,95.48
35121,794172033,02-05-24 21:28,3300,IncomingTransfer,Salary,3395.48
35122,794172033,02-07-24 11:28,153.78,Deposit,Cash Deposit,3549.26
35123,794172033,02-09-24 14:28,146.16,OnlineShopping,AliExpress,3403.1
35124,794172033,2-13-24 10:28,29.13,Purchase,Entertainment,3373.97
35125,794172033,2-17-24 21:28,1300,Payment,Rent Payment,2073.97
35126,794172033,2-19-24 18:28,81.81,Withdrawal,ATM Withdrawal,1992.16
35127,794172033,2-21-24 17:28,66.29,Deposit,Cash Deposit,2058.45
35128,794172033,2-25-24 21:28,94.71,Withdrawal,ATM Withdrawal,1963.74
35129,794172033,03-03-24 19:28,49.1,Deposit,Cash Deposit,2012.84
35130,794172033,03-03-24 21:28,3300,IncomingTransfer,Salary,5312.84
35131,794172033,03-10-24 21:28,1800,Payment,Rent Payment,3512.84
35132,794172033,03-12-24 18:28,232.97,Return,eBay Return,3745.81
35133,794172033,03-12-24 23:28,191.87,Deposit,Cash Deposit,3937.68
35134,794172033,3-13-24 16:28,13.44,Payment,Loan Payment,3924.24
35135,794172033,3-22-24 13:28,217.16,Deposit,Mobile Deposit,4141.4
35136,794172033,3-23-24 15:28,66.95,Payment,Bill Payment,4074.45
35137,794172033,3-26-24 20:28,23.23,Return,Amazon Return,4097.68
35138,794172033,3-30-24 21:28,152.73,Payment,Mortgage Payment,3944.95
35139,794172033,3-31-24 21:28,167.1,Deposit,Direct Deposit,4112.05
35140,794172033,04-02-24 11:28,186.07,Payment,Bill Payment,3925.98
35141,794172033,04-02-24 19:28,156.46,Withdrawal,Mobile App Withdrawal,3769.52
35142,794172033,04-05-24 21:28,3300,IncomingTransfer,Salary,7069.52
35143,794172033,04-06-24 12:28,217.91,Purchase,Gas,6851.61
35144,794172033,04-07-24 11:28,76.03,Purchase,Electronics,6775.58
35145,794172033,04-08-24 13:28,146.02,OnlineShopping,Amazon,6629.56
35146,794172033,04-11-24 21:28,1800,Payment,Rent Payment,4829.56
35147,794172033,4-19-24 14:28,35.51,Deposit,Check Deposit,4865.07
35148,794172033,4-23-24 16:28,38.54,Purchase,Home Improvement,4826.53
35149,794172033,4-24-24 9:28,120.92,Withdrawal,Mobile App Withdrawal,4705.61
35150,794172033,4-28-24 11:28,152.21,Purchase,Grocery,4553.4
35151,794172033,4-28-24 17:28,63.93,Deposit,Cash Deposit,4617.33
35152,794172033,4-28-24 21:28,88.23,IncomingTransfer,Freelance Payment,4705.56
35153,794172033,05-01-24 21:28,3300,IncomingTransfer,Salary,8005.56
35154,794172033,05-02-24 17:28,230.62,OutgoingTransfer,Wire Transfer,7774.94
35155,794172033,05-04-24 15:28,156.54,Return,Store Return,7931.48
35156,794172033,5-13-24 21:28,1600,Payment,Rent Payment,6331.48
35157,794172033,5-23-24 14:28,198.66,OnlineShopping,AliExpress,6132.82
35158,794172033,06-01-24 21:28,3300,IncomingTransfer,Salary,9432.82
35159,794172033,06-02-24 13:28,69.47,OutgoingTransfer,International Transfer,9363.35
35160,794172033,06-02-24 19:28,57.14,IncomingTransfer,Freelance Payment,9420.49
35161,794172033,06-04-24 16:28,103.73,Return,Amazon Return,9524.22
35162,794172033,06-10-24 10:28,41.06,Purchase,Restaurant,9483.16
35163,794172033,06-10-24 14:28,121.35,Purchase,Pharmacy,9361.81
35164,794172033,6-17-24 21:28,900,Payment,Rent Payment,8461.81
35165,794172033,6-19-24 11:28,143.59,Deposit,Mobile Deposit,8605.4
35166,794172033,6-19-24 22:28,189.43,OnlineShopping,eBay,8415.97
35167,794172033,6-20-24 12:28,249.41,Deposit,Mobile Deposit,8665.38
35168,794172033,6-28-24 23:28,157.08,Purchase,Furniture,8508.3
35169,794172033,07-01-24 21:28,3300,IncomingTransfer,Salary,11808.3
35170,794172033,07-03-24 20:28,66.07,Return,Target Return,11874.37
35171,794172033,07-04-24 21:28,79.71,IncomingTransfer,Freelance Payment,11954.08
35172,794172033,07-08-24 21:28,227.82,IncomingTransfer,Freelance Payment,12181.9
35173,794172033,7-14-24 17:28,225.78,Purchase,Clothing,11956.12
35174,794172033,7-17-24 22:28,15.31,Deposit,Check Deposit,11971.43
35175,794172033,7-18-24 21:28,1300,Payment,Rent Payment,10671.43
35176,794567133,1-21-24 12:28,74.04,Deposit,Check Deposit,575.1824864
35177,794567133,1-21-24 13:28,154.34,Return,Store Return,729.5224864
35178,794567133,1-24-24 17:28,201.2,OutgoingTransfer,International Transfer,528.3224864
35179,794567133,1-26-24 21:28,52.02,Withdrawal,Mobile App Withdrawal,476.3024864
35180,794567133,02-01-24 9:28,98.28,Purchase,Clothing,378.0224864
35181,794567133,02-01-24 21:28,1700,IncomingTransfer,Salary,2078.022486
35182,794567133,02-02-24 17:28,65.18,OutgoingTransfer,Bank Transfer,2012.842486
35183,794567133,02-03-24 17:28,80.21,Purchase,Travel,1932.632486
35184,794567133,02-04-24 12:28,215.46,Purchase,Restaurant,1717.172486
35185,794567133,02-06-24 18:28,109.16,Deposit,Cash Deposit,1826.332486
35186,794567133,02-06-24 21:28,800,Payment,Credit Card Payment,1026.332486
35187,794567133,02-12-24 14:28,108.9,Deposit,Mobile Deposit,1135.232486
35188,794567133,2-13-24 21:28,500,Payment,Rent Payment,635.2324864
35189,794567133,2-22-24 23:28,129.63,Payment,Bill Payment,505.6024864
35190,794567133,2-23-24 19:28,233.69,Deposit,Direct Deposit,739.2924864
35191,794567133,2-26-24 20:28,166.75,OutgoingTransfer,International Transfer,572.5424864
35192,794567133,2-27-24 13:28,76.2,Deposit,Cash Deposit,648.7424864
35193,794567133,2-29-24 11:28,200.78,Withdrawal,Mobile App Withdrawal,447.9624864
35194,794567133,03-02-24 21:28,1700,IncomingTransfer,Salary,2147.962486
35195,794567133,03-04-24 14:28,230.61,Purchase,Electronics,1917.352486
35196,794567133,03-07-24 20:28,23.41,OutgoingTransfer,Wire Transfer,1893.942486
35197,794567133,03-07-24 21:28,1000,Payment,Credit Card Payment,893.9424864
35198,794567133,03-11-24 21:28,900,Payment,Rent Payment,-6.057513561
35199,794567133,03-12-24 14:28,134.9,IncomingTransfer,Freelance Payment,128.8424864
35200,794567133,3-20-24 19:28,225.17,Return,Etsy Return,354.0124864
35201,794567133,3-21-24 19:28,87.09,OutgoingTransfer,Peer-to-Peer Transfer,266.9224864
35202,794567133,3-28-24 17:28,150.61,Deposit,Cash Deposit,417.5324864
35203,794567133,3-30-24 14:28,167.79,IncomingTransfer,Freelance Payment,585.3224864
35204,794567133,04-02-24 16:28,243.83,Withdrawal,Branch Withdrawal,341.4924864
35205,794567133,04-03-24 12:28,100.55,OnlineShopping,eBay,240.9424864
35206,794567133,04-03-24 15:28,150.84,Deposit,Direct Deposit,391.7824864
35207,794567133,04-03-24 21:28,1700,IncomingTransfer,Salary,2091.782486
35208,794567133,04-08-24 21:28,1000,Payment,Credit Card Payment,1091.782486
35209,794567133,04-09-24 18:28,93.76,OnlineShopping,eBay,998.0224864
35210,794567133,04-10-24 9:28,118.33,Withdrawal,Mobile App Withdrawal,879.6924864
35211,794567133,04-12-24 20:28,39.25,Purchase,Home Improvement,840.4424864
35212,794567133,4-16-24 21:28,800,Payment,Rent Payment,40.44248644
35213,794567133,4-18-24 19:28,51.18,Deposit,Cash Deposit,91.62248644
35214,794567133,4-19-24 19:28,11.55,Purchase,Gas,80.07248644
35215,794567133,4-23-24 9:28,196.48,Withdrawal,Branch Withdrawal,-116.4075136
35216,794567133,4-24-24 16:28,32.85,Payment,Loan Payment,-149.2575136
35217,794567133,05-02-24 15:28,191.23,Purchase,Entertainment,-340.4875136
35218,794567133,05-02-24 21:28,1700,IncomingTransfer,Salary,1359.512486
35219,794567133,05-03-24 16:28,239.3,Purchase,Gas,1120.212486
35220,794567133,05-04-24 18:28,196.56,Purchase,Entertainment,923.6524864
35221,794567133,05-07-24 21:28,900,Payment,Credit Card Payment,23.65248644
35222,794567133,05-08-24 18:28,187.64,Return,AliExpress Return,211.2924864
35223,794567133,05-12-24 12:28,193.25,IncomingTransfer,Freelance Payment,404.5424864
35224,794567133,05-12-24 20:28,179.74,Deposit,Check Deposit,584.2824864
35225,794567133,5-13-24 21:28,600,Payment,Rent Payment,-15.71751356
35226,794567133,5-14-24 10:28,180.35,Withdrawal,Branch Withdrawal,-196.0675136
35227,794567133,5-15-24 10:28,78.91,Payment,Loan Payment,-274.9775136
35228,794567133,5-17-24 9:28,84.45,Deposit,Cash Deposit,-190.5275136
35229,794567133,5-20-24 17:28,55.53,Withdrawal,Mobile App Withdrawal,-246.0575136
35230,794567133,5-21-24 10:28,62.35,Return,Walmart Return,-183.7075136
35231,794567133,5-24-24 9:28,158.58,Deposit,Check Deposit,-25.12751356
35232,794567133,5-24-24 12:28,179.31,OutgoingTransfer,Bank Transfer,-204.4375136
35233,794567133,5-26-24 14:28,172.74,Purchase,Furniture,-377.1775136
35234,794567133,5-28-24 14:28,71.66,OnlineShopping,Best Buy,-448.8375136
35235,794567133,5-28-24 23:28,207.51,Purchase,Entertainment,-656.3475136
35236,794567133,5-29-24 20:28,35.55,Purchase,Restaurant,-691.8975136
35237,794567133,5-30-24 11:28,20.2,Payment,Loan Payment,-712.0975136
35238,794567133,5-31-24 13:28,114.47,Return,Etsy Return,-597.6275136
35239,794567133,5-31-24 21:28,229.54,Withdrawal,ATM Withdrawal,-827.1675136
35240,794567133,06-02-24 13:28,153.17,Withdrawal,ATM Withdrawal,-980.3375136
35241,794567133,06-04-24 20:28,86.04,OutgoingTransfer,Wire Transfer,-1066.377514
35242,794567133,06-04-24 21:28,32.54,OutgoingTransfer,Peer-to-Peer Transfer,-1098.917514
35243,794567133,06-05-24 21:28,1700,IncomingTransfer,Salary,601.0824864
35244,794567133,06-10-24 12:28,96.51,Withdrawal,ATM Withdrawal,504.5724864
35245,794567133,06-10-24 21:28,900,Payment,Credit Card Payment,-395.4275136
35246,794567133,06-11-24 17:28,28.12,OutgoingTransfer,International Transfer,-423.5475136
35247,794567133,6-13-24 22:28,161.82,Deposit,Mobile Deposit,-261.7275136
35248,794567133,6-14-24 21:28,800,Payment,Rent Payment,-1061.727514
35249,794567133,6-19-24 10:28,24.16,OnlineShopping,AliExpress,-1085.887514
35250,794567133,6-19-24 15:28,152.94,Withdrawal,Branch Withdrawal,-1238.827514
35251,794567133,6-21-24 16:28,11.43,Deposit,Cash Deposit,-1227.397514
35252,794567133,6-23-24 19:28,134.67,Purchase,Electronics,-1362.067514
35253,794567133,6-24-24 17:28,225.9,Return,Walmart Return,-1136.167514
35254,794567133,6-25-24 15:28,240.7,Purchase,Grocery,-1376.867514
35255,794567133,6-28-24 11:28,128.81,IncomingTransfer,Freelance Payment,-1248.057514
35256,794567133,6-30-24 19:28,134.89,Payment,Loan Payment,-1382.947514
35257,794567133,07-02-24 16:28,49.17,Purchase,Electronics,-1432.117514
35258,794567133,07-02-24 21:28,1700,IncomingTransfer,Salary,267.8824864
35259,794567133,07-03-24 16:28,194.87,IncomingTransfer,Freelance Payment,462.7524864
35260,794567133,07-07-24 21:28,1000,Payment,Credit Card Payment,-537.2475136
35261,794567133,07-08-24 16:28,175.04,Deposit,Direct Deposit,-362.2075136
35262,794567133,7-13-24 21:28,900,Payment,Rent Payment,-1262.207514
35263,794567133,7-14-24 10:28,161.02,Deposit,Direct Deposit,-1101.187514
35264,794579658,1-25-24 9:28,588.28,Purchase,Travel,1243.484948
35265,794579658,1-26-24 20:28,622.79,Purchase,Entertainment,620.6949485
35266,794579658,1-27-24 20:28,524.97,Purchase,Travel,95.72494847
35267,794579658,1-28-24 12:28,320.55,Purchase,Gas,-224.8250515
35268,794579658,1-31-24 20:28,725.03,Return,Best Buy Return,500.2049485
35269,794579658,02-02-24 15:28,222.32,Withdrawal,ATM Withdrawal,277.8849485
35270,794579658,02-02-24 20:28,439.53,Purchase,Restaurant,-161.6450515
35271,794579658,02-04-24 21:28,9700,IncomingTransfer,Salary,9538.354948
35272,794579658,02-06-24 22:28,429.54,OutgoingTransfer,International Transfer,9108.814948
35273,794579658,02-09-24 15:28,248.92,OutgoingTransfer,Wire Transfer,8859.894948
35274,794579658,02-09-24 21:28,3200,Payment,Credit Card Payment,5659.894948
35275,794579658,02-11-24 21:28,265.63,IncomingTransfer,Freelance Payment,5925.524948
35276,794579658,2-13-24 17:28,611.61,Deposit,Mobile Deposit,6537.134948
35277,794579658,2-15-24 12:28,445.81,OutgoingTransfer,Bank Transfer,6091.324948
35278,794579658,2-16-24 21:28,3600,Payment,Rent Payment,2491.324948
35279,794579658,2-17-24 11:28,217.33,Deposit,Mobile Deposit,2708.654948
35280,794579658,2-20-24 15:28,163.98,Purchase,Furniture,2544.674948
35281,794579658,2-21-24 9:28,122.91,OutgoingTransfer,International Transfer,2421.764948
35282,794579658,2-22-24 10:28,375.69,IncomingTransfer,Freelance Payment,2797.454948
35283,794579658,2-23-24 15:28,433.7,Withdrawal,ATM Withdrawal,2363.754948
35284,794579658,2-25-24 16:28,465.51,Purchase,Electronics,1898.244948
35285,794579658,2-25-24 16:28,371.39,IncomingTransfer,Freelance Payment,2269.634948
35286,794579658,2-26-24 11:28,239.61,Purchase,Entertainment,2030.024948
35287,794579658,03-05-24 17:28,179.06,IncomingTransfer,Freelance Payment,2209.084948
35288,794579658,03-05-24 21:28,9700,IncomingTransfer,Salary,11909.08495
35289,794579658,03-09-24 19:28,146.88,Deposit,Cash Deposit,12055.96495
35290,794579658,03-10-24 18:28,191.07,OutgoingTransfer,Peer-to-Peer Transfer,11864.89495
35291,794579658,03-10-24 21:28,3200,Payment,Credit Card Payment,8664.894948
35292,794579658,3-13-24 21:28,5800,Payment,Rent Payment,2864.894948
35293,794579658,3-14-24 10:28,623.21,OutgoingTransfer,International Transfer,2241.684948
35294,794579658,3-15-24 10:28,725.18,Withdrawal,Branch Withdrawal,1516.504948
35295,794579658,3-16-24 13:28,658.4,Return,eBay Return,2174.904948
35296,794579658,3-22-24 21:28,660.96,Deposit,Cash Deposit,2835.864948
35297,794579658,3-24-24 16:28,356.44,OutgoingTransfer,International Transfer,2479.424948
35298,794579658,3-27-24 19:28,640.04,IncomingTransfer,Freelance Payment,3119.464948
35299,794579658,3-27-24 19:28,719.73,OnlineShopping,Amazon,2399.734948
35300,794579658,04-03-24 13:28,380.4,Withdrawal,Branch Withdrawal,2019.334948
35301,794579658,04-03-24 21:28,9700,IncomingTransfer,Salary,11719.33495
35302,794579658,04-08-24 21:28,3600,Payment,Credit Card Payment,8119.334948
35303,794579658,04-09-24 16:28,435.08,Return,eBay Return,8554.414948
35304,794579658,04-11-24 13:28,113.41,OutgoingTransfer,Peer-to-Peer Transfer,8441.004948
35305,794579658,4-13-24 16:28,415.59,Withdrawal,Mobile App Withdrawal,8025.414948
35306,794579658,4-13-24 21:28,2500,Payment,Rent Payment,5525.414948
35307,794579658,4-18-24 19:28,462.77,Payment,Bill Payment,5062.644948
35308,794579658,4-19-24 19:28,177.09,OnlineShopping,eBay,4885.554948
35309,794579658,4-19-24 20:28,522.1,IncomingTransfer,Freelance Payment,5407.654948
35310,794579658,4-20-24 16:28,323.79,Deposit,Cash Deposit,5731.444948
35311,794579658,4-22-24 23:28,685.83,OnlineShopping,Walmart,5045.614948
35312,794579658,4-24-24 22:28,122.42,Return,Store Return,5168.034948
35313,794579658,4-25-24 13:28,260.07,Withdrawal,Branch Withdrawal,4907.964948
35314,794579658,4-26-24 20:28,419.39,Purchase,Travel,4488.574948
35315,794579658,4-29-24 17:28,688.45,OnlineShopping,Amazon,3800.124948
35316,794579658,4-30-24 23:28,272.43,Purchase,Electronics,3527.694948
35317,794579658,05-03-24 10:28,263.62,OutgoingTransfer,Bank Transfer,3264.074948
35318,794579658,05-04-24 21:28,9700,IncomingTransfer,Salary,12964.07495
35319,794579658,05-09-24 21:28,3600,Payment,Credit Card Payment,9364.074948
35320,794579658,05-10-24 17:28,445.44,Payment,Loan Payment,8918.634948
35321,794579658,05-10-24 18:28,669.88,OutgoingTransfer,International Transfer,8248.754948
35322,794579658,5-13-24 16:28,530.09,Withdrawal,Branch Withdrawal,7718.664948
35323,794579658,5-13-24 21:28,3200,Payment,Rent Payment,4518.664948
35324,794579658,5-15-24 10:28,597.38,Payment,Bill Payment,3921.284948
35325,794579658,5-15-24 21:28,475.32,Deposit,Check Deposit,4396.604948
35326,794579658,5-18-24 15:28,689.35,Withdrawal,ATM Withdrawal,3707.254948
35327,794579658,5-18-24 19:28,547.09,Deposit,Direct Deposit,4254.344948
35328,794579658,5-21-24 22:28,416.63,Deposit,Direct Deposit,4670.974948
35329,794579658,5-22-24 20:28,422.35,Withdrawal,Mobile App Withdrawal,4248.624948
35330,794579658,5-24-24 20:28,537.21,Return,AliExpress Return,4785.834948
35331,794579658,06-02-24 17:28,728,Deposit,Mobile Deposit,5513.834948
35332,794579658,06-02-24 21:28,9700,IncomingTransfer,Salary,15213.83495
35333,794579658,06-07-24 11:28,164.75,Deposit,Mobile Deposit,15378.58495
35334,794579658,06-07-24 18:28,636.57,OnlineShopping,Best Buy,14742.01495
35335,794579658,06-07-24 21:28,2900,Payment,Credit Card Payment,11842.01495
35336,794579658,06-08-24 15:28,432.4,Purchase,Restaurant,11409.61495
35337,794579658,06-09-24 15:28,611.35,OnlineShopping,Etsy,10798.26495
35338,794579658,06-09-24 17:28,161.04,Return,Etsy Return,10959.30495
35339,794579658,6-17-24 21:28,5500,Payment,Rent Payment,5459.304948
35340,794579658,6-19-24 18:28,103.47,IncomingTransfer,Freelance Payment,5562.774948
35341,794579658,6-24-24 14:28,179.1,Purchase,Grocery,5383.674948
35342,794579658,6-25-24 17:28,695.31,Deposit,Direct Deposit,6078.984948
35343,794579658,6-26-24 23:28,495.39,OutgoingTransfer,Wire Transfer,5583.594948
35344,794579658,6-27-24 20:28,630.6,Purchase,Clothing,4952.994948
35345,794579658,07-01-24 21:28,9700,IncomingTransfer,Salary,14652.99495
35346,794579658,07-02-24 22:28,543.85,Purchase,Clothing,14109.14495
35347,794579658,07-05-24 16:28,439.55,Withdrawal,Branch Withdrawal,13669.59495
35348,794579658,07-06-24 21:28,2700,Payment,Credit Card Payment,10969.59495
35349,794579658,07-08-24 20:28,422.7,OutgoingTransfer,Peer-to-Peer Transfer,10546.89495
35350,794579658,07-09-24 10:28,185.46,OnlineShopping,Walmart,10361.43495
35351,794579658,07-12-24 21:28,6000,Payment,Rent Payment,4361.434948
35352,794579658,7-13-24 12:28,542.06,Deposit,Direct Deposit,4903.494948
35353,794579658,7-13-24 16:28,459.33,Purchase,Clothing,4444.164948
35354,794579658,7-15-24 13:28,118.59,Withdrawal,Branch Withdrawal,4325.574948
35355,794649858,1-20-24 18:28,112.2,Purchase,Entertainment,1085.731805
35356,794649858,1-26-24 17:28,225.1,Withdrawal,ATM Withdrawal,860.6318053
35357,794649858,1-26-24 20:28,48.86,Purchase,Electronics,811.7718053
35358,794649858,1-27-24 19:28,191.71,Deposit,Mobile Deposit,1003.481805
35359,794649858,1-30-24 23:28,66.16,Deposit,Direct Deposit,1069.641805
35360,794649858,2-18-24 15:28,162.52,Withdrawal,ATM Withdrawal,907.1218053
35361,794649858,2-19-24 20:28,175.88,Deposit,Mobile Deposit,1083.001805
35362,794649858,2-20-24 12:28,49.94,Withdrawal,ATM Withdrawal,1033.061805
35363,794649858,2-25-24 15:28,29.53,Purchase,Furniture,1003.531805
35364,794649858,03-04-24 15:28,134.5,Payment,Bill Payment,869.0318053
35365,794649858,03-04-24 21:28,141.59,Deposit,Mobile Deposit,1010.621805
35366,794649858,3-18-24 21:28,111.98,Deposit,Cash Deposit,1122.601805
35367,794649858,3-23-24 11:28,122.16,OutgoingTransfer,Bank Transfer,1000.441805
35368,794649858,3-25-24 11:28,162.18,OnlineShopping,AliExpress,838.2618053
35369,794649858,3-29-24 10:28,188.86,Purchase,Entertainment,649.4018053
35370,794649858,04-02-24 12:28,135.63,Purchase,Electronics,513.7718053
35371,794649858,04-03-24 11:28,35.71,OnlineShopping,Best Buy,478.0618053
35372,794649858,04-05-24 10:28,119,Deposit,Direct Deposit,597.0618053
35373,794649858,4-17-24 19:28,145.33,Payment,Loan Payment,451.7318053
35374,794649858,4-18-24 22:28,120.68,OnlineShopping,Etsy,331.0518053
35375,794649858,4-20-24 22:28,188.33,Purchase,Furniture,142.7218053
35376,794649858,4-24-24 14:28,115.33,Payment,Loan Payment,27.39180533
35377,794649858,05-06-24 11:28,92.92,Deposit,Check Deposit,120.3118053
35378,794649858,05-08-24 9:28,88.5,OnlineShopping,Best Buy,31.81180533
35379,794649858,05-08-24 18:28,115.73,Purchase,Electronics,-83.91819467
35380,794649858,05-09-24 15:28,85.78,OutgoingTransfer,Peer-to-Peer Transfer,-169.6981947
35381,794649858,5-15-24 20:28,247.46,IncomingTransfer,Freelance Payment,77.76180533
35382,794649858,5-21-24 18:28,109.84,Withdrawal,ATM Withdrawal,-32.07819467
35383,794649858,5-23-24 20:28,80.32,Purchase,Pharmacy,-112.3981947
35384,794649858,5-30-24 19:28,43.48,OutgoingTransfer,Peer-to-Peer Transfer,-155.8781947
35385,794649858,06-02-24 21:28,131.24,OnlineShopping,Target,-287.1181947
35386,794649858,6-20-24 16:28,53.12,OutgoingTransfer,Wire Transfer,-340.2381947
35387,794649858,6-20-24 17:28,123.25,Payment,Mortgage Payment,-463.4881947
35388,794649858,07-05-24 19:28,165.54,OnlineShopping,Amazon,-629.0281947
35389,794649858,07-08-24 12:28,116.49,Withdrawal,ATM Withdrawal,-745.5181947
35390,794649858,7-13-24 18:28,241.16,OutgoingTransfer,Bank Transfer,-986.6781947
35391,794649858,7-17-24 19:28,37.28,Deposit,Check Deposit,-949.3981947
35392,794843883,1-21-24 22:28,402.21,Deposit,Mobile Deposit,1388.401643
35393,794843883,02-02-24 21:28,7350,IncomingTransfer,Salary,8738.401643
35394,794843883,02-02-24 21:28,577.27,Payment,Loan Payment,8161.131643
35395,794843883,02-07-24 21:28,1400,Payment,Credit Card Payment,6761.131643
35396,794843883,02-09-24 17:28,442.46,OnlineShopping,Walmart,6318.671643
35397,794843883,2-15-24 16:28,445.07,Purchase,Grocery,5873.601643
35398,794843883,2-15-24 21:28,3700,Payment,Rent Payment,2173.601643
35399,794843883,2-17-24 13:28,642.32,Purchase,Travel,1531.281643
35400,794843883,2-27-24 18:28,700.92,Withdrawal,Mobile App Withdrawal,830.3616428
35401,794843883,2-29-24 11:28,327.82,Purchase,Clothing,502.5416428
35402,794843883,2-29-24 18:28,498.02,Deposit,Check Deposit,1000.561643
35403,794843883,03-01-24 21:28,7350,IncomingTransfer,Salary,8350.561643
35404,794843883,03-06-24 21:28,1700,Payment,Credit Card Payment,6650.561643
35405,794843883,03-07-24 16:28,314.97,Withdrawal,Mobile App Withdrawal,6335.591643
35406,794843883,03-11-24 17:28,178.8,OutgoingTransfer,Peer-to-Peer Transfer,6156.791643
35407,794843883,3-16-24 18:28,654.13,Deposit,Cash Deposit,6810.921643
35408,794843883,3-17-24 17:28,535.02,OutgoingTransfer,Wire Transfer,6275.901643
35409,794843883,3-17-24 21:28,3100,Payment,Rent Payment,3175.901643
35410,794843883,3-30-24 16:28,404.86,Purchase,Gas,2771.041643
35411,794843883,04-05-24 21:28,7350,IncomingTransfer,Salary,10121.04164
35412,794843883,04-08-24 16:28,510.35,Purchase,Grocery,9610.691643
35413,794843883,04-10-24 21:28,1500,Payment,Credit Card Payment,8110.691643
35414,794843883,04-11-24 14:28,697.54,Return,eBay Return,8808.231643
35415,794843883,4-14-24 22:28,523.31,Deposit,Mobile Deposit,9331.541643
35416,794843883,4-15-24 21:28,3200,Payment,Rent Payment,6131.541643
35417,794843883,4-21-24 16:28,320.16,Payment,Mortgage Payment,5811.381643
35418,794843883,4-26-24 17:28,512.02,OutgoingTransfer,Wire Transfer,5299.361643
35419,794843883,4-27-24 11:28,210.4,Return,Walmart Return,5509.761643
35420,794843883,05-04-24 21:28,7350,IncomingTransfer,Salary,12859.76164
35421,794843883,05-08-24 13:28,306.24,OnlineShopping,eBay,12553.52164
35422,794843883,05-09-24 21:28,1700,Payment,Credit Card Payment,10853.52164
35423,794843883,05-10-24 12:28,637.18,Withdrawal,ATM Withdrawal,10216.34164
35424,794843883,5-14-24 21:28,2100,Payment,Rent Payment,8116.341643
35425,794843883,5-15-24 15:28,392.17,Purchase,Clothing,7724.171643
35426,794843883,5-18-24 15:28,736,Withdrawal,ATM Withdrawal,6988.171643
35427,794843883,5-25-24 15:28,640.14,Withdrawal,Mobile App Withdrawal,6348.031643
35428,794843883,5-27-24 21:28,166.68,OnlineShopping,Best Buy,6181.351643
35429,794843883,06-04-24 20:28,267.78,OutgoingTransfer,Wire Transfer,5913.571643
35430,794843883,06-04-24 21:28,7350,IncomingTransfer,Salary,13263.57164
35431,794843883,06-09-24 21:28,1300,Payment,Credit Card Payment,11963.57164
35432,794843883,6-18-24 21:28,2600,Payment,Rent Payment,9363.571643
35433,794843883,6-21-24 16:28,622.77,Withdrawal,Branch Withdrawal,8740.801643
35434,794843883,6-22-24 17:28,513.74,Return,Target Return,9254.541643
35435,794843883,07-01-24 13:28,596.17,OnlineShopping,Walmart,8658.371643
35436,794843883,07-02-24 21:28,7350,IncomingTransfer,Salary,16008.37164
35437,794843883,07-06-24 20:28,393.26,Withdrawal,Mobile App Withdrawal,15615.11164
35438,794843883,07-07-24 21:28,1300,Payment,Credit Card Payment,14315.11164
35439,794843883,07-10-24 11:28,270.15,Payment,Mortgage Payment,14044.96164
35440,794843883,07-11-24 19:28,626.03,Deposit,Cash Deposit,14670.99164
35441,794843883,07-11-24 21:28,4500,Payment,Rent Payment,10170.99164
35442,794843883,7-16-24 16:28,516.61,Deposit,Cash Deposit,10687.60164
35443,794965233,1-21-24 11:28,30.35,Purchase,Gas,513.3893969
35444,794965233,1-26-24 13:28,194.06,Purchase,Pharmacy,319.3293969
35445,794965233,1-28-24 11:28,12.82,Payment,Loan Payment,306.5093969
35446,794965233,1-28-24 16:28,211.32,OutgoingTransfer,Bank Transfer,95.18939688
35447,794965233,02-02-24 21:28,2200,IncomingTransfer,Salary,2295.189397
35448,794965233,02-07-24 20:28,114.81,Deposit,Cash Deposit,2409.999397
35449,794965233,02-07-24 21:28,1000,Payment,Credit Card Payment,1409.999397
35450,794965233,02-09-24 10:28,187.16,Withdrawal,Branch Withdrawal,1222.839397
35451,794965233,02-10-24 17:28,128.25,Purchase,Pharmacy,1094.589397
35452,794965233,02-12-24 21:28,600,Payment,Rent Payment,494.5893969
35453,794965233,2-13-24 11:28,60.29,Payment,Bill Payment,434.2993969
35454,794965233,2-15-24 18:28,36.97,Deposit,Check Deposit,471.2693969
35455,794965233,2-23-24 9:28,18.41,Purchase,Electronics,452.8593969
35456,794965233,2-23-24 9:28,207.25,Return,Best Buy Return,660.1093969
35457,794965233,2-27-24 18:28,60.68,Deposit,Check Deposit,720.7893969
35458,794965233,03-01-24 21:28,2200,IncomingTransfer,Salary,2920.789397
35459,794965233,03-06-24 21:28,800,Payment,Credit Card Payment,2120.789397
35460,794965233,03-10-24 12:28,87.17,Return,Store Return,2207.959397
35461,794965233,03-10-24 21:28,800,Payment,Rent Payment,1407.959397
35462,794965233,3-14-24 12:28,163.89,IncomingTransfer,Freelance Payment,1571.849397
35463,794965233,3-16-24 17:28,193.75,Return,Best Buy Return,1765.599397
35464,794965233,3-26-24 23:28,245.06,Purchase,Grocery,1520.539397
35465,794965233,3-27-24 13:28,215.4,Purchase,Gas,1305.139397
35466,794965233,3-27-24 21:28,226.44,Return,AliExpress Return,1531.579397
35467,794965233,3-29-24 10:28,207.85,Deposit,Direct Deposit,1739.429397
35468,794965233,3-30-24 16:28,112.79,Return,AliExpress Return,1852.219397
35469,794965233,04-02-24 21:28,2200,IncomingTransfer,Salary,4052.219397
35470,794965233,04-06-24 17:28,52.39,IncomingTransfer,Freelance Payment,4104.609397
35471,794965233,04-06-24 21:28,136.17,Purchase,Home Improvement,3968.439397
35472,794965233,04-07-24 21:28,1000,Payment,Credit Card Payment,2968.439397
35473,794965233,04-09-24 16:28,19.05,Payment,Loan Payment,2949.389397
35474,794965233,04-10-24 21:28,700,Payment,Rent Payment,2249.389397
35475,794965233,4-14-24 10:28,181.4,OnlineShopping,AliExpress,2067.989397
35476,794965233,4-19-24 10:28,36.57,Return,Walmart Return,2104.559397
35477,794965233,4-24-24 9:28,110.84,OutgoingTransfer,International Transfer,1993.719397
35478,794965233,4-24-24 12:28,80.21,Deposit,Mobile Deposit,2073.929397
35479,794965233,4-27-24 14:28,41.45,IncomingTransfer,Freelance Payment,2115.379397
35480,794965233,4-30-24 13:28,59.24,Deposit,Direct Deposit,2174.619397
35481,794965233,4-30-24 21:28,172.25,Payment,Loan Payment,2002.369397
35482,794965233,05-03-24 21:28,2200,IncomingTransfer,Salary,4202.369397
35483,794965233,05-08-24 21:28,1100,Payment,Credit Card Payment,3102.369397
35484,794965233,5-13-24 21:28,900,Payment,Rent Payment,2202.369397
35485,794965233,5-21-24 17:28,172.31,Deposit,Check Deposit,2374.679397
35486,794965233,5-28-24 15:28,244.8,Payment,Mortgage Payment,2129.879397
35487,794965233,5-29-24 10:28,216.85,Withdrawal,Branch Withdrawal,1913.029397
35488,794965233,06-03-24 21:28,2200,IncomingTransfer,Salary,4113.029397
35489,794965233,06-03-24 22:28,158.47,Deposit,Check Deposit,4271.499397
35490,794965233,06-05-24 11:28,164.32,OutgoingTransfer,Bank Transfer,4107.179397
35491,794965233,06-08-24 21:28,900,Payment,Credit Card Payment,3207.179397
35492,794965233,06-11-24 22:28,130.34,Payment,Mortgage Payment,3076.839397
35493,794965233,6-14-24 21:28,1300,Payment,Rent Payment,1776.839397
35494,794965233,6-17-24 21:28,22.79,OutgoingTransfer,International Transfer,1754.049397
35495,794965233,6-18-24 17:28,10.83,OutgoingTransfer,Wire Transfer,1743.219397
35496,794965233,6-19-24 18:28,152.73,OutgoingTransfer,Peer-to-Peer Transfer,1590.489397
35497,794965233,6-20-24 17:28,24.95,Deposit,Check Deposit,1615.439397
35498,794965233,6-22-24 19:28,120.32,Payment,Loan Payment,1495.119397
35499,794965233,07-04-24 15:28,191.73,Withdrawal,Branch Withdrawal,1303.389397
35500,794965233,07-04-24 21:28,2200,IncomingTransfer,Salary,3503.389397
35501,794965233,07-09-24 21:28,900,Payment,Credit Card Payment,2603.389397
35502,794965233,07-11-24 10:28,173.39,OnlineShopping,Best Buy,2429.999397
35503,794965233,7-15-24 15:28,59.74,Withdrawal,ATM Withdrawal,2370.259397
35504,794965233,7-17-24 21:28,700,Payment,Rent Payment,1670.259397
35505,795684783,1-20-24 18:28,241.4,Return,eBay Return,1207.374596
35506,795684783,1-22-24 12:28,483.62,Return,Best Buy Return,1690.994596
35507,795684783,1-22-24 21:28,283.67,Purchase,Restaurant,1407.324596
35508,795684783,02-05-24 11:28,473.94,Purchase,Home Improvement,933.3845962
35509,795684783,02-05-24 21:28,5850,IncomingTransfer,Salary,6783.384596
35510,795684783,02-06-24 22:28,248.24,OutgoingTransfer,Bank Transfer,6535.144596
35511,795684783,02-10-24 21:28,2100,Payment,Credit Card Payment,4435.144596
35512,795684783,02-10-24 21:28,1900,Payment,Installment Payment,2535.144596
35513,795684783,02-12-24 13:28,494.61,OnlineShopping,eBay,2040.534596
35514,795684783,2-13-24 15:28,221.53,Withdrawal,ATM Withdrawal,1819.004596
35515,795684783,2-15-24 10:28,105.33,Purchase,Home Improvement,1713.674596
35516,795684783,2-18-24 17:28,53,Purchase,Entertainment,1660.674596
35517,795684783,2-20-24 15:28,353.11,OnlineShopping,Best Buy,1307.564596
35518,795684783,2-21-24 12:28,219.26,Purchase,Pharmacy,1088.304596
35519,795684783,2-21-24 18:28,468.76,Withdrawal,Mobile App Withdrawal,619.5445962
35520,795684783,2-22-24 17:28,531.86,Return,Amazon Return,1151.404596
35521,795684783,2-26-24 14:28,304.63,Deposit,Mobile Deposit,1456.034596
35522,795684783,03-01-24 10:28,163.45,Withdrawal,Mobile App Withdrawal,1292.584596
35523,795684783,03-03-24 18:28,356.62,Purchase,Clothing,935.9645962
35524,795684783,03-05-24 21:28,5850,IncomingTransfer,Salary,6785.964596
35525,795684783,03-10-24 21:28,2100,Payment,Credit Card Payment,4685.964596
35526,795684783,3-13-24 14:28,122.65,IncomingTransfer,Freelance Payment,4808.614596
35527,795684783,3-17-24 12:28,133.68,Deposit,Cash Deposit,4942.294596
35528,795684783,3-17-24 21:28,2600,Payment,Insurance Payment,2342.294596
35529,795684783,3-18-24 14:28,194.11,OnlineShopping,Walmart,2148.184596
35530,795684783,3-24-24 12:28,371.06,Withdrawal,Mobile App Withdrawal,1777.124596
35531,795684783,3-29-24 9:28,130.14,Purchase,Restaurant,1646.984596
35532,795684783,3-30-24 13:28,533.87,Withdrawal,Mobile App Withdrawal,1113.114596
35533,795684783,04-02-24 16:28,291.26,Deposit,Check Deposit,1404.374596
35534,795684783,04-04-24 12:28,296.48,Deposit,Cash Deposit,1700.854596
35535,795684783,04-05-24 9:28,484.26,Purchase,Furniture,1216.594596
35536,795684783,04-05-24 16:28,142.85,Purchase,Home Improvement,1073.744596
35537,795684783,04-05-24 21:28,5850,IncomingTransfer,Salary,6923.744596
35538,795684783,04-07-24 16:28,202.87,Deposit,Direct Deposit,7126.614596
35539,795684783,04-10-24 21:28,2300,Payment,Credit Card Payment,4826.614596
35540,795684783,04-11-24 12:28,421.32,OutgoingTransfer,International Transfer,4405.294596
35541,795684783,04-12-24 23:28,130.15,OnlineShopping,AliExpress,4275.144596
35542,795684783,4-13-24 21:28,2600,Payment,Installment Payment,1675.144596
35543,795684783,4-17-24 10:28,410.52,Deposit,Mobile Deposit,2085.664596
35544,795684783,4-17-24 20:28,140.21,Purchase,Travel,1945.454596
35545,795684783,4-20-24 10:28,324.82,Withdrawal,Mobile App Withdrawal,1620.634596
35546,795684783,4-20-24 16:28,118.4,OutgoingTransfer,Peer-to-Peer Transfer,1502.234596
35547,795684783,4-23-24 23:28,465.94,Purchase,Pharmacy,1036.294596
35548,795684783,4-25-24 23:28,441.07,Deposit,Check Deposit,1477.364596
35549,795684783,4-26-24 11:28,190.29,Withdrawal,Branch Withdrawal,1287.074596
35550,795684783,4-28-24 18:28,202.91,Deposit,Check Deposit,1489.984596
35551,795684783,05-04-24 20:28,381.68,OnlineShopping,eBay,1108.304596
35552,795684783,05-04-24 21:28,5850,IncomingTransfer,Salary,6958.304596
35553,795684783,05-09-24 15:28,497.41,OnlineShopping,Best Buy,6460.894596
35554,795684783,05-09-24 21:28,1900,Payment,Credit Card Payment,4560.894596
35555,795684783,5-14-24 10:28,488.32,OnlineShopping,eBay,4072.574596
35556,795684783,5-14-24 10:28,152.38,Purchase,Pharmacy,3920.194596
35557,795684783,5-14-24 21:28,1800,Payment,Subscription Payment,2120.194596
35558,795684783,5-15-24 15:28,472.36,IncomingTransfer,Freelance Payment,2592.554596
35559,795684783,5-15-24 22:28,435.72,Withdrawal,ATM Withdrawal,2156.834596
35560,795684783,5-15-24 22:28,267.16,OutgoingTransfer,International Transfer,1889.674596
35561,795684783,5-26-24 15:28,327.79,Purchase,Home Improvement,1561.884596
35562,795684783,5-27-24 9:28,50.32,Withdrawal,Branch Withdrawal,1511.564596
35563,795684783,5-31-24 19:28,317.1,Withdrawal,ATM Withdrawal,1194.464596
35564,795684783,06-04-24 17:28,304.11,IncomingTransfer,Freelance Payment,1498.574596
35565,795684783,06-04-24 21:28,5850,IncomingTransfer,Salary,7348.574596
35566,795684783,06-09-24 21:28,2300,Payment,Credit Card Payment,5048.574596
35567,795684783,06-11-24 10:28,402.75,Withdrawal,Branch Withdrawal,4645.824596
35568,795684783,06-12-24 16:28,457.46,Deposit,Cash Deposit,5103.284596
35569,795684783,6-13-24 21:28,1900,Payment,Insurance Payment,3203.284596
35570,795684783,6-16-24 22:28,346.82,Withdrawal,ATM Withdrawal,2856.464596
35571,795684783,07-01-24 22:28,409.93,Payment,Mortgage Payment,2446.534596
35572,795684783,07-02-24 12:28,120.69,Return,Amazon Return,2567.224596
35573,795684783,07-02-24 16:28,90.98,Payment,Loan Payment,2476.244596
35574,795684783,07-05-24 21:28,5850,IncomingTransfer,Salary,8326.244596
35575,795684783,07-06-24 13:28,329.27,IncomingTransfer,Freelance Payment,8655.514596
35576,795684783,07-06-24 20:28,119,Purchase,Entertainment,8536.514596
35577,795684783,07-07-24 21:28,187.97,OnlineShopping,Etsy,8348.544596
35578,795684783,07-10-24 21:28,2200,Payment,Credit Card Payment,6148.544596
35579,795684783,07-10-24 23:28,324.08,OnlineShopping,Walmart,5824.464596
35580,795684783,07-12-24 11:28,291.98,Return,Etsy Return,6116.444596
35581,795684783,7-14-24 21:28,1900,Payment,Installment Payment,4216.444596
35582,795844983,1-21-24 22:28,356.48,Purchase,Travel,-356.48
35583,795844983,1-25-24 10:28,109.59,Withdrawal,Mobile App Withdrawal,-466.07
35584,795844983,1-27-24 16:28,98,Withdrawal,ATM Withdrawal,-564.07
35585,795844983,02-02-24 21:28,4600,IncomingTransfer,Salary,4035.93
35586,795844983,02-04-24 15:28,398.7,Withdrawal,ATM Withdrawal,3637.23
35587,795844983,2-14-24 21:28,26.76,Purchase,Furniture,3610.47
35588,795844983,2-15-24 21:28,1300,Payment,Rent Payment,2310.47
35589,795844983,2-16-24 21:28,147.66,Purchase,Clothing,2162.81
35590,795844983,2-23-24 15:28,197.79,Deposit,Direct Deposit,2360.6
35591,795844983,2-25-24 18:28,239.42,Withdrawal,Mobile App Withdrawal,2121.18
35592,795844983,2-29-24 9:28,116.35,Deposit,Cash Deposit,2237.53
35593,795844983,2-29-24 10:28,320.94,Purchase,Restaurant,1916.59
35594,795844983,2-29-24 15:28,40.66,Return,Amazon Return,1957.25
35595,795844983,03-03-24 21:28,4600,IncomingTransfer,Salary,6557.25
35596,795844983,03-09-24 10:28,212.46,Withdrawal,Mobile App Withdrawal,6344.79
35597,795844983,03-09-24 15:28,349.45,Withdrawal,Mobile App Withdrawal,5995.34
35598,795844983,03-10-24 18:28,85.62,Payment,Loan Payment,5909.72
35599,795844983,03-12-24 15:28,122.16,Payment,Bill Payment,5787.56
35600,795844983,3-13-24 22:28,41.45,Deposit,Cash Deposit,5829.01
35601,795844983,3-16-24 13:28,239.87,Payment,Loan Payment,5589.14
35602,795844983,3-18-24 21:28,1400,Payment,Rent Payment,4189.14
35603,795844983,3-21-24 10:28,38.88,Purchase,Furniture,4150.26
35604,795844983,3-23-24 20:28,131.97,Withdrawal,Branch Withdrawal,4018.29
35605,795844983,3-27-24 20:28,247.57,OutgoingTransfer,Peer-to-Peer Transfer,3770.72
35606,795844983,3-27-24 21:28,67.99,Payment,Bill Payment,3702.73
35607,795844983,3-28-24 13:28,256.7,OnlineShopping,AliExpress,3446.03
35608,795844983,3-28-24 16:28,53.26,Purchase,Home Improvement,3392.77
35609,795844983,3-31-24 10:28,70.6,Deposit,Check Deposit,3463.37
35610,795844983,04-04-24 21:28,4600,IncomingTransfer,Salary,8063.37
35611,795844983,04-06-24 15:28,248.75,OutgoingTransfer,International Transfer,7814.62
35612,795844983,04-07-24 16:28,300.95,Purchase,Pharmacy,7513.67
35613,795844983,04-12-24 21:28,2700,Payment,Rent Payment,4813.67
35614,795844983,4-19-24 22:28,246.82,Withdrawal,ATM Withdrawal,4566.85
35615,795844983,4-24-24 13:28,358.54,Deposit,Cash Deposit,4925.39
35616,795844983,4-27-24 18:28,184.75,Deposit,Cash Deposit,5110.14
35617,795844983,4-28-24 13:28,64.27,Purchase,Restaurant,5045.87
35618,795844983,4-29-24 10:28,397.47,Return,Target Return,5443.34
35619,795844983,05-03-24 21:28,261.7,Deposit,Direct Deposit,5705.04
35620,795844983,05-05-24 21:28,4600,IncomingTransfer,Salary,10305.04
35621,795844983,05-06-24 14:28,80.34,Return,Best Buy Return,10385.38
35622,795844983,05-09-24 11:28,66.4,OnlineShopping,AliExpress,10318.98
35623,795844983,05-11-24 16:28,355.77,OutgoingTransfer,Wire Transfer,9963.21
35624,795844983,05-11-24 19:28,329.44,OutgoingTransfer,International Transfer,9633.77
35625,795844983,05-12-24 13:28,307.94,Purchase,Clothing,9325.83
35626,795844983,5-14-24 10:28,150.07,Withdrawal,Mobile App Withdrawal,9175.76
35627,795844983,5-15-24 9:28,112.66,Return,Store Return,9288.42
35628,795844983,5-17-24 21:28,2900,Payment,Rent Payment,6388.42
35629,795844983,5-19-24 12:28,137.57,Return,Etsy Return,6525.99
35630,795844983,5-19-24 13:28,200.55,OutgoingTransfer,International Transfer,6325.44
35631,795844983,5-21-24 18:28,20.43,OnlineShopping,Walmart,6305.01
35632,795844983,5-23-24 15:28,211.44,Deposit,Cash Deposit,6516.45
35633,795844983,5-23-24 22:28,95.52,Withdrawal,ATM Withdrawal,6420.93
35634,795844983,5-25-24 13:28,114.28,Purchase,Furniture,6306.65
35635,795844983,5-26-24 11:28,176.42,OutgoingTransfer,International Transfer,6130.23
35636,795844983,5-29-24 18:28,203.98,OutgoingTransfer,International Transfer,5926.25
35637,795844983,06-03-24 10:28,375.33,Withdrawal,Mobile App Withdrawal,5550.92
35638,795844983,06-03-24 21:28,367.13,Withdrawal,Mobile App Withdrawal,5183.79
35639,795844983,06-04-24 21:28,4600,IncomingTransfer,Salary,9783.79
35640,795844983,06-04-24 22:28,218.52,OutgoingTransfer,International Transfer,9565.27
35641,795844983,06-06-24 9:28,199.64,Payment,Loan Payment,9365.63
35642,795844983,06-08-24 15:28,381.45,Withdrawal,Mobile App Withdrawal,8984.18
35643,795844983,06-09-24 16:28,75.33,OnlineShopping,Walmart,8908.85
35644,795844983,06-09-24 21:28,198.27,Deposit,Check Deposit,9107.12
35645,795844983,06-10-24 21:28,173.99,Return,Amazon Return,9281.11
35646,795844983,6-14-24 20:28,232.45,OutgoingTransfer,Bank Transfer,9048.66
35647,795844983,6-14-24 21:28,2800,Payment,Rent Payment,6248.66
35648,795844983,6-20-24 14:28,327.68,Payment,Bill Payment,5920.98
35649,795844983,6-21-24 10:28,158.31,OnlineShopping,Target,5762.67
35650,795844983,6-23-24 19:28,303.51,OnlineShopping,AliExpress,5459.16
35651,795844983,6-24-24 16:28,292.84,Purchase,Home Improvement,5166.32
35652,795844983,07-01-24 21:28,4600,IncomingTransfer,Salary,9766.32
35653,795844983,07-06-24 21:28,33.65,Withdrawal,Branch Withdrawal,9732.67
35654,795844983,07-09-24 9:28,73.62,Return,Best Buy Return,9806.29
35655,795844983,07-11-24 9:28,162.01,Purchase,Home Improvement,9644.28
35656,795844983,07-12-24 9:28,243.1,OutgoingTransfer,Bank Transfer,9401.18
35657,795844983,7-15-24 21:28,1700,Payment,Rent Payment,7701.18
35658,795991758,1-21-24 12:28,57.34,Withdrawal,Branch Withdrawal,317.6934949
35659,795991758,1-22-24 17:28,270.02,Deposit,Mobile Deposit,587.7134949
35660,795991758,1-24-24 17:28,22.01,Withdrawal,Branch Withdrawal,565.7034949
35661,795991758,1-26-24 20:28,191.65,Return,eBay Return,757.3534949
35662,795991758,1-27-24 11:28,30.01,IncomingTransfer,Freelance Payment,787.3634949
35663,795991758,1-28-24 13:28,311.96,Purchase,Entertainment,475.4034949
35664,795991758,1-31-24 9:28,179.53,Payment,Bill Payment,295.8734949
35665,795991758,02-01-24 12:28,328.17,Purchase,Entertainment,-32.29650511
35666,795991758,02-04-24 16:28,265.02,Deposit,Mobile Deposit,232.7234949
35667,795991758,02-04-24 21:28,3950,IncomingTransfer,Salary,4182.723495
35668,795991758,02-05-24 12:28,292.09,OutgoingTransfer,Wire Transfer,3890.633495
35669,795991758,02-06-24 12:28,178.42,Deposit,Direct Deposit,4069.053495
35670,795991758,02-09-24 21:28,700,Payment,Credit Card Payment,3369.053495
35671,795991758,02-12-24 21:28,2400,Payment,Rent Payment,969.0534949
35672,795991758,2-13-24 10:28,338.78,Deposit,Cash Deposit,1307.833495
35673,795991758,2-13-24 13:28,265.61,OnlineShopping,Target,1042.223495
35674,795991758,2-19-24 11:28,295.96,Purchase,Gas,746.2634949
35675,795991758,2-21-24 15:28,182.01,Return,Amazon Return,928.2734949
35676,795991758,2-29-24 19:28,375.39,Purchase,Pharmacy,552.8834949
35677,795991758,03-01-24 15:28,175.78,Withdrawal,Branch Withdrawal,377.1034949
35678,795991758,03-02-24 10:28,290.96,OnlineShopping,Amazon,86.14349489
35679,795991758,03-04-24 21:28,3950,IncomingTransfer,Salary,4036.143495
35680,795991758,03-05-24 15:28,80.73,Deposit,Check Deposit,4116.873495
35681,795991758,03-06-24 11:28,347.67,Deposit,Direct Deposit,4464.543495
35682,795991758,03-07-24 10:28,156.67,Withdrawal,Mobile App Withdrawal,4307.873495
35683,795991758,03-08-24 14:28,227.09,OnlineShopping,Walmart,4080.783495
35684,795991758,03-08-24 21:28,293.05,Withdrawal,ATM Withdrawal,3787.733495
35685,795991758,03-09-24 21:28,900,Payment,Credit Card Payment,2887.733495
35686,795991758,03-10-24 14:28,295.75,Purchase,Clothing,2591.983495
35687,795991758,03-10-24 22:28,103.19,Deposit,Cash Deposit,2695.173495
35688,795991758,3-13-24 21:28,1100,Payment,Rent Payment,1595.173495
35689,795991758,3-16-24 22:28,286.88,Withdrawal,Mobile App Withdrawal,1308.293495
35690,795991758,3-24-24 22:28,338.82,Return,Target Return,1647.113495
35691,795991758,3-24-24 22:28,202.73,Return,Amazon Return,1849.843495
35692,795991758,3-29-24 17:28,257.59,Deposit,Direct Deposit,2107.433495
35693,795991758,3-30-24 20:28,235.52,Withdrawal,ATM Withdrawal,1871.913495
35694,795991758,3-31-24 17:28,288.13,Deposit,Check Deposit,2160.043495
35695,795991758,04-04-24 21:28,3950,IncomingTransfer,Salary,6110.043495
35696,795991758,04-06-24 16:28,271.97,Withdrawal,Branch Withdrawal,5838.073495
35697,795991758,04-09-24 21:28,700,Payment,Credit Card Payment,5138.073495
35698,795991758,04-11-24 21:28,2500,Payment,Rent Payment,2638.073495
35699,795991758,4-17-24 11:28,57.47,Withdrawal,ATM Withdrawal,2580.603495
35700,795991758,4-26-24 14:28,192.05,IncomingTransfer,Freelance Payment,2772.653495
35701,795991758,4-27-24 10:28,129.47,Deposit,Cash Deposit,2902.123495
35702,795991758,4-30-24 14:28,351.68,IncomingTransfer,Freelance Payment,3253.803495
35703,795991758,05-02-24 21:28,3950,IncomingTransfer,Salary,7203.803495
35704,795991758,05-07-24 21:28,1000,Payment,Credit Card Payment,6203.803495
35705,795991758,05-11-24 15:28,70.63,Deposit,Check Deposit,6274.433495
35706,795991758,05-11-24 18:28,284.4,OutgoingTransfer,Bank Transfer,5990.033495
35707,795991758,5-14-24 14:28,321.8,Purchase,Restaurant,5668.233495
35708,795991758,5-16-24 21:28,1200,Payment,Rent Payment,4468.233495
35709,795991758,5-18-24 16:28,235.75,Withdrawal,Branch Withdrawal,4232.483495
35710,795991758,5-18-24 19:28,93.17,OnlineShopping,eBay,4139.313495
35711,795991758,5-21-24 11:28,387.47,IncomingTransfer,Freelance Payment,4526.783495
35712,795991758,5-23-24 10:28,37.81,Return,Etsy Return,4564.593495
35713,795991758,5-23-24 13:28,353.31,Withdrawal,Branch Withdrawal,4211.283495
35714,795991758,5-24-24 12:28,40.89,Deposit,Cash Deposit,4252.173495
35715,795991758,5-26-24 13:28,212.61,IncomingTransfer,Freelance Payment,4464.783495
35716,795991758,5-29-24 19:28,152.57,Deposit,Mobile Deposit,4617.353495
35717,795991758,06-01-24 10:28,154.56,Purchase,Home Improvement,4462.793495
35718,795991758,06-01-24 21:28,3950,IncomingTransfer,Salary,8412.793495
35719,795991758,06-05-24 17:28,324.7,Return,Target Return,8737.493495
35720,795991758,06-06-24 21:28,800,Payment,Credit Card Payment,7937.493495
35721,795991758,6-13-24 9:28,81.06,Return,AliExpress Return,8018.553495
35722,795991758,6-14-24 18:28,202.28,Purchase,Electronics,7816.273495
35723,795991758,6-14-24 21:28,1000,Payment,Rent Payment,6816.273495
35724,795991758,6-17-24 21:28,178.22,IncomingTransfer,Freelance Payment,6994.493495
35725,795991758,6-18-24 14:28,243.87,Withdrawal,Mobile App Withdrawal,6750.623495
35726,795991758,6-18-24 20:28,185.21,Deposit,Mobile Deposit,6935.833495
35727,795991758,6-22-24 22:28,60.95,Payment,Loan Payment,6874.883495
35728,795991758,6-24-24 20:28,20.74,Deposit,Direct Deposit,6895.623495
35729,795991758,6-27-24 18:28,360.8,Purchase,Electronics,6534.823495
35730,795991758,6-27-24 23:28,92.32,Return,AliExpress Return,6627.143495
35731,795991758,6-28-24 9:28,392.35,Purchase,Home Improvement,6234.793495
35732,795991758,6-30-24 22:28,223.33,Deposit,Check Deposit,6458.123495
35733,795991758,07-01-24 21:28,3950,IncomingTransfer,Salary,10408.12349
35734,795991758,07-04-24 21:28,149.04,Purchase,Restaurant,10259.08349
35735,795991758,07-06-24 12:28,330.79,Deposit,Cash Deposit,10589.87349
35736,795991758,07-06-24 21:28,1000,Payment,Credit Card Payment,9589.873495
35737,795991758,07-11-24 13:28,39.98,OutgoingTransfer,Bank Transfer,9549.893495
35738,795991758,07-11-24 13:28,281.69,Deposit,Check Deposit,9831.583495
35739,795991758,07-11-24 14:28,392.12,Withdrawal,Branch Withdrawal,9439.463495
35740,795991758,07-12-24 21:28,1100,Payment,Rent Payment,8339.463495
35741,795991758,7-13-24 13:28,20.57,Payment,Loan Payment,8318.893495
35742,795991758,7-13-24 16:28,228.18,OutgoingTransfer,International Transfer,8090.713495
35743,797234508,1-31-24 11:28,104.79,OutgoingTransfer,Peer-to-Peer Transfer,-104.79
35744,797234508,1-31-24 15:28,67.8,IncomingTransfer,Freelance Payment,-36.99
35745,797234508,02-02-24 21:28,5600,IncomingTransfer,Salary,5563.01
35746,797234508,02-05-24 13:28,331.27,Purchase,Entertainment,5231.74
35747,797234508,2-16-24 13:28,537.8,IncomingTransfer,Freelance Payment,5769.54
35748,797234508,2-17-24 12:28,412.13,OnlineShopping,eBay,5357.41
35749,797234508,2-18-24 21:28,2000,Payment,Rent Payment,3357.41
35750,797234508,2-18-24 21:28,82.14,OutgoingTransfer,International Transfer,3275.27
35751,797234508,03-02-24 21:28,5600,IncomingTransfer,Salary,8875.27
35752,797234508,3-14-24 21:28,2700,Payment,Rent Payment,6175.27
35753,797234508,04-01-24 21:28,5600,IncomingTransfer,Salary,11775.27
35754,797234508,04-03-24 20:28,288.96,Purchase,Entertainment,11486.31
35755,797234508,04-11-24 21:28,2900,Payment,Rent Payment,8586.31
35756,797234508,04-12-24 11:28,123.78,Deposit,Mobile Deposit,8710.09
35757,797234508,4-24-24 13:28,330.24,OutgoingTransfer,International Transfer,8379.85
35758,797234508,4-28-24 11:28,262.39,Purchase,Entertainment,8117.46
35759,797234508,05-01-24 21:28,5600,IncomingTransfer,Salary,13717.46
35760,797234508,05-05-24 18:28,354.09,Purchase,Furniture,13363.37
35761,797234508,5-13-24 22:28,298.18,Withdrawal,Branch Withdrawal,13065.19
35762,797234508,5-14-24 13:28,82.29,Deposit,Cash Deposit,13147.48
35763,797234508,5-18-24 21:28,2400,Payment,Rent Payment,10747.48
35764,797234508,5-20-24 20:28,130.54,Deposit,Direct Deposit,10878.02
35765,797234508,06-02-24 21:28,5600,IncomingTransfer,Salary,16478.02
35766,797234508,06-12-24 21:28,2400,Payment,Rent Payment,14078.02
35767,797234508,6-21-24 21:28,429.95,Payment,Bill Payment,13648.07
35768,797234508,6-27-24 20:28,274.48,OutgoingTransfer,International Transfer,13373.59
35769,797234508,07-01-24 16:28,463.58,OutgoingTransfer,Wire Transfer,12910.01
35770,797234508,07-04-24 21:28,5600,IncomingTransfer,Salary,18510.01
35771,797234508,07-05-24 9:28,276.65,Deposit,Check Deposit,18786.66
35772,797234508,07-05-24 19:28,60.68,OutgoingTransfer,Wire Transfer,18725.98
35773,797234508,07-05-24 22:28,421.51,Withdrawal,ATM Withdrawal,18304.47
35774,797234508,07-10-24 21:28,3300,Payment,Rent Payment,15004.47
35775,797389758,1-21-24 15:28,140.71,Payment,Bill Payment,-140.71
35776,797389758,1-23-24 18:28,237.67,Return,Amazon Return,96.96
35777,797389758,1-26-24 13:28,43.28,Return,Store Return,140.24
35778,797389758,1-27-24 13:28,276.46,OutgoingTransfer,Peer-to-Peer Transfer,-136.22
35779,797389758,1-27-24 14:28,171.78,OnlineShopping,Best Buy,-308
35780,797389758,1-29-24 11:28,172.14,Purchase,Home Improvement,-480.14
35781,797389758,1-30-24 19:28,25.86,Purchase,Entertainment,-506
35782,797389758,02-02-24 21:28,4000,IncomingTransfer,Salary,3494
35783,797389758,02-08-24 16:28,334.15,Return,Best Buy Return,3828.15
35784,797389758,02-10-24 12:28,304.08,Purchase,Home Improvement,3524.07
35785,797389758,2-13-24 21:28,1400,Payment,Rent Payment,2124.07
35786,797389758,2-14-24 20:28,284.46,Payment,Mortgage Payment,1839.61
35787,797389758,2-18-24 12:28,46.42,OnlineShopping,Amazon,1793.19
35788,797389758,2-18-24 13:28,121.38,Withdrawal,Mobile App Withdrawal,1671.81
35789,797389758,2-22-24 9:28,187.24,Purchase,Furniture,1484.57
35790,797389758,2-22-24 23:28,249.71,Deposit,Check Deposit,1734.28
35791,797389758,2-23-24 18:28,136.21,OutgoingTransfer,Wire Transfer,1598.07
35792,797389758,2-27-24 17:28,284.5,Return,eBay Return,1882.57
35793,797389758,2-27-24 18:28,263.15,Withdrawal,Branch Withdrawal,1619.42
35794,797389758,03-02-24 15:28,340.85,Payment,Bill Payment,1278.57
35795,797389758,03-04-24 13:28,152.24,Payment,Loan Payment,1126.33
35796,797389758,03-04-24 21:28,4000,IncomingTransfer,Salary,5126.33
35797,797389758,03-09-24 16:28,192.98,Deposit,Direct Deposit,5319.31
35798,797389758,03-10-24 14:28,209.47,Withdrawal,ATM Withdrawal,5109.84
35799,797389758,3-15-24 21:28,2500,Payment,Rent Payment,2609.84
35800,797389758,3-17-24 13:28,394.22,Withdrawal,Mobile App Withdrawal,2215.62
35801,797389758,3-17-24 21:28,392.43,OutgoingTransfer,Wire Transfer,1823.19
35802,797389758,3-22-24 17:28,28.09,Withdrawal,Mobile App Withdrawal,1795.1
35803,797389758,3-22-24 19:28,83.74,Deposit,Check Deposit,1878.84
35804,797389758,3-24-24 15:28,28.85,OnlineShopping,Etsy,1849.99
35805,797389758,3-27-24 20:28,133.75,Purchase,Gas,1716.24
35806,797389758,3-29-24 16:28,142.37,Purchase,Travel,1573.87
35807,797389758,3-30-24 21:28,398.03,OnlineShopping,Etsy,1175.84
35808,797389758,04-01-24 11:28,203.63,Withdrawal,ATM Withdrawal,972.21
35809,797389758,04-01-24 21:28,4000,IncomingTransfer,Salary,4972.21
35810,797389758,04-02-24 11:28,342.98,IncomingTransfer,Freelance Payment,5315.19
35811,797389758,04-02-24 15:28,230.01,Deposit,Direct Deposit,5545.2
35812,797389758,04-04-24 11:28,329.62,OnlineShopping,Etsy,5215.58
35813,797389758,04-04-24 14:28,339.88,OnlineShopping,Amazon,4875.7
35814,797389758,04-07-24 10:28,223.28,Return,AliExpress Return,5098.98
35815,797389758,04-07-24 16:28,290.54,Deposit,Cash Deposit,5389.52
35816,797389758,04-09-24 15:28,36.03,Purchase,Furniture,5353.49
35817,797389758,04-11-24 19:28,102.11,Withdrawal,Mobile App Withdrawal,5251.38
35818,797389758,4-13-24 21:28,2500,Payment,Rent Payment,2751.38
35819,797389758,4-16-24 19:28,26.99,Purchase,Travel,2724.39
35820,797389758,4-18-24 23:28,365.57,IncomingTransfer,Freelance Payment,3089.96
35821,797389758,4-23-24 19:28,163.91,Withdrawal,Branch Withdrawal,2926.05
35822,797389758,4-26-24 20:28,309.59,Payment,Mortgage Payment,2616.46
35823,797389758,4-27-24 21:28,302.76,Deposit,Mobile Deposit,2919.22
35824,797389758,05-01-24 21:28,4000,IncomingTransfer,Salary,6919.22
35825,797389758,05-04-24 21:28,62.54,Deposit,Cash Deposit,6981.76
35826,797389758,05-10-24 18:28,117.3,IncomingTransfer,Freelance Payment,7099.06
35827,797389758,05-11-24 10:28,301.66,Deposit,Cash Deposit,7400.72
35828,797389758,05-11-24 21:28,1400,Payment,Rent Payment,6000.72
35829,797389758,05-12-24 17:28,391.32,Withdrawal,Branch Withdrawal,5609.4
35830,797389758,5-14-24 18:28,124.01,Deposit,Check Deposit,5733.41
35831,797389758,5-14-24 19:28,341.96,Deposit,Mobile Deposit,6075.37
35832,797389758,5-15-24 18:28,50.87,Payment,Loan Payment,6024.5
35833,797389758,5-19-24 10:28,243.23,OutgoingTransfer,Peer-to-Peer Transfer,5781.27
35834,797389758,5-20-24 12:28,207.08,Deposit,Cash Deposit,5988.35
35835,797389758,5-23-24 18:28,149.07,Withdrawal,ATM Withdrawal,5839.28
35836,797389758,5-24-24 19:28,386,IncomingTransfer,Freelance Payment,6225.28
35837,797389758,5-24-24 22:28,107.67,Purchase,Travel,6117.61
35838,797389758,5-26-24 13:28,134.12,OnlineShopping,Amazon,5983.49
35839,797389758,5-28-24 19:28,283.15,Deposit,Mobile Deposit,6266.64
35840,797389758,5-29-24 19:28,184.53,Payment,Loan Payment,6082.11
35841,797389758,5-30-24 9:28,126.05,Purchase,Restaurant,5956.06
35842,797389758,06-01-24 16:28,114.55,Payment,Bill Payment,5841.51
35843,797389758,06-01-24 21:28,4000,IncomingTransfer,Salary,9841.51
35844,797389758,06-05-24 11:28,245.97,Purchase,Clothing,9595.54
35845,797389758,06-07-24 18:28,234,OutgoingTransfer,Wire Transfer,9361.54
35846,797389758,06-10-24 12:28,262.28,Withdrawal,Branch Withdrawal,9099.26
35847,797389758,06-10-24 13:28,218.94,OnlineShopping,Amazon,8880.32
35848,797389758,06-10-24 20:28,168.27,OnlineShopping,eBay,8712.05
35849,797389758,06-11-24 21:28,2200,Payment,Rent Payment,6512.05
35850,797389758,6-15-24 16:28,257.54,Withdrawal,Mobile App Withdrawal,6254.51
35851,797389758,6-17-24 10:28,110.14,OutgoingTransfer,Peer-to-Peer Transfer,6144.37
35852,797389758,6-20-24 20:28,145.21,Deposit,Check Deposit,6289.58
35853,797389758,6-21-24 17:28,225.33,Payment,Loan Payment,6064.25
35854,797389758,6-21-24 23:28,256.24,Payment,Mortgage Payment,5808.01
35855,797389758,6-29-24 16:28,146.35,Deposit,Mobile Deposit,5954.36
35856,797389758,07-01-24 21:28,4000,IncomingTransfer,Salary,9954.36
35857,797389758,07-02-24 18:28,46.34,Deposit,Check Deposit,10000.7
35858,797389758,07-03-24 12:28,369.97,OnlineShopping,AliExpress,9630.73
35859,797389758,07-10-24 10:28,70.63,OutgoingTransfer,International Transfer,9560.1
35860,797389758,07-10-24 18:28,152.45,OnlineShopping,Best Buy,9407.65
35861,797389758,7-13-24 10:28,178.35,Deposit,Cash Deposit,9586
35862,797389758,7-14-24 20:28,73.2,OnlineShopping,Amazon,9512.8
35863,797389758,7-15-24 13:28,229.78,OutgoingTransfer,International Transfer,9283.02
35864,797389758,7-15-24 23:28,272.07,Return,Etsy Return,9555.09
35865,797389758,7-16-24 21:28,1500,Payment,Rent Payment,8055.09
35866,797743233,1-20-24 16:28,491.19,Withdrawal,Mobile App Withdrawal,283.4024908
35867,797743233,1-21-24 13:28,182.72,OnlineShopping,Target,100.6824908
35868,797743233,1-25-24 12:28,311.66,Deposit,Check Deposit,412.3424908
35869,797743233,02-02-24 19:28,220.99,IncomingTransfer,Freelance Payment,633.3324908
35870,797743233,02-04-24 21:28,6450,IncomingTransfer,Salary,7083.332491
35871,797743233,02-05-24 11:28,466.8,Withdrawal,Branch Withdrawal,6616.532491
35872,797743233,02-05-24 15:28,428.48,OutgoingTransfer,Bank Transfer,6188.052491
35873,797743233,02-05-24 23:28,445.63,Deposit,Direct Deposit,6633.682491
35874,797743233,02-09-24 21:28,1100,Payment,Credit Card Payment,5533.682491
35875,797743233,02-12-24 12:28,204.91,Deposit,Cash Deposit,5738.592491
35876,797743233,02-12-24 17:28,494.8,Deposit,Mobile Deposit,6233.392491
35877,797743233,2-13-24 20:28,114.78,Return,Target Return,6348.172491
35878,797743233,2-13-24 23:28,260.69,Purchase,Home Improvement,6087.482491
35879,797743233,2-16-24 20:28,254.94,Withdrawal,Branch Withdrawal,5832.542491
35880,797743233,2-16-24 21:28,1700,Payment,Insurance Payment,4132.542491
35881,797743233,2-19-24 20:28,539.98,Withdrawal,Mobile App Withdrawal,3592.562491
35882,797743233,2-20-24 11:28,390.39,OnlineShopping,Best Buy,3202.172491
35883,797743233,2-21-24 23:28,94.39,Deposit,Mobile Deposit,3296.562491
35884,797743233,2-24-24 22:28,174.58,Deposit,Cash Deposit,3471.142491
35885,797743233,03-02-24 21:28,6450,IncomingTransfer,Salary,9921.142491
35886,797743233,03-03-24 12:28,328.51,Deposit,Cash Deposit,10249.65249
35887,797743233,03-03-24 14:28,321.45,Return,Target Return,10571.10249
35888,797743233,03-03-24 22:28,126.38,Purchase,Travel,10444.72249
35889,797743233,03-06-24 21:28,361.35,Deposit,Check Deposit,10806.07249
35890,797743233,03-07-24 21:28,900,Payment,Credit Card Payment,9906.072491
35891,797743233,03-09-24 16:28,216.86,Return,Best Buy Return,10122.93249
35892,797743233,03-12-24 21:28,126.36,Purchase,Restaurant,9996.572491
35893,797743233,3-13-24 21:28,1700,Payment,Insurance Payment,8296.572491
35894,797743233,3-19-24 16:28,517.56,Return,Store Return,8814.132491
35895,797743233,3-21-24 15:28,492.86,OutgoingTransfer,International Transfer,8321.272491
35896,797743233,3-24-24 12:28,267.4,Deposit,Cash Deposit,8588.672491
35897,797743233,3-25-24 13:28,198.9,Withdrawal,Branch Withdrawal,8389.772491
35898,797743233,3-29-24 22:28,318.51,Return,Target Return,8708.282491
35899,797743233,3-30-24 15:28,154.76,IncomingTransfer,Freelance Payment,8863.042491
35900,797743233,3-30-24 20:28,137.71,Purchase,Gas,8725.332491
35901,797743233,04-02-24 17:28,236.88,Payment,Bill Payment,8488.452491
35902,797743233,04-02-24 21:28,6450,IncomingTransfer,Salary,14938.45249
35903,797743233,04-07-24 21:28,1100,Payment,Credit Card Payment,13838.45249
35904,797743233,04-11-24 10:28,488.46,Purchase,Entertainment,13349.99249
35905,797743233,04-11-24 16:28,227.16,Payment,Bill Payment,13122.83249
35906,797743233,04-12-24 23:28,391.34,Return,Best Buy Return,13514.17249
35907,797743233,4-15-24 18:28,353.54,Withdrawal,ATM Withdrawal,13160.63249
35908,797743233,4-16-24 21:28,2500,Payment,Subscription Payment,10660.63249
35909,797743233,4-17-24 12:28,236.1,OutgoingTransfer,International Transfer,10424.53249
35910,797743233,4-24-24 16:28,200.91,Deposit,Mobile Deposit,10625.44249
35911,797743233,4-24-24 22:28,125.39,Return,Walmart Return,10750.83249
35912,797743233,4-25-24 17:28,212.87,Withdrawal,Branch Withdrawal,10537.96249
35913,797743233,05-02-24 21:28,6450,IncomingTransfer,Salary,16987.96249
35914,797743233,05-03-24 18:28,354.23,Payment,Mortgage Payment,16633.73249
35915,797743233,05-04-24 10:28,397.79,Return,Etsy Return,17031.52249
35916,797743233,05-07-24 20:28,341.33,Withdrawal,Mobile App Withdrawal,16690.19249
35917,797743233,05-07-24 21:28,1000,Payment,Credit Card Payment,15690.19249
35918,797743233,05-08-24 15:28,226.1,Purchase,Home Improvement,15464.09249
35919,797743233,05-12-24 15:28,151.97,Deposit,Direct Deposit,15616.06249
35920,797743233,5-14-24 17:28,112.88,Return,Best Buy Return,15728.94249
35921,797743233,5-16-24 23:28,485.36,Purchase,Entertainment,15243.58249
35922,797743233,5-17-24 18:28,185.58,OnlineShopping,Amazon,15058.00249
35923,797743233,5-18-24 21:28,2700,Payment,Insurance Payment,12358.00249
35924,797743233,5-20-24 14:28,484.47,Deposit,Direct Deposit,12842.47249
35925,797743233,5-20-24 21:28,526.44,Purchase,Pharmacy,12316.03249
35926,797743233,5-22-24 10:28,314.15,Deposit,Check Deposit,12630.18249
35927,797743233,5-22-24 23:28,315.8,Withdrawal,Mobile App Withdrawal,12314.38249
35928,797743233,5-24-24 23:28,186.88,Purchase,Entertainment,12127.50249
35929,797743233,5-25-24 11:28,289.28,Payment,Loan Payment,11838.22249
35930,797743233,5-26-24 13:28,135.13,OnlineShopping,Best Buy,11703.09249
35931,797743233,5-28-24 13:28,350.74,OutgoingTransfer,International Transfer,11352.35249
35932,797743233,5-31-24 20:28,525.41,Purchase,Pharmacy,10826.94249
35933,797743233,06-01-24 10:28,352.51,Return,Walmart Return,11179.45249
35934,797743233,06-01-24 14:28,419.11,Deposit,Cash Deposit,11598.56249
35935,797743233,06-01-24 17:28,252.44,OnlineShopping,Walmart,11346.12249
35936,797743233,06-01-24 21:28,6450,IncomingTransfer,Salary,17796.12249
35937,797743233,06-02-24 12:28,150.53,Withdrawal,Mobile App Withdrawal,17645.59249
35938,797743233,06-05-24 12:28,150.5,Return,AliExpress Return,17796.09249
35939,797743233,06-06-24 21:28,1200,Payment,Credit Card Payment,16596.09249
35940,797743233,06-06-24 22:28,150.28,Payment,Loan Payment,16445.81249
35941,797743233,06-07-24 9:28,472.74,Purchase,Restaurant,15973.07249
35942,797743233,06-11-24 13:28,362.01,Return,Walmart Return,16335.08249
35943,797743233,06-12-24 22:28,133.1,Purchase,Clothing,16201.98249
35944,797743233,6-13-24 13:28,406.26,Purchase,Pharmacy,15795.72249
35945,797743233,6-13-24 20:28,126.54,Purchase,Pharmacy,15669.18249
35946,797743233,6-14-24 17:28,437.55,Withdrawal,ATM Withdrawal,15231.63249
35947,797743233,6-18-24 21:28,2700,Payment,Installment Payment,12531.63249
35948,797743233,6-22-24 14:28,495.18,Purchase,Gas,12036.45249
35949,797743233,6-23-24 12:28,145.08,Return,Target Return,12181.53249
35950,797743233,6-24-24 18:28,174.64,Withdrawal,Mobile App Withdrawal,12006.89249
35951,797743233,6-24-24 19:28,299.65,Deposit,Mobile Deposit,12306.54249
35952,797743233,07-01-24 21:28,6450,IncomingTransfer,Salary,18756.54249
35953,797743233,07-06-24 18:28,59.37,Deposit,Check Deposit,18815.91249
35954,797743233,07-06-24 21:28,1100,Payment,Credit Card Payment,17715.91249
35955,797743233,07-07-24 13:28,244.62,Withdrawal,ATM Withdrawal,17471.29249
35956,797743233,07-10-24 19:28,324.2,Purchase,Gas,17147.09249
35957,797743233,07-10-24 21:28,2200,Payment,Insurance Payment,14947.09249
35958,797743233,07-10-24 23:28,475.14,Purchase,Electronics,14471.95249
35959,797743233,07-11-24 18:28,101.9,OnlineShopping,AliExpress,14370.05249
35960,797743233,7-15-24 22:28,93.57,OnlineShopping,Walmart,14276.48249
35961,798120858,1-21-24 10:28,317.64,Return,Amazon Return,1122.523318
35962,798120858,1-22-24 12:28,389.09,Purchase,Pharmacy,733.4333182
35963,798120858,1-24-24 17:28,267.57,OnlineShopping,Etsy,465.8633182
35964,798120858,02-02-24 11:28,514.83,Withdrawal,ATM Withdrawal,-48.96668184
35965,798120858,02-03-24 15:28,583.28,Return,Walmart Return,534.3133182
35966,798120858,02-03-24 21:28,9800,IncomingTransfer,Salary,10334.31332
35967,798120858,02-08-24 21:28,1800,Payment,Credit Card Payment,8534.313318
35968,798120858,02-10-24 21:28,4300,Payment,Rent Payment,4234.313318
35969,798120858,02-11-24 15:28,300.11,OnlineShopping,Target,3934.203318
35970,798120858,2-18-24 18:28,311.12,OutgoingTransfer,Wire Transfer,3623.083318
35971,798120858,2-20-24 20:28,286.44,OutgoingTransfer,Bank Transfer,3336.643318
35972,798120858,2-26-24 19:28,439.35,Payment,Loan Payment,2897.293318
35973,798120858,03-04-24 9:28,605.71,Deposit,Mobile Deposit,3503.003318
35974,798120858,03-05-24 21:28,9800,IncomingTransfer,Salary,13303.00332
35975,798120858,03-06-24 11:28,617.76,Purchase,Electronics,12685.24332
35976,798120858,03-09-24 11:28,219.09,Deposit,Check Deposit,12904.33332
35977,798120858,03-10-24 21:28,1600,Payment,Credit Card Payment,11304.33332
35978,798120858,03-12-24 21:28,3800,Payment,Rent Payment,7504.333318
35979,798120858,3-15-24 14:28,727.01,Withdrawal,Branch Withdrawal,6777.323318
35980,798120858,3-16-24 22:28,102.86,Withdrawal,ATM Withdrawal,6674.463318
35981,798120858,3-20-24 19:28,158.39,OutgoingTransfer,International Transfer,6516.073318
35982,798120858,3-21-24 13:28,585.66,IncomingTransfer,Freelance Payment,7101.733318
35983,798120858,3-25-24 19:28,340.34,OutgoingTransfer,Wire Transfer,6761.393318
35984,798120858,3-31-24 18:28,344.78,Payment,Loan Payment,6416.613318
35985,798120858,04-01-24 21:28,9800,IncomingTransfer,Salary,16216.61332
35986,798120858,04-01-24 21:28,394.95,IncomingTransfer,Freelance Payment,16611.56332
35987,798120858,04-02-24 16:28,308.13,Deposit,Mobile Deposit,16919.69332
35988,798120858,04-06-24 21:28,1600,Payment,Credit Card Payment,15319.69332
35989,798120858,04-10-24 12:28,182.36,IncomingTransfer,Freelance Payment,15502.05332
35990,798120858,04-10-24 21:28,3800,Payment,Rent Payment,11702.05332
35991,798120858,4-14-24 16:28,658.92,Purchase,Gas,11043.13332
35992,798120858,4-22-24 14:28,403.36,Deposit,Check Deposit,11446.49332
35993,798120858,4-26-24 23:28,237.32,Purchase,Restaurant,11209.17332
35994,798120858,4-29-24 18:28,519.31,OnlineShopping,Amazon,10689.86332
35995,798120858,4-30-24 21:28,690.61,IncomingTransfer,Freelance Payment,11380.47332
35996,798120858,05-02-24 9:28,718.23,Payment,Bill Payment,10662.24332
35997,798120858,05-05-24 21:28,9800,IncomingTransfer,Salary,20462.24332
35998,798120858,05-07-24 22:28,164.51,Withdrawal,Branch Withdrawal,20297.73332
35999,798120858,05-10-24 21:28,1400,Payment,Credit Card Payment,18897.73332
36000,798120858,05-12-24 21:28,3300,Payment,Rent Payment,15597.73332
36001,798120858,5-16-24 9:28,671.42,Purchase,Clothing,14926.31332
36002,798120858,5-17-24 22:28,139.2,Withdrawal,ATM Withdrawal,14787.11332
36003,798120858,5-21-24 19:28,527.65,IncomingTransfer,Freelance Payment,15314.76332
36004,798120858,5-22-24 9:28,133.2,OutgoingTransfer,Wire Transfer,15181.56332
36005,798120858,5-26-24 18:28,171.71,OutgoingTransfer,International Transfer,15009.85332
36006,798120858,5-28-24 13:28,508.43,Return,Target Return,15518.28332
36007,798120858,5-28-24 14:28,300.52,Deposit,Mobile Deposit,15818.80332
36008,798120858,5-30-24 9:28,517.68,OnlineShopping,Walmart,15301.12332
36009,798120858,5-30-24 20:28,170.2,OnlineShopping,Best Buy,15130.92332
36010,798120858,06-03-24 21:28,9800,IncomingTransfer,Salary,24930.92332
36011,798120858,06-08-24 21:28,1700,Payment,Credit Card Payment,23230.92332
36012,798120858,6-17-24 12:28,734.53,OnlineShopping,Target,22496.39332
36013,798120858,6-17-24 21:28,3200,Payment,Rent Payment,19296.39332
36014,798120858,6-19-24 10:28,432.44,Withdrawal,Branch Withdrawal,18863.95332
36015,798120858,6-24-24 10:28,106.71,Purchase,Grocery,18757.24332
36016,798120858,6-25-24 14:28,624.15,Return,eBay Return,19381.39332
36017,798120858,6-27-24 10:28,471.38,Withdrawal,Branch Withdrawal,18910.01332
36018,798120858,07-05-24 21:28,9800,IncomingTransfer,Salary,28710.01332
36019,798120858,07-09-24 23:28,167.49,Purchase,Pharmacy,28542.52332
36020,798120858,07-10-24 21:28,2100,Payment,Credit Card Payment,26442.52332
36021,798120858,07-11-24 17:28,546.87,Purchase,Restaurant,25895.65332
36022,798120858,07-11-24 21:28,5600,Payment,Rent Payment,20295.65332
36023,799020258,1-23-24 21:28,466.23,Deposit,Cash Deposit,466.23
36024,799020258,1-25-24 11:28,519.46,Purchase,Gas,-53.23
36025,799020258,1-25-24 16:28,515.9,Purchase,Gas,-569.13
36026,799020258,1-26-24 13:28,169.73,Payment,Bill Payment,-738.86
36027,799020258,1-27-24 18:28,248.05,IncomingTransfer,Freelance Payment,-490.81
36028,799020258,1-31-24 9:28,155.87,OnlineShopping,Target,-646.68
36029,799020258,02-01-24 18:28,127.41,OutgoingTransfer,International Transfer,-774.09
36030,799020258,02-05-24 21:28,5850,IncomingTransfer,Salary,5075.91
36031,799020258,2-14-24 21:28,199.18,Payment,Loan Payment,4876.73
36032,799020258,2-16-24 9:28,178.72,IncomingTransfer,Freelance Payment,5055.45
36033,799020258,2-17-24 17:28,447.44,Purchase,Grocery,4608.01
36034,799020258,2-17-24 21:28,2200,Payment,Installment Payment,2408.01
36035,799020258,2-20-24 10:28,131.23,Payment,Bill Payment,2276.78
36036,799020258,2-22-24 17:28,465.08,Deposit,Mobile Deposit,2741.86
36037,799020258,2-24-24 18:28,294.71,Withdrawal,Mobile App Withdrawal,2447.15
36038,799020258,2-24-24 22:28,474.38,Deposit,Check Deposit,2921.53
36039,799020258,03-02-24 21:28,5850,IncomingTransfer,Salary,8771.53
36040,799020258,3-15-24 23:28,156.6,Purchase,Clothing,8614.93
36041,799020258,3-18-24 21:28,2500,Payment,Insurance Payment,6114.93
36042,799020258,3-19-24 9:28,232.38,Return,Etsy Return,6347.31
36043,799020258,3-20-24 11:28,416.77,IncomingTransfer,Freelance Payment,6764.08
36044,799020258,3-22-24 19:28,285.83,Withdrawal,ATM Withdrawal,6478.25
36045,799020258,3-23-24 13:28,434.26,Return,Walmart Return,6912.51
36046,799020258,3-24-24 12:28,288.7,Payment,Loan Payment,6623.81
36047,799020258,3-27-24 11:28,166.28,Return,Etsy Return,6790.09
36048,799020258,3-28-24 20:28,141.91,Payment,Loan Payment,6648.18
36049,799020258,3-29-24 19:28,273.34,Withdrawal,Mobile App Withdrawal,6374.84
36050,799020258,3-30-24 21:28,438.72,Purchase,Furniture,5936.12
36051,799020258,3-31-24 15:28,262.79,OutgoingTransfer,Bank Transfer,5673.33
36052,799020258,3-31-24 18:28,113.21,OnlineShopping,eBay,5560.12
36053,799020258,04-01-24 20:28,357.77,Return,Walmart Return,5917.89
36054,799020258,04-02-24 10:28,504.66,IncomingTransfer,Freelance Payment,6422.55
36055,799020258,04-02-24 22:28,134.62,IncomingTransfer,Freelance Payment,6557.17
36056,799020258,04-03-24 15:28,540.61,Withdrawal,Branch Withdrawal,6016.56
36057,799020258,04-03-24 21:28,480.66,Deposit,Cash Deposit,6497.22
36058,799020258,04-04-24 10:28,129.39,OnlineShopping,Etsy,6367.83
36059,799020258,04-04-24 15:28,135.74,Purchase,Entertainment,6232.09
36060,799020258,04-05-24 21:28,5850,IncomingTransfer,Salary,12082.09
36061,799020258,04-11-24 21:28,1500,Payment,Installment Payment,10582.09
36062,799020258,04-11-24 21:28,87.45,Purchase,Clothing,10494.64
36063,799020258,4-19-24 11:28,300.66,Purchase,Entertainment,10193.98
36064,799020258,4-23-24 20:28,259.47,Withdrawal,ATM Withdrawal,9934.51
36065,799020258,4-24-24 11:28,62.82,Withdrawal,Mobile App Withdrawal,9871.69
36066,799020258,4-25-24 12:28,205.86,Purchase,Gas,9665.83
36067,799020258,4-27-24 17:28,204.63,Purchase,Entertainment,9461.2
36068,799020258,05-03-24 13:28,99.59,Withdrawal,ATM Withdrawal,9361.61
36069,799020258,05-03-24 21:28,5850,IncomingTransfer,Salary,15211.61
36070,799020258,05-06-24 20:28,277.13,Withdrawal,Mobile App Withdrawal,14934.48
36071,799020258,05-07-24 23:28,267.84,OutgoingTransfer,Peer-to-Peer Transfer,14666.64
36072,799020258,05-12-24 13:28,326.26,Deposit,Cash Deposit,14992.9
36073,799020258,05-12-24 15:28,252.15,Deposit,Direct Deposit,15245.05
36074,799020258,5-13-24 14:28,164.85,OutgoingTransfer,Peer-to-Peer Transfer,15080.2
36075,799020258,5-13-24 21:28,2600,Payment,Installment Payment,12480.2
36076,799020258,5-13-24 23:28,189.43,Purchase,Restaurant,12290.77
36077,799020258,5-16-24 11:28,464.41,Payment,Mortgage Payment,11826.36
36078,799020258,5-17-24 11:28,345.26,Purchase,Furniture,11481.1
36079,799020258,5-18-24 13:28,384.5,Withdrawal,Branch Withdrawal,11096.6
36080,799020258,5-18-24 13:28,255.58,Purchase,Furniture,10841.02
36081,799020258,5-18-24 15:28,72.05,Deposit,Direct Deposit,10913.07
36082,799020258,5-18-24 19:28,73.85,Return,Etsy Return,10986.92
36083,799020258,5-20-24 15:28,322.5,Deposit,Cash Deposit,11309.42
36084,799020258,5-25-24 16:28,211.42,Payment,Loan Payment,11098
36085,799020258,5-29-24 12:28,119.52,OutgoingTransfer,Bank Transfer,10978.48
36086,799020258,5-29-24 22:28,328.16,Payment,Loan Payment,10650.32
36087,799020258,5-30-24 17:28,274.36,Payment,Loan Payment,10375.96
36088,799020258,5-30-24 22:28,120.05,OutgoingTransfer,Wire Transfer,10255.91
36089,799020258,06-01-24 10:28,297.19,OnlineShopping,Walmart,9958.72
36090,799020258,06-01-24 13:28,144.83,Purchase,Furniture,9813.89
36091,799020258,06-01-24 20:28,544.11,Purchase,Gas,9269.78
36092,799020258,06-01-24 21:28,5850,IncomingTransfer,Salary,15119.78
36093,799020258,06-06-24 15:28,296.98,OnlineShopping,Target,14822.8
36094,799020258,06-06-24 22:28,431.64,Return,Target Return,15254.44
36095,799020258,06-09-24 15:28,460.2,IncomingTransfer,Freelance Payment,15714.64
36096,799020258,06-11-24 15:28,259.75,OutgoingTransfer,Bank Transfer,15454.89
36097,799020258,06-12-24 20:28,101.21,Return,Amazon Return,15556.1
36098,799020258,6-13-24 9:28,401.17,Withdrawal,ATM Withdrawal,15154.93
36099,799020258,6-16-24 15:28,388.21,Withdrawal,Mobile App Withdrawal,14766.72
36100,799020258,6-17-24 21:28,1500,Payment,Insurance Payment,13266.72
36101,799020258,6-19-24 12:28,299.79,Deposit,Check Deposit,13566.51
36102,799020258,6-20-24 16:28,292.45,Deposit,Mobile Deposit,13858.96
36103,799020258,6-20-24 17:28,233.17,Purchase,Pharmacy,13625.79
36104,799020258,6-22-24 17:28,68.8,OutgoingTransfer,Bank Transfer,13556.99
36105,799020258,6-27-24 9:28,258.15,Deposit,Check Deposit,13815.14
36106,799020258,6-27-24 12:28,530.26,Return,AliExpress Return,14345.4
36107,799020258,6-27-24 22:28,419.09,Payment,Loan Payment,13926.31
36108,799020258,6-30-24 10:28,451.99,Withdrawal,Branch Withdrawal,13474.32
36109,799020258,6-30-24 11:28,429.86,Purchase,Restaurant,13044.46
36110,799020258,07-02-24 21:28,215.32,Return,Etsy Return,13259.78
36111,799020258,07-04-24 11:28,449.1,Deposit,Check Deposit,13708.88
36112,799020258,07-04-24 21:28,5850,IncomingTransfer,Salary,19558.88
36113,799020258,07-08-24 13:28,531.77,Withdrawal,Branch Withdrawal,19027.11
36114,799020258,7-14-24 21:28,1700,Payment,Subscription Payment,17327.11
36115,799020258,7-15-24 19:28,439.36,Deposit,Direct Deposit,17766.47
36116,799020258,7-16-24 23:28,445.72,Payment,Bill Payment,17320.75
36117,801369258,1-20-24 10:28,296.36,Withdrawal,Mobile App Withdrawal,93.51915812
36118,801369258,1-20-24 13:28,398.6,Purchase,Entertainment,-305.0808419
36119,801369258,1-21-24 12:28,327.12,Withdrawal,ATM Withdrawal,-632.2008419
36120,801369258,1-21-24 19:28,160.44,Payment,Bill Payment,-792.6408419
36121,801369258,1-24-24 15:28,197.07,Deposit,Direct Deposit,-595.5708419
36122,801369258,1-24-24 17:28,303.1,Purchase,Restaurant,-898.6708419
36123,801369258,1-27-24 11:28,378.29,Deposit,Direct Deposit,-520.3808419
36124,801369258,02-01-24 17:28,150.28,Purchase,Grocery,-670.6608419
36125,801369258,02-04-24 21:28,4400,IncomingTransfer,Salary,3729.339158
36126,801369258,02-04-24 22:28,397.48,Purchase,Travel,3331.859158
36127,801369258,02-09-24 21:28,1100,Payment,Credit Card Payment,2231.859158
36128,801369258,02-11-24 14:28,121.01,Withdrawal,Branch Withdrawal,2110.849158
36129,801369258,02-12-24 11:28,69.6,Deposit,Direct Deposit,2180.449158
36130,801369258,2-13-24 21:28,1500,Payment,Insurance Payment,680.4491581
36131,801369258,2-20-24 23:28,109.52,Purchase,Clothing,570.9291581
36132,801369258,2-21-24 12:28,251.11,OnlineShopping,AliExpress,319.8191581
36133,801369258,2-25-24 17:28,363.26,OutgoingTransfer,International Transfer,-43.44084188
36134,801369258,2-28-24 21:28,347.28,Withdrawal,Mobile App Withdrawal,-390.7208419
36135,801369258,2-29-24 21:28,192.56,Deposit,Check Deposit,-198.1608419
36136,801369258,03-01-24 20:28,81.46,Return,Best Buy Return,-116.7008419
36137,801369258,03-03-24 22:28,313.35,Deposit,Mobile Deposit,196.6491581
36138,801369258,03-05-24 21:28,4400,IncomingTransfer,Salary,4596.649158
36139,801369258,03-10-24 21:28,900,Payment,Credit Card Payment,3696.649158
36140,801369258,3-14-24 11:28,272.8,Return,Etsy Return,3969.449158
36141,801369258,3-16-24 21:28,1200,Payment,Subscription Payment,2769.449158
36142,801369258,3-25-24 17:28,285.5,Payment,Mortgage Payment,2483.949158
36143,801369258,3-26-24 23:28,253.79,Deposit,Mobile Deposit,2737.739158
36144,801369258,04-01-24 15:28,39.06,Deposit,Check Deposit,2776.799158
36145,801369258,04-01-24 21:28,4400,IncomingTransfer,Salary,7176.799158
36146,801369258,04-02-24 19:28,207.97,OutgoingTransfer,Wire Transfer,6968.829158
36147,801369258,04-03-24 11:28,319.36,OnlineShopping,eBay,6649.469158
36148,801369258,04-05-24 15:28,68.65,Deposit,Check Deposit,6718.119158
36149,801369258,04-06-24 21:28,900,Payment,Credit Card Payment,5818.119158
36150,801369258,04-07-24 14:28,370.12,Deposit,Cash Deposit,6188.239158
36151,801369258,04-11-24 17:28,196.3,Return,Best Buy Return,6384.539158
36152,801369258,04-11-24 18:28,119.59,Purchase,Home Improvement,6264.949158
36153,801369258,04-11-24 21:28,1900,Payment,Insurance Payment,4364.949158
36154,801369258,4-17-24 18:28,147.79,Withdrawal,ATM Withdrawal,4217.159158
36155,801369258,4-19-24 13:28,207.96,OnlineShopping,Best Buy,4009.199158
36156,801369258,4-21-24 14:28,205.72,Deposit,Check Deposit,4214.919158
36157,801369258,4-24-24 9:28,357.09,Withdrawal,ATM Withdrawal,3857.829158
36158,801369258,4-30-24 18:28,242.1,Purchase,Pharmacy,3615.729158
36159,801369258,05-04-24 21:28,301.64,Return,Amazon Return,3917.369158
36160,801369258,05-05-24 21:28,4400,IncomingTransfer,Salary,8317.369158
36161,801369258,05-07-24 15:28,25.82,Withdrawal,Mobile App Withdrawal,8291.549158
36162,801369258,05-07-24 15:28,144.85,OutgoingTransfer,Wire Transfer,8146.699158
36163,801369258,05-07-24 21:28,49.36,Withdrawal,Branch Withdrawal,8097.339158
36164,801369258,05-10-24 20:28,157.23,Withdrawal,ATM Withdrawal,7940.109158
36165,801369258,05-10-24 21:28,1100,Payment,Credit Card Payment,6840.109158
36166,801369258,5-15-24 21:28,1800,Payment,Subscription Payment,5040.109158
36167,801369258,5-20-24 18:28,87.2,OutgoingTransfer,Bank Transfer,4952.909158
36168,801369258,5-20-24 23:28,339.17,Return,Etsy Return,5292.079158
36169,801369258,5-22-24 12:28,88.63,Withdrawal,Mobile App Withdrawal,5203.449158
36170,801369258,5-27-24 13:28,48.24,Purchase,Grocery,5155.209158
36171,801369258,5-27-24 14:28,61.97,OutgoingTransfer,Bank Transfer,5093.239158
36172,801369258,5-27-24 15:28,224.58,Purchase,Pharmacy,4868.659158
36173,801369258,06-02-24 16:28,388.87,Withdrawal,Branch Withdrawal,4479.789158
36174,801369258,06-03-24 10:28,25.07,Deposit,Check Deposit,4504.859158
36175,801369258,06-03-24 19:28,294.04,IncomingTransfer,Freelance Payment,4798.899158
36176,801369258,06-03-24 21:28,4400,IncomingTransfer,Salary,9198.899158
36177,801369258,06-07-24 22:28,343.45,OutgoingTransfer,Wire Transfer,8855.449158
36178,801369258,06-08-24 10:28,313.18,Purchase,Pharmacy,8542.269158
36179,801369258,06-08-24 12:28,143.2,OnlineShopping,Etsy,8399.069158
36180,801369258,06-08-24 21:28,1200,Payment,Credit Card Payment,7199.069158
36181,801369258,06-09-24 13:28,214.17,Return,Best Buy Return,7413.239158
36182,801369258,06-12-24 11:28,182,Payment,Loan Payment,7231.239158
36183,801369258,6-13-24 17:28,286.11,Payment,Loan Payment,6945.129158
36184,801369258,6-14-24 20:28,124.79,OnlineShopping,Amazon,6820.339158
36185,801369258,6-15-24 21:28,1800,Payment,Subscription Payment,5020.339158
36186,801369258,6-16-24 12:28,397.51,Purchase,Pharmacy,4622.829158
36187,801369258,6-18-24 17:28,365.9,Withdrawal,Branch Withdrawal,4256.929158
36188,801369258,6-23-24 16:28,38.59,OutgoingTransfer,Wire Transfer,4218.339158
36189,801369258,6-28-24 16:28,116.95,Withdrawal,Branch Withdrawal,4101.389158
36190,801369258,07-05-24 21:28,4400,IncomingTransfer,Salary,8501.389158
36191,801369258,07-10-24 16:28,138.42,Purchase,Clothing,8362.969158
36192,801369258,07-10-24 21:28,1000,Payment,Credit Card Payment,7362.969158
36193,801369258,7-15-24 21:28,1900,Payment,Insurance Payment,5462.969158
36194,802031583,1-21-24 11:28,417.08,Purchase,Furniture,-417.08
36195,802031583,1-28-24 16:28,354.44,Purchase,Travel,-771.52
36196,802031583,02-01-24 21:28,7400,IncomingTransfer,Salary,6628.48
36197,802031583,02-02-24 10:28,483.86,Return,Walmart Return,7112.34
36198,802031583,02-12-24 13:28,487.34,Deposit,Cash Deposit,7599.68
36199,802031583,02-12-24 22:28,468.69,OnlineShopping,Best Buy,7130.99
36200,802031583,2-15-24 14:28,179.82,Withdrawal,Branch Withdrawal,6951.17
36201,802031583,2-16-24 21:28,170.61,Deposit,Check Deposit,7121.78
36202,802031583,2-18-24 12:28,662.6,Withdrawal,Mobile App Withdrawal,6459.18
36203,802031583,2-18-24 21:28,2400,Payment,Rent Payment,4059.18
36204,802031583,2-19-24 16:28,686.54,Deposit,Cash Deposit,4745.72
36205,802031583,2-19-24 21:28,439.88,OutgoingTransfer,International Transfer,4305.84
36206,802031583,2-21-24 17:28,403.15,OutgoingTransfer,Bank Transfer,3902.69
36207,802031583,2-24-24 12:28,422.48,Purchase,Pharmacy,3480.21
36208,802031583,2-25-24 14:28,345.49,Deposit,Mobile Deposit,3825.7
36209,802031583,2-29-24 9:28,651.17,Purchase,Gas,3174.53
36210,802031583,2-29-24 11:28,223.44,Return,Etsy Return,3397.97
36211,802031583,03-01-24 19:28,529.03,IncomingTransfer,Freelance Payment,3927
36212,802031583,03-03-24 21:28,7400,IncomingTransfer,Salary,11327
36213,802031583,03-05-24 12:28,504.57,Withdrawal,Mobile App Withdrawal,10822.43
36214,802031583,03-05-24 19:28,636.81,Deposit,Cash Deposit,11459.24
36215,802031583,03-09-24 19:28,285.56,Payment,Loan Payment,11173.68
36216,802031583,03-10-24 21:28,2700,Payment,Rent Payment,8473.68
36217,802031583,3-13-24 17:28,124.52,Purchase,Electronics,8349.16
36218,802031583,3-19-24 11:28,646.4,OnlineShopping,Best Buy,7702.76
36219,802031583,3-19-24 18:28,472.91,Deposit,Mobile Deposit,8175.67
36220,802031583,3-19-24 21:28,146.2,Withdrawal,ATM Withdrawal,8029.47
36221,802031583,3-20-24 9:28,405.39,Deposit,Direct Deposit,8434.86
36222,802031583,3-21-24 13:28,234.9,Purchase,Electronics,8199.96
36223,802031583,3-22-24 11:28,299.81,OutgoingTransfer,Wire Transfer,7900.15
36224,802031583,3-24-24 10:28,691.56,Return,Walmart Return,8591.71
36225,802031583,3-25-24 21:28,210.56,Deposit,Check Deposit,8802.27
36226,802031583,3-26-24 22:28,110.72,Withdrawal,ATM Withdrawal,8691.55
36227,802031583,3-31-24 13:28,323.22,Deposit,Mobile Deposit,9014.77
36228,802031583,04-01-24 21:28,7400,IncomingTransfer,Salary,16414.77
36229,802031583,04-02-24 14:28,608.66,Payment,Bill Payment,15806.11
36230,802031583,04-09-24 20:28,697.86,Return,Target Return,16503.97
36231,802031583,04-11-24 23:28,128.28,Deposit,Cash Deposit,16632.25
36232,802031583,04-12-24 16:28,197.47,Purchase,Travel,16434.78
36233,802031583,4-14-24 15:28,503.4,OnlineShopping,Target,15931.38
36234,802031583,4-16-24 13:28,570.88,Withdrawal,ATM Withdrawal,15360.5
36235,802031583,4-17-24 21:28,3000,Payment,Rent Payment,12360.5
36236,802031583,4-20-24 20:28,645.16,Deposit,Direct Deposit,13005.66
36237,802031583,4-20-24 20:28,164.33,Deposit,Direct Deposit,13169.99
36238,802031583,4-21-24 10:28,291.08,Purchase,Furniture,12878.91
36239,802031583,4-21-24 20:28,740.97,Withdrawal,Branch Withdrawal,12137.94
36240,802031583,4-23-24 15:28,162.21,Return,eBay Return,12300.15
36241,802031583,4-23-24 20:28,126.77,Deposit,Check Deposit,12426.92
36242,802031583,4-24-24 11:28,508.54,Return,Walmart Return,12935.46
36243,802031583,4-26-24 11:28,208.02,Deposit,Direct Deposit,13143.48
36244,802031583,4-26-24 19:28,248.97,Withdrawal,Branch Withdrawal,12894.51
36245,802031583,4-28-24 20:28,117.63,Deposit,Cash Deposit,13012.14
36246,802031583,4-30-24 20:28,364.01,Withdrawal,Branch Withdrawal,12648.13
36247,802031583,4-30-24 20:28,115.15,OutgoingTransfer,Wire Transfer,12532.98
36248,802031583,4-30-24 23:28,152.6,Deposit,Mobile Deposit,12685.58
36249,802031583,05-02-24 21:28,7400,IncomingTransfer,Salary,20085.58
36250,802031583,05-04-24 14:28,572.73,Purchase,Pharmacy,19512.85
36251,802031583,05-08-24 12:28,151.3,Deposit,Mobile Deposit,19664.15
36252,802031583,05-09-24 13:28,630.61,Purchase,Gas,19033.54
36253,802031583,5-13-24 20:28,447.9,Deposit,Direct Deposit,19481.44
36254,802031583,5-16-24 11:28,122.78,OnlineShopping,Best Buy,19358.66
36255,802031583,5-16-24 22:28,354.44,Withdrawal,Branch Withdrawal,19004.22
36256,802031583,5-17-24 21:28,3700,Payment,Rent Payment,15304.22
36257,802031583,5-20-24 15:28,710.49,Payment,Mortgage Payment,14593.73
36258,802031583,5-20-24 19:28,207.61,Return,Store Return,14801.34
36259,802031583,5-20-24 23:28,391.84,Deposit,Direct Deposit,15193.18
36260,802031583,5-23-24 18:28,305.34,OnlineShopping,Best Buy,14887.84
36261,802031583,5-24-24 12:28,618.42,Withdrawal,ATM Withdrawal,14269.42
36262,802031583,5-26-24 20:28,347.95,Return,Walmart Return,14617.37
36263,802031583,06-01-24 20:28,176.86,Purchase,Travel,14440.51
36264,802031583,06-02-24 19:28,736.22,OnlineShopping,eBay,13704.29
36265,802031583,06-05-24 21:28,7400,IncomingTransfer,Salary,21104.29
36266,802031583,06-08-24 19:28,706.02,Deposit,Cash Deposit,21810.31
36267,802031583,06-12-24 20:28,731.86,Payment,Bill Payment,21078.45
36268,802031583,6-16-24 20:28,280.81,Deposit,Mobile Deposit,21359.26
36269,802031583,6-17-24 21:28,2000,Payment,Rent Payment,19359.26
36270,802031583,6-18-24 10:28,176.54,Withdrawal,ATM Withdrawal,19182.72
36271,802031583,6-18-24 11:28,416.03,OutgoingTransfer,International Transfer,18766.69
36272,802031583,6-18-24 16:28,550.44,Purchase,Clothing,18216.25
36273,802031583,6-19-24 12:28,502.81,Payment,Loan Payment,17713.44
36274,802031583,6-21-24 11:28,359.54,Deposit,Cash Deposit,18072.98
36275,802031583,6-24-24 16:28,240.39,OnlineShopping,AliExpress,17832.59
36276,802031583,6-28-24 11:28,732.45,Purchase,Clothing,17100.14
36277,802031583,6-28-24 19:28,384.95,Deposit,Direct Deposit,17485.09
36278,802031583,07-02-24 17:28,522.56,Purchase,Home Improvement,16962.53
36279,802031583,07-02-24 21:28,7400,IncomingTransfer,Salary,24362.53
36280,802031583,07-03-24 23:28,631.02,Payment,Mortgage Payment,23731.51
36281,802031583,07-04-24 9:28,436.28,Deposit,Cash Deposit,24167.79
36282,802031583,07-06-24 15:28,632.86,OnlineShopping,Walmart,23534.93
36283,802031583,07-09-24 18:28,688.94,Payment,Mortgage Payment,22845.99
36284,802031583,07-10-24 20:28,516.4,Return,Target Return,23362.39
36285,802031583,07-11-24 12:28,666.57,OutgoingTransfer,Peer-to-Peer Transfer,22695.82
36286,802031583,07-12-24 11:28,391.45,Deposit,Direct Deposit,23087.27
36287,802031583,7-16-24 9:28,286.98,OutgoingTransfer,International Transfer,22800.29
36288,802031583,7-17-24 21:28,2000,Payment,Rent Payment,20800.29
36289,802666083,1-20-24 14:28,136.57,Deposit,Cash Deposit,136.57
36290,802666083,1-20-24 22:28,185.17,Withdrawal,Mobile App Withdrawal,-48.6
36291,802666083,1-24-24 12:28,174.6,Withdrawal,Mobile App Withdrawal,-223.2
36292,802666083,1-24-24 16:28,91.56,Return,Walmart Return,-131.64
36293,802666083,1-26-24 17:28,54.23,OnlineShopping,AliExpress,-185.87
36294,802666083,1-29-24 18:28,95.01,OnlineShopping,AliExpress,-280.88
36295,802666083,1-30-24 10:28,218.21,OnlineShopping,eBay,-499.09
36296,802666083,1-30-24 23:28,39.45,Payment,Loan Payment,-538.54
36297,802666083,02-01-24 12:28,95.09,OutgoingTransfer,Bank Transfer,-633.63
36298,802666083,02-01-24 16:28,96.65,OutgoingTransfer,International Transfer,-730.28
36299,802666083,02-03-24 11:28,64.17,Payment,Loan Payment,-794.45
36300,802666083,02-03-24 21:28,2350,IncomingTransfer,Salary,1555.55
36301,802666083,02-04-24 15:28,131.19,Payment,Bill Payment,1424.36
36302,802666083,02-05-24 15:28,191.46,Payment,Bill Payment,1232.9
36303,802666083,02-05-24 17:28,226.14,Withdrawal,Branch Withdrawal,1006.76
36304,802666083,02-08-24 14:28,99.15,Withdrawal,Mobile App Withdrawal,907.61
36305,802666083,02-10-24 11:28,141.33,Return,Etsy Return,1048.94
36306,802666083,02-11-24 21:28,700,Payment,Rent Payment,348.94
36307,802666083,2-15-24 18:28,120.66,Deposit,Check Deposit,469.6
36308,802666083,2-20-24 11:28,214.62,Payment,Mortgage Payment,254.98
36309,802666083,2-21-24 23:28,113.95,Deposit,Check Deposit,368.93
36310,802666083,2-22-24 10:28,212.76,Purchase,Grocery,156.17
36311,802666083,2-24-24 15:28,126.57,OutgoingTransfer,International Transfer,29.6
36312,802666083,03-01-24 18:28,237.45,OutgoingTransfer,Wire Transfer,-207.85
36313,802666083,03-02-24 21:28,2350,IncomingTransfer,Salary,2142.15
36314,802666083,03-11-24 23:28,144.49,Purchase,Home Improvement,1997.66
36315,802666083,3-16-24 21:28,18.99,Payment,Bill Payment,1978.67
36316,802666083,3-17-24 21:28,1300,Payment,Rent Payment,678.67
36317,802666083,3-21-24 11:28,61.73,Deposit,Direct Deposit,740.4
36318,802666083,3-24-24 22:28,244.07,Purchase,Pharmacy,496.33
36319,802666083,3-25-24 20:28,188.4,Payment,Mortgage Payment,307.93
36320,802666083,3-29-24 15:28,220.51,Return,Best Buy Return,528.44
36321,802666083,04-01-24 21:28,2350,IncomingTransfer,Salary,2878.44
36322,802666083,04-03-24 22:28,195.29,Payment,Bill Payment,2683.15
36323,802666083,04-03-24 22:28,235.72,Deposit,Mobile Deposit,2918.87
36324,802666083,04-03-24 23:28,178.59,Deposit,Direct Deposit,3097.46
36325,802666083,04-11-24 16:28,91.89,Deposit,Cash Deposit,3189.35
36326,802666083,4-13-24 21:28,1400,Payment,Rent Payment,1789.35
36327,802666083,4-23-24 11:28,170.4,OutgoingTransfer,International Transfer,1618.95
36328,802666083,4-24-24 23:28,67.9,OutgoingTransfer,Wire Transfer,1551.05
36329,802666083,4-26-24 17:28,67.85,Return,Etsy Return,1618.9
36330,802666083,05-02-24 21:28,2350,IncomingTransfer,Salary,3968.9
36331,802666083,05-10-24 22:28,195.88,Withdrawal,Mobile App Withdrawal,3773.02
36332,802666083,05-10-24 23:28,229.49,Withdrawal,Branch Withdrawal,3543.53
36333,802666083,05-11-24 10:28,179.78,Withdrawal,Mobile App Withdrawal,3363.75
36334,802666083,5-14-24 11:28,39.65,Purchase,Entertainment,3324.1
36335,802666083,5-14-24 21:28,1400,Payment,Rent Payment,1924.1
36336,802666083,5-18-24 20:28,24.16,Return,Amazon Return,1948.26
36337,802666083,5-19-24 15:28,13.46,Purchase,Entertainment,1934.8
36338,802666083,5-20-24 12:28,88.5,Withdrawal,Mobile App Withdrawal,1846.3
36339,802666083,5-26-24 20:28,158.78,Purchase,Electronics,1687.52
36340,802666083,06-01-24 17:28,76,OutgoingTransfer,Bank Transfer,1611.52
36341,802666083,06-03-24 11:28,221.14,OutgoingTransfer,Peer-to-Peer Transfer,1390.38
36342,802666083,06-03-24 21:28,2350,IncomingTransfer,Salary,3740.38
36343,802666083,06-03-24 23:28,125.02,Purchase,Restaurant,3615.36
36344,802666083,06-12-24 12:28,121.78,Withdrawal,Mobile App Withdrawal,3493.58
36345,802666083,6-14-24 20:28,74.56,Purchase,Gas,3419.02
36346,802666083,6-15-24 16:28,185.69,OnlineShopping,eBay,3233.33
36347,802666083,6-17-24 21:28,1000,Payment,Rent Payment,2233.33
36348,802666083,6-23-24 18:28,46.71,Payment,Bill Payment,2186.62
36349,802666083,6-24-24 18:28,172.45,Return,Target Return,2359.07
36350,802666083,6-26-24 15:28,202,Deposit,Check Deposit,2561.07
36351,802666083,6-26-24 19:28,65.61,Deposit,Check Deposit,2626.68
36352,802666083,6-27-24 20:28,75.51,Deposit,Direct Deposit,2702.19
36353,802666083,6-27-24 23:28,80.62,Purchase,Travel,2621.57
36354,802666083,6-28-24 14:28,218.7,OnlineShopping,Etsy,2402.87
36355,802666083,07-03-24 19:28,70.28,Purchase,Entertainment,2332.59
36356,802666083,07-04-24 21:28,2350,IncomingTransfer,Salary,4682.59
36357,802666083,07-05-24 13:28,199.46,Payment,Bill Payment,4483.13
36358,802666083,07-05-24 14:28,249.23,OutgoingTransfer,Wire Transfer,4233.9
36359,802666083,07-07-24 21:28,146.17,Deposit,Mobile Deposit,4380.07
36360,802666083,07-08-24 17:28,87.86,IncomingTransfer,Freelance Payment,4467.93
36361,802666083,7-14-24 12:28,83.31,Purchase,Travel,4384.62
36362,802666083,7-15-24 21:28,600,Payment,Rent Payment,3784.62
36363,802666083,7-17-24 13:28,182.65,Deposit,Check Deposit,3967.27
36364,803339583,1-20-24 22:28,205.42,Payment,Loan Payment,-205.42
36365,803339583,1-21-24 13:28,83.44,Return,eBay Return,-121.98
36366,803339583,1-23-24 17:28,165.28,Withdrawal,Mobile App Withdrawal,-287.26
36367,803339583,1-28-24 17:28,101.45,Payment,Loan Payment,-388.71
36368,803339583,1-29-24 21:28,69.48,Payment,Mortgage Payment,-458.19
36369,803339583,1-30-24 12:28,74.44,Payment,Loan Payment,-532.63
36370,803339583,02-04-24 18:28,175.07,Purchase,Gas,-707.7
36371,803339583,02-09-24 22:28,104.77,Purchase,Travel,-812.47
36372,803339583,02-10-24 20:28,204.17,Deposit,Check Deposit,-608.3
36373,803339583,2-13-24 13:28,57.11,Purchase,Travel,-665.41
36374,803339583,2-17-24 17:28,29.58,Withdrawal,Branch Withdrawal,-694.99
36375,803339583,2-20-24 11:28,184.97,Purchase,Furniture,-879.96
36376,803339583,2-22-24 12:28,114.92,Purchase,Pharmacy,-994.88
36377,803339583,2-22-24 14:28,124,Purchase,Furniture,-1118.88
36378,803339583,2-25-24 14:28,233.95,Payment,Bill Payment,-1352.83
36379,803339583,2-26-24 21:28,37.64,OnlineShopping,AliExpress,-1390.47
36380,803339583,2-27-24 22:28,78.8,OutgoingTransfer,Peer-to-Peer Transfer,-1469.27
36381,803339583,03-08-24 20:28,37.15,Return,eBay Return,-1432.12
36382,803339583,03-12-24 18:28,226.55,Purchase,Electronics,-1658.67
36383,803339583,3-15-24 23:28,56.48,OnlineShopping,Walmart,-1715.15
36384,803339583,3-16-24 16:28,39.62,Withdrawal,ATM Withdrawal,-1754.77
36385,803339583,3-17-24 15:28,62.88,OnlineShopping,Walmart,-1817.65
36386,803339583,3-17-24 16:28,204.3,Return,Target Return,-1613.35
36387,803339583,3-18-24 19:28,136.57,OnlineShopping,Best Buy,-1749.92
36388,803339583,3-18-24 23:28,35.07,Return,Amazon Return,-1714.85
36389,803339583,3-21-24 11:28,57.94,OnlineShopping,Target,-1772.79
36390,803339583,3-21-24 14:28,18.38,OutgoingTransfer,Peer-to-Peer Transfer,-1791.17
36391,803339583,3-21-24 14:28,149.43,OutgoingTransfer,Peer-to-Peer Transfer,-1940.6
36392,803339583,3-27-24 23:28,174.1,Deposit,Cash Deposit,-1766.5
36393,803339583,3-29-24 11:28,107.57,Return,eBay Return,-1658.93
36394,803339583,3-30-24 19:28,243.75,Payment,Mortgage Payment,-1902.68
36395,803339583,04-06-24 13:28,130.41,Deposit,Check Deposit,-1772.27
36396,803339583,04-08-24 23:28,148.54,OutgoingTransfer,Bank Transfer,-1920.81
36397,803339583,04-10-24 10:28,68.64,Payment,Loan Payment,-1989.45
36398,803339583,04-10-24 22:28,159.83,Payment,Bill Payment,-2149.28
36399,803339583,04-12-24 11:28,36.64,Deposit,Mobile Deposit,-2112.64
36400,803339583,4-16-24 12:28,232.37,Deposit,Check Deposit,-1880.27
36401,803339583,4-16-24 20:28,88.3,Withdrawal,ATM Withdrawal,-1968.57
36402,803339583,4-17-24 12:28,198.51,Return,Walmart Return,-1770.06
36403,803339583,4-17-24 17:28,167.08,Return,Best Buy Return,-1602.98
36404,803339583,4-17-24 20:28,143.38,Payment,Mortgage Payment,-1746.36
36405,803339583,4-19-24 12:28,164.86,Return,Store Return,-1581.5
36406,803339583,4-19-24 18:28,106.73,Payment,Bill Payment,-1688.23
36407,803339583,4-19-24 23:28,19.84,Deposit,Mobile Deposit,-1668.39
36408,803339583,4-20-24 22:28,94.19,OnlineShopping,eBay,-1762.58
36409,803339583,4-22-24 21:28,160.88,Withdrawal,Mobile App Withdrawal,-1923.46
36410,803339583,4-24-24 13:28,249.17,Payment,Bill Payment,-2172.63
36411,803339583,4-25-24 13:28,144.34,Deposit,Check Deposit,-2028.29
36412,803339583,4-27-24 15:28,113.15,OutgoingTransfer,International Transfer,-2141.44
36413,803339583,4-28-24 10:28,161.32,Withdrawal,Branch Withdrawal,-2302.76
36414,803339583,4-29-24 13:28,128.89,Payment,Mortgage Payment,-2431.65
36415,803339583,05-01-24 11:28,98.72,OnlineShopping,eBay,-2530.37
36416,803339583,05-02-24 11:28,32.96,Return,eBay Return,-2497.41
36417,803339583,05-03-24 12:28,108.37,IncomingTransfer,Freelance Payment,-2389.04
36418,803339583,05-03-24 14:28,242.89,Deposit,Cash Deposit,-2146.15
36419,803339583,05-06-24 11:28,54.56,Withdrawal,ATM Withdrawal,-2200.71
36420,803339583,05-06-24 13:28,78.32,Deposit,Direct Deposit,-2122.39
36421,803339583,05-06-24 15:28,78.67,Withdrawal,ATM Withdrawal,-2201.06
36422,803339583,05-11-24 15:28,79.02,Withdrawal,Mobile App Withdrawal,-2280.08
36423,803339583,05-12-24 16:28,174.96,Payment,Bill Payment,-2455.04
36424,803339583,5-16-24 18:28,56.97,Withdrawal,Mobile App Withdrawal,-2512.01
36425,803339583,5-29-24 20:28,239.45,IncomingTransfer,Freelance Payment,-2272.56
36426,803339583,5-29-24 23:28,28.81,OnlineShopping,Target,-2301.37
36427,803339583,5-30-24 21:28,24.23,OnlineShopping,Amazon,-2325.6
36428,803339583,06-01-24 19:28,13.15,Deposit,Mobile Deposit,-2312.45
36429,803339583,06-02-24 13:28,123.71,Payment,Mortgage Payment,-2436.16
36430,803339583,06-02-24 22:28,10.67,Withdrawal,Mobile App Withdrawal,-2446.83
36431,803339583,06-04-24 14:28,30.86,OnlineShopping,AliExpress,-2477.69
36432,803339583,06-06-24 20:28,132.51,Deposit,Check Deposit,-2345.18
36433,803339583,06-06-24 23:28,44.36,Deposit,Direct Deposit,-2300.82
36434,803339583,06-12-24 17:28,147.6,Purchase,Electronics,-2448.42
36435,803339583,6-21-24 18:28,132.02,Payment,Bill Payment,-2580.44
36436,803339583,6-22-24 13:28,79.64,Purchase,Clothing,-2660.08
36437,803339583,6-26-24 13:28,202.65,Withdrawal,Branch Withdrawal,-2862.73
36438,803339583,6-28-24 18:28,136,Return,Etsy Return,-2726.73
36439,803339583,07-01-24 9:28,66.49,Deposit,Mobile Deposit,-2660.24
36440,803339583,07-01-24 20:28,93.98,Withdrawal,Branch Withdrawal,-2754.22
36441,803339583,07-02-24 15:28,156.52,OutgoingTransfer,International Transfer,-2910.74
36442,803339583,07-09-24 9:28,218.74,Deposit,Mobile Deposit,-2692
36443,803339583,07-09-24 18:28,175.32,OnlineShopping,AliExpress,-2867.32
36444,803339583,07-10-24 22:28,13.79,Deposit,Mobile Deposit,-2853.53
36445,803339583,07-11-24 22:28,77.42,Deposit,Check Deposit,-2776.11
36446,803347908,1-27-24 12:28,15.86,Purchase,Home Improvement,-15.86
36447,803347908,1-30-24 21:28,219.76,Purchase,Grocery,-235.62
36448,803347908,02-02-24 10:28,174.03,OutgoingTransfer,International Transfer,-409.65
36449,803347908,02-04-24 13:28,44.04,Withdrawal,ATM Withdrawal,-453.69
36450,803347908,02-04-24 21:28,3250,IncomingTransfer,Salary,2796.31
36451,803347908,02-09-24 22:28,11.94,Return,Best Buy Return,2808.25
36452,803347908,02-11-24 17:28,205.57,Purchase,Entertainment,2602.68
36453,803347908,02-12-24 9:28,182.75,OnlineShopping,Walmart,2419.93
36454,803347908,2-13-24 17:28,138.58,OutgoingTransfer,Bank Transfer,2281.35
36455,803347908,2-15-24 14:28,214.78,Deposit,Direct Deposit,2496.13
36456,803347908,2-16-24 15:28,99.5,Withdrawal,Mobile App Withdrawal,2396.63
36457,803347908,2-18-24 21:28,1300,Payment,Rent Payment,1096.63
36458,803347908,2-21-24 23:28,214.86,Return,Target Return,1311.49
36459,803347908,2-24-24 13:28,243.39,OnlineShopping,AliExpress,1068.1
36460,803347908,2-24-24 21:28,172.89,OutgoingTransfer,Peer-to-Peer Transfer,895.21
36461,803347908,2-27-24 11:28,147.58,Payment,Loan Payment,747.63
36462,803347908,2-27-24 15:28,55.56,Deposit,Direct Deposit,803.19
36463,803347908,2-29-24 13:28,151,Purchase,Restaurant,652.19
36464,803347908,03-01-24 10:28,90.15,Withdrawal,ATM Withdrawal,562.04
36465,803347908,03-01-24 21:28,3250,IncomingTransfer,Salary,3812.04
36466,803347908,03-06-24 18:28,141.1,Return,Store Return,3953.14
36467,803347908,03-12-24 20:28,162.92,OutgoingTransfer,Peer-to-Peer Transfer,3790.22
36468,803347908,3-14-24 15:28,25.94,Purchase,Gas,3764.28
36469,803347908,3-14-24 21:28,1500,Payment,Rent Payment,2264.28
36470,803347908,3-22-24 17:28,84.86,Payment,Loan Payment,2179.42
36471,803347908,3-24-24 15:28,51.04,Payment,Mortgage Payment,2128.38
36472,803347908,3-30-24 20:28,246.04,OutgoingTransfer,Bank Transfer,1882.34
36473,803347908,04-01-24 21:28,3250,IncomingTransfer,Salary,5132.34
36474,803347908,04-04-24 16:28,168.21,Purchase,Grocery,4964.13
36475,803347908,04-06-24 13:28,80.42,Return,Target Return,5044.55
36476,803347908,04-06-24 14:28,51.9,Return,Amazon Return,5096.45
36477,803347908,04-06-24 15:28,109.11,Purchase,Home Improvement,4987.34
36478,803347908,04-07-24 22:28,44.87,IncomingTransfer,Freelance Payment,5032.21
36479,803347908,04-09-24 11:28,161.4,Deposit,Cash Deposit,5193.61
36480,803347908,04-12-24 21:28,116.54,IncomingTransfer,Freelance Payment,5310.15
36481,803347908,4-14-24 13:28,52.6,Purchase,Gas,5257.55
36482,803347908,4-15-24 14:28,81.55,Deposit,Direct Deposit,5339.1
36483,803347908,4-18-24 21:28,1400,Payment,Rent Payment,3939.1
36484,803347908,4-22-24 22:28,42.16,OnlineShopping,AliExpress,3896.94
36485,803347908,4-26-24 9:28,197.81,Return,AliExpress Return,4094.75
36486,803347908,4-26-24 18:28,69.63,Return,Walmart Return,4164.38
36487,803347908,4-29-24 15:28,185.97,Withdrawal,Mobile App Withdrawal,3978.41
36488,803347908,4-30-24 15:28,170.86,Purchase,Entertainment,3807.55
36489,803347908,05-01-24 21:28,3250,IncomingTransfer,Salary,7057.55
36490,803347908,05-02-24 16:28,231.87,Purchase,Travel,6825.68
36491,803347908,05-06-24 22:28,47.46,Deposit,Direct Deposit,6873.14
36492,803347908,05-09-24 19:28,186.4,Payment,Mortgage Payment,6686.74
36493,803347908,05-10-24 15:28,154.79,Withdrawal,Mobile App Withdrawal,6531.95
36494,803347908,05-11-24 22:28,245.38,Purchase,Grocery,6286.57
36495,803347908,5-13-24 17:28,96.46,OutgoingTransfer,Bank Transfer,6190.11
36496,803347908,5-14-24 15:28,246.99,OutgoingTransfer,International Transfer,5943.12
36497,803347908,5-17-24 21:28,1200,Payment,Rent Payment,4743.12
36498,803347908,5-19-24 11:28,183.91,Withdrawal,ATM Withdrawal,4559.21
36499,803347908,5-20-24 13:28,52.66,Deposit,Direct Deposit,4611.87
36500,803347908,5-22-24 16:28,180.53,Purchase,Gas,4431.34
36501,803347908,5-24-24 9:28,236.24,OnlineShopping,Walmart,4195.1
36502,803347908,5-25-24 11:28,110.22,Purchase,Electronics,4084.88
36503,803347908,5-31-24 9:28,222.76,Deposit,Cash Deposit,4307.64
36504,803347908,06-01-24 16:28,197.33,Purchase,Travel,4110.31
36505,803347908,06-02-24 21:28,3250,IncomingTransfer,Salary,7360.31
36506,803347908,06-06-24 19:28,55.89,Withdrawal,ATM Withdrawal,7304.42
36507,803347908,06-07-24 10:28,129.63,Payment,Loan Payment,7174.79
36508,803347908,06-10-24 22:28,116.03,Deposit,Cash Deposit,7290.82
36509,803347908,06-12-24 21:28,136.64,Return,Best Buy Return,7427.46
36510,803347908,6-13-24 16:28,238.01,Purchase,Grocery,7189.45
36511,803347908,6-16-24 21:28,1400,Payment,Rent Payment,5789.45
36512,803347908,6-19-24 21:28,163.53,Withdrawal,Branch Withdrawal,5625.92
36513,803347908,6-21-24 13:28,217.55,Payment,Loan Payment,5408.37
36514,803347908,6-21-24 23:28,51.77,Withdrawal,ATM Withdrawal,5356.6
36515,803347908,6-22-24 15:28,225.04,Purchase,Pharmacy,5131.56
36516,803347908,6-28-24 10:28,141.09,Withdrawal,ATM Withdrawal,4990.47
36517,803347908,07-01-24 21:28,3250,IncomingTransfer,Salary,8240.47
36518,803347908,07-03-24 20:28,147.35,OnlineShopping,eBay,8093.12
36519,803347908,07-10-24 18:28,97.17,Return,Etsy Return,8190.29
36520,803347908,07-12-24 21:28,1500,Payment,Rent Payment,6690.29
36521,803347908,7-14-24 13:28,235.32,Withdrawal,Branch Withdrawal,6454.97
36522,803347908,7-17-24 17:28,233.66,Deposit,Check Deposit,6688.63
36523,803587533,1-20-24 17:28,443.44,OutgoingTransfer,Peer-to-Peer Transfer,724.816538
36524,803587533,1-24-24 15:28,170.42,Purchase,Restaurant,554.396538
36525,803587533,1-30-24 10:28,347.34,Purchase,Grocery,207.056538
36526,803587533,1-31-24 11:28,91.51,Return,eBay Return,298.566538
36527,803587533,02-01-24 13:28,50.64,OutgoingTransfer,Wire Transfer,247.926538
36528,803587533,02-03-24 21:28,6100,IncomingTransfer,Salary,6347.926538
36529,803587533,02-05-24 10:28,100.19,Purchase,Entertainment,6247.736538
36530,803587533,02-07-24 9:28,232.34,Deposit,Check Deposit,6480.076538
36531,803587533,02-08-24 12:28,293.12,Purchase,Clothing,6186.956538
36532,803587533,02-08-24 21:28,2400,Payment,Credit Card Payment,3786.956538
36533,803587533,02-11-24 18:28,461.8,Withdrawal,ATM Withdrawal,3325.156538
36534,803587533,02-12-24 21:28,2500,Payment,Installment Payment,825.156538
36535,803587533,2-13-24 22:28,259.92,Deposit,Cash Deposit,1085.076538
36536,803587533,2-13-24 23:28,89.37,Payment,Mortgage Payment,995.706538
36537,803587533,2-14-24 10:28,110.46,Deposit,Check Deposit,1106.166538
36538,803587533,2-17-24 10:28,171.08,Purchase,Electronics,935.086538
36539,803587533,2-19-24 16:28,94.06,Withdrawal,ATM Withdrawal,841.026538
36540,803587533,2-20-24 10:28,484.43,Purchase,Home Improvement,356.596538
36541,803587533,2-20-24 18:28,430.95,Payment,Bill Payment,-74.35346204
36542,803587533,2-22-24 22:28,473.75,Payment,Loan Payment,-548.103462
36543,803587533,2-22-24 22:28,245.82,OnlineShopping,Walmart,-793.923462
36544,803587533,2-26-24 19:28,99.23,Withdrawal,Branch Withdrawal,-893.153462
36545,803587533,03-01-24 21:28,340.27,Deposit,Check Deposit,-552.883462
36546,803587533,03-02-24 17:28,518.6,Purchase,Electronics,-1071.483462
36547,803587533,03-05-24 21:28,6100,IncomingTransfer,Salary,5028.516538
36548,803587533,03-06-24 19:28,149.74,Withdrawal,Mobile App Withdrawal,4878.776538
36549,803587533,03-08-24 22:28,343.45,Return,Best Buy Return,5222.226538
36550,803587533,03-10-24 21:28,2200,Payment,Credit Card Payment,3022.226538
36551,803587533,3-13-24 12:28,539.73,OnlineShopping,Walmart,2482.496538
36552,803587533,3-14-24 21:28,2300,Payment,Installment Payment,182.496538
36553,803587533,3-16-24 11:28,199.37,Deposit,Cash Deposit,381.866538
36554,803587533,3-16-24 19:28,408.01,Deposit,Check Deposit,789.876538
36555,803587533,3-16-24 19:28,325.92,IncomingTransfer,Freelance Payment,1115.796538
36556,803587533,3-19-24 13:28,128.43,Purchase,Restaurant,987.366538
36557,803587533,3-23-24 13:28,58.07,Purchase,Electronics,929.296538
36558,803587533,3-25-24 9:28,234.04,Withdrawal,Mobile App Withdrawal,695.256538
36559,803587533,3-27-24 19:28,419.2,OnlineShopping,eBay,276.056538
36560,803587533,04-02-24 19:28,249.79,Deposit,Mobile Deposit,525.846538
36561,803587533,04-02-24 21:28,6100,IncomingTransfer,Salary,6625.846538
36562,803587533,04-07-24 13:28,176.29,Purchase,Home Improvement,6449.556538
36563,803587533,04-07-24 21:28,2700,Payment,Credit Card Payment,3749.556538
36564,803587533,04-09-24 15:28,447.98,OnlineShopping,Target,3301.576538
36565,803587533,4-13-24 14:28,210.15,Payment,Mortgage Payment,3091.426538
36566,803587533,4-14-24 17:28,300.33,OnlineShopping,Best Buy,2791.096538
36567,803587533,4-14-24 21:28,2200,Payment,Subscription Payment,591.096538
36568,803587533,4-16-24 9:28,421.57,OnlineShopping,Amazon,169.526538
36569,803587533,4-19-24 9:28,203.58,Purchase,Pharmacy,-34.05346204
36570,803587533,4-19-24 14:28,549.5,IncomingTransfer,Freelance Payment,515.446538
36571,803587533,4-21-24 19:28,339.89,Purchase,Electronics,175.556538
36572,803587533,4-22-24 13:28,380.31,OnlineShopping,Walmart,-204.753462
36573,803587533,4-23-24 13:28,196.94,Purchase,Furniture,-401.693462
36574,803587533,4-26-24 13:28,387.98,Deposit,Direct Deposit,-13.71346204
36575,803587533,4-26-24 19:28,497.24,Return,Best Buy Return,483.526538
36576,803587533,4-29-24 12:28,425.21,OnlineShopping,Best Buy,58.31653796
36577,803587533,4-30-24 14:28,303.61,Withdrawal,ATM Withdrawal,-245.293462
36578,803587533,05-01-24 9:28,170.46,Purchase,Clothing,-415.753462
36579,803587533,05-04-24 15:28,120.28,Deposit,Cash Deposit,-295.473462
36580,803587533,05-04-24 17:28,121.88,Purchase,Grocery,-417.353462
36581,803587533,05-05-24 21:28,6100,IncomingTransfer,Salary,5682.646538
36582,803587533,05-06-24 17:28,93.53,OnlineShopping,eBay,5589.116538
36583,803587533,05-06-24 18:28,410.7,Payment,Mortgage Payment,5178.416538
36584,803587533,05-07-24 20:28,283.17,Deposit,Direct Deposit,5461.586538
36585,803587533,05-09-24 21:28,524.28,OutgoingTransfer,Wire Transfer,4937.306538
36586,803587533,05-10-24 21:28,2300,Payment,Credit Card Payment,2637.306538
36587,803587533,05-11-24 21:28,2200,Payment,Subscription Payment,437.306538
36588,803587533,05-12-24 14:28,253.81,Withdrawal,Mobile App Withdrawal,183.496538
36589,803587533,5-13-24 16:28,254.13,OnlineShopping,eBay,-70.63346204
36590,803587533,5-20-24 22:28,227.73,IncomingTransfer,Freelance Payment,157.096538
36591,803587533,5-21-24 20:28,376.86,Deposit,Mobile Deposit,533.956538
36592,803587533,5-21-24 23:28,459.3,Purchase,Furniture,74.65653796
36593,803587533,5-24-24 20:28,106.2,Withdrawal,Branch Withdrawal,-31.54346204
36594,803587533,5-25-24 16:28,392.11,Purchase,Pharmacy,-423.653462
36595,803587533,5-28-24 15:28,448.2,Purchase,Travel,-871.853462
36596,803587533,5-31-24 16:28,324.83,Deposit,Direct Deposit,-547.023462
36597,803587533,06-01-24 22:28,177.19,Withdrawal,ATM Withdrawal,-724.213462
36598,803587533,06-02-24 14:28,407.44,IncomingTransfer,Freelance Payment,-316.773462
36599,803587533,06-03-24 14:28,314.45,Withdrawal,ATM Withdrawal,-631.223462
36600,803587533,06-04-24 21:28,6100,IncomingTransfer,Salary,5468.776538
36601,803587533,06-09-24 20:28,306.07,OnlineShopping,AliExpress,5162.706538
36602,803587533,06-09-24 21:28,2000,Payment,Credit Card Payment,3162.706538
36603,803587533,06-10-24 15:28,374.57,OnlineShopping,Target,2788.136538
36604,803587533,06-10-24 16:28,451.73,Withdrawal,Mobile App Withdrawal,2336.406538
36605,803587533,06-10-24 18:28,176.48,Deposit,Direct Deposit,2512.886538
36606,803587533,06-11-24 12:28,401.01,Withdrawal,Mobile App Withdrawal,2111.876538
36607,803587533,6-14-24 9:28,357.42,OnlineShopping,Target,1754.456538
36608,803587533,6-17-24 21:28,1800,Payment,Subscription Payment,-45.54346204
36609,803587533,6-20-24 11:28,203.93,IncomingTransfer,Freelance Payment,158.386538
36610,803587533,6-22-24 20:28,79.55,Withdrawal,Mobile App Withdrawal,78.83653796
36611,803587533,6-22-24 21:28,431.13,Return,AliExpress Return,509.966538
36612,803587533,6-23-24 22:28,178.64,Return,Store Return,688.606538
36613,803587533,6-25-24 18:28,288.5,Withdrawal,Mobile App Withdrawal,400.106538
36614,803587533,6-27-24 18:28,395.72,IncomingTransfer,Freelance Payment,795.826538
36615,803587533,6-29-24 18:28,224.13,Withdrawal,Mobile App Withdrawal,571.696538
36616,803587533,6-30-24 19:28,461.26,Deposit,Mobile Deposit,1032.956538
36617,803587533,07-01-24 18:28,123.94,Deposit,Check Deposit,1156.896538
36618,803587533,07-01-24 21:28,6100,IncomingTransfer,Salary,7256.896538
36619,803587533,07-01-24 22:28,250.04,OutgoingTransfer,Wire Transfer,7006.856538
36620,803587533,07-04-24 14:28,440.42,Withdrawal,ATM Withdrawal,6566.436538
36621,803587533,07-06-24 21:28,2300,Payment,Credit Card Payment,4266.436538
36622,803587533,07-06-24 22:28,448.52,Purchase,Furniture,3817.916538
36623,803587533,07-07-24 20:28,542.19,Return,Store Return,4360.106538
36624,803587533,07-08-24 18:28,450.78,Purchase,Gas,3909.326538
36625,803587533,7-15-24 22:28,105.63,Return,Best Buy Return,4014.956538
36626,803587533,7-17-24 21:28,2000,Payment,Installment Payment,2014.956538
36627,803963808,1-20-24 18:28,382.3,Deposit,Direct Deposit,382.3
36628,803963808,1-31-24 17:28,181.27,Withdrawal,ATM Withdrawal,201.03
36629,803963808,02-03-24 15:28,695.76,Deposit,Direct Deposit,896.79
36630,803963808,02-04-24 21:28,8200,IncomingTransfer,Salary,9096.79
36631,803963808,02-10-24 20:28,153.89,Payment,Bill Payment,8942.9
36632,803963808,2-14-24 13:28,172.4,Payment,Bill Payment,8770.5
36633,803963808,2-16-24 21:28,4900,Payment,Rent Payment,3870.5
36634,803963808,2-17-24 19:28,309.31,OutgoingTransfer,Wire Transfer,3561.19
36635,803963808,2-17-24 19:28,581.02,Deposit,Check Deposit,4142.21
36636,803963808,2-19-24 12:28,352.91,Return,Store Return,4495.12
36637,803963808,2-20-24 12:28,142.8,IncomingTransfer,Freelance Payment,4637.92
36638,803963808,2-27-24 23:28,403.72,Withdrawal,Mobile App Withdrawal,4234.2
36639,803963808,2-29-24 11:28,509.51,OutgoingTransfer,Wire Transfer,3724.69
36640,803963808,03-02-24 21:28,8200,IncomingTransfer,Salary,11924.69
36641,803963808,03-02-24 22:28,326,Return,Best Buy Return,12250.69
36642,803963808,03-03-24 19:28,315.09,Purchase,Pharmacy,11935.6
36643,803963808,03-06-24 12:28,402.03,Purchase,Home Improvement,11533.57
36644,803963808,03-06-24 21:28,273.07,Deposit,Cash Deposit,11806.64
36645,803963808,03-07-24 16:28,739.95,Return,Best Buy Return,12546.59
36646,803963808,03-07-24 21:28,536.49,Return,Walmart Return,13083.08
36647,803963808,03-08-24 20:28,225.58,Payment,Mortgage Payment,12857.5
36648,803963808,03-09-24 19:28,626.81,OnlineShopping,Etsy,12230.69
36649,803963808,03-10-24 19:28,513.02,Deposit,Cash Deposit,12743.71
36650,803963808,03-11-24 14:28,145.04,Return,AliExpress Return,12888.75
36651,803963808,3-16-24 21:28,4600,Payment,Rent Payment,8288.75
36652,803963808,3-17-24 16:28,166.34,Deposit,Check Deposit,8455.09
36653,803963808,3-20-24 15:28,309.56,Deposit,Direct Deposit,8764.65
36654,803963808,3-20-24 17:28,711,Deposit,Cash Deposit,9475.65
36655,803963808,3-21-24 23:28,395.91,Purchase,Travel,9079.74
36656,803963808,3-22-24 11:28,707.43,Purchase,Grocery,8372.31
36657,803963808,3-24-24 11:28,318.99,Purchase,Home Improvement,8053.32
36658,803963808,3-24-24 20:28,402.95,Payment,Bill Payment,7650.37
36659,803963808,3-26-24 10:28,311.06,Withdrawal,ATM Withdrawal,7339.31
36660,803963808,3-26-24 22:28,264.28,Withdrawal,ATM Withdrawal,7075.03
36661,803963808,3-27-24 17:28,563.95,Return,AliExpress Return,7638.98
36662,803963808,3-28-24 18:28,314.5,Deposit,Mobile Deposit,7953.48
36663,803963808,3-30-24 19:28,343.56,Return,Etsy Return,8297.04
36664,803963808,04-02-24 12:28,525.53,Payment,Bill Payment,7771.51
36665,803963808,04-02-24 21:28,395.07,Deposit,Direct Deposit,8166.58
36666,803963808,04-04-24 21:28,8200,IncomingTransfer,Salary,16366.58
36667,803963808,04-09-24 20:28,405.75,Deposit,Direct Deposit,16772.33
36668,803963808,04-11-24 14:28,421.75,OutgoingTransfer,Bank Transfer,16350.58
36669,803963808,04-11-24 21:28,457.4,Withdrawal,Mobile App Withdrawal,15893.18
36670,803963808,4-16-24 14:28,302.38,Withdrawal,ATM Withdrawal,15590.8
36671,803963808,4-16-24 20:28,519.05,IncomingTransfer,Freelance Payment,16109.85
36672,803963808,4-16-24 21:28,3100,Payment,Rent Payment,13009.85
36673,803963808,4-23-24 16:28,341.32,OnlineShopping,Amazon,12668.53
36674,803963808,4-25-24 21:28,516.71,Withdrawal,Branch Withdrawal,12151.82
36675,803963808,4-29-24 23:28,678.7,Withdrawal,ATM Withdrawal,11473.12
36676,803963808,4-30-24 23:28,476.19,Purchase,Restaurant,10996.93
36677,803963808,05-01-24 21:28,8200,IncomingTransfer,Salary,19196.93
36678,803963808,05-03-24 15:28,559.43,Payment,Bill Payment,18637.5
36679,803963808,05-05-24 10:28,374.23,Withdrawal,Branch Withdrawal,18263.27
36680,803963808,05-05-24 16:28,286.36,Payment,Bill Payment,17976.91
36681,803963808,05-06-24 23:28,134.6,Withdrawal,Branch Withdrawal,17842.31
36682,803963808,05-10-24 15:28,551.83,Payment,Loan Payment,17290.48
36683,803963808,05-10-24 15:28,219.27,Return,AliExpress Return,17509.75
36684,803963808,05-12-24 21:28,4800,Payment,Rent Payment,12709.75
36685,803963808,5-13-24 16:28,382.95,Purchase,Entertainment,12326.8
36686,803963808,5-15-24 10:28,479.99,OnlineShopping,eBay,11846.81
36687,803963808,5-17-24 13:28,149.7,Purchase,Grocery,11697.11
36688,803963808,5-20-24 21:28,528.22,Return,Etsy Return,12225.33
36689,803963808,5-22-24 15:28,670.43,Payment,Loan Payment,11554.9
36690,803963808,5-27-24 20:28,582.4,Payment,Mortgage Payment,10972.5
36691,803963808,5-30-24 11:28,343.81,OutgoingTransfer,Peer-to-Peer Transfer,10628.69
36692,803963808,5-30-24 23:28,732.28,Deposit,Cash Deposit,11360.97
36693,803963808,06-01-24 21:28,8200,IncomingTransfer,Salary,19560.97
36694,803963808,06-08-24 14:28,644.82,Return,eBay Return,20205.79
36695,803963808,06-09-24 19:28,339.43,OnlineShopping,Best Buy,19866.36
36696,803963808,06-10-24 21:28,2100,Payment,Rent Payment,17766.36
36697,803963808,6-15-24 17:28,395.46,Purchase,Restaurant,17370.9
36698,803963808,6-24-24 20:28,582.23,Return,Target Return,17953.13
36699,803963808,6-25-24 20:28,276.72,Payment,Loan Payment,17676.41
36700,803963808,6-25-24 22:28,263.16,Purchase,Gas,17413.25
36701,803963808,6-29-24 19:28,569.35,Deposit,Cash Deposit,17982.6
36702,803963808,6-30-24 10:28,608.63,Purchase,Furniture,17373.97
36703,803963808,07-02-24 23:28,558.82,Withdrawal,ATM Withdrawal,16815.15
36704,803963808,07-02-24 23:28,439.29,Deposit,Check Deposit,17254.44
36705,803963808,07-04-24 21:28,8200,IncomingTransfer,Salary,25454.44
36706,803963808,07-06-24 17:28,112.2,Deposit,Direct Deposit,25566.64
36707,803963808,07-10-24 11:28,451.04,Withdrawal,ATM Withdrawal,25115.6
36708,803963808,07-10-24 20:28,353.11,Purchase,Travel,24762.49
36709,803963808,07-12-24 13:28,252.19,OnlineShopping,Walmart,24510.3
36710,803963808,7-15-24 16:28,476.17,Purchase,Clothing,24034.13
36711,803963808,7-16-24 17:28,429.58,Purchase,Grocery,23604.55
36712,803963808,7-18-24 21:28,5200,Payment,Rent Payment,18404.55
36713,804045933,1-24-24 11:28,234.88,Return,Target Return,1885.333864
36714,804045933,1-24-24 11:28,613.01,Purchase,Pharmacy,1272.323864
36715,804045933,1-24-24 17:28,688.59,IncomingTransfer,Freelance Payment,1960.913864
36716,804045933,1-26-24 15:28,160.64,OutgoingTransfer,International Transfer,1800.273864
36717,804045933,1-31-24 10:28,681.04,Withdrawal,Branch Withdrawal,1119.233864
36718,804045933,1-31-24 10:28,206.96,Return,Store Return,1326.193864
36719,804045933,02-02-24 21:28,9700,IncomingTransfer,Salary,11026.19386
36720,804045933,02-04-24 21:28,740.8,Purchase,Electronics,10285.39386
36721,804045933,02-06-24 15:28,352.27,Withdrawal,ATM Withdrawal,9933.123864
36722,804045933,02-07-24 21:28,3100,Payment,Credit Card Payment,6833.123864
36723,804045933,02-10-24 22:28,550.92,Payment,Bill Payment,6282.203864
36724,804045933,2-14-24 21:28,3500,Payment,Installment Payment,2782.203864
36725,804045933,2-16-24 10:28,375.85,Deposit,Direct Deposit,3158.053864
36726,804045933,2-17-24 20:28,389.34,Return,AliExpress Return,3547.393864
36727,804045933,2-17-24 21:28,127.16,Purchase,Entertainment,3420.233864
36728,804045933,2-24-24 21:28,529.83,OnlineShopping,Amazon,2890.403864
36729,804045933,2-25-24 10:28,375.81,Deposit,Check Deposit,3266.213864
36730,804045933,2-25-24 10:28,516.08,Withdrawal,ATM Withdrawal,2750.133864
36731,804045933,2-25-24 12:28,435,Purchase,Grocery,2315.133864
36732,804045933,2-25-24 19:28,639.25,Purchase,Gas,1675.883864
36733,804045933,2-26-24 9:28,627.07,Withdrawal,ATM Withdrawal,1048.813864
36734,804045933,2-27-24 13:28,712.76,Purchase,Clothing,336.0538638
36735,804045933,2-27-24 15:28,721.77,Withdrawal,Branch Withdrawal,-385.7161362
36736,804045933,2-27-24 20:28,195.84,Withdrawal,Branch Withdrawal,-581.5561362
36737,804045933,03-03-24 21:28,9700,IncomingTransfer,Salary,9118.443864
36738,804045933,03-06-24 14:28,344.76,OutgoingTransfer,Bank Transfer,8773.683864
36739,804045933,03-08-24 21:28,3400,Payment,Credit Card Payment,5373.683864
36740,804045933,03-10-24 21:28,3000,Payment,Insurance Payment,2373.683864
36741,804045933,3-13-24 17:28,527.87,Withdrawal,ATM Withdrawal,1845.813864
36742,804045933,3-14-24 16:28,349.91,Purchase,Gas,1495.903864
36743,804045933,3-17-24 12:28,472.07,Withdrawal,ATM Withdrawal,1023.833864
36744,804045933,3-18-24 14:28,373.62,Payment,Mortgage Payment,650.2138638
36745,804045933,3-18-24 21:28,479.9,Purchase,Travel,170.3138638
36746,804045933,3-26-24 10:28,331.26,Payment,Mortgage Payment,-160.9461362
36747,804045933,3-31-24 14:28,210.99,Withdrawal,ATM Withdrawal,-371.9361362
36748,804045933,04-01-24 19:28,435.56,Deposit,Direct Deposit,63.62386384
36749,804045933,04-02-24 18:28,651.66,Return,AliExpress Return,715.2838638
36750,804045933,04-03-24 21:28,9700,IncomingTransfer,Salary,10415.28386
36751,804045933,04-05-24 19:28,353.22,IncomingTransfer,Freelance Payment,10768.50386
36752,804045933,04-06-24 19:28,353.14,IncomingTransfer,Freelance Payment,11121.64386
36753,804045933,04-06-24 19:28,527.11,OnlineShopping,Target,10594.53386
36754,804045933,04-07-24 20:28,288.07,IncomingTransfer,Freelance Payment,10882.60386
36755,804045933,04-08-24 21:28,3500,Payment,Credit Card Payment,7382.603864
36756,804045933,04-10-24 21:28,3900,Payment,Insurance Payment,3482.603864
36757,804045933,4-14-24 15:28,316.3,Deposit,Mobile Deposit,3798.903864
36758,804045933,4-16-24 12:28,519.03,Deposit,Mobile Deposit,4317.933864
36759,804045933,4-22-24 13:28,428.61,Return,Walmart Return,4746.543864
36760,804045933,05-02-24 21:28,9700,IncomingTransfer,Salary,14446.54386
36761,804045933,05-05-24 18:28,718.75,Purchase,Furniture,13727.79386
36762,804045933,05-07-24 21:28,2500,Payment,Credit Card Payment,11227.79386
36763,804045933,05-08-24 12:28,179.79,Return,eBay Return,11407.58386
36764,804045933,05-09-24 23:28,220.12,Withdrawal,ATM Withdrawal,11187.46386
36765,804045933,5-13-24 16:28,563.65,Payment,Mortgage Payment,10623.81386
36766,804045933,5-15-24 12:28,589.53,Purchase,Grocery,10034.28386
36767,804045933,5-16-24 21:28,3500,Payment,Insurance Payment,6534.283864
36768,804045933,5-16-24 23:28,722.66,IncomingTransfer,Freelance Payment,7256.943864
36769,804045933,5-20-24 23:28,608.89,OutgoingTransfer,Wire Transfer,6648.053864
36770,804045933,5-21-24 14:28,549.84,Withdrawal,Mobile App Withdrawal,6098.213864
36771,804045933,5-22-24 14:28,104,Purchase,Home Improvement,5994.213864
36772,804045933,5-22-24 16:28,558.47,Withdrawal,ATM Withdrawal,5435.743864
36773,804045933,5-22-24 16:28,652.02,Payment,Loan Payment,4783.723864
36774,804045933,5-25-24 11:28,646.62,Payment,Mortgage Payment,4137.103864
36775,804045933,5-26-24 22:28,385.39,Withdrawal,Mobile App Withdrawal,3751.713864
36776,804045933,5-30-24 18:28,394.21,Withdrawal,Branch Withdrawal,3357.503864
36777,804045933,06-03-24 10:28,354.04,Purchase,Travel,3003.463864
36778,804045933,06-05-24 21:28,9700,IncomingTransfer,Salary,12703.46386
36779,804045933,06-06-24 13:28,247.67,Deposit,Mobile Deposit,12951.13386
36780,804045933,06-07-24 20:28,570.48,OutgoingTransfer,Wire Transfer,12380.65386
36781,804045933,06-07-24 20:28,103,Purchase,Pharmacy,12277.65386
36782,804045933,06-07-24 21:28,602.19,Deposit,Check Deposit,12879.84386
36783,804045933,06-08-24 11:28,589.05,Withdrawal,Branch Withdrawal,12290.79386
36784,804045933,06-10-24 21:28,2800,Payment,Credit Card Payment,9490.793864
36785,804045933,06-11-24 16:28,322.59,Withdrawal,ATM Withdrawal,9168.203864
36786,804045933,06-11-24 17:28,746.02,OutgoingTransfer,Wire Transfer,8422.183864
36787,804045933,6-14-24 21:28,4000,Payment,Insurance Payment,4422.183864
36788,804045933,6-16-24 11:28,720.79,OutgoingTransfer,International Transfer,3701.393864
36789,804045933,6-18-24 20:28,661.43,Purchase,Pharmacy,3039.963864
36790,804045933,6-24-24 14:28,623.09,IncomingTransfer,Freelance Payment,3663.053864
36791,804045933,6-24-24 21:28,543,Deposit,Mobile Deposit,4206.053864
36792,804045933,6-30-24 19:28,471.29,Return,Target Return,4677.343864
36793,804045933,07-01-24 21:28,9700,IncomingTransfer,Salary,14377.34386
36794,804045933,07-02-24 23:28,153.03,Deposit,Check Deposit,14530.37386
36795,804045933,07-06-24 21:28,3300,Payment,Credit Card Payment,11230.37386
36796,804045933,07-08-24 18:28,117.61,IncomingTransfer,Freelance Payment,11347.98386
36797,804045933,07-08-24 23:28,684.09,Purchase,Pharmacy,10663.89386
36798,804045933,07-09-24 10:28,271.64,OnlineShopping,eBay,10392.25386
36799,804045933,07-10-24 11:28,628.66,OutgoingTransfer,Bank Transfer,9763.593864
36800,804045933,07-11-24 21:28,3300,Payment,Installment Payment,6463.593864
36801,804045933,07-12-24 13:28,602.36,Payment,Loan Payment,5861.233864
36802,804045933,7-14-24 13:28,720.46,Deposit,Cash Deposit,6581.693864
36803,804045933,7-15-24 13:28,264.22,Return,Store Return,6845.913864
36804,804045933,7-17-24 21:28,517.39,OnlineShopping,Amazon,6328.523864
36805,804434058,1-25-24 9:28,543.96,Withdrawal,ATM Withdrawal,-543.96
36806,804434058,1-26-24 11:28,163.88,Withdrawal,Branch Withdrawal,-707.84
36807,804434058,1-27-24 11:28,356.1,Payment,Loan Payment,-1063.94
36808,804434058,1-27-24 14:28,192.36,Payment,Bill Payment,-1256.3
36809,804434058,1-27-24 20:28,194.8,OnlineShopping,eBay,-1451.1
36810,804434058,02-02-24 17:28,330.08,OnlineShopping,Etsy,-1781.18
36811,804434058,02-03-24 10:28,393.66,Purchase,Entertainment,-2174.84
36812,804434058,02-03-24 20:28,325.73,Return,Walmart Return,-1849.11
36813,804434058,02-03-24 22:28,215.02,Payment,Loan Payment,-2064.13
36814,804434058,02-04-24 10:28,185.75,Withdrawal,ATM Withdrawal,-2249.88
36815,804434058,02-04-24 21:28,5950,IncomingTransfer,Salary,3700.12
36816,804434058,2-14-24 21:28,1500,Payment,Insurance Payment,2200.12
36817,804434058,2-16-24 23:28,63.17,Payment,Mortgage Payment,2136.95
36818,804434058,2-19-24 12:28,345.97,OnlineShopping,Walmart,1790.98
36819,804434058,2-21-24 20:28,197.22,Return,Store Return,1988.2
36820,804434058,2-21-24 22:28,289.97,Withdrawal,ATM Withdrawal,1698.23
36821,804434058,2-23-24 23:28,373.82,OnlineShopping,AliExpress,1324.41
36822,804434058,03-02-24 21:28,5950,IncomingTransfer,Salary,7274.41
36823,804434058,03-05-24 16:28,345.89,Purchase,Clothing,6928.52
36824,804434058,03-05-24 23:28,498.49,Withdrawal,Branch Withdrawal,6430.03
36825,804434058,03-07-24 17:28,188.26,Return,Target Return,6618.29
36826,804434058,03-09-24 11:28,411.81,Deposit,Direct Deposit,7030.1
36827,804434058,3-16-24 13:28,511.37,Purchase,Entertainment,6518.73
36828,804434058,3-16-24 21:28,2000,Payment,Insurance Payment,4518.73
36829,804434058,3-17-24 13:28,433.4,Deposit,Mobile Deposit,4952.13
36830,804434058,3-17-24 18:28,349.66,Purchase,Restaurant,4602.47
36831,804434058,3-17-24 18:28,328.68,Payment,Loan Payment,4273.79
36832,804434058,3-19-24 16:28,266.9,Deposit,Cash Deposit,4540.69
36833,804434058,3-20-24 15:28,441.5,Purchase,Pharmacy,4099.19
36834,804434058,3-22-24 23:28,326.61,IncomingTransfer,Freelance Payment,4425.8
36835,804434058,3-23-24 15:28,327,IncomingTransfer,Freelance Payment,4752.8
36836,804434058,3-25-24 9:28,471.38,Withdrawal,Mobile App Withdrawal,4281.42
36837,804434058,3-26-24 10:28,194.11,OnlineShopping,Etsy,4087.31
36838,804434058,3-27-24 16:28,101.16,Purchase,Home Improvement,3986.15
36839,804434058,3-27-24 23:28,147.41,Payment,Loan Payment,3838.74
36840,804434058,3-31-24 13:28,281.84,Withdrawal,ATM Withdrawal,3556.9
36841,804434058,04-02-24 10:28,534.19,IncomingTransfer,Freelance Payment,4091.09
36842,804434058,04-02-24 21:28,5950,IncomingTransfer,Salary,10041.09
36843,804434058,04-10-24 10:28,525.14,Payment,Bill Payment,9515.95
36844,804434058,04-10-24 21:28,2100,Payment,Insurance Payment,7415.95
36845,804434058,04-10-24 22:28,266.37,Withdrawal,ATM Withdrawal,7149.58
36846,804434058,04-11-24 13:28,288.43,Purchase,Travel,6861.15
36847,804434058,04-11-24 19:28,302.02,Purchase,Entertainment,6559.13
36848,804434058,4-13-24 17:28,459.97,OnlineShopping,Etsy,6099.16
36849,804434058,4-15-24 22:28,316.32,OutgoingTransfer,Wire Transfer,5782.84
36850,804434058,4-27-24 20:28,425.85,Deposit,Check Deposit,6208.69
36851,804434058,05-02-24 12:28,140.95,Withdrawal,Branch Withdrawal,6067.74
36852,804434058,05-02-24 21:28,5950,IncomingTransfer,Salary,12017.74
36853,804434058,05-03-24 9:28,113.59,Withdrawal,Mobile App Withdrawal,11904.15
36854,804434058,05-05-24 10:28,256.1,Deposit,Mobile Deposit,12160.25
36855,804434058,05-06-24 18:28,140.52,Payment,Mortgage Payment,12019.73
36856,804434058,05-07-24 23:28,202.79,Payment,Bill Payment,11816.94
36857,804434058,05-08-24 10:28,140.04,Purchase,Gas,11676.9
36858,804434058,05-08-24 11:28,291.59,Purchase,Entertainment,11385.31
36859,804434058,05-10-24 10:28,439.45,Purchase,Clothing,10945.86
36860,804434058,5-15-24 21:28,2500,Payment,Insurance Payment,8445.86
36861,804434058,5-16-24 23:28,86.98,Purchase,Furniture,8358.88
36862,804434058,5-18-24 14:28,286.02,Deposit,Cash Deposit,8644.9
36863,804434058,5-18-24 16:28,105.63,Withdrawal,ATM Withdrawal,8539.27
36864,804434058,5-18-24 20:28,250.03,IncomingTransfer,Freelance Payment,8789.3
36865,804434058,5-21-24 12:28,94.61,IncomingTransfer,Freelance Payment,8883.91
36866,804434058,5-28-24 11:28,287.88,OnlineShopping,Etsy,8596.03
36867,804434058,5-29-24 13:28,312.81,Return,Etsy Return,8908.84
36868,804434058,06-01-24 21:28,5950,IncomingTransfer,Salary,14858.84
36869,804434058,06-04-24 21:28,402.91,Return,eBay Return,15261.75
36870,804434058,06-04-24 22:28,128.34,Deposit,Mobile Deposit,15390.09
36871,804434058,06-05-24 22:28,362.65,OnlineShopping,eBay,15027.44
36872,804434058,06-06-24 9:28,121.42,Deposit,Check Deposit,15148.86
36873,804434058,06-07-24 12:28,244.98,OutgoingTransfer,International Transfer,14903.88
36874,804434058,06-10-24 19:28,135.43,Deposit,Mobile Deposit,15039.31
36875,804434058,06-10-24 21:28,1800,Payment,Insurance Payment,13239.31
36876,804434058,06-11-24 18:28,501.81,Withdrawal,ATM Withdrawal,12737.5
36877,804434058,6-13-24 13:28,398.27,Withdrawal,ATM Withdrawal,12339.23
36878,804434058,6-19-24 23:28,222.57,Purchase,Entertainment,12116.66
36879,804434058,6-20-24 20:28,449.54,Return,eBay Return,12566.2
36880,804434058,6-24-24 16:28,273.29,IncomingTransfer,Freelance Payment,12839.49
36881,804434058,6-25-24 19:28,382.4,OnlineShopping,Best Buy,12457.09
36882,804434058,6-26-24 11:28,467.88,Purchase,Restaurant,11989.21
36883,804434058,6-26-24 18:28,399.71,Purchase,Restaurant,11589.5
36884,804434058,6-29-24 17:28,460.94,Return,Amazon Return,12050.44
36885,804434058,6-30-24 21:28,97.32,Purchase,Clothing,11953.12
36886,804434058,07-01-24 21:28,442.74,Purchase,Electronics,11510.38
36887,804434058,07-01-24 21:28,421.13,Purchase,Entertainment,11089.25
36888,804434058,07-04-24 21:28,5950,IncomingTransfer,Salary,17039.25
36889,804434058,07-04-24 23:28,532.74,Deposit,Check Deposit,17571.99
36890,804434058,07-06-24 18:28,286.62,Purchase,Travel,17285.37
36891,804434058,07-09-24 21:28,120.54,Payment,Mortgage Payment,17164.83
36892,804434058,07-12-24 21:28,1800,Payment,Insurance Payment,15364.83
36893,804434058,7-15-24 16:28,457.83,Deposit,Mobile Deposit,15822.66
36894,804434058,7-17-24 16:28,121.84,Return,AliExpress Return,15944.5
36895,804434058,7-17-24 16:28,335.42,Deposit,Direct Deposit,16279.92
36896,804437658,1-22-24 12:28,157.13,Withdrawal,ATM Withdrawal,1495.260743
36897,804437658,1-22-24 12:28,24.59,Payment,Bill Payment,1470.670743
36898,804437658,1-24-24 14:28,132.1,Deposit,Mobile Deposit,1602.770743
36899,804437658,1-24-24 16:28,119.54,Purchase,Gas,1483.230743
36900,804437658,1-25-24 9:28,225.56,Purchase,Travel,1257.670743
36901,804437658,1-29-24 23:28,52.42,Purchase,Gas,1205.250743
36902,804437658,1-31-24 9:28,175.81,Return,Store Return,1381.060743
36903,804437658,02-03-24 11:28,194.47,OutgoingTransfer,Bank Transfer,1186.590743
36904,804437658,02-03-24 17:28,15.61,OutgoingTransfer,Peer-to-Peer Transfer,1170.980743
36905,804437658,02-03-24 21:28,1900,IncomingTransfer,Salary,3070.980743
36906,804437658,02-05-24 9:28,148.22,Purchase,Pharmacy,2922.760743
36907,804437658,02-05-24 17:28,120.8,OutgoingTransfer,International Transfer,2801.960743
36908,804437658,02-08-24 12:28,150.89,OnlineShopping,Walmart,2651.070743
36909,804437658,02-08-24 21:28,2200,Payment,Credit Card Payment,451.0707428
36910,804437658,02-08-24 23:28,89.1,Payment,Bill Payment,361.9707428
36911,804437658,02-11-24 21:28,132.88,OnlineShopping,Target,229.0907428
36912,804437658,02-12-24 21:28,800,Payment,Rent Payment,-570.9092572
36913,804437658,02-12-24 21:28,55.68,Purchase,Entertainment,-626.5892572
36914,804437658,2-15-24 9:28,144.26,OutgoingTransfer,Peer-to-Peer Transfer,-770.8492572
36915,804437658,2-19-24 12:28,39.3,Payment,Bill Payment,-810.1492572
36916,804437658,2-21-24 17:28,88.02,OnlineShopping,AliExpress,-898.1692572
36917,804437658,2-23-24 17:28,18.57,Purchase,Restaurant,-916.7392572
36918,804437658,2-26-24 22:28,86.64,Deposit,Direct Deposit,-830.0992572
36919,804437658,2-27-24 20:28,230.67,IncomingTransfer,Freelance Payment,-599.4292572
36920,804437658,2-28-24 9:28,10.85,Withdrawal,ATM Withdrawal,-610.2792572
36921,804437658,03-04-24 11:28,67.61,Withdrawal,ATM Withdrawal,-677.8892572
36922,804437658,03-05-24 21:28,1900,IncomingTransfer,Salary,1222.110743
36923,804437658,03-06-24 17:28,109.16,Payment,Mortgage Payment,1112.950743
36924,804437658,03-09-24 19:28,120.04,OnlineShopping,Etsy,992.9107428
36925,804437658,03-10-24 14:28,238.87,Deposit,Check Deposit,1231.780743
36926,804437658,03-10-24 21:28,2500,Payment,Credit Card Payment,-1268.219257
36927,804437658,03-10-24 21:28,37.79,Withdrawal,Mobile App Withdrawal,-1306.009257
36928,804437658,3-13-24 21:28,900,Payment,Rent Payment,-2206.009257
36929,804437658,3-22-24 23:28,55.52,Deposit,Check Deposit,-2150.489257
36930,804437658,3-24-24 17:28,130.06,IncomingTransfer,Freelance Payment,-2020.429257
36931,804437658,3-28-24 12:28,240.41,Deposit,Mobile Deposit,-1780.019257
36932,804437658,3-29-24 16:28,59.66,Purchase,Pharmacy,-1839.679257
36933,804437658,3-30-24 19:28,88.65,Payment,Loan Payment,-1928.329257
36934,804437658,04-01-24 14:28,120.58,Payment,Bill Payment,-2048.909257
36935,804437658,04-02-24 21:28,1900,IncomingTransfer,Salary,-148.9092572
36936,804437658,04-03-24 21:28,195.62,Withdrawal,Branch Withdrawal,-344.5292572
36937,804437658,04-04-24 16:28,233.11,OnlineShopping,Etsy,-577.6392572
36938,804437658,04-04-24 18:28,201.26,Payment,Loan Payment,-778.8992572
36939,804437658,04-05-24 17:28,101.94,Withdrawal,Branch Withdrawal,-880.8392572
36940,804437658,04-05-24 18:28,202.48,OnlineShopping,eBay,-1083.319257
36941,804437658,04-07-24 21:28,2500,Payment,Credit Card Payment,-3583.319257
36942,804437658,04-09-24 22:28,171.46,IncomingTransfer,Freelance Payment,-3411.859257
36943,804437658,4-13-24 18:28,134.51,Purchase,Pharmacy,-3546.369257
36944,804437658,4-15-24 21:28,153.66,Deposit,Cash Deposit,-3392.709257
36945,804437658,4-17-24 21:28,13.55,Withdrawal,Mobile App Withdrawal,-3406.259257
36946,804437658,4-18-24 21:28,700,Payment,Rent Payment,-4106.259257
36947,804437658,4-25-24 14:28,100.79,Withdrawal,Branch Withdrawal,-4207.049257
36948,804437658,4-27-24 10:28,168.12,OutgoingTransfer,Bank Transfer,-4375.169257
36949,804437658,4-27-24 15:28,181.08,Purchase,Grocery,-4556.249257
36950,804437658,4-28-24 20:28,112.72,Purchase,Grocery,-4668.969257
36951,804437658,05-01-24 15:28,88.35,Purchase,Entertainment,-4757.319257
36952,804437658,05-04-24 15:28,55.56,Deposit,Mobile Deposit,-4701.759257
36953,804437658,05-05-24 21:28,1900,IncomingTransfer,Salary,-2801.759257
36954,804437658,05-10-24 21:28,3200,Payment,Credit Card Payment,-6001.759257
36955,804437658,05-10-24 21:28,900,Payment,Rent Payment,-6901.759257
36956,804437658,5-20-24 10:28,123.74,Deposit,Check Deposit,-6778.019257
36957,804437658,5-26-24 14:28,25.92,Deposit,Mobile Deposit,-6752.099257
36958,804437658,06-01-24 17:28,240.45,Deposit,Mobile Deposit,-6511.649257
36959,804437658,06-04-24 21:28,1900,IncomingTransfer,Salary,-4611.649257
36960,804437658,06-06-24 11:28,133.43,Withdrawal,Mobile App Withdrawal,-4745.079257
36961,804437658,06-07-24 20:28,216.12,OutgoingTransfer,International Transfer,-4961.199257
36962,804437658,06-07-24 22:28,181.78,Payment,Loan Payment,-5142.979257
36963,804437658,06-09-24 21:28,3100,Payment,Credit Card Payment,-8242.979257
36964,804437658,06-10-24 21:28,1100,Payment,Rent Payment,-9342.979257
36965,804437658,6-14-24 22:28,230.2,Return,Store Return,-9112.779257
36966,804437658,6-18-24 12:28,168.22,Return,Amazon Return,-8944.559257
36967,804437658,6-24-24 15:28,47,Deposit,Cash Deposit,-8897.559257
36968,804437658,6-28-24 15:28,228.69,Withdrawal,Branch Withdrawal,-9126.249257
36969,804437658,07-02-24 13:28,21.93,Purchase,Restaurant,-9148.179257
36970,804437658,07-04-24 13:28,150.9,OnlineShopping,Amazon,-9299.079257
36971,804437658,07-05-24 18:28,34.2,Purchase,Electronics,-9333.279257
36972,804437658,07-05-24 21:28,1900,IncomingTransfer,Salary,-7433.279257
36973,804437658,07-06-24 14:28,244.54,Purchase,Grocery,-7677.819257
36974,804437658,07-10-24 21:28,2600,Payment,Credit Card Payment,-10277.81926
36975,804437658,7-13-24 20:28,83.08,Purchase,Travel,-10360.89926
36976,804437658,7-14-24 11:28,135.72,Purchase,Gas,-10496.61926
36977,804437658,7-14-24 21:28,1200,Payment,Rent Payment,-11696.61926
36978,804437658,7-17-24 11:28,167.21,Purchase,Grocery,-11863.82926
36979,804437658,7-17-24 17:28,131.14,Deposit,Mobile Deposit,-11732.68926
36980,804598908,1-28-24 11:28,461.48,Deposit,Cash Deposit,2182.100124
36981,804598908,1-31-24 11:28,131.55,Payment,Loan Payment,2050.550124
36982,804598908,1-31-24 16:28,740.34,Return,Etsy Return,2790.890124
36983,804598908,1-31-24 17:28,104.25,Purchase,Grocery,2686.640124
36984,804598908,02-01-24 11:28,173.54,Withdrawal,ATM Withdrawal,2513.100124
36985,804598908,02-01-24 15:28,712,Withdrawal,Branch Withdrawal,1801.100124
36986,804598908,02-01-24 21:28,8100,IncomingTransfer,Salary,9901.100124
36987,804598908,02-01-24 22:28,138.56,Payment,Bill Payment,9762.540124
36988,804598908,02-03-24 18:28,476.24,OnlineShopping,Amazon,9286.300124
36989,804598908,02-06-24 21:28,3000,Payment,Credit Card Payment,6286.300124
36990,804598908,02-07-24 14:28,693.16,OutgoingTransfer,Peer-to-Peer Transfer,5593.140124
36991,804598908,02-11-24 21:28,5200,Payment,Rent Payment,393.1401241
36992,804598908,02-11-24 22:28,429.94,OutgoingTransfer,Wire Transfer,-36.79987594
36993,804598908,2-15-24 20:28,698.5,Withdrawal,Mobile App Withdrawal,-735.2998759
36994,804598908,2-21-24 21:28,457.81,Deposit,Cash Deposit,-277.4898759
36995,804598908,2-22-24 20:28,474.53,Deposit,Direct Deposit,197.0401241
36996,804598908,2-26-24 21:28,655.97,OutgoingTransfer,Bank Transfer,-458.9298759
36997,804598908,03-01-24 16:28,664.04,Deposit,Cash Deposit,205.1101241
36998,804598908,03-01-24 21:28,8100,IncomingTransfer,Salary,8305.110124
36999,804598908,03-06-24 10:28,379.26,Purchase,Gas,7925.850124
37000,804598908,03-06-24 14:28,570.71,Withdrawal,Branch Withdrawal,7355.140124
37001,804598908,03-06-24 21:28,2200,Payment,Credit Card Payment,5155.140124
37002,804598908,03-08-24 16:28,419.46,OutgoingTransfer,Wire Transfer,4735.680124
37003,804598908,03-11-24 18:28,101.05,Return,eBay Return,4836.730124
37004,804598908,03-11-24 21:28,4300,Payment,Rent Payment,536.7301241
37005,804598908,3-23-24 22:28,168.75,Payment,Mortgage Payment,367.9801241
37006,804598908,3-25-24 17:28,642.16,Deposit,Direct Deposit,1010.140124
37007,804598908,3-26-24 14:28,749.1,Withdrawal,Mobile App Withdrawal,261.0401241
37008,804598908,3-28-24 9:28,546.05,OutgoingTransfer,Wire Transfer,-285.0098759
37009,804598908,3-28-24 12:28,116.94,OnlineShopping,Target,-401.9498759
37010,804598908,04-04-24 21:28,8100,IncomingTransfer,Salary,7698.050124
37011,804598908,04-06-24 16:28,437.09,Deposit,Cash Deposit,8135.140124
37012,804598908,04-08-24 14:28,551.03,Deposit,Mobile Deposit,8686.170124
37013,804598908,04-09-24 21:28,2600,Payment,Credit Card Payment,6086.170124
37014,804598908,04-11-24 11:28,177.95,OutgoingTransfer,Wire Transfer,5908.220124
37015,804598908,04-11-24 16:28,307.53,Withdrawal,Mobile App Withdrawal,5600.690124
37016,804598908,04-11-24 23:28,537.5,Withdrawal,Branch Withdrawal,5063.190124
37017,804598908,4-18-24 21:28,2500,Payment,Rent Payment,2563.190124
37018,804598908,4-29-24 9:28,657.92,Purchase,Home Improvement,1905.270124
37019,804598908,4-29-24 19:28,644.8,IncomingTransfer,Freelance Payment,2550.070124
37020,804598908,05-01-24 22:28,688.24,Deposit,Direct Deposit,3238.310124
37021,804598908,05-02-24 21:28,8100,IncomingTransfer,Salary,11338.31012
37022,804598908,05-03-24 9:28,159.56,Withdrawal,Branch Withdrawal,11178.75012
37023,804598908,05-07-24 21:28,2900,Payment,Credit Card Payment,8278.750124
37024,804598908,05-08-24 12:28,407.73,Purchase,Clothing,7871.020124
37025,804598908,05-12-24 12:28,606.41,OnlineShopping,Amazon,7264.610124
37026,804598908,5-13-24 21:28,3200,Payment,Rent Payment,4064.610124
37027,804598908,5-16-24 11:28,486.82,Payment,Mortgage Payment,3577.790124
37028,804598908,5-19-24 12:28,591.36,Deposit,Cash Deposit,4169.150124
37029,804598908,5-20-24 21:28,402.2,Return,Store Return,4571.350124
37030,804598908,5-23-24 16:28,708.86,Purchase,Gas,3862.490124
37031,804598908,06-01-24 21:28,8100,IncomingTransfer,Salary,11962.49012
37032,804598908,06-03-24 22:28,690.05,Withdrawal,ATM Withdrawal,11272.44012
37033,804598908,06-06-24 21:28,2900,Payment,Credit Card Payment,8372.440124
37034,804598908,06-06-24 22:28,147.71,Purchase,Restaurant,8224.730124
37035,804598908,06-12-24 19:28,415.81,Withdrawal,Branch Withdrawal,7808.920124
37036,804598908,6-14-24 11:28,400.17,Payment,Mortgage Payment,7408.750124
37037,804598908,6-16-24 21:28,2100,Payment,Rent Payment,5308.750124
37038,804598908,6-21-24 15:28,688.23,OutgoingTransfer,Peer-to-Peer Transfer,4620.520124
37039,804598908,6-28-24 10:28,261.07,Deposit,Direct Deposit,4881.590124
37040,804598908,07-03-24 20:28,523.17,Withdrawal,Mobile App Withdrawal,4358.420124
37041,804598908,07-04-24 21:28,8100,IncomingTransfer,Salary,12458.42012
37042,804598908,07-04-24 21:28,709.46,Deposit,Check Deposit,13167.88012
37043,804598908,07-04-24 22:28,334.52,Return,eBay Return,13502.40012
37044,804598908,07-09-24 21:28,2500,Payment,Credit Card Payment,11002.40012
37045,804598908,07-10-24 21:28,3900,Payment,Rent Payment,7102.400124
37046,804598908,7-17-24 15:28,409.71,OnlineShopping,Amazon,6692.690124
37047,804649833,1-23-24 18:28,68.3,IncomingTransfer,Freelance Payment,816.8991147
37048,804649833,1-25-24 21:28,380.79,Deposit,Mobile Deposit,1197.689115
37049,804649833,1-27-24 13:28,254.46,Withdrawal,Mobile App Withdrawal,943.2291147
37050,804649833,1-28-24 12:28,347.97,Purchase,Grocery,595.2591147
37051,804649833,02-03-24 17:28,245.52,OnlineShopping,Etsy,349.7391147
37052,804649833,02-03-24 21:28,4550,IncomingTransfer,Salary,4899.739115
37053,804649833,02-04-24 15:28,313.3,Purchase,Home Improvement,4586.439115
37054,804649833,02-05-24 13:28,78.72,Purchase,Pharmacy,4507.719115
37055,804649833,02-08-24 21:28,1200,Payment,Credit Card Payment,3307.719115
37056,804649833,02-10-24 15:28,188.22,Deposit,Cash Deposit,3495.939115
37057,804649833,02-10-24 21:28,2500,Payment,Rent Payment,995.9391147
37058,804649833,02-11-24 16:28,371.41,Withdrawal,Branch Withdrawal,624.5291147
37059,804649833,2-18-24 14:28,145.97,OutgoingTransfer,Bank Transfer,478.5591147
37060,804649833,2-20-24 10:28,91.85,OnlineShopping,eBay,386.7091147
37061,804649833,2-22-24 14:28,306.6,Deposit,Mobile Deposit,693.3091147
37062,804649833,2-23-24 18:28,398.02,Return,Store Return,1091.329115
37063,804649833,2-25-24 20:28,316.36,Return,Store Return,1407.689115
37064,804649833,03-02-24 11:28,261.28,Payment,Loan Payment,1146.409115
37065,804649833,03-03-24 10:28,69.33,Return,Store Return,1215.739115
37066,804649833,03-04-24 13:28,220.54,IncomingTransfer,Freelance Payment,1436.279115
37067,804649833,03-05-24 21:28,4550,IncomingTransfer,Salary,5986.279115
37068,804649833,03-08-24 13:28,112.09,Purchase,Restaurant,5874.189115
37069,804649833,03-09-24 17:28,269.56,Deposit,Direct Deposit,6143.749115
37070,804649833,03-10-24 21:28,1200,Payment,Credit Card Payment,4943.749115
37071,804649833,03-11-24 21:28,1500,Payment,Rent Payment,3443.749115
37072,804649833,3-14-24 11:28,191.9,Withdrawal,Mobile App Withdrawal,3251.849115
37073,804649833,3-16-24 20:28,122.22,Purchase,Entertainment,3129.629115
37074,804649833,3-27-24 15:28,292.91,Purchase,Furniture,2836.719115
37075,804649833,3-29-24 16:28,355.65,OnlineShopping,Best Buy,2481.069115
37076,804649833,3-30-24 13:28,389.77,Withdrawal,Branch Withdrawal,2091.299115
37077,804649833,3-31-24 10:28,207.09,Deposit,Mobile Deposit,2298.389115
37078,804649833,04-01-24 21:28,4550,IncomingTransfer,Salary,6848.389115
37079,804649833,04-03-24 16:28,50.23,IncomingTransfer,Freelance Payment,6898.619115
37080,804649833,04-03-24 21:28,259.42,OnlineShopping,Etsy,6639.199115
37081,804649833,04-04-24 12:28,178.84,OutgoingTransfer,International Transfer,6460.359115
37082,804649833,04-04-24 16:28,138.76,Return,AliExpress Return,6599.119115
37083,804649833,04-04-24 23:28,119.29,OutgoingTransfer,Peer-to-Peer Transfer,6479.829115
37084,804649833,04-06-24 10:28,121.56,Payment,Bill Payment,6358.269115
37085,804649833,04-06-24 21:28,1600,Payment,Credit Card Payment,4758.269115
37086,804649833,04-07-24 17:28,291.15,OnlineShopping,Etsy,4467.119115
37087,804649833,04-08-24 23:28,269.3,Withdrawal,Branch Withdrawal,4197.819115
37088,804649833,04-12-24 16:28,215.84,Return,Amazon Return,4413.659115
37089,804649833,4-14-24 21:28,1900,Payment,Rent Payment,2513.659115
37090,804649833,4-16-24 14:28,346.36,OnlineShopping,AliExpress,2167.299115
37091,804649833,4-18-24 21:28,209.55,Purchase,Electronics,1957.749115
37092,804649833,4-19-24 14:28,123.88,Return,AliExpress Return,2081.629115
37093,804649833,4-23-24 11:28,106.04,Deposit,Check Deposit,2187.669115
37094,804649833,05-01-24 13:28,318.85,Purchase,Gas,1868.819115
37095,804649833,05-02-24 11:28,338.94,Return,AliExpress Return,2207.759115
37096,804649833,05-03-24 10:28,174,Return,Amazon Return,2381.759115
37097,804649833,05-03-24 16:28,105.2,Deposit,Mobile Deposit,2486.959115
37098,804649833,05-04-24 21:28,4550,IncomingTransfer,Salary,7036.959115
37099,804649833,05-05-24 10:28,368.18,Deposit,Check Deposit,7405.139115
37100,804649833,05-05-24 21:28,146,IncomingTransfer,Freelance Payment,7551.139115
37101,804649833,05-07-24 20:28,45.39,Return,AliExpress Return,7596.529115
37102,804649833,05-09-24 9:28,182.01,OnlineShopping,Etsy,7414.519115
37103,804649833,05-09-24 21:28,1600,Payment,Credit Card Payment,5814.519115
37104,804649833,05-10-24 12:28,210.45,Purchase,Clothing,5604.069115
37105,804649833,05-10-24 21:28,2300,Payment,Rent Payment,3304.069115
37106,804649833,05-12-24 22:28,27.8,IncomingTransfer,Freelance Payment,3331.869115
37107,804649833,5-13-24 15:28,374.1,OutgoingTransfer,Wire Transfer,2957.769115
37108,804649833,5-16-24 11:28,215.53,Withdrawal,Branch Withdrawal,2742.239115
37109,804649833,5-17-24 21:28,317.36,Purchase,Entertainment,2424.879115
37110,804649833,5-20-24 12:28,218.23,OnlineShopping,Target,2206.649115
37111,804649833,5-22-24 12:28,24.07,Payment,Bill Payment,2182.579115
37112,804649833,5-23-24 21:28,370.2,Purchase,Pharmacy,1812.379115
37113,804649833,5-24-24 10:28,227.6,Deposit,Direct Deposit,2039.979115
37114,804649833,5-28-24 9:28,190.75,Purchase,Home Improvement,1849.229115
37115,804649833,06-01-24 16:28,332.71,Purchase,Clothing,1516.519115
37116,804649833,06-02-24 21:28,4550,IncomingTransfer,Salary,6066.519115
37117,804649833,06-03-24 22:28,240.44,OnlineShopping,Walmart,5826.079115
37118,804649833,06-04-24 20:28,385.35,Return,AliExpress Return,6211.429115
37119,804649833,06-05-24 15:28,127.17,Payment,Bill Payment,6084.259115
37120,804649833,06-07-24 9:28,339.72,Deposit,Mobile Deposit,6423.979115
37121,804649833,06-07-24 21:28,1500,Payment,Credit Card Payment,4923.979115
37122,804649833,6-14-24 21:28,2400,Payment,Rent Payment,2523.979115
37123,804649833,6-17-24 9:28,399.77,OutgoingTransfer,Wire Transfer,2124.209115
37124,804649833,6-21-24 20:28,321.18,IncomingTransfer,Freelance Payment,2445.389115
37125,804649833,6-29-24 20:28,356.51,Purchase,Gas,2088.879115
37126,804649833,6-29-24 21:28,325.19,Return,Walmart Return,2414.069115
37127,804649833,07-01-24 14:28,275.09,OutgoingTransfer,International Transfer,2138.979115
37128,804649833,07-03-24 18:28,212.12,Withdrawal,ATM Withdrawal,1926.859115
37129,804649833,07-05-24 21:28,4550,IncomingTransfer,Salary,6476.859115
37130,804649833,07-06-24 20:28,377.35,Deposit,Direct Deposit,6854.209115
37131,804649833,07-07-24 10:28,197.51,Purchase,Gas,6656.699115
37132,804649833,07-09-24 12:28,173.78,Withdrawal,Branch Withdrawal,6482.919115
37133,804649833,07-09-24 16:28,384.5,Payment,Mortgage Payment,6098.419115
37134,804649833,07-09-24 18:28,266,Purchase,Furniture,5832.419115
37135,804649833,07-10-24 21:28,1500,Payment,Credit Card Payment,4332.419115
37136,804649833,07-10-24 21:28,2200,Payment,Rent Payment,2132.419115
37137,804649833,07-12-24 16:28,138.26,Purchase,Gas,1994.159115
37138,804649833,7-14-24 12:28,204.27,OnlineShopping,eBay,1789.889115
37139,804847308,1-25-24 9:28,335.76,Withdrawal,Branch Withdrawal,-335.76
37140,804847308,1-26-24 18:28,302.78,Deposit,Check Deposit,-32.98
37141,804847308,1-30-24 9:28,301.47,Purchase,Grocery,-334.45
37142,804847308,1-30-24 12:28,230.45,Return,Amazon Return,-104
37143,804847308,1-31-24 16:28,269.78,Purchase,Furniture,-373.78
37144,804847308,1-31-24 21:28,357.69,OnlineShopping,Best Buy,-731.47
37145,804847308,02-01-24 18:28,102.84,Return,Etsy Return,-628.63
37146,804847308,02-01-24 21:28,3750,IncomingTransfer,Salary,3121.37
37147,804847308,02-04-24 15:28,294.75,Deposit,Cash Deposit,3416.12
37148,804847308,02-05-24 19:28,229.45,Purchase,Travel,3186.67
37149,804847308,02-09-24 16:28,286.21,Withdrawal,ATM Withdrawal,2900.46
37150,804847308,02-12-24 17:28,322.08,Deposit,Cash Deposit,3222.54
37151,804847308,2-17-24 21:28,1600,Payment,Rent Payment,1622.54
37152,804847308,03-02-24 21:28,3750,IncomingTransfer,Salary,5372.54
37153,804847308,03-03-24 13:28,247.99,Return,Target Return,5620.53
37154,804847308,03-07-24 9:28,149.79,Deposit,Direct Deposit,5770.32
37155,804847308,03-08-24 22:28,48.6,Deposit,Check Deposit,5818.92
37156,804847308,03-09-24 13:28,143.24,OutgoingTransfer,Bank Transfer,5675.68
37157,804847308,03-09-24 16:28,156.85,Withdrawal,ATM Withdrawal,5518.83
37158,804847308,03-10-24 21:28,169.28,Withdrawal,Mobile App Withdrawal,5349.55
37159,804847308,3-14-24 14:28,274.48,OutgoingTransfer,Wire Transfer,5075.07
37160,804847308,3-16-24 11:28,94.39,Return,Etsy Return,5169.46
37161,804847308,3-17-24 21:28,1900,Payment,Rent Payment,3269.46
37162,804847308,3-19-24 15:28,373.03,Withdrawal,Mobile App Withdrawal,2896.43
37163,804847308,3-23-24 11:28,234.39,Purchase,Furniture,2662.04
37164,804847308,3-23-24 12:28,158.76,Withdrawal,Mobile App Withdrawal,2503.28
37165,804847308,3-23-24 22:28,314.25,Purchase,Restaurant,2189.03
37166,804847308,3-29-24 10:28,101.85,Purchase,Electronics,2087.18
37167,804847308,3-31-24 19:28,47.11,Payment,Mortgage Payment,2040.07
37168,804847308,04-01-24 13:28,388.09,Deposit,Mobile Deposit,2428.16
37169,804847308,04-04-24 21:28,3750,IncomingTransfer,Salary,6178.16
37170,804847308,04-06-24 14:28,153.45,Deposit,Mobile Deposit,6331.61
37171,804847308,04-09-24 12:28,115.14,Purchase,Furniture,6216.47
37172,804847308,4-13-24 10:28,310.16,Withdrawal,Branch Withdrawal,5906.31
37173,804847308,4-16-24 21:28,1700,Payment,Rent Payment,4206.31
37174,804847308,4-21-24 12:28,300.66,IncomingTransfer,Freelance Payment,4506.97
37175,804847308,4-23-24 22:28,125.7,OutgoingTransfer,Bank Transfer,4381.27
37176,804847308,4-23-24 23:28,391.85,Withdrawal,ATM Withdrawal,3989.42
37177,804847308,4-24-24 15:28,327.83,Deposit,Cash Deposit,4317.25
37178,804847308,4-26-24 11:28,309.79,Withdrawal,Branch Withdrawal,4007.46
37179,804847308,4-26-24 22:28,302.11,Deposit,Mobile Deposit,4309.57
37180,804847308,4-28-24 15:28,287.29,Payment,Bill Payment,4022.28
37181,804847308,4-30-24 19:28,228.95,Deposit,Cash Deposit,4251.23
37182,804847308,05-01-24 21:28,3750,IncomingTransfer,Salary,8001.23
37183,804847308,05-02-24 13:28,86.76,Withdrawal,Mobile App Withdrawal,7914.47
37184,804847308,05-02-24 22:28,92.96,Deposit,Cash Deposit,8007.43
37185,804847308,5-13-24 11:28,79.29,Deposit,Check Deposit,8086.72
37186,804847308,5-13-24 23:28,234.01,IncomingTransfer,Freelance Payment,8320.73
37187,804847308,5-14-24 9:28,216.69,Withdrawal,ATM Withdrawal,8104.04
37188,804847308,5-14-24 10:28,75.63,Purchase,Clothing,8028.41
37189,804847308,5-15-24 22:28,225.89,Return,Store Return,8254.3
37190,804847308,5-17-24 11:28,234.56,Purchase,Grocery,8019.74
37191,804847308,5-17-24 14:28,212.45,Deposit,Mobile Deposit,8232.19
37192,804847308,5-18-24 21:28,1000,Payment,Rent Payment,7232.19
37193,804847308,5-19-24 13:28,189.11,OutgoingTransfer,Peer-to-Peer Transfer,7043.08
37194,804847308,5-21-24 9:28,77.99,Purchase,Electronics,6965.09
37195,804847308,5-21-24 9:28,48.72,Withdrawal,ATM Withdrawal,6916.37
37196,804847308,5-21-24 9:28,116.55,Payment,Mortgage Payment,6799.82
37197,804847308,5-23-24 16:28,92.75,Deposit,Direct Deposit,6892.57
37198,804847308,5-25-24 16:28,152.65,OnlineShopping,Target,6739.92
37199,804847308,5-27-24 16:28,291.27,Payment,Bill Payment,6448.65
37200,804847308,5-27-24 19:28,62.52,Return,Walmart Return,6511.17
37201,804847308,06-03-24 19:28,363.51,Return,Target Return,6874.68
37202,804847308,06-05-24 21:28,3750,IncomingTransfer,Salary,10624.68
37203,804847308,06-10-24 17:28,96.27,Deposit,Cash Deposit,10720.95
37204,804847308,06-10-24 19:28,356.16,IncomingTransfer,Freelance Payment,11077.11
37205,804847308,06-11-24 21:28,1000,Payment,Rent Payment,10077.11
37206,804847308,06-11-24 23:28,369.39,Purchase,Gas,9707.72
37207,804847308,6-18-24 18:28,379.11,Withdrawal,ATM Withdrawal,9328.61
37208,804847308,6-19-24 17:28,79.83,Payment,Loan Payment,9248.78
37209,804847308,6-20-24 17:28,380.57,OutgoingTransfer,Bank Transfer,8868.21
37210,804847308,6-25-24 14:28,298.54,OnlineShopping,Amazon,8569.67
37211,804847308,6-26-24 10:28,263.3,Deposit,Direct Deposit,8832.97
37212,804847308,6-28-24 18:28,60.48,Payment,Bill Payment,8772.49
37213,804847308,6-30-24 22:28,36.73,Return,Amazon Return,8809.22
37214,804847308,07-01-24 12:28,266.8,Deposit,Check Deposit,9076.02
37215,804847308,07-01-24 14:28,74.26,Purchase,Travel,9001.76
37216,804847308,07-01-24 21:28,3750,IncomingTransfer,Salary,12751.76
37217,804847308,07-05-24 10:28,337.38,Deposit,Mobile Deposit,13089.14
37218,804847308,7-17-24 20:28,194.52,Payment,Bill Payment,12894.62
37219,804847308,7-18-24 21:28,1900,Payment,Rent Payment,10994.62
37220,805261983,1-21-24 21:28,113.48,OutgoingTransfer,International Transfer,571.9741269
37221,805261983,1-23-24 13:28,227.96,Withdrawal,ATM Withdrawal,344.0141269
37222,805261983,1-29-24 10:28,16.71,Deposit,Mobile Deposit,360.7241269
37223,805261983,02-03-24 21:28,2550,IncomingTransfer,Salary,2910.724127
37224,805261983,02-07-24 16:28,52.44,OnlineShopping,Etsy,2858.284127
37225,805261983,02-08-24 21:28,1300,Payment,Credit Card Payment,1558.284127
37226,805261983,02-10-24 21:28,39.51,Payment,Mortgage Payment,1518.774127
37227,805261983,02-11-24 16:28,247.54,Deposit,Direct Deposit,1766.314127
37228,805261983,02-11-24 21:28,180.53,Purchase,Restaurant,1585.784127
37229,805261983,2-13-24 21:28,1300,Payment,Rent Payment,285.7841269
37230,805261983,2-15-24 14:28,176.03,Withdrawal,ATM Withdrawal,109.7541269
37231,805261983,2-26-24 23:28,150.7,Purchase,Furniture,-40.94587308
37232,805261983,2-29-24 17:28,72.98,Purchase,Entertainment,-113.9258731
37233,805261983,03-01-24 10:28,33.37,OnlineShopping,AliExpress,-147.2958731
37234,805261983,03-04-24 21:28,2550,IncomingTransfer,Salary,2402.704127
37235,805261983,03-08-24 14:28,162.37,Deposit,Direct Deposit,2565.074127
37236,805261983,03-09-24 21:28,1400,Payment,Credit Card Payment,1165.074127
37237,805261983,03-10-24 19:28,85.92,Deposit,Check Deposit,1250.994127
37238,805261983,03-11-24 14:28,78.35,IncomingTransfer,Freelance Payment,1329.344127
37239,805261983,03-11-24 21:28,1300,Payment,Rent Payment,29.34412692
37240,805261983,3-13-24 23:28,155.31,Deposit,Check Deposit,184.6541269
37241,805261983,3-16-24 21:28,163.08,OutgoingTransfer,International Transfer,21.57412692
37242,805261983,3-18-24 11:28,17.62,Purchase,Clothing,3.954126915
37243,805261983,3-18-24 21:28,40.17,Deposit,Mobile Deposit,44.12412692
37244,805261983,3-21-24 21:28,206.19,IncomingTransfer,Freelance Payment,250.3141269
37245,805261983,3-22-24 10:28,178.24,Deposit,Direct Deposit,428.5541269
37246,805261983,3-29-24 13:28,178.1,Withdrawal,Branch Withdrawal,250.4541269
37247,805261983,3-31-24 11:28,68.57,Payment,Mortgage Payment,181.8841269
37248,805261983,04-01-24 11:28,76.56,IncomingTransfer,Freelance Payment,258.4441269
37249,805261983,04-03-24 11:28,123.25,Return,AliExpress Return,381.6941269
37250,805261983,04-04-24 21:28,2550,IncomingTransfer,Salary,2931.694127
37251,805261983,04-07-24 22:28,218.11,Return,Best Buy Return,3149.804127
37252,805261983,04-09-24 21:28,1100,Payment,Credit Card Payment,2049.804127
37253,805261983,04-11-24 15:28,15.47,Purchase,Home Improvement,2034.334127
37254,805261983,04-11-24 19:28,144.85,Withdrawal,Mobile App Withdrawal,1889.484127
37255,805261983,04-12-24 17:28,211.66,Return,Store Return,2101.144127
37256,805261983,04-12-24 23:28,55.55,Return,Store Return,2156.694127
37257,805261983,4-13-24 21:28,1200,Payment,Rent Payment,956.6941269
37258,805261983,4-16-24 9:28,213.47,Purchase,Pharmacy,743.2241269
37259,805261983,4-19-24 12:28,216.03,Payment,Mortgage Payment,527.1941269
37260,805261983,05-02-24 20:28,221.83,Return,Amazon Return,749.0241269
37261,805261983,05-02-24 21:28,2550,IncomingTransfer,Salary,3299.024127
37262,805261983,05-03-24 17:28,135.04,Purchase,Furniture,3163.984127
37263,805261983,05-05-24 11:28,31.5,Deposit,Cash Deposit,3195.484127
37264,805261983,05-06-24 13:28,132.46,Return,Store Return,3327.944127
37265,805261983,05-06-24 15:28,173.17,Purchase,Grocery,3154.774127
37266,805261983,05-07-24 12:28,224.95,Purchase,Clothing,2929.824127
37267,805261983,05-07-24 21:28,1000,Payment,Credit Card Payment,1929.824127
37268,805261983,05-11-24 22:28,183.96,OnlineShopping,AliExpress,1745.864127
37269,805261983,05-12-24 17:28,71.96,Payment,Bill Payment,1673.904127
37270,805261983,5-16-24 21:28,1400,Payment,Rent Payment,273.9041269
37271,805261983,5-18-24 14:28,14.44,Withdrawal,ATM Withdrawal,259.4641269
37272,805261983,5-18-24 15:28,47.16,Deposit,Check Deposit,306.6241269
37273,805261983,5-19-24 14:28,29.73,Return,Etsy Return,336.3541269
37274,805261983,5-19-24 21:28,125.18,Withdrawal,ATM Withdrawal,211.1741269
37275,805261983,5-22-24 22:28,249.72,OnlineShopping,eBay,-38.54587308
37276,805261983,5-24-24 10:28,114.05,Withdrawal,ATM Withdrawal,-152.5958731
37277,805261983,5-24-24 20:28,51.3,Deposit,Direct Deposit,-101.2958731
37278,805261983,5-26-24 11:28,109.43,Deposit,Cash Deposit,8.134126915
37279,805261983,5-28-24 9:28,246.24,Payment,Mortgage Payment,-238.1058731
37280,805261983,06-02-24 21:28,2550,IncomingTransfer,Salary,2311.894127
37281,805261983,06-07-24 21:28,1000,Payment,Credit Card Payment,1311.894127
37282,805261983,06-10-24 21:28,900,Payment,Rent Payment,411.8941269
37283,805261983,06-11-24 12:28,73.86,OnlineShopping,eBay,338.0341269
37284,805261983,6-14-24 11:28,40.66,OutgoingTransfer,Bank Transfer,297.3741269
37285,805261983,6-18-24 21:28,190.66,OnlineShopping,Best Buy,106.7141269
37286,805261983,6-25-24 11:28,242.06,OnlineShopping,AliExpress,-135.3458731
37287,805261983,6-25-24 14:28,149.52,Purchase,Grocery,-284.8658731
37288,805261983,07-01-24 13:28,230.42,Purchase,Gas,-515.2858731
37289,805261983,07-01-24 23:28,139.66,Purchase,Travel,-654.9458731
37290,805261983,07-02-24 21:28,2550,IncomingTransfer,Salary,1895.054127
37291,805261983,07-04-24 14:28,200.19,OnlineShopping,Best Buy,1694.864127
37292,805261983,07-06-24 11:28,247.37,Deposit,Direct Deposit,1942.234127
37293,805261983,07-06-24 17:28,182.32,Payment,Bill Payment,1759.914127
37294,805261983,07-07-24 21:28,1300,Payment,Credit Card Payment,459.9141269
37295,805261983,07-10-24 11:28,165.87,OutgoingTransfer,Peer-to-Peer Transfer,294.0441269
37296,805261983,07-11-24 20:28,135.45,OnlineShopping,Best Buy,158.5941269
37297,805261983,7-14-24 21:28,1500,Payment,Rent Payment,-1341.405873
37298,805261983,7-17-24 9:28,126.37,Deposit,Mobile Deposit,-1215.035873
37299,805522758,1-22-24 20:28,193.26,Deposit,Direct Deposit,1109.804722
37300,805522758,02-01-24 11:28,227.19,Return,AliExpress Return,1336.994722
37301,805522758,02-03-24 16:28,109.12,Payment,Loan Payment,1227.874722
37302,805522758,02-05-24 21:28,2750,IncomingTransfer,Salary,3977.874722
37303,805522758,02-10-24 21:28,2200,Payment,Credit Card Payment,1777.874722
37304,805522758,02-12-24 14:28,161.68,Purchase,Furniture,1616.194722
37305,805522758,2-13-24 18:28,58.26,Payment,Mortgage Payment,1557.934722
37306,805522758,2-15-24 21:28,900,Payment,Rent Payment,657.9347223
37307,805522758,2-17-24 20:28,28.71,Purchase,Gas,629.2247223
37308,805522758,2-26-24 12:28,171.78,Withdrawal,Mobile App Withdrawal,457.4447223
37309,805522758,03-03-24 20:28,13.92,Withdrawal,Branch Withdrawal,443.5247223
37310,805522758,03-05-24 21:28,2750,IncomingTransfer,Salary,3193.524722
37311,805522758,03-06-24 14:28,100.06,Deposit,Direct Deposit,3293.584722
37312,805522758,03-10-24 21:28,2200,Payment,Credit Card Payment,1093.584722
37313,805522758,03-12-24 20:28,154.73,IncomingTransfer,Freelance Payment,1248.314722
37314,805522758,3-13-24 21:28,1700,Payment,Rent Payment,-451.6852777
37315,805522758,3-23-24 17:28,39.88,Withdrawal,Mobile App Withdrawal,-491.5652777
37316,805522758,3-24-24 14:28,47.6,Deposit,Cash Deposit,-443.9652777
37317,805522758,3-30-24 10:28,10.77,Return,AliExpress Return,-433.1952777
37318,805522758,04-05-24 20:28,249.26,Purchase,Furniture,-682.4552777
37319,805522758,04-05-24 21:28,2750,IncomingTransfer,Salary,2067.544722
37320,805522758,04-09-24 22:28,183.14,Withdrawal,ATM Withdrawal,1884.404722
37321,805522758,04-10-24 21:28,1900,Payment,Credit Card Payment,-15.59527767
37322,805522758,04-12-24 21:28,1100,Payment,Rent Payment,-1115.595278
37323,805522758,4-14-24 18:28,36.33,OnlineShopping,Best Buy,-1151.925278
37324,805522758,4-14-24 19:28,97.36,Payment,Mortgage Payment,-1249.285278
37325,805522758,4-18-24 12:28,225.16,Deposit,Mobile Deposit,-1024.125278
37326,805522758,4-19-24 18:28,182.21,Withdrawal,ATM Withdrawal,-1206.335278
37327,805522758,4-26-24 16:28,196.04,Deposit,Check Deposit,-1010.295278
37328,805522758,4-26-24 20:28,170.3,Deposit,Check Deposit,-839.9952777
37329,805522758,05-01-24 22:28,77.92,Purchase,Home Improvement,-917.9152777
37330,805522758,05-02-24 21:28,2750,IncomingTransfer,Salary,1832.084722
37331,805522758,05-03-24 20:28,248.43,Purchase,Furniture,1583.654722
37332,805522758,05-04-24 22:28,16.76,OutgoingTransfer,Bank Transfer,1566.894722
37333,805522758,05-07-24 21:28,2200,Payment,Credit Card Payment,-633.1052777
37334,805522758,05-12-24 10:28,60.74,Purchase,Furniture,-693.8452777
37335,805522758,5-14-24 21:28,106.05,Purchase,Pharmacy,-799.8952777
37336,805522758,5-16-24 15:28,10.53,Withdrawal,Mobile App Withdrawal,-810.4252777
37337,805522758,5-17-24 21:28,52.04,OnlineShopping,eBay,-862.4652777
37338,805522758,5-18-24 21:28,1300,Payment,Rent Payment,-2162.465278
37339,805522758,5-23-24 23:28,94.92,OutgoingTransfer,International Transfer,-2257.385278
37340,805522758,06-01-24 21:28,2750,IncomingTransfer,Salary,492.6147223
37341,805522758,06-06-24 21:28,2400,Payment,Credit Card Payment,-1907.385278
37342,805522758,06-10-24 21:28,1000,Payment,Rent Payment,-2907.385278
37343,805522758,6-20-24 18:28,34.41,Withdrawal,Mobile App Withdrawal,-2941.795278
37344,805522758,6-27-24 11:28,218.69,Payment,Bill Payment,-3160.485278
37345,805522758,07-02-24 21:28,2750,IncomingTransfer,Salary,-410.4852777
37346,805522758,07-07-24 21:28,2500,Payment,Credit Card Payment,-2910.485278
37347,805522758,07-08-24 23:28,221.98,Purchase,Gas,-3132.465278
37348,805522758,7-17-24 22:28,143.08,Purchase,Electronics,-3275.545278
37349,805522758,7-18-24 21:28,900,Payment,Rent Payment,-4175.545278
37350,806432433,1-23-24 18:28,331.39,Purchase,Electronics,1132.587497
37351,806432433,1-24-24 10:28,398.35,Purchase,Electronics,734.2374973
37352,806432433,1-26-24 15:28,54.45,Withdrawal,Branch Withdrawal,679.7874973
37353,806432433,1-29-24 23:28,311.33,Deposit,Cash Deposit,991.1174973
37354,806432433,02-01-24 20:28,65.33,Payment,Loan Payment,925.7874973
37355,806432433,02-01-24 21:28,4750,IncomingTransfer,Salary,5675.787497
37356,806432433,02-04-24 13:28,217.54,Return,AliExpress Return,5893.327497
37357,806432433,02-06-24 21:28,2400,Payment,Credit Card Payment,3493.327497
37358,806432433,02-06-24 23:28,224.19,Purchase,Travel,3269.137497
37359,806432433,02-11-24 21:28,2000,Payment,Rent Payment,1269.137497
37360,806432433,2-15-24 11:28,151.48,OnlineShopping,Etsy,1117.657497
37361,806432433,2-18-24 22:28,276.11,Purchase,Entertainment,841.5474973
37362,806432433,2-19-24 14:28,396.9,Deposit,Direct Deposit,1238.447497
37363,806432433,2-19-24 18:28,290.2,Purchase,Travel,948.2474973
37364,806432433,2-20-24 16:28,146.17,Purchase,Clothing,802.0774973
37365,806432433,2-22-24 12:28,124.22,Return,Store Return,926.2974973
37366,806432433,2-22-24 23:28,353.51,Withdrawal,Branch Withdrawal,572.7874973
37367,806432433,2-25-24 17:28,229.51,Deposit,Mobile Deposit,802.2974973
37368,806432433,2-26-24 12:28,393.43,Purchase,Gas,408.8674973
37369,806432433,03-02-24 16:28,49.77,Withdrawal,Mobile App Withdrawal,359.0974973
37370,806432433,03-02-24 20:28,63.16,OutgoingTransfer,Wire Transfer,295.9374973
37371,806432433,03-03-24 12:28,370.64,IncomingTransfer,Freelance Payment,666.5774973
37372,806432433,03-03-24 19:28,49.07,Withdrawal,Mobile App Withdrawal,617.5074973
37373,806432433,03-04-24 16:28,390.78,Purchase,Grocery,226.7274973
37374,806432433,03-05-24 21:28,4750,IncomingTransfer,Salary,4976.727497
37375,806432433,03-06-24 12:28,96.65,Withdrawal,ATM Withdrawal,4880.077497
37376,806432433,03-07-24 9:28,192.56,Deposit,Cash Deposit,5072.637497
37377,806432433,03-09-24 10:28,21.65,Purchase,Furniture,5050.987497
37378,806432433,03-10-24 12:28,57.58,Withdrawal,ATM Withdrawal,4993.407497
37379,806432433,03-10-24 17:28,178.17,Payment,Loan Payment,4815.237497
37380,806432433,03-10-24 21:28,2500,Payment,Credit Card Payment,2315.237497
37381,806432433,03-12-24 21:28,2400,Payment,Rent Payment,-84.76250266
37382,806432433,3-16-24 14:28,92.51,IncomingTransfer,Freelance Payment,7.747497341
37383,806432433,3-17-24 15:28,293.64,Return,AliExpress Return,301.3874973
37384,806432433,3-18-24 19:28,28.42,Purchase,Home Improvement,272.9674973
37385,806432433,3-18-24 21:28,278.71,OutgoingTransfer,Peer-to-Peer Transfer,-5.742502659
37386,806432433,3-18-24 23:28,262.87,Deposit,Direct Deposit,257.1274973
37387,806432433,3-20-24 22:28,231.81,OutgoingTransfer,Wire Transfer,25.31749734
37388,806432433,3-23-24 13:28,222.47,OnlineShopping,Etsy,-197.1525027
37389,806432433,3-23-24 18:28,85.36,Purchase,Clothing,-282.5125027
37390,806432433,3-25-24 14:28,386.26,Purchase,Furniture,-668.7725027
37391,806432433,3-25-24 21:28,20.3,Payment,Mortgage Payment,-689.0725027
37392,806432433,3-25-24 22:28,325.09,OnlineShopping,Etsy,-1014.162503
37393,806432433,3-26-24 20:28,262.01,Deposit,Cash Deposit,-752.1525027
37394,806432433,04-02-24 10:28,133.09,Return,Target Return,-619.0625027
37395,806432433,04-02-24 11:28,363.84,Deposit,Cash Deposit,-255.2225027
37396,806432433,04-03-24 21:28,4750,IncomingTransfer,Salary,4494.777497
37397,806432433,04-05-24 20:28,229.29,Purchase,Clothing,4265.487497
37398,806432433,04-06-24 11:28,91.31,Return,Amazon Return,4356.797497
37399,806432433,04-08-24 21:28,2400,Payment,Credit Card Payment,1956.797497
37400,806432433,04-11-24 21:28,2500,Payment,Rent Payment,-543.2025027
37401,806432433,4-13-24 19:28,36.35,Purchase,Home Improvement,-579.5525027
37402,806432433,4-16-24 18:28,249.08,Purchase,Grocery,-828.6325027
37403,806432433,4-18-24 15:28,41.83,Return,Amazon Return,-786.8025027
37404,806432433,4-18-24 17:28,335.15,OnlineShopping,Etsy,-1121.952503
37405,806432433,4-21-24 16:28,107.54,Purchase,Home Improvement,-1229.492503
37406,806432433,4-24-24 23:28,342.41,Purchase,Furniture,-1571.902503
37407,806432433,4-28-24 19:28,385.07,OnlineShopping,Best Buy,-1956.972503
37408,806432433,4-28-24 22:28,178.32,Purchase,Clothing,-2135.292503
37409,806432433,4-30-24 18:28,108.72,OnlineShopping,eBay,-2244.012503
37410,806432433,05-02-24 14:28,252.53,Deposit,Cash Deposit,-1991.482503
37411,806432433,05-03-24 21:28,4750,IncomingTransfer,Salary,2758.517497
37412,806432433,05-06-24 14:28,278.06,Purchase,Entertainment,2480.457497
37413,806432433,05-08-24 21:28,2400,Payment,Credit Card Payment,80.45749734
37414,806432433,05-09-24 23:28,192.06,Withdrawal,Branch Withdrawal,-111.6025027
37415,806432433,05-10-24 21:28,296.98,Purchase,Furniture,-408.5825027
37416,806432433,05-11-24 19:28,135.4,Deposit,Check Deposit,-273.1825027
37417,806432433,5-15-24 21:28,2700,Payment,Rent Payment,-2973.182503
37418,806432433,5-15-24 23:28,335.07,Payment,Loan Payment,-3308.252503
37419,806432433,5-18-24 19:28,217.13,Purchase,Restaurant,-3525.382503
37420,806432433,5-20-24 23:28,287.86,IncomingTransfer,Freelance Payment,-3237.522503
37421,806432433,5-22-24 21:28,279.25,Return,Etsy Return,-2958.272503
37422,806432433,5-23-24 10:28,144,Return,Amazon Return,-2814.272503
37423,806432433,5-23-24 21:28,288.26,Payment,Bill Payment,-3102.532503
37424,806432433,5-24-24 11:28,133.59,Withdrawal,ATM Withdrawal,-3236.122503
37425,806432433,5-24-24 17:28,398.71,Purchase,Clothing,-3634.832503
37426,806432433,5-27-24 9:28,183.57,Return,Best Buy Return,-3451.262503
37427,806432433,5-30-24 9:28,160.28,Deposit,Mobile Deposit,-3290.982503
37428,806432433,5-31-24 16:28,51.51,Purchase,Furniture,-3342.492503
37429,806432433,5-31-24 19:28,101.92,Purchase,Clothing,-3444.412503
37430,806432433,06-01-24 17:28,131.48,Payment,Mortgage Payment,-3575.892503
37431,806432433,06-01-24 22:28,162.67,OnlineShopping,AliExpress,-3738.562503
37432,806432433,06-04-24 12:28,182.36,Deposit,Direct Deposit,-3556.202503
37433,806432433,06-05-24 21:28,4750,IncomingTransfer,Salary,1193.797497
37434,806432433,06-08-24 10:28,306,Return,Amazon Return,1499.797497
37435,806432433,06-09-24 13:28,219.17,Withdrawal,Branch Withdrawal,1280.627497
37436,806432433,06-10-24 21:28,1900,Payment,Credit Card Payment,-619.3725027
37437,806432433,06-12-24 18:28,143.28,Withdrawal,ATM Withdrawal,-762.6525027
37438,806432433,6-13-24 21:28,2300,Payment,Rent Payment,-3062.652503
37439,806432433,6-14-24 19:28,133.9,OutgoingTransfer,International Transfer,-3196.552503
37440,806432433,6-14-24 20:28,83.96,Return,AliExpress Return,-3112.592503
37441,806432433,6-14-24 20:28,312.23,Return,Target Return,-2800.362503
37442,806432433,6-18-24 12:28,235.03,Deposit,Check Deposit,-2565.332503
37443,806432433,6-20-24 21:28,147.02,Deposit,Cash Deposit,-2418.312503
37444,806432433,6-21-24 21:28,329.63,IncomingTransfer,Freelance Payment,-2088.682503
37445,806432433,6-22-24 19:28,277.53,Withdrawal,Mobile App Withdrawal,-2366.212503
37446,806432433,6-29-24 20:28,379.94,Withdrawal,Mobile App Withdrawal,-2746.152503
37447,806432433,07-01-24 17:28,129.77,Return,Walmart Return,-2616.382503
37448,806432433,07-03-24 21:28,4750,IncomingTransfer,Salary,2133.617497
37449,806432433,07-06-24 19:28,258.84,Withdrawal,Mobile App Withdrawal,1874.777497
37450,806432433,07-07-24 13:28,393.6,Return,Etsy Return,2268.377497
37451,806432433,07-08-24 21:28,1900,Payment,Credit Card Payment,368.3774973
37452,806432433,07-10-24 22:28,271.7,Withdrawal,ATM Withdrawal,96.67749734
37453,806432433,07-11-24 16:28,41.23,OnlineShopping,Target,55.44749734
37454,806432433,07-12-24 14:28,236.68,IncomingTransfer,Freelance Payment,292.1274973
37455,806432433,7-15-24 21:28,1600,Payment,Rent Payment,-1307.872503
37456,806634783,1-22-24 22:28,86.89,OutgoingTransfer,Wire Transfer,853.7075386
37457,806634783,1-26-24 12:28,119.98,Purchase,Restaurant,733.7275386
37458,806634783,1-26-24 13:28,126.87,Deposit,Direct Deposit,860.5975386
37459,806634783,1-26-24 21:28,223.63,Purchase,Restaurant,636.9675386
37460,806634783,1-27-24 11:28,150.73,IncomingTransfer,Freelance Payment,787.6975386
37461,806634783,1-30-24 22:28,129.14,Purchase,Furniture,658.5575386
37462,806634783,02-01-24 21:28,55.98,Withdrawal,Mobile App Withdrawal,602.5775386
37463,806634783,02-02-24 12:28,113.89,Deposit,Cash Deposit,716.4675386
37464,806634783,02-03-24 21:28,1700,IncomingTransfer,Salary,2416.467539
37465,806634783,02-08-24 16:28,179.31,Payment,Loan Payment,2237.157539
37466,806634783,02-08-24 21:28,1700,Payment,Credit Card Payment,537.1575386
37467,806634783,02-09-24 19:28,239.03,OutgoingTransfer,Bank Transfer,298.1275386
37468,806634783,02-10-24 12:28,145.36,OutgoingTransfer,Bank Transfer,152.7675386
37469,806634783,2-15-24 22:28,164.6,Deposit,Mobile Deposit,317.3675386
37470,806634783,2-18-24 21:28,900,Payment,Rent Payment,-582.6324614
37471,806634783,2-22-24 11:28,198.65,Withdrawal,Branch Withdrawal,-781.2824614
37472,806634783,2-22-24 16:28,180.3,OutgoingTransfer,International Transfer,-961.5824614
37473,806634783,2-24-24 18:28,103.51,Deposit,Check Deposit,-858.0724614
37474,806634783,2-25-24 22:28,13.53,IncomingTransfer,Freelance Payment,-844.5424614
37475,806634783,03-01-24 9:28,16.26,Purchase,Entertainment,-860.8024614
37476,806634783,03-01-24 21:28,1700,IncomingTransfer,Salary,839.1975386
37477,806634783,03-02-24 12:28,135.73,Purchase,Gas,703.4675386
37478,806634783,03-06-24 21:28,2000,Payment,Credit Card Payment,-1296.532461
37479,806634783,03-12-24 20:28,95.32,Purchase,Gas,-1391.852461
37480,806634783,3-15-24 21:28,500,Payment,Rent Payment,-1891.852461
37481,806634783,3-18-24 9:28,224.14,Purchase,Electronics,-2115.992461
37482,806634783,3-18-24 16:28,10.71,Purchase,Home Improvement,-2126.702461
37483,806634783,3-22-24 15:28,149.26,OutgoingTransfer,Peer-to-Peer Transfer,-2275.962461
37484,806634783,3-22-24 22:28,145.37,Withdrawal,Branch Withdrawal,-2421.332461
37485,806634783,3-28-24 15:28,95.69,Withdrawal,Mobile App Withdrawal,-2517.022461
37486,806634783,3-31-24 17:28,45.04,Withdrawal,Mobile App Withdrawal,-2562.062461
37487,806634783,04-02-24 16:28,144.82,Deposit,Cash Deposit,-2417.242461
37488,806634783,04-04-24 17:28,65.76,Purchase,Grocery,-2483.002461
37489,806634783,04-04-24 21:28,1700,IncomingTransfer,Salary,-783.0024614
37490,806634783,04-05-24 11:28,171.94,Deposit,Direct Deposit,-611.0624614
37491,806634783,04-05-24 13:28,101.6,Purchase,Clothing,-712.6624614
37492,806634783,04-06-24 16:28,75.28,OnlineShopping,Etsy,-787.9424614
37493,806634783,04-08-24 18:28,73.28,OnlineShopping,Walmart,-861.2224614
37494,806634783,04-09-24 21:28,1500,Payment,Credit Card Payment,-2361.222461
37495,806634783,04-11-24 18:28,14.55,Purchase,Pharmacy,-2375.772461
37496,806634783,04-11-24 22:28,47.86,Deposit,Mobile Deposit,-2327.912461
37497,806634783,04-12-24 13:28,26.05,Withdrawal,ATM Withdrawal,-2353.962461
37498,806634783,04-12-24 21:28,700,Payment,Rent Payment,-3053.962461
37499,806634783,4-13-24 16:28,163.36,Purchase,Electronics,-3217.322461
37500,806634783,4-15-24 21:28,249.26,Withdrawal,Branch Withdrawal,-3466.582461
37501,806634783,4-27-24 14:28,245.13,IncomingTransfer,Freelance Payment,-3221.452461
37502,806634783,4-29-24 19:28,13.88,Withdrawal,Branch Withdrawal,-3235.332461
37503,806634783,05-01-24 21:28,1700,IncomingTransfer,Salary,-1535.332461
37504,806634783,05-02-24 19:28,49.73,Return,Store Return,-1485.602461
37505,806634783,05-03-24 11:28,13.09,Deposit,Cash Deposit,-1472.512461
37506,806634783,05-04-24 22:28,196.27,OutgoingTransfer,Bank Transfer,-1668.782461
37507,806634783,05-06-24 21:28,1700,Payment,Credit Card Payment,-3368.782461
37508,806634783,05-07-24 23:28,209.03,Return,Store Return,-3159.752461
37509,806634783,05-09-24 15:28,172.07,Deposit,Direct Deposit,-2987.682461
37510,806634783,05-09-24 17:28,190.93,OnlineShopping,Walmart,-3178.612461
37511,806634783,05-09-24 17:28,109.1,Purchase,Furniture,-3287.712461
37512,806634783,05-12-24 21:28,1000,Payment,Rent Payment,-4287.712461
37513,806634783,5-13-24 22:28,208.19,Return,Amazon Return,-4079.522461
37514,806634783,5-15-24 9:28,129.17,OutgoingTransfer,International Transfer,-4208.692461
37515,806634783,5-16-24 10:28,120.14,Purchase,Pharmacy,-4328.832461
37516,806634783,5-17-24 20:28,187.87,OutgoingTransfer,Peer-to-Peer Transfer,-4516.702461
37517,806634783,5-18-24 22:28,229.75,Withdrawal,Mobile App Withdrawal,-4746.452461
37518,806634783,5-19-24 10:28,144.01,OnlineShopping,Amazon,-4890.462461
37519,806634783,5-28-24 19:28,132.9,OnlineShopping,Best Buy,-5023.362461
37520,806634783,5-28-24 23:28,18.95,IncomingTransfer,Freelance Payment,-5004.412461
37521,806634783,5-31-24 14:28,128.93,IncomingTransfer,Freelance Payment,-4875.482461
37522,806634783,5-31-24 19:28,59.44,Deposit,Cash Deposit,-4816.042461
37523,806634783,5-31-24 20:28,187.82,IncomingTransfer,Freelance Payment,-4628.222461
37524,806634783,06-02-24 21:28,201.27,Return,Walmart Return,-4426.952461
37525,806634783,06-05-24 21:28,1700,IncomingTransfer,Salary,-2726.952461
37526,806634783,06-05-24 23:28,14.3,OnlineShopping,Walmart,-2741.252461
37527,806634783,06-06-24 11:28,115.36,Deposit,Check Deposit,-2625.892461
37528,806634783,06-07-24 14:28,174.5,Deposit,Mobile Deposit,-2451.392461
37529,806634783,06-09-24 15:28,71.77,OnlineShopping,AliExpress,-2523.162461
37530,806634783,06-09-24 22:28,91.23,Deposit,Cash Deposit,-2431.932461
37531,806634783,06-10-24 16:28,91.81,OutgoingTransfer,International Transfer,-2523.742461
37532,806634783,06-10-24 21:28,1800,Payment,Credit Card Payment,-4323.742461
37533,806634783,06-11-24 22:28,37.54,Deposit,Check Deposit,-4286.202461
37534,806634783,6-15-24 21:28,600,Payment,Rent Payment,-4886.202461
37535,806634783,6-20-24 17:28,31.79,Purchase,Pharmacy,-4917.992461
37536,806634783,6-22-24 21:28,228.33,OnlineShopping,Etsy,-5146.322461
37537,806634783,6-23-24 10:28,91.41,OutgoingTransfer,Wire Transfer,-5237.732461
37538,806634783,6-24-24 23:28,20,Deposit,Check Deposit,-5217.732461
37539,806634783,6-25-24 22:28,20.75,IncomingTransfer,Freelance Payment,-5196.982461
37540,806634783,6-27-24 21:28,177.8,Purchase,Clothing,-5374.782461
37541,806634783,6-28-24 20:28,174.45,Withdrawal,ATM Withdrawal,-5549.232461
37542,806634783,07-02-24 9:28,96.79,Deposit,Direct Deposit,-5452.442461
37543,806634783,07-02-24 21:28,1700,IncomingTransfer,Salary,-3752.442461
37544,806634783,07-05-24 20:28,208.38,Withdrawal,Branch Withdrawal,-3960.822461
37545,806634783,07-07-24 14:28,39.44,Withdrawal,Mobile App Withdrawal,-4000.262461
37546,806634783,07-07-24 21:28,1700,Payment,Credit Card Payment,-5700.262461
37547,806634783,7-14-24 21:28,1000,Payment,Rent Payment,-6700.262461
37548,806634783,7-15-24 21:28,65.74,Deposit,Check Deposit,-6634.522461
37549,806970033,1-22-24 16:28,306.15,Deposit,Check Deposit,1464.546396
37550,806970033,1-23-24 16:28,128.64,Purchase,Furniture,1335.906396
37551,806970033,1-24-24 18:28,198.88,Payment,Bill Payment,1137.026396
37552,806970033,1-26-24 21:28,286.69,Deposit,Cash Deposit,1423.716396
37553,806970033,1-28-24 17:28,310.18,Purchase,Gas,1113.536396
37554,806970033,02-03-24 21:28,4200,IncomingTransfer,Salary,5313.536396
37555,806970033,02-05-24 11:28,257.86,OutgoingTransfer,Bank Transfer,5055.676396
37556,806970033,02-05-24 21:28,222.77,Withdrawal,Branch Withdrawal,4832.906396
37557,806970033,02-06-24 13:28,378.65,Purchase,Clothing,4454.256396
37558,806970033,02-06-24 23:28,252.32,Withdrawal,ATM Withdrawal,4201.936396
37559,806970033,02-08-24 19:28,290,Purchase,Furniture,3911.936396
37560,806970033,02-08-24 21:28,2000,Payment,Credit Card Payment,1911.936396
37561,806970033,2-13-24 23:28,145.4,Withdrawal,Mobile App Withdrawal,1766.536396
37562,806970033,2-14-24 23:28,354.26,OnlineShopping,Best Buy,1412.276396
37563,806970033,2-15-24 21:28,1800,Payment,Rent Payment,-387.7236042
37564,806970033,2-27-24 13:28,389.96,Purchase,Pharmacy,-777.6836042
37565,806970033,03-01-24 21:28,246.69,OutgoingTransfer,International Transfer,-1024.373604
37566,806970033,03-02-24 10:28,82.31,OnlineShopping,Best Buy,-1106.683604
37567,806970033,03-02-24 21:28,354.55,IncomingTransfer,Freelance Payment,-752.1336042
37568,806970033,03-05-24 13:28,157.85,Deposit,Cash Deposit,-594.2836042
37569,806970033,03-05-24 21:28,4200,IncomingTransfer,Salary,3605.716396
37570,806970033,03-08-24 15:28,290.7,Purchase,Furniture,3315.016396
37571,806970033,03-10-24 21:28,1600,Payment,Credit Card Payment,1715.016396
37572,806970033,03-11-24 11:28,145.27,Payment,Loan Payment,1569.746396
37573,806970033,3-15-24 21:28,1500,Payment,Rent Payment,69.74639581
37574,806970033,3-18-24 10:28,24.18,Return,AliExpress Return,93.92639581
37575,806970033,3-18-24 18:28,189.6,Payment,Bill Payment,-95.67360419
37576,806970033,3-19-24 23:28,344.44,OutgoingTransfer,International Transfer,-440.1136042
37577,806970033,3-23-24 12:28,167.91,OutgoingTransfer,Wire Transfer,-608.0236042
37578,806970033,3-23-24 21:28,328.56,OnlineShopping,Best Buy,-936.5836042
37579,806970033,3-27-24 20:28,91.74,OnlineShopping,eBay,-1028.323604
37580,806970033,3-30-24 21:28,118.13,Withdrawal,Branch Withdrawal,-1146.453604
37581,806970033,04-01-24 18:28,238.11,Purchase,Clothing,-1384.563604
37582,806970033,04-01-24 21:28,4200,IncomingTransfer,Salary,2815.436396
37583,806970033,04-02-24 14:28,375.13,Payment,Loan Payment,2440.306396
37584,806970033,04-06-24 21:28,1700,Payment,Credit Card Payment,740.3063958
37585,806970033,04-09-24 9:28,352.49,Withdrawal,ATM Withdrawal,387.8163958
37586,806970033,04-12-24 12:28,72.78,Purchase,Restaurant,315.0363958
37587,806970033,4-13-24 16:28,101.54,Deposit,Cash Deposit,416.5763958
37588,806970033,4-13-24 21:28,1600,Payment,Rent Payment,-1183.423604
37589,806970033,4-15-24 19:28,118.32,Payment,Loan Payment,-1301.743604
37590,806970033,4-18-24 19:28,395.43,Deposit,Direct Deposit,-906.3136042
37591,806970033,4-21-24 11:28,328.77,OnlineShopping,Amazon,-1235.083604
37592,806970033,4-22-24 16:28,138.83,OnlineShopping,Walmart,-1373.913604
37593,806970033,4-22-24 20:28,161.7,Purchase,Clothing,-1535.613604
37594,806970033,4-26-24 16:28,61.36,Return,eBay Return,-1474.253604
37595,806970033,4-28-24 14:28,34.78,Deposit,Cash Deposit,-1439.473604
37596,806970033,4-29-24 22:28,126.1,Return,Walmart Return,-1313.373604
37597,806970033,4-30-24 20:28,180.92,Purchase,Grocery,-1494.293604
37598,806970033,05-01-24 16:28,179.68,Deposit,Cash Deposit,-1314.613604
37599,806970033,05-05-24 21:28,4200,IncomingTransfer,Salary,2885.386396
37600,806970033,05-06-24 12:28,64.38,Deposit,Cash Deposit,2949.766396
37601,806970033,05-06-24 17:28,222.74,OnlineShopping,Best Buy,2727.026396
37602,806970033,05-07-24 21:28,24.88,Purchase,Pharmacy,2702.146396
37603,806970033,05-08-24 19:28,242.95,Withdrawal,Branch Withdrawal,2459.196396
37604,806970033,05-10-24 21:28,1800,Payment,Credit Card Payment,659.1963958
37605,806970033,05-11-24 11:28,56.77,Deposit,Mobile Deposit,715.9663958
37606,806970033,05-12-24 12:28,95.62,Payment,Mortgage Payment,620.3463958
37607,806970033,5-15-24 23:28,104.57,Return,eBay Return,724.9163958
37608,806970033,5-16-24 21:28,1700,Payment,Rent Payment,-975.0836042
37609,806970033,5-19-24 10:28,91.24,Deposit,Direct Deposit,-883.8436042
37610,806970033,5-19-24 16:28,374.77,IncomingTransfer,Freelance Payment,-509.0736042
37611,806970033,5-22-24 18:28,102.18,Payment,Loan Payment,-611.2536042
37612,806970033,5-30-24 12:28,134.44,Purchase,Entertainment,-745.6936042
37613,806970033,5-30-24 13:28,313.85,Purchase,Furniture,-1059.543604
37614,806970033,06-03-24 18:28,80.2,Deposit,Mobile Deposit,-979.3436042
37615,806970033,06-05-24 21:28,4200,IncomingTransfer,Salary,3220.656396
37616,806970033,06-05-24 22:28,140.3,Payment,Mortgage Payment,3080.356396
37617,806970033,06-10-24 13:28,33.54,OutgoingTransfer,International Transfer,3046.816396
37618,806970033,06-10-24 17:28,75.6,Payment,Bill Payment,2971.216396
37619,806970033,06-10-24 21:28,1800,Payment,Credit Card Payment,1171.216396
37620,806970033,06-11-24 9:28,294.76,Payment,Bill Payment,876.4563958
37621,806970033,06-11-24 16:28,282.87,Payment,Bill Payment,593.5863958
37622,806970033,06-12-24 9:28,80.27,Purchase,Furniture,513.3163958
37623,806970033,6-14-24 21:28,2000,Payment,Rent Payment,-1486.683604
37624,806970033,6-15-24 21:28,367.88,Purchase,Furniture,-1854.563604
37625,806970033,6-17-24 12:28,250.84,OutgoingTransfer,Bank Transfer,-2105.403604
37626,806970033,6-17-24 16:28,20.8,Withdrawal,Mobile App Withdrawal,-2126.203604
37627,806970033,6-19-24 14:28,226.3,Purchase,Travel,-2352.503604
37628,806970033,6-19-24 14:28,160.06,OnlineShopping,eBay,-2512.563604
37629,806970033,6-23-24 10:28,256.05,Purchase,Entertainment,-2768.613604
37630,806970033,6-24-24 23:28,278.79,Purchase,Grocery,-3047.403604
37631,806970033,6-27-24 19:28,396.07,Return,AliExpress Return,-2651.333604
37632,806970033,6-29-24 13:28,399.25,IncomingTransfer,Freelance Payment,-2252.083604
37633,806970033,6-30-24 10:28,51.97,OutgoingTransfer,Peer-to-Peer Transfer,-2304.053604
37634,806970033,07-01-24 15:28,307.37,Purchase,Entertainment,-2611.423604
37635,806970033,07-02-24 21:28,4200,IncomingTransfer,Salary,1588.576396
37636,806970033,07-06-24 21:28,366.6,Payment,Loan Payment,1221.976396
37637,806970033,07-07-24 21:28,1700,Payment,Credit Card Payment,-478.0236042
37638,806970033,07-08-24 10:28,345.75,Deposit,Direct Deposit,-132.2736042
37639,806970033,07-08-24 19:28,96.41,Withdrawal,Branch Withdrawal,-228.6836042
37640,806970033,07-11-24 10:28,318.38,Payment,Loan Payment,-547.0636042
37641,806970033,07-11-24 19:28,371.63,IncomingTransfer,Freelance Payment,-175.4336042
37642,806970033,7-14-24 13:28,280.6,Purchase,Clothing,-456.0336042
37643,806970033,7-18-24 21:28,1500,Payment,Rent Payment,-1956.033604
37644,806989008,1-20-24 11:28,161.66,Purchase,Home Improvement,773.9637258
37645,806989008,1-20-24 21:28,75.43,Purchase,Travel,698.5337258
37646,806989008,1-26-24 11:28,133.74,Purchase,Pharmacy,564.7937258
37647,806989008,1-30-24 19:28,472.88,Return,Target Return,1037.673726
37648,806989008,1-31-24 15:28,71.77,Withdrawal,Branch Withdrawal,965.9037258
37649,806989008,02-02-24 20:28,78.87,OutgoingTransfer,Peer-to-Peer Transfer,887.0337258
37650,806989008,02-02-24 21:28,4300,IncomingTransfer,Salary,5187.033726
37651,806989008,02-03-24 22:28,90.98,OutgoingTransfer,International Transfer,5096.053726
37652,806989008,02-04-24 17:28,129.12,Payment,Mortgage Payment,4966.933726
37653,806989008,02-06-24 17:28,440.34,Payment,Bill Payment,4526.593726
37654,806989008,02-07-24 12:28,155.69,OutgoingTransfer,Wire Transfer,4370.903726
37655,806989008,02-07-24 21:28,1500,Payment,Credit Card Payment,2870.903726
37656,806989008,02-09-24 11:28,364.22,Purchase,Travel,2506.683726
37657,806989008,02-12-24 19:28,109.12,OnlineShopping,eBay,2397.563726
37658,806989008,2-13-24 10:28,335.65,Purchase,Home Improvement,2061.913726
37659,806989008,2-13-24 21:28,238.72,Payment,Bill Payment,1823.193726
37660,806989008,2-13-24 21:28,195.33,Purchase,Clothing,1627.863726
37661,806989008,2-16-24 12:28,458.22,Purchase,Entertainment,1169.643726
37662,806989008,2-16-24 20:28,478.01,Payment,Loan Payment,691.6337258
37663,806989008,2-17-24 21:28,2600,Payment,Rent Payment,-1908.366274
37664,806989008,2-21-24 14:28,497.41,Payment,Loan Payment,-2405.776274
37665,806989008,2-21-24 22:28,283.69,Deposit,Check Deposit,-2122.086274
37666,806989008,2-22-24 16:28,453.3,OnlineShopping,AliExpress,-2575.386274
37667,806989008,2-23-24 11:28,479.35,Purchase,Electronics,-3054.736274
37668,806989008,2-25-24 14:28,310.24,Purchase,Restaurant,-3364.976274
37669,806989008,2-29-24 13:28,274.59,Deposit,Direct Deposit,-3090.386274
37670,806989008,03-02-24 13:28,261.62,Withdrawal,Branch Withdrawal,-3352.006274
37671,806989008,03-02-24 15:28,161.16,OnlineShopping,eBay,-3513.166274
37672,806989008,03-03-24 19:28,424.46,OnlineShopping,Target,-3937.626274
37673,806989008,03-03-24 21:28,4300,IncomingTransfer,Salary,362.3737258
37674,806989008,03-05-24 13:28,227.3,Return,Walmart Return,589.6737258
37675,806989008,03-07-24 14:28,141.25,Purchase,Restaurant,448.4237258
37676,806989008,03-08-24 15:28,13.4,Deposit,Cash Deposit,461.8237258
37677,806989008,03-08-24 21:28,1500,Payment,Credit Card Payment,-1038.176274
37678,806989008,03-09-24 19:28,450.77,Deposit,Direct Deposit,-587.4062742
37679,806989008,3-14-24 10:28,179.97,OnlineShopping,Etsy,-767.3762742
37680,806989008,3-15-24 22:28,95.01,Purchase,Electronics,-862.3862742
37681,806989008,3-16-24 21:28,2200,Payment,Rent Payment,-3062.386274
37682,806989008,3-23-24 22:28,406.84,Purchase,Clothing,-3469.226274
37683,806989008,3-24-24 18:28,65.28,Deposit,Direct Deposit,-3403.946274
37684,806989008,3-28-24 11:28,110.28,Purchase,Grocery,-3514.226274
37685,806989008,3-31-24 13:28,31.66,Purchase,Travel,-3545.886274
37686,806989008,3-31-24 19:28,259.73,Payment,Bill Payment,-3805.616274
37687,806989008,04-01-24 13:28,307.29,OutgoingTransfer,Wire Transfer,-4112.906274
37688,806989008,04-03-24 21:28,4300,IncomingTransfer,Salary,187.0937258
37689,806989008,04-04-24 16:28,438.36,Withdrawal,Mobile App Withdrawal,-251.2662742
37690,806989008,04-08-24 21:28,1500,Payment,Credit Card Payment,-1751.266274
37691,806989008,04-09-24 23:28,321.52,OutgoingTransfer,Wire Transfer,-2072.786274
37692,806989008,4-14-24 17:28,359.66,Withdrawal,Mobile App Withdrawal,-2432.446274
37693,806989008,4-14-24 21:28,1400,Payment,Rent Payment,-3832.446274
37694,806989008,4-16-24 17:28,156.84,Deposit,Mobile Deposit,-3675.606274
37695,806989008,4-20-24 20:28,330.62,Deposit,Cash Deposit,-3344.986274
37696,806989008,4-26-24 12:28,285.92,Return,Etsy Return,-3059.066274
37697,806989008,05-05-24 21:28,4300,IncomingTransfer,Salary,1240.933726
37698,806989008,05-07-24 9:28,372.87,Purchase,Restaurant,868.0637258
37699,806989008,05-08-24 23:28,189.1,Purchase,Clothing,678.9637258
37700,806989008,05-09-24 12:28,481.17,Deposit,Cash Deposit,1160.133726
37701,806989008,05-10-24 21:28,1300,Payment,Credit Card Payment,-139.8662742
37702,806989008,05-10-24 23:28,166.59,Return,Etsy Return,26.72372583
37703,806989008,5-15-24 21:28,1700,Payment,Rent Payment,-1673.276274
37704,806989008,5-16-24 21:28,390.95,Return,eBay Return,-1282.326274
37705,806989008,5-18-24 11:28,468.96,OutgoingTransfer,Wire Transfer,-1751.286274
37706,806989008,5-18-24 15:28,127.75,Payment,Bill Payment,-1879.036274
37707,806989008,5-19-24 17:28,369.04,Deposit,Check Deposit,-1509.996274
37708,806989008,5-22-24 21:28,370.69,Deposit,Direct Deposit,-1139.306274
37709,806989008,5-24-24 23:28,125.85,OnlineShopping,Target,-1265.156274
37710,806989008,5-25-24 12:28,408.92,Purchase,Travel,-1674.076274
37711,806989008,5-25-24 22:28,77.71,Deposit,Mobile Deposit,-1596.366274
37712,806989008,5-29-24 15:28,312.12,Deposit,Direct Deposit,-1284.246274
37713,806989008,06-02-24 15:28,317.83,Purchase,Home Improvement,-1602.076274
37714,806989008,06-03-24 18:28,181.43,Payment,Mortgage Payment,-1783.506274
37715,806989008,06-05-24 21:28,4300,IncomingTransfer,Salary,2516.493726
37716,806989008,06-06-24 11:28,62.01,OutgoingTransfer,Wire Transfer,2454.483726
37717,806989008,06-10-24 21:28,1500,Payment,Credit Card Payment,954.4837258
37718,806989008,06-10-24 22:28,129.65,Return,AliExpress Return,1084.133726
37719,806989008,06-10-24 23:28,126.85,OutgoingTransfer,Peer-to-Peer Transfer,957.2837258
37720,806989008,6-13-24 15:28,352.05,Withdrawal,Branch Withdrawal,605.2337258
37721,806989008,6-16-24 21:28,2200,Payment,Rent Payment,-1594.766274
37722,806989008,6-17-24 18:28,69.35,Purchase,Grocery,-1664.116274
37723,806989008,6-20-24 19:28,192.39,OnlineShopping,AliExpress,-1856.506274
37724,806989008,6-27-24 13:28,304.91,Purchase,Travel,-2161.416274
37725,806989008,6-28-24 9:28,81.22,Purchase,Electronics,-2242.636274
37726,806989008,6-28-24 11:28,52.11,OutgoingTransfer,Bank Transfer,-2294.746274
37727,806989008,6-29-24 12:28,191.76,OutgoingTransfer,Peer-to-Peer Transfer,-2486.506274
37728,806989008,07-02-24 21:28,4300,IncomingTransfer,Salary,1813.493726
37729,806989008,07-02-24 21:28,407.61,Payment,Bill Payment,1405.883726
37730,806989008,07-03-24 20:28,85.29,Payment,Mortgage Payment,1320.593726
37731,806989008,07-06-24 10:28,319.41,Withdrawal,ATM Withdrawal,1001.183726
37732,806989008,07-07-24 10:28,69.56,Return,AliExpress Return,1070.743726
37733,806989008,07-07-24 17:28,214.61,Withdrawal,Branch Withdrawal,856.1337258
37734,806989008,07-07-24 21:28,1500,Payment,Credit Card Payment,-643.8662742
37735,806989008,07-09-24 11:28,161.66,Purchase,Restaurant,-805.5262742
37736,806989008,07-10-24 12:28,304.88,Withdrawal,ATM Withdrawal,-1110.406274
37737,806989008,07-11-24 10:28,459.78,Payment,Bill Payment,-1570.186274
37738,806989008,07-11-24 19:28,308.81,IncomingTransfer,Freelance Payment,-1261.376274
37739,806989008,07-11-24 19:28,390.34,Purchase,Grocery,-1651.716274
37740,806989008,07-12-24 16:28,148.9,OnlineShopping,eBay,-1800.616274
37741,806989008,7-13-24 22:28,61.38,Purchase,Pharmacy,-1861.996274
37742,806989008,7-17-24 16:28,251.94,IncomingTransfer,Freelance Payment,-1610.056274
37743,806989008,7-18-24 21:28,2300,Payment,Rent Payment,-3910.056274
37744,807157833,1-20-24 11:28,185.91,Purchase,Grocery,689.9387596
37745,807157833,1-23-24 9:28,161.43,Purchase,Pharmacy,528.5087596
37746,807157833,1-27-24 21:28,313.86,OutgoingTransfer,Bank Transfer,214.6487596
37747,807157833,02-03-24 21:28,2200,IncomingTransfer,Salary,2414.64876
37748,807157833,02-07-24 9:28,308.19,Payment,Loan Payment,2106.45876
37749,807157833,02-08-24 21:28,1900,Payment,Credit Card Payment,206.4587596
37750,807157833,02-10-24 14:28,29.38,Deposit,Direct Deposit,235.8387596
37751,807157833,02-10-24 16:28,483.46,Withdrawal,Branch Withdrawal,-247.6212404
37752,807157833,02-10-24 17:28,391.91,Purchase,Restaurant,-639.5312404
37753,807157833,02-12-24 18:28,245.64,Withdrawal,ATM Withdrawal,-885.1712404
37754,807157833,2-13-24 17:28,391.65,Return,Store Return,-493.5212404
37755,807157833,2-14-24 13:28,368.45,Purchase,Furniture,-861.9712404
37756,807157833,2-16-24 21:28,1000,Payment,Rent Payment,-1861.97124
37757,807157833,2-18-24 10:28,353.33,Purchase,Gas,-2215.30124
37758,807157833,2-23-24 16:28,473.61,Withdrawal,Mobile App Withdrawal,-2688.91124
37759,807157833,2-23-24 20:28,134.36,Withdrawal,Mobile App Withdrawal,-2823.27124
37760,807157833,2-24-24 17:28,378.99,Deposit,Direct Deposit,-2444.28124
37761,807157833,2-29-24 16:28,287.74,Return,Best Buy Return,-2156.54124
37762,807157833,2-29-24 17:28,53.77,Deposit,Mobile Deposit,-2102.77124
37763,807157833,03-03-24 16:28,197.83,Return,Amazon Return,-1904.94124
37764,807157833,03-05-24 10:28,206.72,Purchase,Electronics,-2111.66124
37765,807157833,03-05-24 21:28,2200,IncomingTransfer,Salary,88.33875959
37766,807157833,03-07-24 11:28,142.82,OutgoingTransfer,Wire Transfer,-54.48124041
37767,807157833,03-07-24 20:28,119.04,OutgoingTransfer,Wire Transfer,-173.5212404
37768,807157833,03-07-24 20:28,366.91,Withdrawal,ATM Withdrawal,-540.4312404
37769,807157833,03-10-24 21:28,1600,Payment,Credit Card Payment,-2140.43124
37770,807157833,3-14-24 21:28,1400,Payment,Rent Payment,-3540.43124
37771,807157833,3-17-24 20:28,413.94,OutgoingTransfer,International Transfer,-3954.37124
37772,807157833,3-18-24 11:28,420.98,OnlineShopping,Walmart,-4375.35124
37773,807157833,3-19-24 17:28,368.88,Return,Etsy Return,-4006.47124
37774,807157833,3-19-24 22:28,326.04,OutgoingTransfer,Peer-to-Peer Transfer,-4332.51124
37775,807157833,3-20-24 17:28,248.47,Deposit,Cash Deposit,-4084.04124
37776,807157833,3-22-24 17:28,11.21,Purchase,Electronics,-4095.25124
37777,807157833,3-22-24 17:28,155.76,OutgoingTransfer,Wire Transfer,-4251.01124
37778,807157833,3-22-24 21:28,308.02,IncomingTransfer,Freelance Payment,-3942.99124
37779,807157833,3-26-24 16:28,98.01,OnlineShopping,Target,-4041.00124
37780,807157833,3-27-24 14:28,67.4,Deposit,Direct Deposit,-3973.60124
37781,807157833,3-27-24 22:28,110.85,OnlineShopping,Amazon,-4084.45124
37782,807157833,04-02-24 21:28,2200,IncomingTransfer,Salary,-1884.45124
37783,807157833,04-03-24 11:28,143.3,OutgoingTransfer,Wire Transfer,-2027.75124
37784,807157833,04-03-24 18:28,122.11,Return,Store Return,-1905.64124
37785,807157833,04-05-24 13:28,296.01,Withdrawal,Branch Withdrawal,-2201.65124
37786,807157833,04-07-24 11:28,134.36,Withdrawal,ATM Withdrawal,-2336.01124
37787,807157833,04-07-24 21:28,1300,Payment,Credit Card Payment,-3636.01124
37788,807157833,04-09-24 20:28,336.19,Payment,Loan Payment,-3972.20124
37789,807157833,04-09-24 23:28,425.75,Deposit,Cash Deposit,-3546.45124
37790,807157833,04-11-24 14:28,84.36,Withdrawal,Branch Withdrawal,-3630.81124
37791,807157833,4-16-24 16:28,268.49,Return,Target Return,-3362.32124
37792,807157833,4-18-24 21:28,800,Payment,Rent Payment,-4162.32124
37793,807157833,4-24-24 11:28,440.58,Purchase,Electronics,-4602.90124
37794,807157833,4-26-24 18:28,464.62,OnlineShopping,Walmart,-5067.52124
37795,807157833,4-27-24 20:28,203.88,Deposit,Cash Deposit,-4863.64124
37796,807157833,4-30-24 16:28,120.24,IncomingTransfer,Freelance Payment,-4743.40124
37797,807157833,05-03-24 21:28,2200,IncomingTransfer,Salary,-2543.40124
37798,807157833,05-04-24 13:28,168.76,Payment,Mortgage Payment,-2712.16124
37799,807157833,05-05-24 17:28,257.37,Return,Store Return,-2454.79124
37800,807157833,05-07-24 19:28,250.46,Withdrawal,Branch Withdrawal,-2705.25124
37801,807157833,05-08-24 15:28,419.8,Return,Target Return,-2285.45124
37802,807157833,05-08-24 21:28,1500,Payment,Credit Card Payment,-3785.45124
37803,807157833,05-11-24 16:28,24.37,Deposit,Check Deposit,-3761.08124
37804,807157833,5-13-24 11:28,43.79,OnlineShopping,AliExpress,-3804.87124
37805,807157833,5-13-24 21:28,800,Payment,Rent Payment,-4604.87124
37806,807157833,5-14-24 11:28,218.17,Purchase,Grocery,-4823.04124
37807,807157833,5-14-24 15:28,29.65,Withdrawal,ATM Withdrawal,-4852.69124
37808,807157833,5-14-24 23:28,210.99,Purchase,Gas,-5063.68124
37809,807157833,5-20-24 21:28,150.75,Deposit,Cash Deposit,-4912.93124
37810,807157833,5-25-24 17:28,107.21,Withdrawal,Branch Withdrawal,-5020.14124
37811,807157833,5-29-24 13:28,390.62,Withdrawal,Branch Withdrawal,-5410.76124
37812,807157833,06-02-24 21:28,2200,IncomingTransfer,Salary,-3210.76124
37813,807157833,06-02-24 22:28,147.73,Deposit,Direct Deposit,-3063.03124
37814,807157833,06-03-24 13:28,346.07,Purchase,Electronics,-3409.10124
37815,807157833,06-04-24 15:28,440.14,Deposit,Mobile Deposit,-2968.96124
37816,807157833,06-04-24 21:28,491.65,OnlineShopping,Walmart,-3460.61124
37817,807157833,06-07-24 21:28,1900,Payment,Credit Card Payment,-5360.61124
37818,807157833,06-08-24 11:28,138.18,OutgoingTransfer,International Transfer,-5498.79124
37819,807157833,06-10-24 11:28,319.82,OutgoingTransfer,Peer-to-Peer Transfer,-5818.61124
37820,807157833,06-10-24 21:28,52.77,OnlineShopping,eBay,-5871.38124
37821,807157833,06-12-24 21:28,1300,Payment,Rent Payment,-7171.38124
37822,807157833,6-14-24 9:28,274.78,Payment,Bill Payment,-7446.16124
37823,807157833,6-19-24 12:28,161,Purchase,Gas,-7607.16124
37824,807157833,6-23-24 14:28,75.38,Deposit,Cash Deposit,-7531.78124
37825,807157833,6-24-24 15:28,17.01,Deposit,Direct Deposit,-7514.77124
37826,807157833,6-27-24 22:28,210.43,Purchase,Clothing,-7725.20124
37827,807157833,6-29-24 15:28,412.46,Withdrawal,ATM Withdrawal,-8137.66124
37828,807157833,6-30-24 18:28,480.56,Return,Walmart Return,-7657.10124
37829,807157833,07-04-24 21:28,2200,IncomingTransfer,Salary,-5457.10124
37830,807157833,07-05-24 20:28,216.97,Purchase,Home Improvement,-5674.07124
37831,807157833,07-09-24 21:28,1900,Payment,Credit Card Payment,-7574.07124
37832,807157833,07-11-24 9:28,204.67,Withdrawal,Mobile App Withdrawal,-7778.74124
37833,807157833,7-15-24 13:28,267.84,Purchase,Entertainment,-8046.58124
37834,807157833,7-18-24 21:28,1000,Payment,Rent Payment,-9046.58124
37835,807600633,1-20-24 12:28,126.55,Deposit,Check Deposit,541.0977317
37836,807600633,1-21-24 17:28,58.06,Deposit,Cash Deposit,599.1577317
37837,807600633,1-22-24 18:28,474.96,Withdrawal,Branch Withdrawal,124.1977317
37838,807600633,1-24-24 17:28,186.83,Withdrawal,ATM Withdrawal,-62.63226835
37839,807600633,1-25-24 22:28,150.96,OutgoingTransfer,Peer-to-Peer Transfer,-213.5922683
37840,807600633,1-26-24 13:28,438.09,OutgoingTransfer,Bank Transfer,-651.6822683
37841,807600633,1-29-24 16:28,167.21,Withdrawal,Branch Withdrawal,-818.8922683
37842,807600633,1-30-24 19:28,380.08,IncomingTransfer,Freelance Payment,-438.8122683
37843,807600633,02-01-24 21:28,2600,IncomingTransfer,Salary,2161.187732
37844,807600633,02-02-24 10:28,239.03,OnlineShopping,Etsy,1922.157732
37845,807600633,02-04-24 10:28,448.66,OnlineShopping,Best Buy,1473.497732
37846,807600633,02-06-24 21:28,800,Payment,Credit Card Payment,673.4977317
37847,807600633,02-09-24 23:28,339.36,OutgoingTransfer,Peer-to-Peer Transfer,334.1377317
37848,807600633,02-10-24 10:28,407.13,Withdrawal,Mobile App Withdrawal,-72.99226835
37849,807600633,02-10-24 12:28,26.62,Return,eBay Return,-46.37226835
37850,807600633,2-16-24 13:28,118.13,Purchase,Grocery,-164.5022683
37851,807600633,2-16-24 21:28,1000,Payment,Insurance Payment,-1164.502268
37852,807600633,2-17-24 16:28,245.54,IncomingTransfer,Freelance Payment,-918.9622683
37853,807600633,2-20-24 18:28,157.14,OutgoingTransfer,Peer-to-Peer Transfer,-1076.102268
37854,807600633,2-22-24 10:28,92.05,Purchase,Travel,-1168.152268
37855,807600633,2-23-24 10:28,36.62,Deposit,Cash Deposit,-1131.532268
37856,807600633,2-28-24 17:28,77.71,OutgoingTransfer,Bank Transfer,-1209.242268
37857,807600633,03-01-24 11:28,177.3,Purchase,Home Improvement,-1386.542268
37858,807600633,03-02-24 13:28,220.43,OnlineShopping,Best Buy,-1606.972268
37859,807600633,03-03-24 21:28,2600,IncomingTransfer,Salary,993.0277317
37860,807600633,03-05-24 13:28,224.57,Return,Amazon Return,1217.597732
37861,807600633,03-08-24 21:28,900,Payment,Credit Card Payment,317.5977317
37862,807600633,03-09-24 22:28,23.93,OnlineShopping,Best Buy,293.6677317
37863,807600633,03-10-24 21:28,1000,Payment,Insurance Payment,-706.3322683
37864,807600633,3-14-24 9:28,302.38,OutgoingTransfer,Peer-to-Peer Transfer,-1008.712268
37865,807600633,3-14-24 9:28,335.81,Return,Amazon Return,-672.9022683
37866,807600633,3-14-24 13:28,243.85,Deposit,Direct Deposit,-429.0522683
37867,807600633,3-17-24 13:28,292.83,Withdrawal,Mobile App Withdrawal,-721.8822683
37868,807600633,3-18-24 21:28,483.6,Withdrawal,Mobile App Withdrawal,-1205.482268
37869,807600633,3-20-24 19:28,266.64,OutgoingTransfer,Bank Transfer,-1472.122268
37870,807600633,3-23-24 10:28,150.27,Withdrawal,ATM Withdrawal,-1622.392268
37871,807600633,3-25-24 11:28,225.44,Payment,Mortgage Payment,-1847.832268
37872,807600633,3-25-24 13:28,286.1,Payment,Loan Payment,-2133.932268
37873,807600633,3-28-24 23:28,189.04,Withdrawal,Branch Withdrawal,-2322.972268
37874,807600633,3-30-24 14:28,171.2,Deposit,Mobile Deposit,-2151.772268
37875,807600633,04-03-24 14:28,149.05,Purchase,Entertainment,-2300.822268
37876,807600633,04-04-24 21:28,2600,IncomingTransfer,Salary,299.1777317
37877,807600633,04-09-24 21:28,900,Payment,Credit Card Payment,-600.8222683
37878,807600633,04-11-24 11:28,437.06,OnlineShopping,Target,-1037.882268
37879,807600633,4-14-24 22:28,224.14,Purchase,Travel,-1262.022268
37880,807600633,4-15-24 21:28,700,Payment,Subscription Payment,-1962.022268
37881,807600633,4-16-24 22:28,71.67,Return,Walmart Return,-1890.352268
37882,807600633,4-18-24 9:28,176.71,OnlineShopping,Best Buy,-2067.062268
37883,807600633,4-20-24 12:28,130.95,OnlineShopping,Best Buy,-2198.012268
37884,807600633,4-22-24 14:28,467.86,Payment,Bill Payment,-2665.872268
37885,807600633,4-22-24 20:28,281.33,Purchase,Travel,-2947.202268
37886,807600633,4-25-24 13:28,83.21,Withdrawal,ATM Withdrawal,-3030.412268
37887,807600633,4-26-24 16:28,209.35,Payment,Mortgage Payment,-3239.762268
37888,807600633,4-26-24 19:28,487.25,Payment,Bill Payment,-3727.012268
37889,807600633,4-28-24 12:28,175.76,Withdrawal,Branch Withdrawal,-3902.772268
37890,807600633,4-29-24 16:28,368.08,OnlineShopping,Etsy,-4270.852268
37891,807600633,05-02-24 21:28,2600,IncomingTransfer,Salary,-1670.852268
37892,807600633,05-05-24 15:28,234.86,Purchase,Gas,-1905.712268
37893,807600633,05-05-24 18:28,308.91,IncomingTransfer,Freelance Payment,-1596.802268
37894,807600633,05-07-24 21:28,700,Payment,Credit Card Payment,-2296.802268
37895,807600633,05-09-24 10:28,146.13,Purchase,Grocery,-2442.932268
37896,807600633,05-12-24 21:28,1100,Payment,Subscription Payment,-3542.932268
37897,807600633,5-14-24 10:28,84.41,Return,eBay Return,-3458.522268
37898,807600633,5-15-24 9:28,41.76,Purchase,Entertainment,-3500.282268
37899,807600633,5-17-24 11:28,212.3,Deposit,Check Deposit,-3287.982268
37900,807600633,5-19-24 11:28,102.31,Return,Target Return,-3185.672268
37901,807600633,5-19-24 22:28,155.86,Payment,Bill Payment,-3341.532268
37902,807600633,5-21-24 9:28,172.38,Return,Store Return,-3169.152268
37903,807600633,5-24-24 9:28,334.77,Payment,Loan Payment,-3503.922268
37904,807600633,5-29-24 13:28,231.27,Purchase,Furniture,-3735.192268
37905,807600633,5-31-24 14:28,60.09,IncomingTransfer,Freelance Payment,-3675.102268
37906,807600633,06-01-24 21:28,2600,IncomingTransfer,Salary,-1075.102268
37907,807600633,06-02-24 17:28,266.79,OnlineShopping,eBay,-1341.892268
37908,807600633,06-03-24 19:28,15.43,IncomingTransfer,Freelance Payment,-1326.462268
37909,807600633,06-06-24 11:28,112.23,Return,Amazon Return,-1214.232268
37910,807600633,06-06-24 21:28,900,Payment,Credit Card Payment,-2114.232268
37911,807600633,06-08-24 19:28,434.61,Payment,Mortgage Payment,-2548.842268
37912,807600633,06-09-24 10:28,53.39,Purchase,Gas,-2602.232268
37913,807600633,6-13-24 20:28,246.49,IncomingTransfer,Freelance Payment,-2355.742268
37914,807600633,6-15-24 15:28,425.62,Withdrawal,Branch Withdrawal,-2781.362268
37915,807600633,6-18-24 9:28,135.94,Purchase,Travel,-2917.302268
37916,807600633,6-18-24 21:28,1100,Payment,Installment Payment,-4017.302268
37917,807600633,6-19-24 18:28,290.54,OnlineShopping,Best Buy,-4307.842268
37918,807600633,6-19-24 19:28,148.07,Payment,Mortgage Payment,-4455.912268
37919,807600633,6-19-24 22:28,16.24,Deposit,Cash Deposit,-4439.672268
37920,807600633,6-24-24 20:28,399.26,Deposit,Direct Deposit,-4040.412268
37921,807600633,6-27-24 23:28,353.25,Withdrawal,ATM Withdrawal,-4393.662268
37922,807600633,6-30-24 12:28,367.39,OutgoingTransfer,Wire Transfer,-4761.052268
37923,807600633,6-30-24 14:28,383.5,OnlineShopping,eBay,-5144.552268
37924,807600633,07-01-24 11:28,427.78,OutgoingTransfer,Wire Transfer,-5572.332268
37925,807600633,07-01-24 21:28,47,Deposit,Direct Deposit,-5525.332268
37926,807600633,07-03-24 18:28,71.46,Payment,Mortgage Payment,-5596.792268
37927,807600633,07-05-24 21:28,2600,IncomingTransfer,Salary,-2996.792268
37928,807600633,07-06-24 19:28,493.57,Purchase,Gas,-3490.362268
37929,807600633,07-08-24 16:28,193.41,Deposit,Mobile Deposit,-3296.952268
37930,807600633,07-10-24 21:28,700,Payment,Credit Card Payment,-3996.952268
37931,807600633,07-10-24 21:28,174.07,Purchase,Electronics,-4171.022268
37932,807600633,7-13-24 16:28,195.45,Purchase,Gas,-4366.472268
37933,807600633,7-14-24 19:28,218.61,Withdrawal,Branch Withdrawal,-4585.082268
37934,807600633,7-15-24 21:28,1000,Payment,Insurance Payment,-5585.082268
37935,807600633,7-16-24 11:28,203.2,Deposit,Check Deposit,-5381.882268
37936,808279158,1-23-24 13:28,434.63,Deposit,Direct Deposit,1548.591691
37937,808279158,1-23-24 15:28,349.24,OnlineShopping,AliExpress,1199.351691
37938,808279158,1-25-24 12:28,112.57,Payment,Mortgage Payment,1086.781691
37939,808279158,1-29-24 16:28,247.92,Payment,Loan Payment,838.8616914
37940,808279158,02-01-24 10:28,310.02,Deposit,Check Deposit,1148.881691
37941,808279158,02-01-24 13:28,637.25,Deposit,Direct Deposit,1786.131691
37942,808279158,02-01-24 14:28,666.65,OnlineShopping,Etsy,1119.481691
37943,808279158,02-02-24 17:28,361.85,Purchase,Electronics,757.6316914
37944,808279158,02-02-24 21:28,9100,IncomingTransfer,Salary,9857.631691
37945,808279158,02-07-24 21:28,2100,Payment,Credit Card Payment,7757.631691
37946,808279158,02-10-24 18:28,154.66,Deposit,Check Deposit,7912.291691
37947,808279158,02-10-24 18:28,540.83,Return,Store Return,8453.121691
37948,808279158,2-13-24 10:28,380.36,Deposit,Check Deposit,8833.481691
37949,808279158,2-14-24 19:28,217.53,Return,Amazon Return,9051.011691
37950,808279158,2-15-24 15:28,308.48,Deposit,Direct Deposit,9359.491691
37951,808279158,2-15-24 22:28,724.92,Deposit,Mobile Deposit,10084.41169
37952,808279158,2-16-24 12:28,323.98,IncomingTransfer,Freelance Payment,10408.39169
37953,808279158,2-16-24 12:28,486.84,IncomingTransfer,Freelance Payment,10895.23169
37954,808279158,2-16-24 17:28,230.33,Purchase,Pharmacy,10664.90169
37955,808279158,2-18-24 21:28,2900,Payment,Installment Payment,7764.901691
37956,808279158,2-19-24 22:28,603.31,Withdrawal,Branch Withdrawal,7161.591691
37957,808279158,2-22-24 15:28,729.89,IncomingTransfer,Freelance Payment,7891.481691
37958,808279158,2-22-24 23:28,396.99,IncomingTransfer,Freelance Payment,8288.471691
37959,808279158,2-23-24 23:28,444.76,Deposit,Cash Deposit,8733.231691
37960,808279158,2-25-24 10:28,496.87,Purchase,Restaurant,8236.361691
37961,808279158,2-28-24 10:28,387.56,OnlineShopping,Walmart,7848.801691
37962,808279158,03-02-24 21:28,9100,IncomingTransfer,Salary,16948.80169
37963,808279158,03-04-24 18:28,525.25,Payment,Bill Payment,16423.55169
37964,808279158,03-04-24 20:28,619.77,Deposit,Check Deposit,17043.32169
37965,808279158,03-05-24 10:28,707.66,Withdrawal,Mobile App Withdrawal,16335.66169
37966,808279158,03-07-24 21:28,1900,Payment,Credit Card Payment,14435.66169
37967,808279158,03-08-24 14:28,153.19,Withdrawal,Mobile App Withdrawal,14282.47169
37968,808279158,03-09-24 12:28,256.02,OutgoingTransfer,Peer-to-Peer Transfer,14026.45169
37969,808279158,3-13-24 21:28,2500,Payment,Installment Payment,11526.45169
37970,808279158,3-15-24 16:28,318.96,Deposit,Mobile Deposit,11845.41169
37971,808279158,3-18-24 16:28,520.45,Deposit,Cash Deposit,12365.86169
37972,808279158,3-24-24 19:28,427.39,Deposit,Check Deposit,12793.25169
37973,808279158,3-29-24 15:28,407.06,Payment,Mortgage Payment,12386.19169
37974,808279158,3-31-24 18:28,189.38,Payment,Loan Payment,12196.81169
37975,808279158,04-01-24 21:28,506.13,OnlineShopping,Best Buy,11690.68169
37976,808279158,04-02-24 21:28,178.29,Purchase,Grocery,11512.39169
37977,808279158,04-03-24 11:28,522.51,Deposit,Direct Deposit,12034.90169
37978,808279158,04-03-24 21:28,9100,IncomingTransfer,Salary,21134.90169
37979,808279158,04-05-24 12:28,403.09,Withdrawal,ATM Withdrawal,20731.81169
37980,808279158,04-05-24 14:28,719.11,Deposit,Cash Deposit,21450.92169
37981,808279158,04-05-24 18:28,132.11,Deposit,Cash Deposit,21583.03169
37982,808279158,04-08-24 21:28,1800,Payment,Credit Card Payment,19783.03169
37983,808279158,04-08-24 22:28,625.77,Deposit,Cash Deposit,20408.80169
37984,808279158,04-10-24 19:28,664.73,OutgoingTransfer,International Transfer,19744.07169
37985,808279158,04-10-24 23:28,748.48,OutgoingTransfer,Peer-to-Peer Transfer,18995.59169
37986,808279158,04-11-24 10:28,401.84,Purchase,Travel,18593.75169
37987,808279158,4-15-24 14:28,533.09,OnlineShopping,Best Buy,18060.66169
37988,808279158,4-15-24 21:28,2400,Payment,Insurance Payment,15660.66169
37989,808279158,4-18-24 18:28,572.99,Payment,Mortgage Payment,15087.67169
37990,808279158,4-22-24 15:28,293.76,Deposit,Direct Deposit,15381.43169
37991,808279158,4-24-24 18:28,624.76,Return,Target Return,16006.19169
37992,808279158,4-25-24 19:28,264.6,OutgoingTransfer,Wire Transfer,15741.59169
37993,808279158,4-26-24 14:28,701.3,Purchase,Clothing,15040.29169
37994,808279158,4-30-24 19:28,382.12,OnlineShopping,Walmart,14658.17169
37995,808279158,05-03-24 9:28,197.46,OutgoingTransfer,Wire Transfer,14460.71169
37996,808279158,05-04-24 19:28,733.78,OutgoingTransfer,Bank Transfer,13726.93169
37997,808279158,05-05-24 12:28,547.13,Purchase,Grocery,13179.80169
37998,808279158,05-05-24 21:28,9100,IncomingTransfer,Salary,22279.80169
37999,808279158,05-10-24 13:28,143.05,Withdrawal,Branch Withdrawal,22136.75169
38000,808279158,05-10-24 21:28,1900,Payment,Credit Card Payment,20236.75169
38001,808279158,05-12-24 21:28,3300,Payment,Insurance Payment,16936.75169
38002,808279158,5-13-24 15:28,496.56,OnlineShopping,eBay,16440.19169
38003,808279158,5-13-24 20:28,464.79,Purchase,Pharmacy,15975.40169
38004,808279158,5-14-24 15:28,412.51,OutgoingTransfer,Wire Transfer,15562.89169
38005,808279158,5-16-24 17:28,641.35,Purchase,Electronics,14921.54169
38006,808279158,5-18-24 19:28,159.44,Deposit,Mobile Deposit,15080.98169
38007,808279158,5-20-24 21:28,741.43,OnlineShopping,eBay,14339.55169
38008,808279158,5-22-24 14:28,448.17,Payment,Bill Payment,13891.38169
38009,808279158,5-23-24 11:28,333.92,OutgoingTransfer,Peer-to-Peer Transfer,13557.46169
38010,808279158,5-27-24 16:28,592.82,OnlineShopping,Target,12964.64169
38011,808279158,5-28-24 13:28,682.09,Return,Store Return,13646.73169
38012,808279158,5-29-24 15:28,614.6,Deposit,Check Deposit,14261.33169
38013,808279158,5-29-24 22:28,162.78,IncomingTransfer,Freelance Payment,14424.11169
38014,808279158,5-30-24 9:28,665.03,Purchase,Grocery,13759.08169
38015,808279158,5-30-24 22:28,201.13,Purchase,Gas,13557.95169
38016,808279158,5-31-24 9:28,286.1,Deposit,Cash Deposit,13844.05169
38017,808279158,06-03-24 21:28,9100,IncomingTransfer,Salary,22944.05169
38018,808279158,06-05-24 10:28,445.57,OnlineShopping,Amazon,22498.48169
38019,808279158,06-07-24 21:28,171.39,Withdrawal,Mobile App Withdrawal,22327.09169
38020,808279158,06-07-24 23:28,389.92,OnlineShopping,Amazon,21937.17169
38021,808279158,06-08-24 21:28,1500,Payment,Credit Card Payment,20437.17169
38022,808279158,06-11-24 17:28,647.27,Payment,Loan Payment,19789.90169
38023,808279158,06-12-24 20:28,711.47,Purchase,Entertainment,19078.43169
38024,808279158,6-14-24 17:28,136.91,Deposit,Direct Deposit,19215.34169
38025,808279158,6-15-24 11:28,141.43,Purchase,Electronics,19073.91169
38026,808279158,6-15-24 20:28,179.97,Purchase,Pharmacy,18893.94169
38027,808279158,6-16-24 16:28,132.38,OnlineShopping,Amazon,18761.56169
38028,808279158,6-16-24 21:28,3300,Payment,Installment Payment,15461.56169
38029,808279158,6-17-24 13:28,223.54,Deposit,Check Deposit,15685.10169
38030,808279158,6-17-24 23:28,169.88,Deposit,Direct Deposit,15854.98169
38031,808279158,6-18-24 20:28,417.12,OutgoingTransfer,Peer-to-Peer Transfer,15437.86169
38032,808279158,6-20-24 16:28,284.98,OutgoingTransfer,Bank Transfer,15152.88169
38033,808279158,6-21-24 16:28,739.56,OutgoingTransfer,Wire Transfer,14413.32169
38034,808279158,6-24-24 13:28,635.82,Return,Store Return,15049.14169
38035,808279158,6-25-24 9:28,185.95,Withdrawal,Mobile App Withdrawal,14863.19169
38036,808279158,6-26-24 11:28,330.3,Payment,Bill Payment,14532.89169
38037,808279158,6-30-24 20:28,264.64,Return,eBay Return,14797.53169
38038,808279158,07-01-24 13:28,281.42,OnlineShopping,Etsy,14516.11169
38039,808279158,07-01-24 17:28,340.3,OnlineShopping,AliExpress,14175.81169
38040,808279158,07-04-24 14:28,408.08,Purchase,Pharmacy,13767.73169
38041,808279158,07-04-24 16:28,229.84,Return,Amazon Return,13997.57169
38042,808279158,07-04-24 22:28,107.97,Purchase,Pharmacy,13889.60169
38043,808279158,07-05-24 12:28,378.34,Purchase,Grocery,13511.26169
38044,808279158,07-05-24 19:28,615.58,Return,AliExpress Return,14126.84169
38045,808279158,07-05-24 21:28,9100,IncomingTransfer,Salary,23226.84169
38046,808279158,07-05-24 21:28,370.99,Purchase,Grocery,22855.85169
38047,808279158,07-07-24 21:28,423.05,OutgoingTransfer,Peer-to-Peer Transfer,22432.80169
38048,808279158,07-09-24 20:28,729.7,Withdrawal,Mobile App Withdrawal,21703.10169
38049,808279158,07-10-24 21:28,1600,Payment,Credit Card Payment,20103.10169
38050,808279158,7-15-24 14:28,390.07,Payment,Mortgage Payment,19713.03169
38051,808279158,7-17-24 11:28,421.25,Withdrawal,ATM Withdrawal,19291.78169
38052,808279158,7-17-24 21:28,3400,Payment,Installment Payment,15891.78169
38053,808681158,1-21-24 10:28,393.02,Purchase,Travel,1216.491842
38054,808681158,1-23-24 11:28,144.58,Deposit,Cash Deposit,1361.071842
38055,808681158,1-27-24 20:28,196.57,Deposit,Check Deposit,1557.641842
38056,808681158,1-31-24 10:28,408.48,Deposit,Mobile Deposit,1966.121842
38057,808681158,02-03-24 16:28,368.75,Withdrawal,Branch Withdrawal,1597.371842
38058,808681158,02-05-24 21:28,9450,IncomingTransfer,Salary,11047.37184
38059,808681158,02-08-24 15:28,181.8,Purchase,Furniture,10865.57184
38060,808681158,02-10-24 21:28,3100,Payment,Credit Card Payment,7765.571842
38061,808681158,2-14-24 9:28,748.49,Withdrawal,ATM Withdrawal,7017.081842
38062,808681158,2-14-24 21:28,2800,Payment,Insurance Payment,4217.081842
38063,808681158,2-16-24 11:28,717.95,Deposit,Cash Deposit,4935.031842
38064,808681158,2-17-24 16:28,556.2,OnlineShopping,AliExpress,4378.831842
38065,808681158,2-25-24 10:28,383.25,Payment,Mortgage Payment,3995.581842
38066,808681158,2-26-24 22:28,409.92,Return,Walmart Return,4405.501842
38067,808681158,03-04-24 21:28,9450,IncomingTransfer,Salary,13855.50184
38068,808681158,03-09-24 21:28,2700,Payment,Credit Card Payment,11155.50184
38069,808681158,3-13-24 13:28,453.54,Return,Walmart Return,11609.04184
38070,808681158,3-17-24 16:28,450.22,Purchase,Restaurant,11158.82184
38071,808681158,3-18-24 21:28,2700,Payment,Insurance Payment,8458.821842
38072,808681158,3-24-24 22:28,113.71,Purchase,Home Improvement,8345.111842
38073,808681158,3-31-24 10:28,451.37,Purchase,Electronics,7893.741842
38074,808681158,04-05-24 21:28,9450,IncomingTransfer,Salary,17343.74184
38075,808681158,04-09-24 17:28,362.56,Purchase,Grocery,16981.18184
38076,808681158,04-10-24 21:28,2600,Payment,Credit Card Payment,14381.18184
38077,808681158,04-11-24 21:28,3600,Payment,Subscription Payment,10781.18184
38078,808681158,4-13-24 18:28,216.8,Payment,Mortgage Payment,10564.38184
38079,808681158,4-24-24 15:28,659.02,OnlineShopping,eBay,9905.361842
38080,808681158,4-26-24 13:28,679.27,Purchase,Gas,9226.091842
38081,808681158,05-02-24 14:28,243.48,Deposit,Direct Deposit,9469.571842
38082,808681158,05-04-24 21:28,9450,IncomingTransfer,Salary,18919.57184
38083,808681158,05-05-24 19:28,137.43,Withdrawal,ATM Withdrawal,18782.14184
38084,808681158,05-09-24 21:28,2500,Payment,Credit Card Payment,16282.14184
38085,808681158,5-14-24 21:28,3900,Payment,Installment Payment,12382.14184
38086,808681158,5-18-24 20:28,273.72,Withdrawal,Mobile App Withdrawal,12108.42184
38087,808681158,5-29-24 13:28,604.31,Withdrawal,ATM Withdrawal,11504.11184
38088,808681158,06-02-24 14:28,370.77,Deposit,Direct Deposit,11874.88184
38089,808681158,06-02-24 20:28,665.86,Deposit,Mobile Deposit,12540.74184
38090,808681158,06-04-24 21:28,9450,IncomingTransfer,Salary,21990.74184
38091,808681158,06-06-24 21:28,563.66,Purchase,Travel,21427.08184
38092,808681158,06-07-24 18:28,566.29,Purchase,Pharmacy,20860.79184
38093,808681158,06-07-24 23:28,411.16,Purchase,Entertainment,20449.63184
38094,808681158,06-09-24 21:28,3100,Payment,Credit Card Payment,17349.63184
38095,808681158,06-11-24 21:28,4200,Payment,Installment Payment,13149.63184
38096,808681158,6-13-24 18:28,465.18,Payment,Mortgage Payment,12684.45184
38097,808681158,6-13-24 21:28,520.34,Purchase,Entertainment,12164.11184
38098,808681158,6-23-24 16:28,610.35,Withdrawal,Mobile App Withdrawal,11553.76184
38099,808681158,6-24-24 15:28,692.17,IncomingTransfer,Freelance Payment,12245.93184
38100,808681158,07-01-24 11:28,187.45,Deposit,Direct Deposit,12433.38184
38101,808681158,07-01-24 21:28,9450,IncomingTransfer,Salary,21883.38184
38102,808681158,07-06-24 21:28,2600,Payment,Credit Card Payment,19283.38184
38103,808681158,07-06-24 21:28,240.66,Purchase,Home Improvement,19042.72184
38104,808681158,07-09-24 12:28,404.78,Purchase,Gas,18637.94184
38105,808681158,7-15-24 21:28,3900,Payment,Installment Payment,14737.94184
38106,808909008,1-23-24 16:28,151.16,OutgoingTransfer,International Transfer,-151.16
38107,808909008,1-23-24 23:28,183.42,Withdrawal,Mobile App Withdrawal,-334.58
38108,808909008,1-25-24 22:28,46.83,Return,AliExpress Return,-287.75
38109,808909008,1-27-24 20:28,230.64,Payment,Mortgage Payment,-518.39
38110,808909008,1-31-24 23:28,182.52,Deposit,Direct Deposit,-335.87
38111,808909008,02-01-24 19:28,83.49,Purchase,Electronics,-419.36
38112,808909008,02-02-24 21:28,247.67,Return,Store Return,-171.69
38113,808909008,02-05-24 21:28,2000,IncomingTransfer,Salary,1828.31
38114,808909008,2-16-24 21:28,800,Payment,Rent Payment,1028.31
38115,808909008,2-23-24 22:28,124.22,Purchase,Travel,904.09
38116,808909008,2-24-24 17:28,245.07,Withdrawal,ATM Withdrawal,659.02
38117,808909008,2-27-24 14:28,207.33,OutgoingTransfer,Peer-to-Peer Transfer,451.69
38118,808909008,03-01-24 21:28,2000,IncomingTransfer,Salary,2451.69
38119,808909008,03-03-24 11:28,56.63,Deposit,Cash Deposit,2508.32
38120,808909008,03-07-24 9:28,183.49,Payment,Loan Payment,2324.83
38121,808909008,03-10-24 11:28,192,Return,Etsy Return,2516.83
38122,808909008,03-10-24 22:28,217.7,Deposit,Check Deposit,2734.53
38123,808909008,3-13-24 21:28,1200,Payment,Rent Payment,1534.53
38124,808909008,3-16-24 14:28,135.95,Deposit,Direct Deposit,1670.48
38125,808909008,3-18-24 23:28,35,Withdrawal,Mobile App Withdrawal,1635.48
38126,808909008,04-05-24 21:28,2000,IncomingTransfer,Salary,3635.48
38127,808909008,04-12-24 10:28,183.86,Return,Etsy Return,3819.34
38128,808909008,4-18-24 21:28,700,Payment,Rent Payment,3119.34
38129,808909008,4-18-24 23:28,129.78,Withdrawal,Branch Withdrawal,2989.56
38130,808909008,4-20-24 14:28,99.17,Purchase,Home Improvement,2890.39
38131,808909008,4-30-24 22:28,19.4,OnlineShopping,Target,2870.99
38132,808909008,05-03-24 21:28,2000,IncomingTransfer,Salary,4870.99
38133,808909008,5-18-24 15:28,129.17,Purchase,Entertainment,4741.82
38134,808909008,5-18-24 21:28,600,Payment,Rent Payment,4141.82
38135,808909008,5-24-24 13:28,207.35,OnlineShopping,Etsy,3934.47
38136,808909008,5-25-24 12:28,216.67,Return,Etsy Return,4151.14
38137,808909008,5-28-24 23:28,182.41,Deposit,Mobile Deposit,4333.55
38138,808909008,06-01-24 10:28,109.26,Purchase,Furniture,4224.29
38139,808909008,06-02-24 21:28,2000,IncomingTransfer,Salary,6224.29
38140,808909008,06-09-24 22:28,70.61,OutgoingTransfer,Wire Transfer,6153.68
38141,808909008,6-15-24 21:28,600,Payment,Rent Payment,5553.68
38142,808909008,6-23-24 19:28,149.02,Payment,Mortgage Payment,5404.66
38143,808909008,6-29-24 13:28,170.33,Withdrawal,Branch Withdrawal,5234.33
38144,808909008,07-04-24 21:28,2000,IncomingTransfer,Salary,7234.33
38145,808909008,07-05-24 14:28,231.37,Payment,Mortgage Payment,7002.96
38146,808909008,07-07-24 10:28,195.48,Payment,Loan Payment,6807.48
38147,808909008,07-10-24 16:28,82.63,OnlineShopping,Walmart,6724.85
38148,808909008,7-17-24 21:28,600,Payment,Rent Payment,6124.85
38149,809127858,1-20-24 17:28,24.32,Purchase,Pharmacy,942.3770364
38150,809127858,1-23-24 17:28,150.3,OutgoingTransfer,Wire Transfer,792.0770364
38151,809127858,1-27-24 16:28,54.69,Return,eBay Return,846.7670364
38152,809127858,1-28-24 15:28,395.7,OutgoingTransfer,International Transfer,451.0670364
38153,809127858,1-31-24 11:28,312.52,Payment,Mortgage Payment,138.5470364
38154,809127858,02-04-24 17:28,267.72,Deposit,Check Deposit,406.2670364
38155,809127858,02-05-24 21:28,4500,IncomingTransfer,Salary,4906.267036
38156,809127858,02-06-24 16:28,322.37,Withdrawal,Mobile App Withdrawal,4583.897036
38157,809127858,02-08-24 20:28,289.72,Withdrawal,Mobile App Withdrawal,4294.177036
38158,809127858,02-10-24 12:28,44.74,Return,Target Return,4338.917036
38159,809127858,02-10-24 21:28,1600,Payment,Credit Card Payment,2738.917036
38160,809127858,02-10-24 21:28,294.79,Payment,Bill Payment,2444.127036
38161,809127858,02-11-24 21:28,1400,Payment,Installment Payment,1044.127036
38162,809127858,02-11-24 21:28,116.24,Deposit,Cash Deposit,1160.367036
38163,809127858,2-18-24 19:28,178.86,IncomingTransfer,Freelance Payment,1339.227036
38164,809127858,2-19-24 23:28,96.41,Deposit,Direct Deposit,1435.637036
38165,809127858,2-20-24 23:28,393.73,OutgoingTransfer,Bank Transfer,1041.907036
38166,809127858,2-24-24 17:28,359.83,Withdrawal,ATM Withdrawal,682.0770364
38167,809127858,2-25-24 19:28,209.86,Return,Etsy Return,891.9370364
38168,809127858,2-26-24 17:28,58.55,Deposit,Check Deposit,950.4870364
38169,809127858,2-28-24 22:28,88.76,Deposit,Mobile Deposit,1039.247036
38170,809127858,03-01-24 10:28,352.69,OnlineShopping,Etsy,686.5570364
38171,809127858,03-04-24 15:28,60.92,OutgoingTransfer,International Transfer,625.6370364
38172,809127858,03-04-24 21:28,4500,IncomingTransfer,Salary,5125.637036
38173,809127858,03-06-24 12:28,351.58,OutgoingTransfer,International Transfer,4774.057036
38174,809127858,03-08-24 18:28,136.72,OnlineShopping,Target,4637.337036
38175,809127858,03-09-24 20:28,239.76,Payment,Bill Payment,4397.577036
38176,809127858,03-09-24 21:28,1700,Payment,Credit Card Payment,2697.577036
38177,809127858,03-11-24 13:28,144.62,OutgoingTransfer,Wire Transfer,2552.957036
38178,809127858,03-12-24 10:28,385.52,Payment,Mortgage Payment,2167.437036
38179,809127858,3-13-24 20:28,188.52,Withdrawal,ATM Withdrawal,1978.917036
38180,809127858,3-14-24 10:28,133.61,Deposit,Cash Deposit,2112.527036
38181,809127858,3-18-24 21:28,1200,Payment,Installment Payment,912.5270364
38182,809127858,3-24-24 19:28,83.76,Purchase,Restaurant,828.7670364
38183,809127858,3-25-24 9:28,47.39,Payment,Bill Payment,781.3770364
38184,809127858,3-27-24 20:28,178.21,OutgoingTransfer,International Transfer,603.1670364
38185,809127858,04-02-24 10:28,392.57,Return,Walmart Return,995.7370364
38186,809127858,04-05-24 21:28,4500,IncomingTransfer,Salary,5495.737036
38187,809127858,04-10-24 20:28,374.58,OutgoingTransfer,Bank Transfer,5121.157036
38188,809127858,04-10-24 21:28,1600,Payment,Credit Card Payment,3521.157036
38189,809127858,04-11-24 13:28,154.36,Return,Etsy Return,3675.517036
38190,809127858,4-15-24 21:28,1700,Payment,Insurance Payment,1975.517036
38191,809127858,4-16-24 12:28,237.77,Withdrawal,Mobile App Withdrawal,1737.747036
38192,809127858,4-18-24 14:28,399.97,Deposit,Cash Deposit,2137.717036
38193,809127858,4-19-24 20:28,369.88,Payment,Mortgage Payment,1767.837036
38194,809127858,4-23-24 21:28,322.6,Purchase,Pharmacy,1445.237036
38195,809127858,4-26-24 10:28,324.62,Purchase,Gas,1120.617036
38196,809127858,4-27-24 11:28,302.39,Deposit,Cash Deposit,1423.007036
38197,809127858,4-30-24 17:28,382.53,Deposit,Check Deposit,1805.537036
38198,809127858,05-02-24 10:28,32.46,Return,Walmart Return,1837.997036
38199,809127858,05-03-24 14:28,224.23,OutgoingTransfer,Wire Transfer,1613.767036
38200,809127858,05-03-24 21:28,4500,IncomingTransfer,Salary,6113.767036
38201,809127858,05-04-24 13:28,146.7,IncomingTransfer,Freelance Payment,6260.467036
38202,809127858,05-05-24 12:28,98.09,Return,AliExpress Return,6358.557036
38203,809127858,05-08-24 21:28,1600,Payment,Credit Card Payment,4758.557036
38204,809127858,05-12-24 21:28,374.79,Withdrawal,Mobile App Withdrawal,4383.767036
38205,809127858,5-13-24 9:28,48.73,IncomingTransfer,Freelance Payment,4432.497036
38206,809127858,5-17-24 22:28,102.14,Deposit,Direct Deposit,4534.637036
38207,809127858,5-18-24 15:28,224.29,OutgoingTransfer,Wire Transfer,4310.347036
38208,809127858,5-18-24 21:28,1700,Payment,Subscription Payment,2610.347036
38209,809127858,5-20-24 16:28,282.89,Withdrawal,Branch Withdrawal,2327.457036
38210,809127858,5-25-24 20:28,192.45,Purchase,Pharmacy,2135.007036
38211,809127858,5-28-24 11:28,163.18,OutgoingTransfer,Bank Transfer,1971.827036
38212,809127858,06-01-24 12:28,384.95,Deposit,Check Deposit,2356.777036
38213,809127858,06-04-24 21:28,4500,IncomingTransfer,Salary,6856.777036
38214,809127858,06-07-24 23:28,337.31,Purchase,Clothing,6519.467036
38215,809127858,06-09-24 19:28,341.78,Withdrawal,ATM Withdrawal,6177.687036
38216,809127858,06-09-24 21:28,1700,Payment,Credit Card Payment,4477.687036
38217,809127858,06-11-24 21:28,1900,Payment,Subscription Payment,2577.687036
38218,809127858,6-17-24 20:28,201.07,Payment,Bill Payment,2376.617036
38219,809127858,6-18-24 9:28,230.51,Payment,Mortgage Payment,2146.107036
38220,809127858,6-18-24 10:28,386.1,Payment,Mortgage Payment,1760.007036
38221,809127858,6-22-24 18:28,66.32,Deposit,Cash Deposit,1826.327036
38222,809127858,6-23-24 13:28,338.67,Return,eBay Return,2164.997036
38223,809127858,6-23-24 16:28,65.22,Deposit,Direct Deposit,2230.217036
38224,809127858,6-30-24 17:28,105.79,Payment,Bill Payment,2124.427036
38225,809127858,07-02-24 9:28,221.99,Purchase,Grocery,1902.437036
38226,809127858,07-03-24 10:28,295.92,Withdrawal,Mobile App Withdrawal,1606.517036
38227,809127858,07-03-24 20:28,64.7,Purchase,Furniture,1541.817036
38228,809127858,07-04-24 21:28,4500,IncomingTransfer,Salary,6041.817036
38229,809127858,07-05-24 21:28,22.31,Deposit,Direct Deposit,6064.127036
38230,809127858,07-06-24 15:28,147.75,Deposit,Direct Deposit,6211.877036
38231,809127858,07-07-24 10:28,112.03,Return,Store Return,6323.907036
38232,809127858,07-09-24 13:28,279,OutgoingTransfer,Peer-to-Peer Transfer,6044.907036
38233,809127858,07-09-24 21:28,1400,Payment,Credit Card Payment,4644.907036
38234,809127858,07-10-24 12:28,93.77,OnlineShopping,Best Buy,4551.137036
38235,809127858,07-11-24 22:28,107.17,Purchase,Electronics,4443.967036
38236,809127858,07-12-24 9:28,196.46,Payment,Mortgage Payment,4247.507036
38237,809127858,07-12-24 17:28,330.83,OnlineShopping,Walmart,3916.677036
38238,809127858,07-12-24 21:28,2000,Payment,Insurance Payment,1916.677036
38239,809459733,1-20-24 15:28,90.52,Withdrawal,Branch Withdrawal,-90.52
38240,809459733,1-21-24 16:28,202.19,Withdrawal,ATM Withdrawal,-292.71
38241,809459733,1-21-24 20:28,167.69,Purchase,Electronics,-460.4
38242,809459733,1-22-24 16:28,59.44,Purchase,Grocery,-519.84
38243,809459733,1-22-24 23:28,158.19,Withdrawal,Mobile App Withdrawal,-678.03
38244,809459733,1-27-24 10:28,44.4,Deposit,Direct Deposit,-633.63
38245,809459733,1-28-24 12:28,38.33,Withdrawal,Branch Withdrawal,-671.96
38246,809459733,1-28-24 21:28,201.52,Purchase,Furniture,-873.48
38247,809459733,1-31-24 19:28,184.72,Payment,Loan Payment,-1058.2
38248,809459733,02-02-24 19:28,238.33,Purchase,Clothing,-1296.53
38249,809459733,02-02-24 21:28,2000,IncomingTransfer,Salary,703.47
38250,809459733,02-07-24 13:28,194.21,Purchase,Electronics,509.26
38251,809459733,02-07-24 15:28,58.61,OnlineShopping,AliExpress,450.65
38252,809459733,02-07-24 17:28,228.33,Withdrawal,ATM Withdrawal,222.32
38253,809459733,02-08-24 9:28,197.37,Return,Target Return,419.69
38254,809459733,02-08-24 20:28,125.86,Withdrawal,ATM Withdrawal,293.83
38255,809459733,02-09-24 12:28,193.67,Purchase,Grocery,100.16
38256,809459733,02-09-24 19:28,75.67,OnlineShopping,Best Buy,24.49
38257,809459733,2-14-24 17:28,240.99,OnlineShopping,Best Buy,-216.5
38258,809459733,2-14-24 17:28,73.41,Payment,Bill Payment,-289.91
38259,809459733,2-14-24 21:28,1200,Payment,Rent Payment,-1489.91
38260,809459733,2-15-24 9:28,110.75,Purchase,Home Improvement,-1600.66
38261,809459733,2-19-24 12:28,158.43,Withdrawal,Mobile App Withdrawal,-1759.09
38262,809459733,2-20-24 14:28,172.41,Withdrawal,ATM Withdrawal,-1931.5
38263,809459733,2-27-24 15:28,184.26,Return,Etsy Return,-1747.24
38264,809459733,2-29-24 23:28,101.86,Payment,Mortgage Payment,-1849.1
38265,809459733,03-03-24 21:28,2000,IncomingTransfer,Salary,150.9
38266,809459733,03-07-24 19:28,143.71,Deposit,Cash Deposit,294.61
38267,809459733,03-08-24 18:28,222.67,Return,eBay Return,517.28
38268,809459733,03-09-24 11:28,97.66,Deposit,Check Deposit,614.94
38269,809459733,03-09-24 16:28,36.49,Purchase,Entertainment,578.45
38270,809459733,03-10-24 21:28,700,Payment,Rent Payment,-121.55
38271,809459733,03-11-24 13:28,210.25,Purchase,Gas,-331.8
38272,809459733,03-11-24 20:28,145.02,OutgoingTransfer,Wire Transfer,-476.82
38273,809459733,3-15-24 11:28,125.51,OnlineShopping,Etsy,-602.33
38274,809459733,3-15-24 11:28,187.76,Payment,Bill Payment,-790.09
38275,809459733,3-18-24 14:28,232.16,Payment,Bill Payment,-1022.25
38276,809459733,3-23-24 14:28,214.53,Payment,Mortgage Payment,-1236.78
38277,809459733,3-23-24 14:28,31.21,Purchase,Travel,-1267.99
38278,809459733,3-24-24 14:28,114.03,Purchase,Entertainment,-1382.02
38279,809459733,3-24-24 22:28,29.8,Purchase,Restaurant,-1411.82
38280,809459733,3-26-24 11:28,35.7,Return,Amazon Return,-1376.12
38281,809459733,3-27-24 21:28,132.98,Deposit,Direct Deposit,-1243.14
38282,809459733,3-28-24 21:28,113.81,Withdrawal,Mobile App Withdrawal,-1356.95
38283,809459733,3-30-24 11:28,147.48,Purchase,Home Improvement,-1504.43
38284,809459733,04-04-24 21:28,2000,IncomingTransfer,Salary,495.57
38285,809459733,04-07-24 20:28,233.67,OutgoingTransfer,Bank Transfer,261.9
38286,809459733,04-10-24 21:28,1200,Payment,Rent Payment,-938.1
38287,809459733,4-13-24 17:28,172.83,Return,Store Return,-765.27
38288,809459733,4-13-24 17:28,203.68,OnlineShopping,Etsy,-968.95
38289,809459733,4-14-24 11:28,159.05,OutgoingTransfer,Peer-to-Peer Transfer,-1128
38290,809459733,4-14-24 15:28,156.93,Purchase,Travel,-1284.93
38291,809459733,4-15-24 11:28,200.16,Withdrawal,Branch Withdrawal,-1485.09
38292,809459733,4-24-24 12:28,125.33,Withdrawal,Mobile App Withdrawal,-1610.42
38293,809459733,4-29-24 14:28,112.74,Purchase,Gas,-1723.16
38294,809459733,4-29-24 16:28,31.45,Deposit,Cash Deposit,-1691.71
38295,809459733,05-03-24 21:28,2000,IncomingTransfer,Salary,308.29
38296,809459733,05-04-24 17:28,209.97,Payment,Bill Payment,98.32
38297,809459733,05-04-24 21:28,11.41,Deposit,Mobile Deposit,109.73
38298,809459733,05-05-24 17:28,241.13,Withdrawal,Branch Withdrawal,-131.4
38299,809459733,05-07-24 12:28,188.95,Purchase,Clothing,-320.35
38300,809459733,05-12-24 16:28,238.66,Withdrawal,ATM Withdrawal,-559.01
38301,809459733,5-14-24 19:28,123.02,Payment,Mortgage Payment,-682.03
38302,809459733,5-14-24 21:28,1200,Payment,Rent Payment,-1882.03
38303,809459733,5-15-24 22:28,100.99,Payment,Bill Payment,-1983.02
38304,809459733,5-18-24 12:28,219.08,Withdrawal,ATM Withdrawal,-2202.1
38305,809459733,5-21-24 23:28,164.71,OutgoingTransfer,Peer-to-Peer Transfer,-2366.81
38306,809459733,5-23-24 12:28,142.88,Withdrawal,ATM Withdrawal,-2509.69
38307,809459733,5-23-24 13:28,39.47,Purchase,Entertainment,-2549.16
38308,809459733,5-25-24 11:28,44.31,OutgoingTransfer,Peer-to-Peer Transfer,-2593.47
38309,809459733,5-27-24 11:28,142.51,Purchase,Furniture,-2735.98
38310,809459733,5-29-24 20:28,203.74,Withdrawal,Mobile App Withdrawal,-2939.72
38311,809459733,5-30-24 11:28,58.37,Purchase,Home Improvement,-2998.09
38312,809459733,06-01-24 21:28,2000,IncomingTransfer,Salary,-998.09
38313,809459733,06-02-24 13:28,192.51,Purchase,Gas,-1190.6
38314,809459733,06-04-24 20:28,156.79,OnlineShopping,Best Buy,-1347.39
38315,809459733,06-06-24 11:28,224.56,Deposit,Cash Deposit,-1122.83
38316,809459733,06-08-24 16:28,116.78,Purchase,Gas,-1239.61
38317,809459733,06-08-24 20:28,107.43,Purchase,Clothing,-1347.04
38318,809459733,06-09-24 10:28,122.98,OutgoingTransfer,Bank Transfer,-1470.02
38319,809459733,06-10-24 23:28,229.31,Deposit,Check Deposit,-1240.71
38320,809459733,06-11-24 23:28,71.58,OutgoingTransfer,International Transfer,-1312.29
38321,809459733,06-12-24 9:28,244.69,Return,Etsy Return,-1067.6
38322,809459733,6-13-24 22:28,196.28,Deposit,Direct Deposit,-871.32
38323,809459733,6-15-24 21:28,800,Payment,Rent Payment,-1671.32
38324,809459733,6-16-24 12:28,203.67,Deposit,Mobile Deposit,-1467.65
38325,809459733,6-20-24 18:28,63.23,OnlineShopping,Amazon,-1530.88
38326,809459733,6-20-24 22:28,206.94,OnlineShopping,eBay,-1737.82
38327,809459733,6-24-24 18:28,126.15,Withdrawal,ATM Withdrawal,-1863.97
38328,809459733,6-26-24 11:28,142.06,Payment,Loan Payment,-2006.03
38329,809459733,6-28-24 22:28,53.2,Purchase,Restaurant,-2059.23
38330,809459733,6-29-24 13:28,232.63,Withdrawal,ATM Withdrawal,-2291.86
38331,809459733,6-29-24 14:28,145.93,Purchase,Furniture,-2437.79
38332,809459733,07-02-24 21:28,2000,IncomingTransfer,Salary,-437.79
38333,809459733,07-06-24 18:28,24.33,OnlineShopping,Amazon,-462.12
38334,809459733,07-07-24 16:28,181.39,Deposit,Mobile Deposit,-280.73
38335,809459733,07-08-24 10:28,190.32,Withdrawal,ATM Withdrawal,-471.05
38336,809459733,07-08-24 22:28,47.59,Purchase,Clothing,-518.64
38337,809459733,07-09-24 13:28,113.39,Purchase,Furniture,-632.03
38338,809459733,07-10-24 21:28,900,Payment,Rent Payment,-1532.03
38339,809459733,07-12-24 23:28,213.26,OnlineShopping,Etsy,-1745.29
38340,809459733,7-15-24 22:28,35.79,Purchase,Clothing,-1781.08
38341,809951133,1-24-24 14:28,767.19,Purchase,Pharmacy,-767.19
38342,809951133,1-26-24 16:28,370.75,OnlineShopping,Etsy,-1137.94
38343,809951133,1-27-24 13:28,837.78,Payment,Mortgage Payment,-1975.72
38344,809951133,1-31-24 18:28,942.01,OnlineShopping,AliExpress,-2917.73
38345,809951133,02-01-24 21:28,14950,IncomingTransfer,Salary,12032.27
38346,809951133,02-05-24 16:28,763.57,Purchase,Furniture,11268.7
38347,809951133,02-12-24 21:28,4200,Payment,Insurance Payment,7068.7
38348,809951133,2-15-24 12:28,907.21,Deposit,Check Deposit,7975.91
38349,809951133,2-21-24 22:28,505.33,OutgoingTransfer,Wire Transfer,7470.58
38350,809951133,2-23-24 10:28,792.19,Purchase,Electronics,6678.39
38351,809951133,2-24-24 13:28,838.03,IncomingTransfer,Freelance Payment,7516.42
38352,809951133,2-25-24 12:28,601.77,Withdrawal,Branch Withdrawal,6914.65
38353,809951133,03-04-24 21:28,14950,IncomingTransfer,Salary,21864.65
38354,809951133,3-15-24 21:28,5600,Payment,Installment Payment,16264.65
38355,809951133,3-18-24 19:28,437.39,Return,Target Return,16702.04
38356,809951133,3-27-24 18:28,813.15,Purchase,Restaurant,15888.89
38357,809951133,04-02-24 21:28,14950,IncomingTransfer,Salary,30838.89
38358,809951133,4-15-24 19:28,211.74,Deposit,Mobile Deposit,31050.63
38359,809951133,4-15-24 21:28,4700,Payment,Subscription Payment,26350.63
38360,809951133,4-19-24 20:28,940.57,Withdrawal,Mobile App Withdrawal,25410.06
38361,809951133,4-19-24 23:28,377.69,Purchase,Gas,25032.37
38362,809951133,05-04-24 21:28,14950,IncomingTransfer,Salary,39982.37
38363,809951133,05-11-24 21:28,378.18,Deposit,Mobile Deposit,40360.55
38364,809951133,5-15-24 21:28,6600,Payment,Subscription Payment,33760.55
38365,809951133,5-24-24 23:28,773.28,Deposit,Cash Deposit,34533.83
38366,809951133,5-27-24 19:28,384.29,Payment,Bill Payment,34149.54
38367,809951133,06-03-24 21:28,14950,IncomingTransfer,Salary,49099.54
38368,809951133,06-07-24 22:28,926.73,Purchase,Furniture,48172.81
38369,809951133,06-10-24 21:28,6100,Payment,Subscription Payment,42072.81
38370,809951133,6-23-24 22:28,235.81,Deposit,Cash Deposit,42308.62
38371,809951133,07-01-24 21:28,14950,IncomingTransfer,Salary,57258.62
38372,809951133,07-04-24 10:28,550.62,Purchase,Furniture,56708
38373,809951133,07-08-24 18:28,903.56,Deposit,Mobile Deposit,57611.56
38374,809951133,7-13-24 19:28,433.57,Withdrawal,ATM Withdrawal,57177.99
38375,809951133,7-15-24 12:28,535.9,OnlineShopping,Amazon,56642.09
38376,809951133,7-18-24 21:28,4000,Payment,Subscription Payment,52642.09
38377,811081083,1-22-24 18:28,107.65,Purchase,Clothing,676.7144517
38378,811081083,1-25-24 15:28,30.52,Return,Walmart Return,707.2344517
38379,811081083,1-27-24 20:28,128.01,Purchase,Gas,579.2244517
38380,811081083,1-28-24 16:28,92.2,OutgoingTransfer,International Transfer,487.0244517
38381,811081083,1-28-24 22:28,236.91,Deposit,Check Deposit,723.9344517
38382,811081083,1-31-24 17:28,53.6,Purchase,Pharmacy,670.3344517
38383,811081083,02-01-24 9:28,227.38,OnlineShopping,AliExpress,442.9544517
38384,811081083,02-03-24 21:28,3150,IncomingTransfer,Salary,3592.954452
38385,811081083,02-06-24 20:28,139.96,Purchase,Travel,3452.994452
38386,811081083,02-06-24 22:28,150.77,Purchase,Grocery,3302.224452
38387,811081083,02-08-24 21:28,1300,Payment,Credit Card Payment,2002.224452
38388,811081083,02-09-24 15:28,166.86,Purchase,Travel,1835.364452
38389,811081083,2-16-24 18:28,55.84,Deposit,Check Deposit,1891.204452
38390,811081083,2-16-24 21:28,2000,Payment,Rent Payment,-108.7955483
38391,811081083,2-18-24 17:28,236.27,Deposit,Direct Deposit,127.4744517
38392,811081083,2-22-24 11:28,205.75,Purchase,Restaurant,-78.2755483
38393,811081083,2-23-24 18:28,29.87,Purchase,Furniture,-108.1455483
38394,811081083,2-25-24 18:28,59.63,Purchase,Travel,-167.7755483
38395,811081083,2-26-24 14:28,128.9,Deposit,Cash Deposit,-38.8755483
38396,811081083,2-28-24 16:28,13.04,Return,AliExpress Return,-25.8355483
38397,811081083,03-04-24 13:28,54.46,Deposit,Cash Deposit,28.6244517
38398,811081083,03-05-24 21:28,3150,IncomingTransfer,Salary,3178.624452
38399,811081083,03-06-24 12:28,212.71,Deposit,Cash Deposit,3391.334452
38400,811081083,03-06-24 22:28,21.43,Purchase,Electronics,3369.904452
38401,811081083,03-08-24 17:28,248.34,Return,Target Return,3618.244452
38402,811081083,03-08-24 22:28,91.25,Deposit,Check Deposit,3709.494452
38403,811081083,03-09-24 18:28,176.07,Purchase,Restaurant,3533.424452
38404,811081083,03-10-24 14:28,227.1,Deposit,Direct Deposit,3760.524452
38405,811081083,03-10-24 21:28,1500,Payment,Credit Card Payment,2260.524452
38406,811081083,03-10-24 21:28,1200,Payment,Rent Payment,1060.524452
38407,811081083,3-14-24 16:28,111.83,Purchase,Clothing,948.6944517
38408,811081083,3-24-24 19:28,67.3,OutgoingTransfer,International Transfer,881.3944517
38409,811081083,3-25-24 16:28,13.43,Deposit,Direct Deposit,894.8244517
38410,811081083,3-25-24 18:28,119.63,OnlineShopping,Amazon,775.1944517
38411,811081083,3-27-24 9:28,138.57,Purchase,Gas,636.6244517
38412,811081083,3-29-24 21:28,162.47,OutgoingTransfer,Peer-to-Peer Transfer,474.1544517
38413,811081083,3-31-24 13:28,43.21,OutgoingTransfer,Bank Transfer,430.9444517
38414,811081083,04-02-24 22:28,30.06,Payment,Bill Payment,400.8844517
38415,811081083,04-03-24 16:28,13.78,Payment,Mortgage Payment,387.1044517
38416,811081083,04-03-24 21:28,3150,IncomingTransfer,Salary,3537.104452
38417,811081083,04-07-24 13:28,90.55,Withdrawal,Mobile App Withdrawal,3446.554452
38418,811081083,04-08-24 21:28,1400,Payment,Credit Card Payment,2046.554452
38419,811081083,04-12-24 9:28,237.53,Payment,Bill Payment,1809.024452
38420,811081083,04-12-24 9:28,36.87,OnlineShopping,Best Buy,1772.154452
38421,811081083,04-12-24 21:28,900,Payment,Rent Payment,872.1544517
38422,811081083,4-16-24 9:28,41.36,Deposit,Check Deposit,913.5144517
38423,811081083,4-18-24 15:28,151.69,Purchase,Pharmacy,761.8244517
38424,811081083,4-23-24 22:28,80.41,Deposit,Cash Deposit,842.2344517
38425,811081083,4-29-24 12:28,93.34,Payment,Bill Payment,748.8944517
38426,811081083,4-29-24 12:28,147.32,OnlineShopping,eBay,601.5744517
38427,811081083,4-30-24 11:28,93.6,IncomingTransfer,Freelance Payment,695.1744517
38428,811081083,05-02-24 21:28,3150,IncomingTransfer,Salary,3845.174452
38429,811081083,05-07-24 21:28,1800,Payment,Credit Card Payment,2045.174452
38430,811081083,05-08-24 13:28,66.07,Purchase,Entertainment,1979.104452
38431,811081083,05-08-24 23:28,180.1,Withdrawal,Branch Withdrawal,1799.004452
38432,811081083,05-09-24 12:28,203.66,Payment,Loan Payment,1595.344452
38433,811081083,05-10-24 15:28,214.14,Deposit,Cash Deposit,1809.484452
38434,811081083,05-11-24 13:28,119.41,Withdrawal,Branch Withdrawal,1690.074452
38435,811081083,05-11-24 18:28,18.62,Deposit,Cash Deposit,1708.694452
38436,811081083,05-11-24 21:28,1800,Payment,Rent Payment,-91.3055483
38437,811081083,5-13-24 19:28,71.98,Withdrawal,Branch Withdrawal,-163.2855483
38438,811081083,5-14-24 14:28,75.1,Purchase,Home Improvement,-238.3855483
38439,811081083,5-20-24 13:28,137.38,Purchase,Home Improvement,-375.7655483
38440,811081083,5-27-24 10:28,120.73,Purchase,Pharmacy,-496.4955483
38441,811081083,5-29-24 21:28,99.33,Purchase,Pharmacy,-595.8255483
38442,811081083,06-04-24 14:28,135.62,Purchase,Grocery,-731.4455483
38443,811081083,06-04-24 19:28,239.93,Deposit,Cash Deposit,-491.5155483
38444,811081083,06-05-24 19:28,118.8,Purchase,Grocery,-610.3155483
38445,811081083,06-05-24 21:28,3150,IncomingTransfer,Salary,2539.684452
38446,811081083,06-05-24 21:28,35.35,Deposit,Direct Deposit,2575.034452
38447,811081083,06-06-24 22:28,228.88,Return,Amazon Return,2803.914452
38448,811081083,06-07-24 9:28,10.91,Purchase,Home Improvement,2793.004452
38449,811081083,06-07-24 13:28,51.49,Withdrawal,ATM Withdrawal,2741.514452
38450,811081083,06-07-24 17:28,120.38,Payment,Mortgage Payment,2621.134452
38451,811081083,06-07-24 20:28,120.77,Return,Store Return,2741.904452
38452,811081083,06-08-24 18:28,156.8,Payment,Mortgage Payment,2585.104452
38453,811081083,06-09-24 21:28,136.72,Withdrawal,Branch Withdrawal,2448.384452
38454,811081083,06-10-24 17:28,47.96,Payment,Mortgage Payment,2400.424452
38455,811081083,06-10-24 21:28,1500,Payment,Credit Card Payment,900.4244517
38456,811081083,06-10-24 21:28,1100,Payment,Rent Payment,-199.5755483
38457,811081083,06-12-24 19:28,202.13,Payment,Mortgage Payment,-401.7055483
38458,811081083,6-13-24 20:28,145.94,OutgoingTransfer,Wire Transfer,-547.6455483
38459,811081083,6-18-24 14:28,53.4,OnlineShopping,Walmart,-601.0455483
38460,811081083,6-19-24 21:28,115.58,Deposit,Cash Deposit,-485.4655483
38461,811081083,6-24-24 16:28,64.31,Deposit,Direct Deposit,-421.1555483
38462,811081083,6-26-24 12:28,44.33,Deposit,Mobile Deposit,-376.8255483
38463,811081083,6-26-24 13:28,10.32,Return,Etsy Return,-366.5055483
38464,811081083,07-01-24 18:28,206.73,Purchase,Travel,-573.2355483
38465,811081083,07-02-24 10:28,198.48,Return,AliExpress Return,-374.7555483
38466,811081083,07-04-24 21:28,3150,IncomingTransfer,Salary,2775.244452
38467,811081083,07-06-24 10:28,91.3,Withdrawal,Mobile App Withdrawal,2683.944452
38468,811081083,07-06-24 13:28,66.64,Withdrawal,Mobile App Withdrawal,2617.304452
38469,811081083,07-06-24 20:28,187.3,IncomingTransfer,Freelance Payment,2804.604452
38470,811081083,07-09-24 21:28,1200,Payment,Credit Card Payment,1604.604452
38471,811081083,07-12-24 12:28,17.56,Deposit,Check Deposit,1622.164452
38472,811081083,7-18-24 21:28,1300,Payment,Rent Payment,322.1644517
38473,811140933,1-20-24 13:28,126.57,Deposit,Direct Deposit,1429.768451
38474,811140933,1-20-24 19:28,153.23,OutgoingTransfer,Peer-to-Peer Transfer,1276.538451
38475,811140933,1-20-24 22:28,145.78,Return,Best Buy Return,1422.318451
38476,811140933,1-22-24 17:28,62.71,Deposit,Cash Deposit,1485.028451
38477,811140933,1-23-24 17:28,234.7,IncomingTransfer,Freelance Payment,1719.728451
38478,811140933,1-25-24 21:28,113.39,OnlineShopping,Etsy,1606.338451
38479,811140933,1-30-24 9:28,223.05,Deposit,Check Deposit,1829.388451
38480,811140933,1-30-24 15:28,163.05,Deposit,Mobile Deposit,1992.438451
38481,811140933,02-02-24 21:28,3000,IncomingTransfer,Salary,4992.438451
38482,811140933,02-07-24 21:28,1900,Payment,Credit Card Payment,3092.438451
38483,811140933,02-09-24 20:28,131.57,Deposit,Direct Deposit,3224.008451
38484,811140933,02-11-24 13:28,234.74,Return,Walmart Return,3458.748451
38485,811140933,2-14-24 12:28,93.03,OutgoingTransfer,Peer-to-Peer Transfer,3365.718451
38486,811140933,2-14-24 21:28,129.4,Deposit,Mobile Deposit,3495.118451
38487,811140933,2-15-24 17:28,102.15,Withdrawal,ATM Withdrawal,3392.968451
38488,811140933,2-17-24 21:28,900,Payment,Rent Payment,2492.968451
38489,811140933,2-18-24 19:28,174.83,Payment,Loan Payment,2318.138451
38490,811140933,03-04-24 21:28,3000,IncomingTransfer,Salary,5318.138451
38491,811140933,03-06-24 10:28,248.7,Deposit,Cash Deposit,5566.838451
38492,811140933,03-09-24 21:28,2400,Payment,Credit Card Payment,3166.838451
38493,811140933,03-10-24 21:28,1800,Payment,Rent Payment,1366.838451
38494,811140933,03-11-24 9:28,228.34,Purchase,Pharmacy,1138.498451
38495,811140933,3-15-24 9:28,79.48,Withdrawal,ATM Withdrawal,1059.018451
38496,811140933,3-18-24 11:28,214.01,Return,Best Buy Return,1273.028451
38497,811140933,3-24-24 18:28,156.09,Deposit,Mobile Deposit,1429.118451
38498,811140933,3-25-24 16:28,191.46,Withdrawal,Branch Withdrawal,1237.658451
38499,811140933,3-26-24 16:28,26.9,OnlineShopping,Etsy,1210.758451
38500,811140933,3-30-24 21:28,53.73,Deposit,Check Deposit,1264.488451
38501,811140933,04-01-24 18:28,110.49,Deposit,Direct Deposit,1374.978451
38502,811140933,04-03-24 21:28,3000,IncomingTransfer,Salary,4374.978451
38503,811140933,04-05-24 20:28,71.28,Deposit,Mobile Deposit,4446.258451
38504,811140933,04-06-24 21:28,176.2,Payment,Loan Payment,4270.058451
38505,811140933,04-08-24 21:28,2400,Payment,Credit Card Payment,1870.058451
38506,811140933,04-09-24 21:28,185.61,Withdrawal,Branch Withdrawal,1684.448451
38507,811140933,04-10-24 15:28,157.48,Deposit,Mobile Deposit,1841.928451
38508,811140933,4-17-24 18:28,196.13,Purchase,Clothing,1645.798451
38509,811140933,4-17-24 21:28,1400,Payment,Rent Payment,245.7984506
38510,811140933,4-22-24 17:28,38.02,Return,Target Return,283.8184506
38511,811140933,4-22-24 18:28,196.98,Deposit,Cash Deposit,480.7984506
38512,811140933,4-22-24 19:28,111.55,Deposit,Check Deposit,592.3484506
38513,811140933,4-23-24 20:28,38.7,Purchase,Clothing,553.6484506
38514,811140933,4-25-24 16:28,16.41,Return,Etsy Return,570.0584506
38515,811140933,05-01-24 11:28,231.44,Deposit,Check Deposit,801.4984506
38516,811140933,05-02-24 20:28,176.81,Return,Target Return,978.3084506
38517,811140933,05-02-24 21:28,178.02,OnlineShopping,Etsy,800.2884506
38518,811140933,05-04-24 21:28,3000,IncomingTransfer,Salary,3800.288451
38519,811140933,05-09-24 21:28,2600,Payment,Credit Card Payment,1200.288451
38520,811140933,05-10-24 11:28,64.25,Withdrawal,ATM Withdrawal,1136.038451
38521,811140933,05-12-24 13:28,214.27,OnlineShopping,Best Buy,921.7684506
38522,811140933,05-12-24 14:28,125.21,Return,Target Return,1046.978451
38523,811140933,05-12-24 21:28,800,Payment,Rent Payment,246.9784506
38524,811140933,5-15-24 11:28,169.65,Deposit,Cash Deposit,416.6284506
38525,811140933,5-16-24 15:28,234.4,Withdrawal,Mobile App Withdrawal,182.2284506
38526,811140933,5-19-24 21:28,106.23,OutgoingTransfer,Peer-to-Peer Transfer,75.99845062
38527,811140933,5-21-24 11:28,201.34,Payment,Loan Payment,-125.3415494
38528,811140933,5-21-24 23:28,43.5,Purchase,Gas,-168.8415494
38529,811140933,5-31-24 15:28,246.52,Purchase,Gas,-415.3615494
38530,811140933,5-31-24 22:28,115.41,Deposit,Check Deposit,-299.9515494
38531,811140933,06-02-24 21:28,3000,IncomingTransfer,Salary,2700.048451
38532,811140933,06-05-24 22:28,138.69,Purchase,Home Improvement,2561.358451
38533,811140933,06-05-24 22:28,125.64,Payment,Bill Payment,2435.718451
38534,811140933,06-07-24 21:28,2600,Payment,Credit Card Payment,-164.2815494
38535,811140933,6-13-24 21:28,1000,Payment,Rent Payment,-1164.281549
38536,811140933,6-16-24 14:28,240.18,Deposit,Direct Deposit,-924.1015494
38537,811140933,6-19-24 13:28,99.88,OnlineShopping,AliExpress,-1023.981549
38538,811140933,6-23-24 11:28,192.54,OnlineShopping,Target,-1216.521549
38539,811140933,6-23-24 12:28,211.16,Purchase,Furniture,-1427.681549
38540,811140933,6-23-24 20:28,110.16,IncomingTransfer,Freelance Payment,-1317.521549
38541,811140933,6-29-24 10:28,167.28,Purchase,Furniture,-1484.801549
38542,811140933,07-03-24 18:28,206.76,Return,Etsy Return,-1278.041549
38543,811140933,07-03-24 18:28,203.88,Purchase,Clothing,-1481.921549
38544,811140933,07-04-24 21:28,3000,IncomingTransfer,Salary,1518.078451
38545,811140933,07-07-24 15:28,38.3,Withdrawal,Mobile App Withdrawal,1479.778451
38546,811140933,07-09-24 21:28,2100,Payment,Credit Card Payment,-620.2215494
38547,811140933,07-09-24 22:28,108.73,Deposit,Check Deposit,-511.4915494
38548,811140933,07-10-24 15:28,242.11,OnlineShopping,AliExpress,-753.6015494
38549,811140933,07-10-24 21:28,1100,Payment,Rent Payment,-1853.601549
38550,811140933,07-12-24 15:28,174.81,Return,Store Return,-1678.791549
38551,811140933,7-13-24 11:28,31.66,Deposit,Direct Deposit,-1647.131549
38552,811140933,7-13-24 22:28,40.81,Purchase,Restaurant,-1687.941549
38553,811140933,7-15-24 19:28,220.8,Withdrawal,Branch Withdrawal,-1908.741549
38554,811970808,1-21-24 21:28,182.17,Withdrawal,Mobile App Withdrawal,1115.556193
38555,811970808,1-22-24 15:28,169.87,Purchase,Gas,945.6861926
38556,811970808,1-24-24 20:28,76.35,Return,Store Return,1022.036193
38557,811970808,02-02-24 21:28,2000,IncomingTransfer,Salary,3022.036193
38558,811970808,02-06-24 20:28,246,OnlineShopping,Amazon,2776.036193
38559,811970808,02-07-24 13:28,217.02,IncomingTransfer,Freelance Payment,2993.056193
38560,811970808,02-07-24 16:28,195.33,Purchase,Entertainment,2797.726193
38561,811970808,02-07-24 21:28,2100,Payment,Credit Card Payment,697.7261926
38562,811970808,2-15-24 13:28,142.23,Deposit,Mobile Deposit,839.9561926
38563,811970808,2-16-24 21:28,1200,Payment,Rent Payment,-360.0438074
38564,811970808,2-17-24 20:28,34.16,IncomingTransfer,Freelance Payment,-325.8838074
38565,811970808,2-18-24 18:28,113.22,OnlineShopping,Best Buy,-439.1038074
38566,811970808,2-21-24 16:28,229.01,Withdrawal,Mobile App Withdrawal,-668.1138074
38567,811970808,2-22-24 18:28,166.8,Return,AliExpress Return,-501.3138074
38568,811970808,2-25-24 16:28,161.6,Purchase,Travel,-662.9138074
38569,811970808,2-28-24 18:28,38.22,Payment,Loan Payment,-701.1338074
38570,811970808,2-28-24 23:28,20.34,Return,Amazon Return,-680.7938074
38571,811970808,2-29-24 13:28,124.1,Purchase,Home Improvement,-804.8938074
38572,811970808,03-03-24 21:28,2000,IncomingTransfer,Salary,1195.106193
38573,811970808,03-05-24 10:28,45.5,Purchase,Entertainment,1149.606193
38574,811970808,03-05-24 18:28,59.7,OnlineShopping,Amazon,1089.906193
38575,811970808,03-08-24 21:28,2800,Payment,Credit Card Payment,-1710.093807
38576,811970808,03-10-24 14:28,216.9,Withdrawal,Branch Withdrawal,-1926.993807
38577,811970808,03-12-24 9:28,178.34,Purchase,Entertainment,-2105.333807
38578,811970808,03-12-24 14:28,214.3,Withdrawal,ATM Withdrawal,-2319.633807
38579,811970808,3-16-24 12:28,41.24,Deposit,Cash Deposit,-2278.393807
38580,811970808,3-17-24 21:28,700,Payment,Rent Payment,-2978.393807
38581,811970808,3-19-24 19:28,69.16,OutgoingTransfer,Wire Transfer,-3047.553807
38582,811970808,3-23-24 10:28,59.48,Payment,Mortgage Payment,-3107.033807
38583,811970808,3-28-24 10:28,214.44,Deposit,Mobile Deposit,-2892.593807
38584,811970808,3-28-24 18:28,170.49,Deposit,Direct Deposit,-2722.103807
38585,811970808,04-01-24 12:28,43.82,IncomingTransfer,Freelance Payment,-2678.283807
38586,811970808,04-02-24 9:28,132.74,Purchase,Furniture,-2811.023807
38587,811970808,04-03-24 11:28,201.72,Purchase,Travel,-3012.743807
38588,811970808,04-04-24 15:28,213.55,OutgoingTransfer,Peer-to-Peer Transfer,-3226.293807
38589,811970808,04-04-24 21:28,2000,IncomingTransfer,Salary,-1226.293807
38590,811970808,04-04-24 22:28,69.1,Withdrawal,ATM Withdrawal,-1295.393807
38591,811970808,04-08-24 10:28,70.15,Deposit,Cash Deposit,-1225.243807
38592,811970808,04-09-24 21:28,2200,Payment,Credit Card Payment,-3425.243807
38593,811970808,04-11-24 17:28,234.35,Return,Etsy Return,-3190.893807
38594,811970808,04-12-24 21:28,247.08,Deposit,Direct Deposit,-2943.813807
38595,811970808,4-14-24 13:28,167.1,Purchase,Electronics,-3110.913807
38596,811970808,4-14-24 21:28,1200,Payment,Rent Payment,-4310.913807
38597,811970808,4-15-24 22:28,209.99,OutgoingTransfer,Peer-to-Peer Transfer,-4520.903807
38598,811970808,4-19-24 14:28,109.77,IncomingTransfer,Freelance Payment,-4411.133807
38599,811970808,4-22-24 16:28,155.41,Withdrawal,Branch Withdrawal,-4566.543807
38600,811970808,4-25-24 16:28,153.1,Payment,Mortgage Payment,-4719.643807
38601,811970808,4-27-24 21:28,54.2,Deposit,Mobile Deposit,-4665.443807
38602,811970808,4-30-24 15:28,16.05,Purchase,Clothing,-4681.493807
38603,811970808,05-01-24 21:28,2000,IncomingTransfer,Salary,-2681.493807
38604,811970808,05-06-24 21:28,2200,Payment,Credit Card Payment,-4881.493807
38605,811970808,05-08-24 23:28,94.65,Purchase,Gas,-4976.143807
38606,811970808,5-13-24 11:28,239.36,IncomingTransfer,Freelance Payment,-4736.783807
38607,811970808,5-16-24 13:28,52.62,Deposit,Cash Deposit,-4684.163807
38608,811970808,5-17-24 14:28,126.35,Purchase,Home Improvement,-4810.513807
38609,811970808,5-17-24 21:28,600,Payment,Rent Payment,-5410.513807
38610,811970808,5-18-24 14:28,212.43,Withdrawal,Mobile App Withdrawal,-5622.943807
38611,811970808,06-03-24 16:28,75.17,OnlineShopping,Best Buy,-5698.113807
38612,811970808,06-03-24 21:28,2000,IncomingTransfer,Salary,-3698.113807
38613,811970808,06-04-24 22:28,182.57,Deposit,Direct Deposit,-3515.543807
38614,811970808,06-05-24 23:28,79.59,Withdrawal,Mobile App Withdrawal,-3595.133807
38615,811970808,06-08-24 15:28,28.45,OutgoingTransfer,Bank Transfer,-3623.583807
38616,811970808,06-08-24 21:28,2600,Payment,Credit Card Payment,-6223.583807
38617,811970808,06-11-24 21:28,900,Payment,Rent Payment,-7123.583807
38618,811970808,6-15-24 17:28,241.61,Purchase,Home Improvement,-7365.193807
38619,811970808,6-18-24 10:28,101.83,IncomingTransfer,Freelance Payment,-7263.363807
38620,811970808,6-19-24 13:28,75.84,Deposit,Check Deposit,-7187.523807
38621,811970808,6-22-24 16:28,235.91,IncomingTransfer,Freelance Payment,-6951.613807
38622,811970808,6-23-24 11:28,112.72,OutgoingTransfer,Peer-to-Peer Transfer,-7064.333807
38623,811970808,6-24-24 22:28,156.13,Purchase,Pharmacy,-7220.463807
38624,811970808,6-29-24 21:28,226.81,Withdrawal,ATM Withdrawal,-7447.273807
38625,811970808,6-30-24 12:28,182.03,Purchase,Clothing,-7629.303807
38626,811970808,07-04-24 15:28,102.43,Return,Amazon Return,-7526.873807
38627,811970808,07-04-24 21:28,2000,IncomingTransfer,Salary,-5526.873807
38628,811970808,07-07-24 13:28,141.64,Return,Target Return,-5385.233807
38629,811970808,07-07-24 15:28,32.76,Payment,Loan Payment,-5417.993807
38630,811970808,07-08-24 9:28,48.67,Purchase,Pharmacy,-5466.663807
38631,811970808,07-09-24 21:28,2000,Payment,Credit Card Payment,-7466.663807
38632,811970808,07-10-24 21:28,1000,Payment,Rent Payment,-8466.663807
38633,811970808,07-12-24 19:28,117.35,Purchase,Entertainment,-8584.013807
38634,811970808,7-14-24 15:28,32.65,Payment,Loan Payment,-8616.663807
38635,811970808,7-14-24 18:28,217.02,Deposit,Mobile Deposit,-8399.643807
38636,811970808,7-17-24 23:28,96.45,OnlineShopping,Etsy,-8496.093807
38637,812488608,1-21-24 20:28,174,Return,AliExpress Return,1802.023193
38638,812488608,02-02-24 20:28,73.03,Purchase,Clothing,1728.993193
38639,812488608,02-03-24 21:28,3300,IncomingTransfer,Salary,5028.993193
38640,812488608,02-05-24 13:28,56.76,Deposit,Mobile Deposit,5085.753193
38641,812488608,02-07-24 17:28,236.52,Deposit,Check Deposit,5322.273193
38642,812488608,02-07-24 21:28,85.36,Payment,Mortgage Payment,5236.913193
38643,812488608,02-08-24 21:28,2400,Payment,Credit Card Payment,2836.913193
38644,812488608,02-09-24 15:28,187.61,Purchase,Entertainment,2649.303193
38645,812488608,02-12-24 21:28,1100,Payment,Rent Payment,1549.303193
38646,812488608,2-15-24 20:28,185.81,OnlineShopping,Walmart,1363.493193
38647,812488608,2-16-24 14:28,113.03,Purchase,Restaurant,1250.463193
38648,812488608,2-16-24 20:28,164.66,Payment,Bill Payment,1085.803193
38649,812488608,2-16-24 23:28,67.45,Purchase,Travel,1018.353193
38650,812488608,2-21-24 20:28,48.37,Return,AliExpress Return,1066.723193
38651,812488608,2-22-24 23:28,197.35,OnlineShopping,Etsy,869.3731929
38652,812488608,2-23-24 18:28,112.07,Purchase,Restaurant,757.3031929
38653,812488608,2-24-24 16:28,75.26,Payment,Loan Payment,682.0431929
38654,812488608,2-27-24 15:28,238.53,Withdrawal,ATM Withdrawal,443.5131929
38655,812488608,2-27-24 20:28,55.94,Return,Store Return,499.4531929
38656,812488608,03-02-24 16:28,18.27,Withdrawal,Branch Withdrawal,481.1831929
38657,812488608,03-03-24 21:28,3300,IncomingTransfer,Salary,3781.183193
38658,812488608,03-05-24 12:28,121.08,OnlineShopping,Etsy,3660.103193
38659,812488608,03-05-24 17:28,111.54,Deposit,Cash Deposit,3771.643193
38660,812488608,03-07-24 11:28,44.69,Payment,Bill Payment,3726.953193
38661,812488608,03-07-24 20:28,175.56,Payment,Bill Payment,3551.393193
38662,812488608,03-08-24 14:28,206.74,Withdrawal,Mobile App Withdrawal,3344.653193
38663,812488608,03-08-24 21:28,2900,Payment,Credit Card Payment,444.6531929
38664,812488608,03-09-24 10:28,206.62,Deposit,Check Deposit,651.2731929
38665,812488608,03-09-24 21:28,246.15,Purchase,Electronics,405.1231929
38666,812488608,03-12-24 15:28,107.92,Deposit,Check Deposit,513.0431929
38667,812488608,3-14-24 21:28,2000,Payment,Rent Payment,-1486.956807
38668,812488608,3-17-24 11:28,36.52,Purchase,Restaurant,-1523.476807
38669,812488608,3-17-24 15:28,68,Return,AliExpress Return,-1455.476807
38670,812488608,3-19-24 9:28,183.56,Withdrawal,ATM Withdrawal,-1639.036807
38671,812488608,3-20-24 9:28,120.71,Deposit,Direct Deposit,-1518.326807
38672,812488608,3-20-24 11:28,49.09,Payment,Bill Payment,-1567.416807
38673,812488608,3-25-24 10:28,52.66,Return,eBay Return,-1514.756807
38674,812488608,3-26-24 18:28,18.72,Withdrawal,Mobile App Withdrawal,-1533.476807
38675,812488608,3-27-24 14:28,36.43,Deposit,Mobile Deposit,-1497.046807
38676,812488608,3-30-24 15:28,96.95,Purchase,Travel,-1593.996807
38677,812488608,3-30-24 18:28,66.17,Payment,Mortgage Payment,-1660.166807
38678,812488608,04-01-24 10:28,243.83,Purchase,Home Improvement,-1903.996807
38679,812488608,04-03-24 21:28,3300,IncomingTransfer,Salary,1396.003193
38680,812488608,04-05-24 11:28,39.12,Purchase,Grocery,1356.883193
38681,812488608,04-06-24 22:28,33.56,Purchase,Home Improvement,1323.323193
38682,812488608,04-07-24 14:28,65.76,OnlineShopping,AliExpress,1257.563193
38683,812488608,04-08-24 21:28,3100,Payment,Credit Card Payment,-1842.436807
38684,812488608,04-10-24 21:28,1500,Payment,Rent Payment,-3342.436807
38685,812488608,04-10-24 21:28,191.65,OnlineShopping,eBay,-3534.086807
38686,812488608,04-11-24 17:28,23.36,Return,Target Return,-3510.726807
38687,812488608,4-13-24 17:28,113.59,Payment,Bill Payment,-3624.316807
38688,812488608,4-15-24 20:28,38.07,Purchase,Home Improvement,-3662.386807
38689,812488608,4-18-24 10:28,91.95,Withdrawal,ATM Withdrawal,-3754.336807
38690,812488608,4-18-24 22:28,23.65,OutgoingTransfer,Peer-to-Peer Transfer,-3777.986807
38691,812488608,4-27-24 11:28,103.21,OutgoingTransfer,Bank Transfer,-3881.196807
38692,812488608,4-29-24 12:28,35.68,Withdrawal,Mobile App Withdrawal,-3916.876807
38693,812488608,4-30-24 15:28,28.34,Purchase,Pharmacy,-3945.216807
38694,812488608,05-05-24 21:28,3300,IncomingTransfer,Salary,-645.2168071
38695,812488608,05-09-24 13:28,178.83,OutgoingTransfer,Bank Transfer,-824.0468071
38696,812488608,05-10-24 21:28,2300,Payment,Credit Card Payment,-3124.046807
38697,812488608,05-12-24 18:28,234.94,Payment,Mortgage Payment,-3358.986807
38698,812488608,5-13-24 21:28,1000,Payment,Rent Payment,-4358.986807
38699,812488608,5-13-24 22:28,237.75,Return,Target Return,-4121.236807
38700,812488608,5-16-24 23:28,95.19,Purchase,Home Improvement,-4216.426807
38701,812488608,5-18-24 17:28,137.59,OutgoingTransfer,Peer-to-Peer Transfer,-4354.016807
38702,812488608,5-22-24 19:28,136.97,Deposit,Mobile Deposit,-4217.046807
38703,812488608,5-23-24 21:28,38.65,Purchase,Entertainment,-4255.696807
38704,812488608,5-29-24 20:28,245.52,Deposit,Mobile Deposit,-4010.176807
38705,812488608,06-01-24 21:28,3300,IncomingTransfer,Salary,-710.1768071
38706,812488608,06-03-24 9:28,32.39,Withdrawal,Branch Withdrawal,-742.5668071
38707,812488608,06-03-24 22:28,25.49,Return,Amazon Return,-717.0768071
38708,812488608,06-05-24 22:28,108.46,Return,Target Return,-608.6168071
38709,812488608,06-06-24 21:28,2300,Payment,Credit Card Payment,-2908.616807
38710,812488608,06-11-24 12:28,142.88,OutgoingTransfer,Peer-to-Peer Transfer,-3051.496807
38711,812488608,6-18-24 21:28,1400,Payment,Rent Payment,-4451.496807
38712,812488608,6-24-24 13:28,60.82,Payment,Bill Payment,-4512.316807
38713,812488608,6-25-24 12:28,187.05,Return,Etsy Return,-4325.266807
38714,812488608,07-02-24 21:28,3300,IncomingTransfer,Salary,-1025.266807
38715,812488608,07-04-24 16:28,182.71,OnlineShopping,AliExpress,-1207.976807
38716,812488608,07-07-24 21:28,2400,Payment,Credit Card Payment,-3607.976807
38717,812488608,07-08-24 16:28,248.03,Return,Best Buy Return,-3359.946807
38718,812488608,07-08-24 16:28,218.99,Purchase,Home Improvement,-3578.936807
38719,812488608,07-11-24 15:28,82.93,Deposit,Cash Deposit,-3496.006807
38720,812488608,07-11-24 18:28,86.14,Deposit,Mobile Deposit,-3409.866807
38721,812488608,07-11-24 20:28,73.28,Purchase,Grocery,-3483.146807
38722,812488608,07-12-24 13:28,192.84,Deposit,Check Deposit,-3290.306807
38723,812488608,07-12-24 22:28,91.61,Payment,Bill Payment,-3381.916807
38724,812488608,7-13-24 22:28,67.33,Deposit,Check Deposit,-3314.586807
38725,812488608,7-15-24 18:28,165.58,Deposit,Cash Deposit,-3149.006807
38726,812488608,7-16-24 11:28,241.86,IncomingTransfer,Freelance Payment,-2907.146807
38727,812488608,7-16-24 21:28,2000,Payment,Rent Payment,-4907.146807
38728,812671758,1-20-24 22:28,128.51,IncomingTransfer,Freelance Payment,1948.724175
38729,812671758,1-27-24 18:28,446.16,Purchase,Grocery,1502.564175
38730,812671758,1-28-24 22:28,218.57,Purchase,Furniture,1283.994175
38731,812671758,02-05-24 21:28,2200,IncomingTransfer,Salary,3483.994175
38732,812671758,02-09-24 20:28,442.56,OutgoingTransfer,International Transfer,3041.434175
38733,812671758,02-10-24 21:28,2500,Payment,Credit Card Payment,541.434175
38734,812671758,2-17-24 21:28,900,Payment,Rent Payment,-358.565825
38735,812671758,2-19-24 15:28,110.97,Payment,Bill Payment,-469.535825
38736,812671758,03-02-24 10:28,392.39,Purchase,Electronics,-861.925825
38737,812671758,03-03-24 21:28,2200,IncomingTransfer,Salary,1338.074175
38738,812671758,03-05-24 21:28,448.15,OutgoingTransfer,Peer-to-Peer Transfer,889.924175
38739,812671758,03-08-24 17:28,120.66,Payment,Loan Payment,769.264175
38740,812671758,03-08-24 21:28,2800,Payment,Credit Card Payment,-2030.735825
38741,812671758,03-09-24 10:28,466.67,Return,Etsy Return,-1564.065825
38742,812671758,03-10-24 21:28,800,Payment,Rent Payment,-2364.065825
38743,812671758,3-13-24 20:28,228.67,Withdrawal,ATM Withdrawal,-2592.735825
38744,812671758,3-24-24 21:28,80.97,Payment,Bill Payment,-2673.705825
38745,812671758,3-25-24 9:28,458.75,Return,Store Return,-2214.955825
38746,812671758,3-31-24 15:28,358.75,OnlineShopping,AliExpress,-2573.705825
38747,812671758,04-02-24 9:28,453.71,Deposit,Direct Deposit,-2119.995825
38748,812671758,04-03-24 16:28,423.87,Payment,Loan Payment,-2543.865825
38749,812671758,04-03-24 21:28,2200,IncomingTransfer,Salary,-343.865825
38750,812671758,04-06-24 18:28,144.59,Purchase,Travel,-488.455825
38751,812671758,04-08-24 21:28,2200,Payment,Credit Card Payment,-2688.455825
38752,812671758,04-09-24 20:28,47.68,Purchase,Gas,-2736.135825
38753,812671758,04-10-24 11:28,143.21,Deposit,Cash Deposit,-2592.925825
38754,812671758,04-11-24 21:28,1100,Payment,Rent Payment,-3692.925825
38755,812671758,4-14-24 14:28,312.67,OutgoingTransfer,Bank Transfer,-4005.595825
38756,812671758,4-14-24 16:28,125.76,Purchase,Clothing,-4131.355825
38757,812671758,4-19-24 18:28,299.19,Withdrawal,Branch Withdrawal,-4430.545825
38758,812671758,4-21-24 22:28,165.75,OnlineShopping,Walmart,-4596.295825
38759,812671758,4-29-24 12:28,112.84,OutgoingTransfer,International Transfer,-4709.135825
38760,812671758,05-03-24 19:28,388.77,Withdrawal,Branch Withdrawal,-5097.905825
38761,812671758,05-03-24 21:28,2200,IncomingTransfer,Salary,-2897.905825
38762,812671758,05-06-24 21:28,98.43,Withdrawal,Mobile App Withdrawal,-2996.335825
38763,812671758,05-07-24 10:28,474.75,Withdrawal,ATM Withdrawal,-3471.085825
38764,812671758,05-08-24 21:28,3100,Payment,Credit Card Payment,-6571.085825
38765,812671758,05-10-24 21:28,1000,Payment,Rent Payment,-7571.085825
38766,812671758,05-11-24 10:28,147.67,Payment,Bill Payment,-7718.755825
38767,812671758,5-15-24 13:28,401.13,Withdrawal,Mobile App Withdrawal,-8119.885825
38768,812671758,5-18-24 16:28,436.36,Return,eBay Return,-7683.525825
38769,812671758,5-21-24 19:28,310.4,Withdrawal,Branch Withdrawal,-7993.925825
38770,812671758,5-23-24 21:28,243.09,Withdrawal,ATM Withdrawal,-8237.015825
38771,812671758,06-01-24 17:28,315.95,Deposit,Direct Deposit,-7921.065825
38772,812671758,06-02-24 12:28,116.95,OutgoingTransfer,Wire Transfer,-8038.015825
38773,812671758,06-03-24 21:28,2200,IncomingTransfer,Salary,-5838.015825
38774,812671758,06-08-24 21:28,3200,Payment,Credit Card Payment,-9038.015825
38775,812671758,06-11-24 14:28,169.5,OutgoingTransfer,Peer-to-Peer Transfer,-9207.515825
38776,812671758,06-11-24 17:28,288.97,Deposit,Cash Deposit,-8918.545825
38777,812671758,06-11-24 21:28,700,Payment,Rent Payment,-9618.545825
38778,812671758,06-12-24 20:28,197.69,Purchase,Grocery,-9816.235825
38779,812671758,6-14-24 10:28,103.86,IncomingTransfer,Freelance Payment,-9712.375825
38780,812671758,6-14-24 15:28,137.77,Purchase,Restaurant,-9850.145825
38781,812671758,6-18-24 12:28,129.86,Purchase,Pharmacy,-9980.005825
38782,812671758,6-21-24 15:28,334.71,Withdrawal,Mobile App Withdrawal,-10314.71582
38783,812671758,6-25-24 19:28,161.22,Deposit,Check Deposit,-10153.49582
38784,812671758,07-01-24 21:28,2200,IncomingTransfer,Salary,-7953.495825
38785,812671758,07-06-24 21:28,3200,Payment,Credit Card Payment,-11153.49582
38786,812671758,07-09-24 17:28,225.07,Return,Target Return,-10928.42582
38787,812671758,07-11-24 13:28,353.41,IncomingTransfer,Freelance Payment,-10575.01582
38788,812671758,7-13-24 21:28,900,Payment,Rent Payment,-11475.01582
38789,812671758,7-13-24 21:28,49.32,OutgoingTransfer,Bank Transfer,-11524.33582
38790,813182658,1-21-24 18:28,77.81,Payment,Mortgage Payment,402.4200951
38791,813182658,1-24-24 12:28,26.14,Payment,Bill Payment,376.2800951
38792,813182658,1-26-24 9:28,132.23,Deposit,Check Deposit,508.5100951
38793,813182658,1-27-24 19:28,179.54,Return,Etsy Return,688.0500951
38794,813182658,1-30-24 9:28,75.67,Payment,Bill Payment,612.3800951
38795,813182658,1-30-24 18:28,127.09,Deposit,Direct Deposit,739.4700951
38796,813182658,1-30-24 22:28,67.18,Return,Walmart Return,806.6500951
38797,813182658,02-01-24 23:28,24.57,Withdrawal,Mobile App Withdrawal,782.0800951
38798,813182658,02-02-24 21:28,3300,IncomingTransfer,Salary,4082.080095
38799,813182658,02-03-24 15:28,116.61,Withdrawal,Mobile App Withdrawal,3965.470095
38800,813182658,02-04-24 21:28,214.13,Return,Etsy Return,4179.600095
38801,813182658,02-07-24 21:28,1300,Payment,Credit Card Payment,2879.600095
38802,813182658,02-09-24 10:28,249.4,Purchase,Gas,2630.200095
38803,813182658,02-11-24 22:28,64.1,Return,Etsy Return,2694.300095
38804,813182658,2-13-24 21:28,1000,Payment,Rent Payment,1694.300095
38805,813182658,2-15-24 12:28,244.65,OnlineShopping,Etsy,1449.650095
38806,813182658,2-15-24 20:28,19.28,OnlineShopping,AliExpress,1430.370095
38807,813182658,2-19-24 18:28,22.38,Deposit,Check Deposit,1452.750095
38808,813182658,2-21-24 19:28,248.65,Purchase,Clothing,1204.100095
38809,813182658,2-24-24 11:28,49.17,Withdrawal,ATM Withdrawal,1154.930095
38810,813182658,2-26-24 16:28,185.38,Withdrawal,Mobile App Withdrawal,969.5500951
38811,813182658,2-26-24 23:28,105.99,Deposit,Cash Deposit,1075.540095
38812,813182658,03-01-24 9:28,223.58,OutgoingTransfer,International Transfer,851.9600951
38813,813182658,03-01-24 15:28,136.68,Withdrawal,Mobile App Withdrawal,715.2800951
38814,813182658,03-01-24 15:28,228.67,Withdrawal,Mobile App Withdrawal,486.6100951
38815,813182658,03-03-24 21:28,3300,IncomingTransfer,Salary,3786.610095
38816,813182658,03-06-24 9:28,16.95,Payment,Loan Payment,3769.660095
38817,813182658,03-06-24 16:28,249.19,Deposit,Cash Deposit,4018.850095
38818,813182658,03-08-24 21:28,900,Payment,Credit Card Payment,3118.850095
38819,813182658,03-09-24 17:28,180.32,Return,Etsy Return,3299.170095
38820,813182658,03-10-24 21:28,1400,Payment,Rent Payment,1899.170095
38821,813182658,3-17-24 16:28,174.11,Return,Etsy Return,2073.280095
38822,813182658,3-19-24 21:28,241.48,Payment,Loan Payment,1831.800095
38823,813182658,3-21-24 20:28,101.68,OutgoingTransfer,Peer-to-Peer Transfer,1730.120095
38824,813182658,3-24-24 14:28,170.01,OutgoingTransfer,Wire Transfer,1560.110095
38825,813182658,3-24-24 21:28,111.65,Deposit,Direct Deposit,1671.760095
38826,813182658,3-26-24 10:28,242.82,Deposit,Cash Deposit,1914.580095
38827,813182658,3-26-24 18:28,221.43,Deposit,Cash Deposit,2136.010095
38828,813182658,3-27-24 19:28,150.36,Deposit,Direct Deposit,2286.370095
38829,813182658,3-30-24 18:28,245.76,Withdrawal,Branch Withdrawal,2040.610095
38830,813182658,04-03-24 15:28,17.52,Return,Walmart Return,2058.130095
38831,813182658,04-03-24 21:28,3300,IncomingTransfer,Salary,5358.130095
38832,813182658,04-03-24 21:28,136.9,Return,Store Return,5495.030095
38833,813182658,04-05-24 18:28,47.77,Withdrawal,ATM Withdrawal,5447.260095
38834,813182658,04-08-24 21:28,1100,Payment,Credit Card Payment,4347.260095
38835,813182658,04-12-24 16:28,25.99,Return,Etsy Return,4373.250095
38836,813182658,04-12-24 21:28,2000,Payment,Rent Payment,2373.250095
38837,813182658,4-13-24 22:28,185.61,OnlineShopping,eBay,2187.640095
38838,813182658,4-16-24 15:28,69.13,OnlineShopping,Best Buy,2118.510095
38839,813182658,4-21-24 11:28,228.37,Return,Store Return,2346.880095
38840,813182658,4-22-24 20:28,178.15,Purchase,Furniture,2168.730095
38841,813182658,4-23-24 10:28,95.76,Purchase,Clothing,2072.970095
38842,813182658,4-24-24 16:28,91.37,Return,Amazon Return,2164.340095
38843,813182658,4-27-24 13:28,76.44,Purchase,Clothing,2087.900095
38844,813182658,05-02-24 15:28,156.61,Deposit,Check Deposit,2244.510095
38845,813182658,05-03-24 11:28,189.69,Purchase,Furniture,2054.820095
38846,813182658,05-03-24 18:28,46.38,Purchase,Clothing,2008.440095
38847,813182658,05-04-24 21:28,3300,IncomingTransfer,Salary,5308.440095
38848,813182658,05-06-24 20:28,186.32,Withdrawal,Branch Withdrawal,5122.120095
38849,813182658,05-07-24 23:28,222.68,OutgoingTransfer,Bank Transfer,4899.440095
38850,813182658,05-09-24 21:28,1200,Payment,Credit Card Payment,3699.440095
38851,813182658,05-10-24 11:28,207.99,Deposit,Cash Deposit,3907.430095
38852,813182658,05-10-24 14:28,114.56,Deposit,Direct Deposit,4021.990095
38853,813182658,05-11-24 22:28,210.09,Purchase,Gas,3811.900095
38854,813182658,5-15-24 21:28,2000,Payment,Rent Payment,1811.900095
38855,813182658,5-18-24 16:28,95.72,Purchase,Gas,1716.180095
38856,813182658,5-19-24 19:28,104.96,Payment,Bill Payment,1611.220095
38857,813182658,5-25-24 13:28,230.81,Payment,Loan Payment,1380.410095
38858,813182658,5-26-24 21:28,130.8,OnlineShopping,Target,1249.610095
38859,813182658,5-27-24 18:28,48.39,Withdrawal,Mobile App Withdrawal,1201.220095
38860,813182658,5-31-24 18:28,107.59,OnlineShopping,eBay,1093.630095
38861,813182658,5-31-24 22:28,62.5,Withdrawal,Branch Withdrawal,1031.130095
38862,813182658,06-03-24 13:28,15.28,OnlineShopping,Best Buy,1015.850095
38863,813182658,06-03-24 21:28,22.18,OutgoingTransfer,Peer-to-Peer Transfer,993.6700951
38864,813182658,06-04-24 21:28,83.01,OnlineShopping,eBay,910.6600951
38865,813182658,06-05-24 21:28,3300,IncomingTransfer,Salary,4210.660095
38866,813182658,06-10-24 21:28,1000,Payment,Credit Card Payment,3210.660095
38867,813182658,6-14-24 21:28,900,Payment,Rent Payment,2310.660095
38868,813182658,6-22-24 16:28,88.94,OutgoingTransfer,Wire Transfer,2221.720095
38869,813182658,6-24-24 20:28,193.05,OutgoingTransfer,Peer-to-Peer Transfer,2028.670095
38870,813182658,6-27-24 10:28,85.18,Withdrawal,ATM Withdrawal,1943.490095
38871,813182658,6-27-24 10:28,213.98,Deposit,Direct Deposit,2157.470095
38872,813182658,6-27-24 19:28,65.84,Return,Amazon Return,2223.310095
38873,813182658,6-30-24 19:28,224.68,Return,Etsy Return,2447.990095
38874,813182658,07-01-24 15:28,228.78,Withdrawal,ATM Withdrawal,2219.210095
38875,813182658,07-01-24 19:28,201.75,Payment,Mortgage Payment,2017.460095
38876,813182658,07-03-24 21:28,3300,IncomingTransfer,Salary,5317.460095
38877,813182658,07-06-24 15:28,53.32,Deposit,Mobile Deposit,5370.780095
38878,813182658,07-07-24 11:28,11.05,Purchase,Restaurant,5359.730095
38879,813182658,07-07-24 21:28,168.1,Payment,Loan Payment,5191.630095
38880,813182658,07-08-24 21:28,1100,Payment,Credit Card Payment,4091.630095
38881,813182658,07-10-24 12:28,141.79,Deposit,Cash Deposit,4233.420095
38882,813182658,07-12-24 13:28,179.4,IncomingTransfer,Freelance Payment,4412.820095
38883,813182658,07-12-24 23:28,179.61,IncomingTransfer,Freelance Payment,4592.430095
38884,813182658,7-13-24 21:28,115.35,Deposit,Direct Deposit,4707.780095
38885,813182658,7-15-24 11:28,30.48,Withdrawal,ATM Withdrawal,4677.300095
38886,813182658,7-16-24 21:28,2000,Payment,Rent Payment,2677.300095
38887,813380058,1-21-24 18:28,224.03,OutgoingTransfer,Peer-to-Peer Transfer,456.01282
38888,813380058,1-25-24 23:28,213.47,Return,Amazon Return,669.48282
38889,813380058,1-30-24 23:28,489.86,OnlineShopping,Amazon,179.62282
38890,813380058,1-31-24 16:28,149.29,Deposit,Direct Deposit,328.91282
38891,813380058,02-02-24 20:28,405.47,Withdrawal,Mobile App Withdrawal,-76.55717996
38892,813380058,02-05-24 21:28,1950,IncomingTransfer,Salary,1873.44282
38893,813380058,02-08-24 16:28,196.83,Purchase,Entertainment,1676.61282
38894,813380058,02-10-24 21:28,1100,Payment,Credit Card Payment,576.61282
38895,813380058,02-11-24 11:28,150.83,Deposit,Direct Deposit,727.44282
38896,813380058,02-11-24 13:28,460.07,Return,Best Buy Return,1187.51282
38897,813380058,2-14-24 21:28,900,Payment,Insurance Payment,287.51282
38898,813380058,2-17-24 22:28,31.9,Withdrawal,Branch Withdrawal,255.61282
38899,813380058,2-19-24 10:28,60.11,Deposit,Check Deposit,315.72282
38900,813380058,2-22-24 12:28,115.34,IncomingTransfer,Freelance Payment,431.06282
38901,813380058,2-28-24 9:28,25.39,Purchase,Entertainment,405.67282
38902,813380058,2-28-24 10:28,212.75,Purchase,Restaurant,192.92282
38903,813380058,03-01-24 22:28,311.26,Deposit,Mobile Deposit,504.18282
38904,813380058,03-02-24 18:28,391.75,Deposit,Mobile Deposit,895.93282
38905,813380058,03-03-24 16:28,337.11,Return,Target Return,1233.04282
38906,813380058,03-05-24 11:28,315.55,Withdrawal,Branch Withdrawal,917.49282
38907,813380058,03-05-24 21:28,1950,IncomingTransfer,Salary,2867.49282
38908,813380058,03-07-24 16:28,411.25,Payment,Loan Payment,2456.24282
38909,813380058,03-10-24 21:28,1200,Payment,Credit Card Payment,1256.24282
38910,813380058,03-12-24 21:28,900,Payment,Installment Payment,356.24282
38911,813380058,3-23-24 10:28,219.47,Return,Store Return,575.71282
38912,813380058,3-25-24 17:28,36.85,Return,Store Return,612.56282
38913,813380058,3-27-24 15:28,289.81,Return,Amazon Return,902.37282
38914,813380058,3-30-24 15:28,23.94,Withdrawal,ATM Withdrawal,878.43282
38915,813380058,3-30-24 17:28,398.65,OutgoingTransfer,Peer-to-Peer Transfer,479.78282
38916,813380058,04-01-24 12:28,384.01,Deposit,Cash Deposit,863.79282
38917,813380058,04-02-24 16:28,214.74,Purchase,Electronics,649.05282
38918,813380058,04-03-24 21:28,1950,IncomingTransfer,Salary,2599.05282
38919,813380058,04-05-24 10:28,352.47,OnlineShopping,Amazon,2246.58282
38920,813380058,04-07-24 22:28,149.41,OnlineShopping,Etsy,2097.17282
38921,813380058,04-08-24 21:28,1000,Payment,Credit Card Payment,1097.17282
38922,813380058,04-08-24 21:28,462.02,Purchase,Travel,635.15282
38923,813380058,04-10-24 21:28,600,Payment,Insurance Payment,35.15282004
38924,813380058,4-14-24 15:28,107.72,IncomingTransfer,Freelance Payment,142.87282
38925,813380058,4-17-24 11:28,496.52,Withdrawal,Branch Withdrawal,-353.64718
38926,813380058,4-21-24 20:28,117.03,Return,Target Return,-236.61718
38927,813380058,4-22-24 20:28,42.62,Purchase,Pharmacy,-279.23718
38928,813380058,4-28-24 12:28,294.61,Deposit,Check Deposit,15.37282004
38929,813380058,05-02-24 23:28,365.97,OutgoingTransfer,Peer-to-Peer Transfer,-350.59718
38930,813380058,05-05-24 21:28,1950,IncomingTransfer,Salary,1599.40282
38931,813380058,05-10-24 21:28,900,Payment,Credit Card Payment,699.40282
38932,813380058,5-15-24 16:28,410.97,Purchase,Grocery,288.43282
38933,813380058,5-15-24 21:28,500,Payment,Subscription Payment,-211.56718
38934,813380058,5-21-24 18:28,212.45,IncomingTransfer,Freelance Payment,0.882820043
38935,813380058,5-25-24 19:28,325.64,Return,Best Buy Return,326.52282
38936,813380058,5-28-24 18:28,112.23,Purchase,Restaurant,214.29282
38937,813380058,5-30-24 10:28,418.58,Return,Amazon Return,632.87282
38938,813380058,5-30-24 15:28,279.73,OnlineShopping,Target,353.14282
38939,813380058,5-30-24 22:28,459.92,Deposit,Cash Deposit,813.06282
38940,813380058,06-01-24 12:28,278.33,Purchase,Entertainment,534.73282
38941,813380058,06-01-24 21:28,92.64,OutgoingTransfer,International Transfer,442.09282
38942,813380058,06-02-24 21:28,1950,IncomingTransfer,Salary,2392.09282
38943,813380058,06-07-24 10:28,334.34,OutgoingTransfer,Bank Transfer,2057.75282
38944,813380058,06-07-24 21:28,900,Payment,Credit Card Payment,1157.75282
38945,813380058,06-12-24 23:28,61.89,Purchase,Furniture,1095.86282
38946,813380058,6-15-24 17:28,80.22,Withdrawal,Mobile App Withdrawal,1015.64282
38947,813380058,6-17-24 21:28,800,Payment,Subscription Payment,215.64282
38948,813380058,6-20-24 13:28,392.1,Withdrawal,Branch Withdrawal,-176.45718
38949,813380058,6-20-24 18:28,228.01,Deposit,Cash Deposit,51.55282004
38950,813380058,6-24-24 21:28,496.74,IncomingTransfer,Freelance Payment,548.29282
38951,813380058,07-02-24 20:28,57.66,OutgoingTransfer,Wire Transfer,490.63282
38952,813380058,07-05-24 21:28,1950,IncomingTransfer,Salary,2440.63282
38953,813380058,07-06-24 21:28,182.46,OutgoingTransfer,Bank Transfer,2258.17282
38954,813380058,07-10-24 21:28,1000,Payment,Credit Card Payment,1258.17282
38955,813380058,7-17-24 21:28,700,Payment,Subscription Payment,558.17282
38956,813901458,1-20-24 17:28,405.52,Payment,Mortgage Payment,1002.864672
38957,813901458,1-23-24 13:28,292.85,Purchase,Home Improvement,710.0146724
38958,813901458,1-23-24 15:28,67.58,Withdrawal,ATM Withdrawal,642.4346724
38959,813901458,1-29-24 9:28,300.09,Return,Amazon Return,942.5246724
38960,813901458,1-31-24 18:28,297.89,IncomingTransfer,Freelance Payment,1240.414672
38961,813901458,02-03-24 21:28,5500,IncomingTransfer,Salary,6740.414672
38962,813901458,02-06-24 12:28,53.39,OnlineShopping,Amazon,6687.024672
38963,813901458,02-08-24 21:28,1900,Payment,Credit Card Payment,4787.024672
38964,813901458,02-09-24 13:28,482.52,Payment,Bill Payment,4304.504672
38965,813901458,02-09-24 16:28,185.83,Deposit,Check Deposit,4490.334672
38966,813901458,02-10-24 10:28,423.47,Withdrawal,Mobile App Withdrawal,4066.864672
38967,813901458,02-11-24 15:28,162.77,Withdrawal,ATM Withdrawal,3904.094672
38968,813901458,2-16-24 21:28,2500,Payment,Rent Payment,1404.094672
38969,813901458,2-17-24 17:28,183.66,Withdrawal,Mobile App Withdrawal,1220.434672
38970,813901458,2-17-24 19:28,107.01,Purchase,Clothing,1113.424672
38971,813901458,2-21-24 9:28,481.03,IncomingTransfer,Freelance Payment,1594.454672
38972,813901458,2-23-24 12:28,264.48,Purchase,Home Improvement,1329.974672
38973,813901458,2-24-24 10:28,321.01,Payment,Bill Payment,1008.964672
38974,813901458,2-24-24 16:28,549.82,Withdrawal,Branch Withdrawal,459.1446724
38975,813901458,2-24-24 18:28,246.77,Deposit,Direct Deposit,705.9146724
38976,813901458,2-26-24 14:28,210.63,Purchase,Clothing,495.2846724
38977,813901458,2-26-24 22:28,89.18,Purchase,Travel,406.1046724
38978,813901458,2-27-24 13:28,235.89,Payment,Mortgage Payment,170.2146724
38979,813901458,03-01-24 23:28,129.32,OutgoingTransfer,International Transfer,40.89467239
38980,813901458,03-04-24 21:28,5500,IncomingTransfer,Salary,5540.894672
38981,813901458,03-05-24 18:28,63.1,Return,Amazon Return,5603.994672
38982,813901458,03-07-24 10:28,367.72,OutgoingTransfer,Bank Transfer,5236.274672
38983,813901458,03-09-24 21:28,2200,Payment,Credit Card Payment,3036.274672
38984,813901458,03-10-24 21:28,2500,Payment,Rent Payment,536.2746724
38985,813901458,3-15-24 16:28,129.05,OnlineShopping,Amazon,407.2246724
38986,813901458,3-16-24 21:28,401.72,Payment,Bill Payment,5.504672385
38987,813901458,3-27-24 10:28,435.2,Return,eBay Return,440.7046724
38988,813901458,3-28-24 10:28,413.84,Deposit,Check Deposit,854.5446724
38989,813901458,3-28-24 20:28,477.77,Deposit,Direct Deposit,1332.314672
38990,813901458,3-29-24 14:28,58.42,Purchase,Travel,1273.894672
38991,813901458,3-30-24 11:28,214.68,Deposit,Check Deposit,1488.574672
38992,813901458,3-30-24 13:28,474.94,IncomingTransfer,Freelance Payment,1963.514672
38993,813901458,3-31-24 18:28,199.89,OnlineShopping,eBay,1763.624672
38994,813901458,04-01-24 21:28,5500,IncomingTransfer,Salary,7263.624672
38995,813901458,04-04-24 15:28,456.76,Withdrawal,ATM Withdrawal,6806.864672
38996,813901458,04-06-24 21:28,2300,Payment,Credit Card Payment,4506.864672
38997,813901458,04-07-24 19:28,433.98,Deposit,Mobile Deposit,4940.844672
38998,813901458,04-07-24 20:28,330.56,OutgoingTransfer,Peer-to-Peer Transfer,4610.284672
38999,813901458,04-10-24 17:28,301.54,OnlineShopping,eBay,4308.744672
39000,813901458,04-11-24 10:28,397.37,Withdrawal,ATM Withdrawal,3911.374672
39001,813901458,04-12-24 21:28,1700,Payment,Rent Payment,2211.374672
39002,813901458,4-13-24 19:28,236.66,Purchase,Travel,1974.714672
39003,813901458,4-15-24 11:28,146.9,OnlineShopping,Walmart,1827.814672
39004,813901458,4-15-24 23:28,229.73,OnlineShopping,Amazon,1598.084672
39005,813901458,4-17-24 12:28,344.97,OutgoingTransfer,Bank Transfer,1253.114672
39006,813901458,4-17-24 22:28,214.31,Withdrawal,Mobile App Withdrawal,1038.804672
39007,813901458,4-18-24 10:28,301.83,Withdrawal,Mobile App Withdrawal,736.9746724
39008,813901458,4-19-24 15:28,470.18,OutgoingTransfer,International Transfer,266.7946724
39009,813901458,4-23-24 13:28,491.16,Deposit,Mobile Deposit,757.9546724
39010,813901458,4-24-24 13:28,516.23,OutgoingTransfer,Peer-to-Peer Transfer,241.7246724
39011,813901458,4-25-24 12:28,446.27,Return,Amazon Return,687.9946724
39012,813901458,4-26-24 16:28,541.94,IncomingTransfer,Freelance Payment,1229.934672
39013,813901458,4-26-24 20:28,142.41,OutgoingTransfer,International Transfer,1087.524672
39014,813901458,4-28-24 10:28,299.44,Deposit,Cash Deposit,1386.964672
39015,813901458,4-28-24 22:28,223.55,OnlineShopping,Target,1163.414672
39016,813901458,4-30-24 13:28,159.62,Deposit,Check Deposit,1323.034672
39017,813901458,05-01-24 12:28,496.26,Return,Target Return,1819.294672
39018,813901458,05-02-24 18:28,107.91,Purchase,Entertainment,1711.384672
39019,813901458,05-02-24 23:28,445.21,Withdrawal,Mobile App Withdrawal,1266.174672
39020,813901458,05-03-24 21:28,5500,IncomingTransfer,Salary,6766.174672
39021,813901458,05-04-24 19:28,507.57,Purchase,Clothing,6258.604672
39022,813901458,05-05-24 20:28,185.78,Withdrawal,Mobile App Withdrawal,6072.824672
39023,813901458,05-07-24 11:28,471.02,Withdrawal,Mobile App Withdrawal,5601.804672
39024,813901458,05-08-24 10:28,246.22,Payment,Loan Payment,5355.584672
39025,813901458,05-08-24 15:28,442.67,Withdrawal,Mobile App Withdrawal,4912.914672
39026,813901458,05-08-24 21:28,2300,Payment,Credit Card Payment,2612.914672
39027,813901458,05-10-24 16:28,182.62,Deposit,Direct Deposit,2795.534672
39028,813901458,05-12-24 15:28,292.09,Withdrawal,Mobile App Withdrawal,2503.444672
39029,813901458,5-14-24 21:28,2000,Payment,Rent Payment,503.4446724
39030,813901458,5-14-24 23:28,376.63,Deposit,Direct Deposit,880.0746724
39031,813901458,5-17-24 16:28,175.39,Return,AliExpress Return,1055.464672
39032,813901458,5-19-24 13:28,96.82,OnlineShopping,eBay,958.6446724
39033,813901458,5-22-24 23:28,82.87,OnlineShopping,Best Buy,875.7746724
39034,813901458,5-25-24 14:28,183.78,Withdrawal,Branch Withdrawal,691.9946724
39035,813901458,5-29-24 20:28,537.4,OutgoingTransfer,Bank Transfer,154.5946724
39036,813901458,5-31-24 17:28,277.39,OnlineShopping,Best Buy,-122.7953276
39037,813901458,06-01-24 21:28,5500,IncomingTransfer,Salary,5377.204672
39038,813901458,06-02-24 22:28,498.86,Payment,Bill Payment,4878.344672
39039,813901458,06-04-24 11:28,340.12,Withdrawal,Branch Withdrawal,4538.224672
39040,813901458,06-06-24 21:28,2500,Payment,Credit Card Payment,2038.224672
39041,813901458,06-08-24 14:28,295.7,Deposit,Mobile Deposit,2333.924672
39042,813901458,06-09-24 15:28,127.59,Deposit,Check Deposit,2461.514672
39043,813901458,06-11-24 18:28,307.04,Purchase,Travel,2154.474672
39044,813901458,06-12-24 10:28,341.01,Deposit,Check Deposit,2495.484672
39045,813901458,06-12-24 18:28,390.12,OutgoingTransfer,Peer-to-Peer Transfer,2105.364672
39046,813901458,06-12-24 21:28,2000,Payment,Rent Payment,105.3646724
39047,813901458,6-13-24 19:28,210.59,OnlineShopping,eBay,-105.2253276
39048,813901458,6-15-24 10:28,493.03,Purchase,Furniture,-598.2553276
39049,813901458,6-17-24 14:28,519.54,OutgoingTransfer,Wire Transfer,-1117.795328
39050,813901458,6-17-24 15:28,262.41,OnlineShopping,Best Buy,-1380.205328
39051,813901458,6-20-24 10:28,186.02,Payment,Loan Payment,-1566.225328
39052,813901458,6-20-24 14:28,414.14,Purchase,Furniture,-1980.365328
39053,813901458,6-22-24 18:28,288.71,OutgoingTransfer,Peer-to-Peer Transfer,-2269.075328
39054,813901458,6-24-24 23:28,255.86,Deposit,Mobile Deposit,-2013.215328
39055,813901458,6-25-24 15:28,208.78,Deposit,Check Deposit,-1804.435328
39056,813901458,6-27-24 14:28,391.23,OutgoingTransfer,Wire Transfer,-2195.665328
39057,813901458,6-28-24 19:28,168.1,Purchase,Furniture,-2363.765328
39058,813901458,6-30-24 13:28,249.91,IncomingTransfer,Freelance Payment,-2113.855328
39059,813901458,07-02-24 13:28,270.67,OnlineShopping,Etsy,-2384.525328
39060,813901458,07-02-24 16:28,324.39,OutgoingTransfer,Peer-to-Peer Transfer,-2708.915328
39061,813901458,07-05-24 17:28,205.5,Deposit,Direct Deposit,-2503.415328
39062,813901458,07-05-24 21:28,5500,IncomingTransfer,Salary,2996.584672
39063,813901458,07-07-24 10:28,73.99,OnlineShopping,Target,2922.594672
39064,813901458,07-09-24 15:28,297.99,Payment,Loan Payment,2624.604672
39065,813901458,07-10-24 21:28,2200,Payment,Credit Card Payment,424.6046724
39066,813901458,07-10-24 21:28,1800,Payment,Rent Payment,-1375.395328
39067,813901458,7-15-24 16:28,177.33,Purchase,Travel,-1552.725328
39068,813901458,7-15-24 17:28,417.73,Purchase,Travel,-1970.455328
39069,814995933,02-02-24 21:28,2600,IncomingTransfer,Salary,3912.431313
39070,814995933,02-07-24 12:28,218.47,Payment,Bill Payment,3693.961313
39071,814995933,02-07-24 21:28,2100,Payment,Credit Card Payment,1593.961313
39072,814995933,02-11-24 18:28,184.68,Deposit,Cash Deposit,1778.641313
39073,814995933,2-13-24 18:28,102.25,Deposit,Cash Deposit,1880.891313
39074,814995933,2-15-24 12:28,161.46,Purchase,Home Improvement,1719.431313
39075,814995933,2-16-24 21:28,1000,Payment,Insurance Payment,719.4313127
39076,814995933,2-20-24 10:28,145.2,Purchase,Grocery,574.2313127
39077,814995933,2-29-24 16:28,198.33,Deposit,Cash Deposit,772.5613127
39078,814995933,03-01-24 20:28,60.92,Deposit,Cash Deposit,833.4813127
39079,814995933,03-02-24 21:28,2600,IncomingTransfer,Salary,3433.481313
39080,814995933,03-03-24 18:28,161.52,Deposit,Direct Deposit,3595.001313
39081,814995933,03-04-24 22:28,25.01,Purchase,Gas,3569.991313
39082,814995933,03-07-24 9:28,212.25,Payment,Mortgage Payment,3357.741313
39083,814995933,03-07-24 21:28,1900,Payment,Credit Card Payment,1457.741313
39084,814995933,03-10-24 21:28,1100,Payment,Insurance Payment,357.7413127
39085,814995933,03-11-24 17:28,158.57,Purchase,Electronics,199.1713127
39086,814995933,3-13-24 13:28,126.85,Withdrawal,ATM Withdrawal,72.32131274
39087,814995933,3-15-24 9:28,128.25,Withdrawal,ATM Withdrawal,-55.92868726
39088,814995933,3-17-24 13:28,158.49,Purchase,Home Improvement,-214.4186873
39089,814995933,3-18-24 9:28,154.19,OutgoingTransfer,Wire Transfer,-368.6086873
39090,814995933,3-22-24 10:28,216.24,Deposit,Cash Deposit,-152.3686873
39091,814995933,3-22-24 14:28,153.6,OnlineShopping,Best Buy,-305.9686873
39092,814995933,3-25-24 13:28,82.5,Deposit,Mobile Deposit,-223.4686873
39093,814995933,3-30-24 11:28,239.27,Purchase,Grocery,-462.7386873
39094,814995933,04-04-24 21:28,2600,IncomingTransfer,Salary,2137.261313
39095,814995933,04-07-24 12:28,191.01,Withdrawal,ATM Withdrawal,1946.251313
39096,814995933,04-09-24 15:28,229.12,OutgoingTransfer,International Transfer,1717.131313
39097,814995933,04-09-24 21:28,2700,Payment,Credit Card Payment,-982.8686873
39098,814995933,04-12-24 9:28,147.38,Return,eBay Return,-835.4886873
39099,814995933,4-13-24 20:28,203.68,Payment,Bill Payment,-1039.168687
39100,814995933,4-17-24 21:28,800,Payment,Installment Payment,-1839.168687
39101,814995933,4-19-24 21:28,194.36,Deposit,Check Deposit,-1644.808687
39102,814995933,4-21-24 21:28,129.8,Purchase,Clothing,-1774.608687
39103,814995933,4-23-24 17:28,89.17,OutgoingTransfer,Wire Transfer,-1863.778687
39104,814995933,4-30-24 12:28,248.62,Purchase,Gas,-2112.398687
39105,814995933,05-02-24 14:28,186.26,Purchase,Clothing,-2298.658687
39106,814995933,05-03-24 21:28,2600,IncomingTransfer,Salary,301.3413127
39107,814995933,05-05-24 15:28,85.68,Return,eBay Return,387.0213127
39108,814995933,05-08-24 12:28,203.53,Purchase,Gas,183.4913127
39109,814995933,05-08-24 21:28,2300,Payment,Credit Card Payment,-2116.508687
39110,814995933,05-11-24 21:28,1100,Payment,Installment Payment,-3216.508687
39111,814995933,5-25-24 11:28,129.33,Purchase,Travel,-3345.838687
39112,814995933,5-28-24 10:28,39.36,Return,Target Return,-3306.478687
39113,814995933,5-31-24 10:28,141.43,Purchase,Travel,-3447.908687
39114,814995933,06-01-24 21:28,2600,IncomingTransfer,Salary,-847.9086873
39115,814995933,06-02-24 11:28,179.09,OutgoingTransfer,Peer-to-Peer Transfer,-1026.998687
39116,814995933,06-02-24 19:28,108.95,Deposit,Mobile Deposit,-918.0486873
39117,814995933,06-05-24 23:28,79.19,OnlineShopping,Etsy,-997.2386873
39118,814995933,06-06-24 21:28,2300,Payment,Credit Card Payment,-3297.238687
39119,814995933,06-12-24 21:28,800,Payment,Installment Payment,-4097.238687
39120,814995933,6-15-24 11:28,223.19,Withdrawal,Mobile App Withdrawal,-4320.428687
39121,814995933,6-22-24 17:28,30.93,Purchase,Clothing,-4351.358687
39122,814995933,07-01-24 20:28,123.92,Deposit,Check Deposit,-4227.438687
39123,814995933,07-04-24 15:28,197.37,OutgoingTransfer,Peer-to-Peer Transfer,-4424.808687
39124,814995933,07-04-24 21:28,2600,IncomingTransfer,Salary,-1824.808687
39125,814995933,07-05-24 18:28,18.81,Purchase,Restaurant,-1843.618687
39126,814995933,07-05-24 21:28,15.41,Withdrawal,Branch Withdrawal,-1859.028687
39127,814995933,07-09-24 20:28,161.97,Return,Best Buy Return,-1697.058687
39128,814995933,07-09-24 21:28,2500,Payment,Credit Card Payment,-4197.058687
39129,814995933,07-10-24 12:28,72.85,Withdrawal,ATM Withdrawal,-4269.908687
39130,814995933,07-12-24 21:28,700,Payment,Insurance Payment,-4969.908687
39131,814995933,7-17-24 22:28,208.5,Deposit,Check Deposit,-4761.408687
39132,815230458,1-21-24 20:28,224.95,Payment,Bill Payment,565.5486462
39133,815230458,1-21-24 22:28,399.37,OnlineShopping,eBay,166.1786462
39134,815230458,1-23-24 20:28,76.69,OutgoingTransfer,Bank Transfer,89.48864622
39135,815230458,1-25-24 10:28,384.12,Return,Amazon Return,473.6086462
39136,815230458,1-26-24 20:28,146.63,OutgoingTransfer,Peer-to-Peer Transfer,326.9786462
39137,815230458,1-28-24 16:28,132.64,Purchase,Travel,194.3386462
39138,815230458,1-31-24 22:28,365.67,Payment,Loan Payment,-171.3313538
39139,815230458,02-02-24 10:28,254.07,Payment,Bill Payment,-425.4013538
39140,815230458,02-02-24 10:28,320.33,Purchase,Furniture,-745.7313538
39141,815230458,02-03-24 17:28,124.48,OutgoingTransfer,Wire Transfer,-870.2113538
39142,815230458,02-03-24 21:28,4000,IncomingTransfer,Salary,3129.788646
39143,815230458,02-04-24 15:28,328.76,Purchase,Grocery,2801.028646
39144,815230458,02-04-24 22:28,337.4,Deposit,Direct Deposit,3138.428646
39145,815230458,02-04-24 22:28,122.04,Withdrawal,ATM Withdrawal,3016.388646
39146,815230458,02-05-24 15:28,288.67,Withdrawal,Branch Withdrawal,2727.718646
39147,815230458,02-08-24 21:28,1600,Payment,Credit Card Payment,1127.718646
39148,815230458,02-09-24 21:28,344.52,Deposit,Check Deposit,1472.238646
39149,815230458,02-11-24 19:28,38.8,Return,Target Return,1511.038646
39150,815230458,02-12-24 14:28,29.47,Return,Walmart Return,1540.508646
39151,815230458,2-15-24 17:28,49.13,Withdrawal,Branch Withdrawal,1491.378646
39152,815230458,2-16-24 9:28,375.18,Purchase,Electronics,1116.198646
39153,815230458,2-17-24 12:28,144.55,Return,Walmart Return,1260.748646
39154,815230458,2-17-24 21:28,59.97,Return,Target Return,1320.718646
39155,815230458,2-18-24 13:28,73.15,Purchase,Home Improvement,1247.568646
39156,815230458,2-18-24 20:28,135.49,Purchase,Home Improvement,1112.078646
39157,815230458,2-18-24 21:28,1600,Payment,Installment Payment,-487.9213538
39158,815230458,2-18-24 21:28,398.29,Deposit,Mobile Deposit,-89.63135378
39159,815230458,2-20-24 12:28,224.03,Purchase,Electronics,-313.6613538
39160,815230458,2-22-24 14:28,298.53,OutgoingTransfer,Wire Transfer,-612.1913538
39161,815230458,2-23-24 11:28,285.36,Withdrawal,ATM Withdrawal,-897.5513538
39162,815230458,2-23-24 21:28,70.56,OnlineShopping,Walmart,-968.1113538
39163,815230458,2-24-24 14:28,344.75,Withdrawal,Branch Withdrawal,-1312.861354
39164,815230458,2-26-24 15:28,196.46,Deposit,Check Deposit,-1116.401354
39165,815230458,2-28-24 21:28,398.9,Purchase,Home Improvement,-1515.301354
39166,815230458,2-29-24 11:28,239.22,Withdrawal,Branch Withdrawal,-1754.521354
39167,815230458,03-01-24 18:28,183.41,IncomingTransfer,Freelance Payment,-1571.111354
39168,815230458,03-01-24 18:28,129.49,Return,Store Return,-1441.621354
39169,815230458,03-01-24 23:28,274.77,Withdrawal,ATM Withdrawal,-1716.391354
39170,815230458,03-02-24 16:28,196.78,Deposit,Check Deposit,-1519.611354
39171,815230458,03-05-24 21:28,4000,IncomingTransfer,Salary,2480.388646
39172,815230458,03-06-24 19:28,161.75,Deposit,Cash Deposit,2642.138646
39173,815230458,03-10-24 21:28,1800,Payment,Credit Card Payment,842.1386462
39174,815230458,03-11-24 20:28,21.62,IncomingTransfer,Freelance Payment,863.7586462
39175,815230458,03-12-24 18:28,325.81,Withdrawal,Branch Withdrawal,537.9486462
39176,815230458,3-17-24 12:28,198.97,Purchase,Restaurant,338.9786462
39177,815230458,3-17-24 16:28,193.54,Purchase,Travel,145.4386462
39178,815230458,3-17-24 21:28,1300,Payment,Installment Payment,-1154.561354
39179,815230458,3-18-24 11:28,311.45,Purchase,Entertainment,-1466.011354
39180,815230458,3-19-24 23:28,335.16,OnlineShopping,AliExpress,-1801.171354
39181,815230458,3-21-24 18:28,144.44,OutgoingTransfer,Peer-to-Peer Transfer,-1945.611354
39182,815230458,3-25-24 12:28,341.19,Withdrawal,Mobile App Withdrawal,-2286.801354
39183,815230458,3-26-24 22:28,133.04,Deposit,Check Deposit,-2153.761354
39184,815230458,3-27-24 10:28,112.99,Payment,Bill Payment,-2266.751354
39185,815230458,3-28-24 10:28,105.45,Purchase,Entertainment,-2372.201354
39186,815230458,3-28-24 17:28,186.97,Return,Target Return,-2185.231354
39187,815230458,3-29-24 20:28,265.36,Deposit,Cash Deposit,-1919.871354
39188,815230458,04-02-24 20:28,327.15,Withdrawal,ATM Withdrawal,-2247.021354
39189,815230458,04-02-24 21:28,4000,IncomingTransfer,Salary,1752.978646
39190,815230458,04-05-24 11:28,254.58,Purchase,Furniture,1498.398646
39191,815230458,04-06-24 17:28,43.25,Deposit,Check Deposit,1541.648646
39192,815230458,04-07-24 11:28,192.01,Withdrawal,ATM Withdrawal,1349.638646
39193,815230458,04-07-24 21:28,1500,Payment,Credit Card Payment,-150.3613538
39194,815230458,04-09-24 13:28,259.07,Withdrawal,ATM Withdrawal,-409.4313538
39195,815230458,04-10-24 20:28,79.54,Payment,Loan Payment,-488.9713538
39196,815230458,04-11-24 21:28,1100,Payment,Installment Payment,-1588.971354
39197,815230458,04-12-24 14:28,169,Return,AliExpress Return,-1419.971354
39198,815230458,4-15-24 19:28,47.19,Withdrawal,ATM Withdrawal,-1467.161354
39199,815230458,4-17-24 16:28,304.48,OnlineShopping,Best Buy,-1771.641354
39200,815230458,4-17-24 19:28,218.4,Payment,Bill Payment,-1990.041354
39201,815230458,4-21-24 17:28,264.79,Deposit,Check Deposit,-1725.251354
39202,815230458,4-25-24 12:28,334.52,Withdrawal,ATM Withdrawal,-2059.771354
39203,815230458,4-25-24 18:28,181.79,OnlineShopping,Amazon,-2241.561354
39204,815230458,4-26-24 9:28,188.46,Purchase,Pharmacy,-2430.021354
39205,815230458,4-26-24 21:28,378.78,Deposit,Check Deposit,-2051.241354
39206,815230458,4-28-24 15:28,213.2,Deposit,Mobile Deposit,-1838.041354
39207,815230458,4-30-24 10:28,338.56,Deposit,Check Deposit,-1499.481354
39208,815230458,05-01-24 21:28,4000,IncomingTransfer,Salary,2500.518646
39209,815230458,05-03-24 19:28,117.45,OutgoingTransfer,Peer-to-Peer Transfer,2383.068646
39210,815230458,05-05-24 12:28,350.77,OutgoingTransfer,Peer-to-Peer Transfer,2032.298646
39211,815230458,05-06-24 21:28,1300,Payment,Credit Card Payment,732.2986462
39212,815230458,05-07-24 23:28,150.83,Return,Amazon Return,883.1286462
39213,815230458,05-08-24 19:28,255.47,Purchase,Travel,627.6586462
39214,815230458,05-10-24 22:28,302.93,IncomingTransfer,Freelance Payment,930.5886462
39215,815230458,5-13-24 10:28,337.84,Return,Walmart Return,1268.428646
39216,815230458,5-14-24 18:28,354.11,Return,Walmart Return,1622.538646
39217,815230458,5-15-24 21:28,1000,Payment,Subscription Payment,622.5386462
39218,815230458,5-22-24 20:28,88.15,Withdrawal,Branch Withdrawal,534.3886462
39219,815230458,5-25-24 14:28,155.27,IncomingTransfer,Freelance Payment,689.6586462
39220,815230458,5-26-24 11:28,316.06,Deposit,Mobile Deposit,1005.718646
39221,815230458,5-28-24 13:28,129.71,Purchase,Entertainment,876.0086462
39222,815230458,5-28-24 19:28,294.61,Deposit,Cash Deposit,1170.618646
39223,815230458,5-28-24 22:28,146.84,Withdrawal,ATM Withdrawal,1023.778646
39224,815230458,5-29-24 17:28,324.75,Purchase,Entertainment,699.0286462
39225,815230458,5-30-24 12:28,146.44,Deposit,Mobile Deposit,845.4686462
39226,815230458,5-30-24 16:28,396.25,Purchase,Electronics,449.2186462
39227,815230458,06-02-24 11:28,133.04,Return,eBay Return,582.2586462
39228,815230458,06-03-24 11:28,194,Withdrawal,ATM Withdrawal,388.2586462
39229,815230458,06-03-24 21:28,4000,IncomingTransfer,Salary,4388.258646
39230,815230458,06-08-24 11:28,200.3,Return,Amazon Return,4588.558646
39231,815230458,06-08-24 21:28,1900,Payment,Credit Card Payment,2688.558646
39232,815230458,06-08-24 21:28,240.75,Return,Amazon Return,2929.308646
39233,815230458,06-10-24 21:28,1800,Payment,Subscription Payment,1129.308646
39234,815230458,06-11-24 14:28,124.97,OnlineShopping,Best Buy,1004.338646
39235,815230458,06-12-24 9:28,238.12,Deposit,Check Deposit,1242.458646
39236,815230458,6-14-24 12:28,171.85,Return,Store Return,1414.308646
39237,815230458,6-14-24 23:28,292.6,Withdrawal,ATM Withdrawal,1121.708646
39238,815230458,6-15-24 13:28,384.53,OutgoingTransfer,Wire Transfer,737.1786462
39239,815230458,6-15-24 14:28,28.02,Purchase,Clothing,709.1586462
39240,815230458,6-15-24 19:28,72.13,OutgoingTransfer,Wire Transfer,637.0286462
39241,815230458,6-16-24 10:28,148.26,Purchase,Gas,488.7686462
39242,815230458,6-18-24 10:28,153.07,Withdrawal,Mobile App Withdrawal,335.6986462
39243,815230458,6-18-24 14:28,61.88,OnlineShopping,Walmart,273.8186462
39244,815230458,6-18-24 19:28,322,Purchase,Electronics,-48.18135378
39245,815230458,6-18-24 23:28,278.21,Purchase,Gas,-326.3913538
39246,815230458,6-21-24 11:28,196.07,OutgoingTransfer,International Transfer,-522.4613538
39247,815230458,6-21-24 20:28,158.87,OutgoingTransfer,Peer-to-Peer Transfer,-681.3313538
39248,815230458,6-22-24 15:28,290.52,Withdrawal,ATM Withdrawal,-971.8513538
39249,815230458,6-24-24 15:28,80.74,Purchase,Electronics,-1052.591354
39250,815230458,6-25-24 12:28,225.93,Return,Target Return,-826.6613538
39251,815230458,6-25-24 23:28,214.86,Deposit,Direct Deposit,-611.8013538
39252,815230458,6-26-24 13:28,244.48,Return,Target Return,-367.3213538
39253,815230458,6-26-24 14:28,370.46,OnlineShopping,eBay,-737.7813538
39254,815230458,6-27-24 23:28,199.57,Purchase,Travel,-937.3513538
39255,815230458,6-28-24 15:28,354.28,IncomingTransfer,Freelance Payment,-583.0713538
39256,815230458,6-30-24 16:28,334,Purchase,Gas,-917.0713538
39257,815230458,07-01-24 21:28,32.96,Withdrawal,Mobile App Withdrawal,-950.0313538
39258,815230458,07-02-24 21:28,4000,IncomingTransfer,Salary,3049.968646
39259,815230458,07-02-24 22:28,218.64,Withdrawal,Branch Withdrawal,2831.328646
39260,815230458,07-03-24 19:28,178.7,Deposit,Cash Deposit,3010.028646
39261,815230458,07-03-24 20:28,30.84,IncomingTransfer,Freelance Payment,3040.868646
39262,815230458,07-05-24 9:28,252.04,OnlineShopping,Target,2788.828646
39263,815230458,07-06-24 10:28,221.26,Deposit,Check Deposit,3010.088646
39264,815230458,07-06-24 11:28,38.73,OnlineShopping,Best Buy,2971.358646
39265,815230458,07-07-24 13:28,249.08,Payment,Bill Payment,2722.278646
39266,815230458,07-07-24 17:28,320.39,OutgoingTransfer,Peer-to-Peer Transfer,2401.888646
39267,815230458,07-07-24 18:28,320.43,Purchase,Clothing,2081.458646
39268,815230458,07-07-24 21:28,1700,Payment,Credit Card Payment,381.4586462
39269,815230458,07-10-24 17:28,165.3,Payment,Bill Payment,216.1586462
39270,815230458,07-10-24 21:28,161.41,OnlineShopping,AliExpress,54.74864622
39271,815230458,07-11-24 21:28,1400,Payment,Subscription Payment,-1345.251354
39272,815230458,07-12-24 10:28,114.49,Payment,Mortgage Payment,-1459.741354
39273,815230458,7-13-24 17:28,237.58,Purchase,Electronics,-1697.321354
39274,815230458,7-15-24 22:28,192.37,Purchase,Grocery,-1889.691354
39275,815230458,7-16-24 19:28,45.46,Withdrawal,ATM Withdrawal,-1935.151354
39276,815240358,1-22-24 16:28,395.43,Purchase,Furniture,475.5717356
39277,815240358,1-26-24 19:28,124.03,Purchase,Restaurant,351.5417356
39278,815240358,1-31-24 17:28,310.87,IncomingTransfer,Freelance Payment,662.4117356
39279,815240358,02-02-24 11:28,275.46,Deposit,Mobile Deposit,937.8717356
39280,815240358,02-03-24 21:28,7250,IncomingTransfer,Salary,8187.871736
39281,815240358,02-06-24 14:28,280.78,Return,Target Return,8468.651736
39282,815240358,02-07-24 21:28,481.15,OutgoingTransfer,Wire Transfer,7987.501736
39283,815240358,02-07-24 23:28,158.59,Deposit,Cash Deposit,8146.091736
39284,815240358,02-08-24 21:28,1600,Payment,Credit Card Payment,6546.091736
39285,815240358,02-10-24 11:28,162.08,OnlineShopping,AliExpress,6384.011736
39286,815240358,02-10-24 21:28,2000,Payment,Rent Payment,4384.011736
39287,815240358,2-13-24 11:28,256.81,Return,Walmart Return,4640.821736
39288,815240358,2-19-24 12:28,288.17,Purchase,Travel,4352.651736
39289,815240358,2-23-24 12:28,476.25,Withdrawal,Mobile App Withdrawal,3876.401736
39290,815240358,2-25-24 13:28,47.48,OnlineShopping,Etsy,3828.921736
39291,815240358,2-28-24 9:28,485.48,Withdrawal,ATM Withdrawal,3343.441736
39292,815240358,2-28-24 11:28,320.82,Return,Store Return,3664.261736
39293,815240358,2-28-24 18:28,243.39,Return,Best Buy Return,3907.651736
39294,815240358,03-02-24 21:28,7250,IncomingTransfer,Salary,11157.65174
39295,815240358,03-07-24 14:28,362.1,Deposit,Mobile Deposit,11519.75174
39296,815240358,03-07-24 21:28,1700,Payment,Credit Card Payment,9819.751736
39297,815240358,03-10-24 21:28,3300,Payment,Rent Payment,6519.751736
39298,815240358,03-11-24 18:28,133.74,OutgoingTransfer,Bank Transfer,6386.011736
39299,815240358,3-20-24 12:28,135.71,Purchase,Entertainment,6250.301736
39300,815240358,3-21-24 20:28,181.5,OnlineShopping,Walmart,6068.801736
39301,815240358,3-22-24 15:28,147.01,OutgoingTransfer,Bank Transfer,5921.791736
39302,815240358,3-28-24 21:28,63.86,Purchase,Pharmacy,5857.931736
39303,815240358,3-29-24 16:28,473.59,IncomingTransfer,Freelance Payment,6331.521736
39304,815240358,04-01-24 21:28,7250,IncomingTransfer,Salary,13581.52174
39305,815240358,04-03-24 17:28,40.88,Payment,Loan Payment,13540.64174
39306,815240358,04-04-24 9:28,189.62,OutgoingTransfer,International Transfer,13351.02174
39307,815240358,04-06-24 21:28,1700,Payment,Credit Card Payment,11651.02174
39308,815240358,04-07-24 12:28,150.33,Withdrawal,Branch Withdrawal,11500.69174
39309,815240358,04-11-24 14:28,168.81,Withdrawal,Mobile App Withdrawal,11331.88174
39310,815240358,04-11-24 21:28,4000,Payment,Rent Payment,7331.881736
39311,815240358,04-12-24 14:28,15.95,Purchase,Electronics,7315.931736
39312,815240358,4-19-24 21:28,370.39,Purchase,Home Improvement,6945.541736
39313,815240358,4-24-24 14:28,110.04,Payment,Bill Payment,6835.501736
39314,815240358,4-27-24 20:28,112.58,OutgoingTransfer,International Transfer,6722.921736
39315,815240358,4-29-24 11:28,448.06,Withdrawal,Branch Withdrawal,6274.861736
39316,815240358,05-02-24 21:28,7250,IncomingTransfer,Salary,13524.86174
39317,815240358,05-04-24 12:28,98.55,Withdrawal,ATM Withdrawal,13426.31174
39318,815240358,05-06-24 9:28,438.22,Withdrawal,Branch Withdrawal,12988.09174
39319,815240358,05-06-24 9:28,192.82,Withdrawal,Branch Withdrawal,12795.27174
39320,815240358,05-07-24 21:28,2200,Payment,Credit Card Payment,10595.27174
39321,815240358,05-08-24 21:28,349.14,IncomingTransfer,Freelance Payment,10944.41174
39322,815240358,05-11-24 20:28,411.33,Purchase,Travel,10533.08174
39323,815240358,05-12-24 17:28,93.65,Deposit,Cash Deposit,10626.73174
39324,815240358,5-13-24 21:28,2600,Payment,Rent Payment,8026.731736
39325,815240358,5-15-24 12:28,312.63,Payment,Loan Payment,7714.101736
39326,815240358,5-21-24 21:28,77.77,IncomingTransfer,Freelance Payment,7791.871736
39327,815240358,5-22-24 16:28,317.55,Withdrawal,Mobile App Withdrawal,7474.321736
39328,815240358,5-26-24 11:28,50.19,Return,Store Return,7524.511736
39329,815240358,06-02-24 21:28,7250,IncomingTransfer,Salary,14774.51174
39330,815240358,06-03-24 21:28,18.26,OnlineShopping,Target,14756.25174
39331,815240358,06-06-24 10:28,208.43,Deposit,Direct Deposit,14964.68174
39332,815240358,06-06-24 14:28,282.32,Purchase,Restaurant,14682.36174
39333,815240358,06-07-24 18:28,160.49,Deposit,Cash Deposit,14842.85174
39334,815240358,06-07-24 19:28,406.44,Purchase,Travel,14436.41174
39335,815240358,06-07-24 21:28,2100,Payment,Credit Card Payment,12336.41174
39336,815240358,06-08-24 10:28,467.02,Withdrawal,Mobile App Withdrawal,11869.39174
39337,815240358,06-10-24 15:28,270.35,IncomingTransfer,Freelance Payment,12139.74174
39338,815240358,06-11-24 9:28,171.27,Purchase,Entertainment,11968.47174
39339,815240358,06-11-24 14:28,392.36,OnlineShopping,AliExpress,11576.11174
39340,815240358,6-14-24 21:28,2700,Payment,Rent Payment,8876.111736
39341,815240358,6-15-24 21:28,73.92,Payment,Mortgage Payment,8802.191736
39342,815240358,6-20-24 14:28,268.02,Withdrawal,ATM Withdrawal,8534.171736
39343,815240358,6-23-24 13:28,340.34,Purchase,Pharmacy,8193.831736
39344,815240358,6-25-24 20:28,393.97,OnlineShopping,Best Buy,7799.861736
39345,815240358,6-30-24 16:28,432.37,Deposit,Cash Deposit,8232.231736
39346,815240358,07-03-24 21:28,7250,IncomingTransfer,Salary,15482.23174
39347,815240358,07-04-24 21:28,139.71,Deposit,Check Deposit,15621.94174
39348,815240358,07-06-24 19:28,491.18,Withdrawal,Branch Withdrawal,15130.76174
39349,815240358,07-07-24 20:28,31.37,OutgoingTransfer,International Transfer,15099.39174
39350,815240358,07-08-24 21:28,1500,Payment,Credit Card Payment,13599.39174
39351,815240358,07-10-24 13:28,409.15,Return,Etsy Return,14008.54174
39352,815240358,07-11-24 22:28,372.07,Return,Walmart Return,14380.61174
39353,815240358,07-12-24 21:28,104.68,OutgoingTransfer,International Transfer,14275.93174
39354,815240358,7-15-24 21:28,3300,Payment,Rent Payment,10975.93174
39355,815240358,7-16-24 20:28,386.05,Withdrawal,Mobile App Withdrawal,10589.88174
39356,816094233,1-26-24 17:28,439.14,Purchase,Restaurant,611.4096457
39357,816094233,02-01-24 21:28,13100,IncomingTransfer,Salary,13711.40965
39358,816094233,02-06-24 16:28,520.94,Withdrawal,ATM Withdrawal,13190.46965
39359,816094233,02-06-24 21:28,1900,Payment,Credit Card Payment,11290.46965
39360,816094233,02-08-24 20:28,844.59,OutgoingTransfer,Bank Transfer,10445.87965
39361,816094233,2-15-24 22:28,599.57,Return,Etsy Return,11045.44965
39362,816094233,2-17-24 20:28,349.67,Deposit,Direct Deposit,11395.11965
39363,816094233,2-17-24 21:28,7500,Payment,Rent Payment,3895.119646
39364,816094233,2-19-24 15:28,463.46,Payment,Mortgage Payment,3431.659646
39365,816094233,2-20-24 22:28,759.33,Return,eBay Return,4190.989646
39366,816094233,2-25-24 19:28,382.69,Purchase,Restaurant,3808.299646
39367,816094233,03-02-24 10:28,934.75,Withdrawal,ATM Withdrawal,2873.549646
39368,816094233,03-04-24 21:28,13100,IncomingTransfer,Salary,15973.54965
39369,816094233,03-08-24 15:28,213.5,Withdrawal,ATM Withdrawal,15760.04965
39370,816094233,03-09-24 21:28,2000,Payment,Credit Card Payment,13760.04965
39371,816094233,3-13-24 21:28,6400,Payment,Rent Payment,7360.049646
39372,816094233,3-15-24 18:28,557.57,IncomingTransfer,Freelance Payment,7917.619646
39373,816094233,3-22-24 13:28,640.04,Payment,Bill Payment,7277.579646
39374,816094233,3-27-24 9:28,330.84,Payment,Mortgage Payment,6946.739646
39375,816094233,04-02-24 21:28,13100,IncomingTransfer,Salary,20046.73965
39376,816094233,04-07-24 21:28,1800,Payment,Credit Card Payment,18246.73965
39377,816094233,4-14-24 12:28,558.73,OutgoingTransfer,Bank Transfer,17688.00965
39378,816094233,4-15-24 21:28,3300,Payment,Rent Payment,14388.00965
39379,816094233,4-19-24 19:28,730.27,OutgoingTransfer,Wire Transfer,13657.73965
39380,816094233,4-20-24 21:28,230.86,Purchase,Furniture,13426.87965
39381,816094233,4-21-24 17:28,868.74,Payment,Mortgage Payment,12558.13965
39382,816094233,4-22-24 19:28,534.6,Deposit,Check Deposit,13092.73965
39383,816094233,4-27-24 20:28,693.86,Withdrawal,ATM Withdrawal,12398.87965
39384,816094233,05-03-24 21:28,13100,IncomingTransfer,Salary,25498.87965
39385,816094233,05-06-24 13:28,698.11,Withdrawal,Branch Withdrawal,24800.76965
39386,816094233,05-06-24 21:28,335.24,Deposit,Check Deposit,25136.00965
39387,816094233,05-08-24 21:28,1700,Payment,Credit Card Payment,23436.00965
39388,816094233,05-10-24 18:28,866.56,Purchase,Grocery,22569.44965
39389,816094233,05-12-24 11:28,461.13,OutgoingTransfer,Bank Transfer,22108.31965
39390,816094233,05-12-24 21:28,5400,Payment,Rent Payment,16708.31965
39391,816094233,5-13-24 12:28,456.49,Deposit,Check Deposit,17164.80965
39392,816094233,5-13-24 19:28,661.83,Payment,Mortgage Payment,16502.97965
39393,816094233,5-19-24 13:28,857.68,Deposit,Cash Deposit,17360.65965
39394,816094233,5-21-24 10:28,946.38,OutgoingTransfer,International Transfer,16414.27965
39395,816094233,5-27-24 22:28,678.11,OnlineShopping,Amazon,15736.16965
39396,816094233,06-01-24 21:28,13100,IncomingTransfer,Salary,28836.16965
39397,816094233,06-05-24 15:28,926.54,OnlineShopping,Best Buy,27909.62965
39398,816094233,06-06-24 21:28,1800,Payment,Credit Card Payment,26109.62965
39399,816094233,06-09-24 21:28,437.01,Purchase,Gas,25672.61965
39400,816094233,06-12-24 14:28,276.42,Purchase,Entertainment,25396.19965
39401,816094233,6-13-24 21:28,6200,Payment,Rent Payment,19196.19965
39402,816094233,6-23-24 22:28,460.95,IncomingTransfer,Freelance Payment,19657.14965
39403,816094233,6-25-24 18:28,923.01,Withdrawal,Mobile App Withdrawal,18734.13965
39404,816094233,6-27-24 20:28,510.76,OutgoingTransfer,International Transfer,18223.37965
39405,816094233,07-01-24 21:28,13100,IncomingTransfer,Salary,31323.37965
39406,816094233,07-05-24 10:28,893.07,Return,Target Return,32216.44965
39407,816094233,07-06-24 21:28,1500,Payment,Credit Card Payment,30716.44965
39408,816094233,07-12-24 22:28,808.53,OnlineShopping,eBay,29907.91965
39409,816094233,7-14-24 21:28,5200,Payment,Rent Payment,24707.91965
39410,816094233,7-17-24 18:28,213.79,Purchase,Clothing,24494.12965
39411,816094233,7-17-24 22:28,704.8,OnlineShopping,Best Buy,23789.32965
39412,816263808,1-24-24 19:28,676.68,Deposit,Check Deposit,1227.095411
39413,816263808,1-25-24 21:28,335.57,OutgoingTransfer,Wire Transfer,891.5254109
39414,816263808,02-01-24 12:28,656.76,Purchase,Pharmacy,234.7654109
39415,816263808,02-02-24 17:28,562.37,OnlineShopping,Best Buy,-327.6045891
39416,816263808,02-03-24 21:28,7850,IncomingTransfer,Salary,7522.395411
39417,816263808,02-04-24 11:28,435.31,Purchase,Travel,7087.085411
39418,816263808,02-06-24 21:28,428.67,Withdrawal,ATM Withdrawal,6658.415411
39419,816263808,02-08-24 21:28,800,Payment,Credit Card Payment,5858.415411
39420,816263808,02-08-24 23:28,192.23,IncomingTransfer,Freelance Payment,6050.645411
39421,816263808,02-09-24 11:28,498.69,Return,Walmart Return,6549.335411
39422,816263808,02-09-24 21:28,590.03,Withdrawal,Branch Withdrawal,5959.305411
39423,816263808,2-18-24 21:28,2000,Payment,Rent Payment,3959.305411
39424,816263808,2-20-24 13:28,626.06,Withdrawal,Branch Withdrawal,3333.245411
39425,816263808,2-23-24 19:28,628.07,OnlineShopping,Target,2705.175411
39426,816263808,2-26-24 19:28,148.21,Purchase,Entertainment,2556.965411
39427,816263808,2-28-24 13:28,613.7,Purchase,Entertainment,1943.265411
39428,816263808,03-02-24 11:28,520.11,Purchase,Pharmacy,1423.155411
39429,816263808,03-04-24 19:28,189.35,Payment,Loan Payment,1233.805411
39430,816263808,03-04-24 21:28,7850,IncomingTransfer,Salary,9083.805411
39431,816263808,03-05-24 15:28,658.03,OutgoingTransfer,Bank Transfer,8425.775411
39432,816263808,03-08-24 12:28,208.01,OutgoingTransfer,Wire Transfer,8217.765411
39433,816263808,03-09-24 21:28,800,Payment,Credit Card Payment,7417.765411
39434,816263808,3-13-24 17:28,632.52,Purchase,Gas,6785.245411
39435,816263808,3-14-24 21:28,2600,Payment,Rent Payment,4185.245411
39436,816263808,3-18-24 10:28,684.74,OnlineShopping,Best Buy,3500.505411
39437,816263808,3-18-24 16:28,515.39,Purchase,Electronics,2985.115411
39438,816263808,3-20-24 18:28,352.4,IncomingTransfer,Freelance Payment,3337.515411
39439,816263808,3-22-24 14:28,646.01,Deposit,Mobile Deposit,3983.525411
39440,816263808,3-26-24 13:28,440.3,Purchase,Home Improvement,3543.225411
39441,816263808,3-26-24 21:28,550.8,OnlineShopping,Target,2992.425411
39442,816263808,04-03-24 21:28,7850,IncomingTransfer,Salary,10842.42541
39443,816263808,04-06-24 14:28,434.08,Payment,Bill Payment,10408.34541
39444,816263808,04-06-24 19:28,372.68,Payment,Loan Payment,10035.66541
39445,816263808,04-06-24 21:28,571.45,OutgoingTransfer,Wire Transfer,9464.215411
39446,816263808,04-06-24 22:28,594.25,Withdrawal,ATM Withdrawal,8869.965411
39447,816263808,04-07-24 13:28,386.06,Withdrawal,Branch Withdrawal,8483.905411
39448,816263808,04-08-24 21:28,900,Payment,Credit Card Payment,7583.905411
39449,816263808,04-10-24 11:28,442.31,Deposit,Direct Deposit,8026.215411
39450,816263808,4-13-24 14:28,392.43,Return,eBay Return,8418.645411
39451,816263808,4-13-24 19:28,391.8,Purchase,Furniture,8026.845411
39452,816263808,4-16-24 21:28,3800,Payment,Rent Payment,4226.845411
39453,816263808,4-22-24 11:28,505.39,Payment,Mortgage Payment,3721.455411
39454,816263808,4-26-24 19:28,327.46,Payment,Bill Payment,3393.995411
39455,816263808,4-27-24 22:28,562.5,Deposit,Check Deposit,3956.495411
39456,816263808,05-04-24 17:28,719.84,Deposit,Mobile Deposit,4676.335411
39457,816263808,05-05-24 21:28,7850,IncomingTransfer,Salary,12526.33541
39458,816263808,05-10-24 21:28,800,Payment,Credit Card Payment,11726.33541
39459,816263808,05-11-24 21:28,2900,Payment,Rent Payment,8826.335411
39460,816263808,5-15-24 9:28,731.83,Purchase,Gas,8094.505411
39461,816263808,5-27-24 16:28,474.95,Return,Best Buy Return,8569.455411
39462,816263808,5-29-24 13:28,698.21,Withdrawal,ATM Withdrawal,7871.245411
39463,816263808,5-31-24 11:28,129.25,Deposit,Direct Deposit,8000.495411
39464,816263808,06-03-24 16:28,351.58,Withdrawal,ATM Withdrawal,7648.915411
39465,816263808,06-04-24 21:28,7850,IncomingTransfer,Salary,15498.91541
39466,816263808,06-06-24 13:28,443.17,Return,Walmart Return,15942.08541
39467,816263808,06-07-24 12:28,471.72,OnlineShopping,eBay,15470.36541
39468,816263808,06-09-24 21:28,1100,Payment,Credit Card Payment,14370.36541
39469,816263808,06-10-24 9:28,573.58,Deposit,Mobile Deposit,14943.94541
39470,816263808,06-12-24 21:28,2600,Payment,Rent Payment,12343.94541
39471,816263808,6-15-24 21:28,569.41,Purchase,Furniture,11774.53541
39472,816263808,6-17-24 15:28,459.92,OnlineShopping,AliExpress,11314.61541
39473,816263808,6-28-24 13:28,718.7,OnlineShopping,AliExpress,10595.91541
39474,816263808,6-30-24 18:28,713.7,Deposit,Mobile Deposit,11309.61541
39475,816263808,07-02-24 9:28,529.5,Deposit,Check Deposit,11839.11541
39476,816263808,07-04-24 11:28,581.52,Purchase,Restaurant,11257.59541
39477,816263808,07-04-24 21:28,568.37,Purchase,Travel,10689.22541
39478,816263808,07-05-24 21:28,7850,IncomingTransfer,Salary,18539.22541
39479,816263808,07-07-24 19:28,289.17,Return,AliExpress Return,18828.39541
39480,816263808,07-10-24 21:28,1000,Payment,Credit Card Payment,17828.39541
39481,816263808,07-12-24 9:28,257.06,Withdrawal,ATM Withdrawal,17571.33541
39482,816263808,07-12-24 13:28,150.61,Deposit,Cash Deposit,17721.94541
39483,816263808,7-15-24 15:28,281.09,Deposit,Mobile Deposit,18003.03541
39484,816263808,7-16-24 20:28,473.05,Deposit,Cash Deposit,18476.08541
39485,816263808,7-17-24 21:28,4400,Payment,Rent Payment,14076.08541
39486,816378033,1-22-24 23:28,656.83,Payment,Mortgage Payment,197.1134247
39487,816378033,02-05-24 21:28,7100,IncomingTransfer,Salary,7297.113425
39488,816378033,02-08-24 16:28,514.82,Deposit,Check Deposit,7811.933425
39489,816378033,02-09-24 14:28,448.11,Deposit,Cash Deposit,8260.043425
39490,816378033,02-10-24 10:28,714.39,Deposit,Direct Deposit,8974.433425
39491,816378033,02-10-24 21:28,1200,Payment,Credit Card Payment,7774.433425
39492,816378033,2-13-24 20:28,462.51,OnlineShopping,Walmart,7311.923425
39493,816378033,2-14-24 16:28,422.95,IncomingTransfer,Freelance Payment,7734.873425
39494,816378033,2-16-24 21:28,2500,Payment,Rent Payment,5234.873425
39495,816378033,2-21-24 13:28,688.34,Withdrawal,Branch Withdrawal,4546.533425
39496,816378033,2-28-24 18:28,511.42,Deposit,Check Deposit,5057.953425
39497,816378033,03-03-24 20:28,263.86,Payment,Mortgage Payment,4794.093425
39498,816378033,03-04-24 21:28,7100,IncomingTransfer,Salary,11894.09342
39499,816378033,03-09-24 21:28,1500,Payment,Credit Card Payment,10394.09342
39500,816378033,03-10-24 15:28,518.6,OnlineShopping,AliExpress,9875.493425
39501,816378033,3-14-24 21:28,2300,Payment,Rent Payment,7575.493425
39502,816378033,3-15-24 10:28,151.28,OutgoingTransfer,Wire Transfer,7424.213425
39503,816378033,3-22-24 16:28,605.59,Purchase,Gas,6818.623425
39504,816378033,3-26-24 15:28,143.21,Deposit,Mobile Deposit,6961.833425
39505,816378033,3-27-24 11:28,123.96,OutgoingTransfer,International Transfer,6837.873425
39506,816378033,3-29-24 14:28,136.73,Withdrawal,Mobile App Withdrawal,6701.143425
39507,816378033,04-04-24 21:28,7100,IncomingTransfer,Salary,13801.14342
39508,816378033,04-04-24 21:28,491.5,Withdrawal,Mobile App Withdrawal,13309.64342
39509,816378033,04-09-24 12:28,682.83,Deposit,Mobile Deposit,13992.47342
39510,816378033,04-09-24 21:28,1300,Payment,Credit Card Payment,12692.47342
39511,816378033,04-11-24 21:28,1900,Payment,Rent Payment,10792.47342
39512,816378033,4-18-24 9:28,653.9,Deposit,Cash Deposit,11446.37342
39513,816378033,4-20-24 13:28,675.22,IncomingTransfer,Freelance Payment,12121.59342
39514,816378033,4-22-24 20:28,387.01,Purchase,Home Improvement,11734.58342
39515,816378033,4-24-24 14:28,294.37,Withdrawal,ATM Withdrawal,11440.21342
39516,816378033,4-28-24 11:28,366.41,Deposit,Cash Deposit,11806.62342
39517,816378033,4-30-24 16:28,383.52,Purchase,Entertainment,11423.10342
39518,816378033,05-03-24 21:28,7100,IncomingTransfer,Salary,18523.10342
39519,816378033,05-04-24 19:28,154.35,Purchase,Restaurant,18368.75342
39520,816378033,05-08-24 21:28,1600,Payment,Credit Card Payment,16768.75342
39521,816378033,05-10-24 23:28,239.51,Deposit,Mobile Deposit,17008.26342
39522,816378033,05-12-24 10:28,429.61,Return,Etsy Return,17437.87342
39523,816378033,5-13-24 21:28,4000,Payment,Rent Payment,13437.87342
39524,816378033,5-20-24 17:28,338.17,Deposit,Direct Deposit,13776.04342
39525,816378033,5-22-24 9:28,113.74,OutgoingTransfer,International Transfer,13662.30342
39526,816378033,06-02-24 19:28,150.19,Purchase,Travel,13512.11342
39527,816378033,06-04-24 21:28,7100,IncomingTransfer,Salary,20612.11342
39528,816378033,06-06-24 9:28,350.48,OutgoingTransfer,Peer-to-Peer Transfer,20261.63342
39529,816378033,06-06-24 10:28,450.45,Purchase,Electronics,19811.18342
39530,816378033,06-09-24 21:28,1200,Payment,Credit Card Payment,18611.18342
39531,816378033,6-13-24 21:28,2800,Payment,Rent Payment,15811.18342
39532,816378033,6-14-24 20:28,388.36,Withdrawal,ATM Withdrawal,15422.82342
39533,816378033,6-15-24 15:28,532.47,Payment,Bill Payment,14890.35342
39534,816378033,6-15-24 19:28,361.79,Deposit,Cash Deposit,15252.14342
39535,816378033,6-15-24 20:28,548.7,OutgoingTransfer,Bank Transfer,14703.44342
39536,816378033,6-20-24 13:28,692.26,OutgoingTransfer,Peer-to-Peer Transfer,14011.18342
39537,816378033,6-22-24 20:28,381.97,IncomingTransfer,Freelance Payment,14393.15342
39538,816378033,6-25-24 16:28,255.64,Purchase,Entertainment,14137.51342
39539,816378033,6-25-24 23:28,509.19,Withdrawal,ATM Withdrawal,13628.32342
39540,816378033,6-29-24 15:28,683.47,Deposit,Cash Deposit,14311.79342
39541,816378033,07-02-24 21:28,506.2,Return,Store Return,14817.99342
39542,816378033,07-03-24 19:28,387.91,Withdrawal,ATM Withdrawal,14430.08342
39543,816378033,07-04-24 21:28,679.48,Deposit,Cash Deposit,15109.56342
39544,816378033,07-05-24 21:28,7100,IncomingTransfer,Salary,22209.56342
39545,816378033,07-10-24 21:28,1100,Payment,Credit Card Payment,21109.56342
39546,816378033,07-11-24 11:28,542.79,Purchase,Home Improvement,20566.77342
39547,816378033,07-11-24 22:28,241.1,Purchase,Gas,20325.67342
39548,816378033,07-11-24 22:28,426.73,Purchase,Clothing,19898.94342
39549,816378033,7-14-24 19:28,233.17,Withdrawal,ATM Withdrawal,19665.77342
39550,816378033,7-18-24 21:28,3500,Payment,Rent Payment,16165.77342
39551,816549933,1-23-24 10:28,276.42,Purchase,Entertainment,270.7180583
39552,816549933,1-23-24 13:28,665.44,Purchase,Grocery,-394.7219417
39553,816549933,1-24-24 21:28,230.93,Withdrawal,Branch Withdrawal,-625.6519417
39554,816549933,1-27-24 20:28,568.83,Return,AliExpress Return,-56.82194175
39555,816549933,1-28-24 17:28,325.08,Deposit,Direct Deposit,268.2580583
39556,816549933,1-31-24 13:28,119.91,Deposit,Direct Deposit,388.1680583
39557,816549933,1-31-24 19:28,482.7,Return,Best Buy Return,870.8680583
39558,816549933,02-02-24 21:28,8000,IncomingTransfer,Salary,8870.868058
39559,816549933,02-03-24 15:28,164.53,Purchase,Pharmacy,8706.338058
39560,816549933,02-03-24 22:28,324.77,IncomingTransfer,Freelance Payment,9031.108058
39561,816549933,02-04-24 16:28,249.99,Withdrawal,Mobile App Withdrawal,8781.118058
39562,816549933,02-07-24 21:28,1400,Payment,Credit Card Payment,7381.118058
39563,816549933,02-08-24 23:28,618.88,Withdrawal,Mobile App Withdrawal,6762.238058
39564,816549933,02-11-24 21:28,3700,Payment,Rent Payment,3062.238058
39565,816549933,2-16-24 9:28,210.01,OutgoingTransfer,Peer-to-Peer Transfer,2852.228058
39566,816549933,2-17-24 13:28,339.17,Deposit,Direct Deposit,3191.398058
39567,816549933,2-20-24 10:28,612,Deposit,Direct Deposit,3803.398058
39568,816549933,2-21-24 9:28,390.69,IncomingTransfer,Freelance Payment,4194.088058
39569,816549933,2-22-24 22:28,124.95,Withdrawal,Mobile App Withdrawal,4069.138058
39570,816549933,2-26-24 14:28,431.97,OnlineShopping,Target,3637.168058
39571,816549933,2-29-24 12:28,529.52,Return,Amazon Return,4166.688058
39572,816549933,03-04-24 21:28,8000,IncomingTransfer,Salary,12166.68806
39573,816549933,03-09-24 17:28,478.92,Deposit,Mobile Deposit,12645.60806
39574,816549933,03-09-24 21:28,1400,Payment,Credit Card Payment,11245.60806
39575,816549933,03-12-24 21:28,266.9,Return,Target Return,11512.50806
39576,816549933,3-13-24 18:28,272.7,Purchase,Electronics,11239.80806
39577,816549933,3-14-24 21:28,3100,Payment,Rent Payment,8139.808058
39578,816549933,3-15-24 17:28,449.75,Deposit,Direct Deposit,8589.558058
39579,816549933,3-15-24 22:28,615.12,OnlineShopping,Walmart,7974.438058
39580,816549933,3-16-24 16:28,469.55,Withdrawal,Branch Withdrawal,7504.888058
39581,816549933,3-16-24 19:28,647.83,Return,Walmart Return,8152.718058
39582,816549933,3-18-24 9:28,732.09,Purchase,Travel,7420.628058
39583,816549933,3-19-24 11:28,628.38,Payment,Loan Payment,6792.248058
39584,816549933,3-23-24 13:28,477.28,Purchase,Pharmacy,6314.968058
39585,816549933,3-23-24 19:28,509.69,Purchase,Pharmacy,5805.278058
39586,816549933,3-27-24 9:28,492.18,Withdrawal,ATM Withdrawal,5313.098058
39587,816549933,3-28-24 10:28,428.14,Deposit,Check Deposit,5741.238058
39588,816549933,3-29-24 23:28,343.26,Withdrawal,Branch Withdrawal,5397.978058
39589,816549933,3-30-24 17:28,301.91,Return,Etsy Return,5699.888058
39590,816549933,04-01-24 17:28,339.8,Withdrawal,ATM Withdrawal,5360.088058
39591,816549933,04-02-24 14:28,331.26,Deposit,Check Deposit,5691.348058
39592,816549933,04-02-24 21:28,8000,IncomingTransfer,Salary,13691.34806
39593,816549933,04-06-24 13:28,619.93,Withdrawal,ATM Withdrawal,13071.41806
39594,816549933,04-06-24 19:28,702.92,OutgoingTransfer,International Transfer,12368.49806
39595,816549933,04-07-24 10:28,251.85,Withdrawal,Branch Withdrawal,12116.64806
39596,816549933,04-07-24 21:28,1000,Payment,Credit Card Payment,11116.64806
39597,816549933,04-07-24 21:28,300.83,IncomingTransfer,Freelance Payment,11417.47806
39598,816549933,04-11-24 21:28,4900,Payment,Rent Payment,6517.478058
39599,816549933,04-12-24 9:28,553.22,IncomingTransfer,Freelance Payment,7070.698058
39600,816549933,04-12-24 20:28,262.19,Return,AliExpress Return,7332.888058
39601,816549933,4-13-24 18:28,689.23,Purchase,Furniture,6643.658058
39602,816549933,4-14-24 20:28,219.08,Purchase,Gas,6424.578058
39603,816549933,4-15-24 10:28,572.14,Withdrawal,Mobile App Withdrawal,5852.438058
39604,816549933,4-15-24 17:28,467.17,Payment,Loan Payment,5385.268058
39605,816549933,4-21-24 20:28,516.81,Payment,Bill Payment,4868.458058
39606,816549933,4-23-24 14:28,335.7,Purchase,Pharmacy,4532.758058
39607,816549933,4-23-24 19:28,684.93,Deposit,Cash Deposit,5217.688058
39608,816549933,4-26-24 20:28,537.64,Payment,Loan Payment,4680.048058
39609,816549933,05-02-24 20:28,414.13,Purchase,Home Improvement,4265.918058
39610,816549933,05-05-24 13:28,701.89,Deposit,Direct Deposit,4967.808058
39611,816549933,05-05-24 21:28,8000,IncomingTransfer,Salary,12967.80806
39612,816549933,05-10-24 21:28,1400,Payment,Credit Card Payment,11567.80806
39613,816549933,05-12-24 11:28,588.62,Deposit,Direct Deposit,12156.42806
39614,816549933,05-12-24 16:28,105.69,Return,eBay Return,12262.11806
39615,816549933,5-13-24 11:28,297.55,Purchase,Pharmacy,11964.56806
39616,816549933,5-13-24 21:28,3500,Payment,Rent Payment,8464.568058
39617,816549933,5-15-24 12:28,689.6,Withdrawal,ATM Withdrawal,7774.968058
39618,816549933,5-17-24 13:28,353.19,Deposit,Mobile Deposit,8128.158058
39619,816549933,5-17-24 15:28,334.71,Purchase,Grocery,7793.448058
39620,816549933,5-18-24 14:28,183.12,Payment,Bill Payment,7610.328058
39621,816549933,5-21-24 19:28,244.54,Withdrawal,Mobile App Withdrawal,7365.788058
39622,816549933,5-22-24 12:28,299.16,Payment,Bill Payment,7066.628058
39623,816549933,5-22-24 16:28,256.59,Deposit,Mobile Deposit,7323.218058
39624,816549933,5-27-24 16:28,187.49,Withdrawal,ATM Withdrawal,7135.728058
39625,816549933,5-29-24 16:28,250.5,OutgoingTransfer,Bank Transfer,6885.228058
39626,816549933,5-29-24 22:28,562.32,OutgoingTransfer,International Transfer,6322.908058
39627,816549933,06-01-24 19:28,340.12,Withdrawal,Mobile App Withdrawal,5982.788058
39628,816549933,06-04-24 21:28,8000,IncomingTransfer,Salary,13982.78806
39629,816549933,06-06-24 22:28,529.51,OutgoingTransfer,Wire Transfer,13453.27806
39630,816549933,06-09-24 21:28,1500,Payment,Credit Card Payment,11953.27806
39631,816549933,06-10-24 12:28,512.28,Purchase,Restaurant,11440.99806
39632,816549933,06-10-24 21:28,5000,Payment,Rent Payment,6440.998058
39633,816549933,6-16-24 11:28,429.73,Return,Amazon Return,6870.728058
39634,816549933,6-20-24 10:28,667.75,OutgoingTransfer,Bank Transfer,6202.978058
39635,816549933,6-21-24 10:28,183.79,Return,Store Return,6386.768058
39636,816549933,6-27-24 21:28,398.12,OutgoingTransfer,Wire Transfer,5988.648058
39637,816549933,6-29-24 13:28,322.29,Deposit,Direct Deposit,6310.938058
39638,816549933,07-01-24 11:28,372.08,Deposit,Direct Deposit,6683.018058
39639,816549933,07-02-24 21:28,8000,IncomingTransfer,Salary,14683.01806
39640,816549933,07-04-24 15:28,111.07,Purchase,Entertainment,14571.94806
39641,816549933,07-07-24 19:28,706.73,Deposit,Direct Deposit,15278.67806
39642,816549933,07-07-24 21:28,1300,Payment,Credit Card Payment,13978.67806
39643,816549933,07-08-24 17:28,235.19,Withdrawal,ATM Withdrawal,13743.48806
39644,816549933,07-10-24 12:28,182.64,Deposit,Cash Deposit,13926.12806
39645,816549933,07-11-24 9:28,666.77,Deposit,Direct Deposit,14592.89806
39646,816549933,07-11-24 14:28,516.51,Withdrawal,Mobile App Withdrawal,14076.38806
39647,816549933,07-12-24 20:28,616.09,Deposit,Mobile Deposit,14692.47806
39648,816549933,7-15-24 23:28,336.26,Deposit,Mobile Deposit,15028.73806
39649,816549933,7-17-24 23:28,694.16,Deposit,Direct Deposit,15722.89806
39650,816549933,7-18-24 21:28,2400,Payment,Rent Payment,13322.89806
39651,817958733,1-23-24 18:28,102.28,Withdrawal,Branch Withdrawal,689.9069792
39652,817958733,1-26-24 10:28,366.23,Withdrawal,Branch Withdrawal,323.6769792
39653,817958733,02-01-24 20:28,388.42,Payment,Mortgage Payment,-64.74302082
39654,817958733,02-01-24 21:28,3800,IncomingTransfer,Salary,3735.256979
39655,817958733,02-03-24 20:28,223.8,Withdrawal,Mobile App Withdrawal,3511.456979
39656,817958733,02-04-24 19:28,463.85,Withdrawal,Mobile App Withdrawal,3047.606979
39657,817958733,02-06-24 21:28,1100,Payment,Credit Card Payment,1947.606979
39658,817958733,02-07-24 23:28,297.15,OutgoingTransfer,Wire Transfer,1650.456979
39659,817958733,2-14-24 14:28,86.89,Payment,Mortgage Payment,1563.566979
39660,817958733,2-14-24 21:28,1300,Payment,Rent Payment,263.5669792
39661,817958733,2-19-24 22:28,30.18,Deposit,Check Deposit,293.7469792
39662,817958733,2-21-24 9:28,231.68,Purchase,Home Improvement,62.06697918
39663,817958733,2-21-24 10:28,381.38,IncomingTransfer,Freelance Payment,443.4469792
39664,817958733,2-21-24 21:28,57.22,Deposit,Cash Deposit,500.6669792
39665,817958733,2-23-24 9:28,490.28,Purchase,Gas,10.38697918
39666,817958733,2-23-24 20:28,39.54,Deposit,Mobile Deposit,49.92697918
39667,817958733,2-25-24 10:28,349.74,OutgoingTransfer,Wire Transfer,-299.8130208
39668,817958733,03-01-24 19:28,313.88,Purchase,Clothing,-613.6930208
39669,817958733,03-04-24 18:28,459.55,OutgoingTransfer,International Transfer,-1073.243021
39670,817958733,03-05-24 21:28,3800,IncomingTransfer,Salary,2726.756979
39671,817958733,03-09-24 21:28,466.33,Deposit,Direct Deposit,3193.086979
39672,817958733,03-10-24 21:28,1000,Payment,Credit Card Payment,2193.086979
39673,817958733,3-14-24 21:28,1200,Payment,Rent Payment,993.0869792
39674,817958733,3-15-24 10:28,422.24,Purchase,Restaurant,570.8469792
39675,817958733,3-28-24 21:28,59.73,OutgoingTransfer,International Transfer,511.1169792
39676,817958733,3-29-24 10:28,222.28,Purchase,Home Improvement,288.8369792
39677,817958733,3-30-24 11:28,80.16,IncomingTransfer,Freelance Payment,368.9969792
39678,817958733,04-02-24 9:28,404.26,IncomingTransfer,Freelance Payment,773.2569792
39679,817958733,04-02-24 13:28,215.75,Purchase,Home Improvement,557.5069792
39680,817958733,04-04-24 21:28,3800,IncomingTransfer,Salary,4357.506979
39681,817958733,04-07-24 11:28,340.99,Payment,Bill Payment,4016.516979
39682,817958733,04-07-24 16:28,445.87,Withdrawal,Mobile App Withdrawal,3570.646979
39683,817958733,04-08-24 12:28,407.31,Deposit,Cash Deposit,3977.956979
39684,817958733,04-08-24 16:28,89.89,OutgoingTransfer,Wire Transfer,3888.066979
39685,817958733,04-09-24 21:28,1000,Payment,Credit Card Payment,2888.066979
39686,817958733,04-10-24 21:28,1900,Payment,Rent Payment,988.0669792
39687,817958733,04-10-24 22:28,247.12,Deposit,Cash Deposit,1235.186979
39688,817958733,04-11-24 11:28,14.41,Deposit,Check Deposit,1249.596979
39689,817958733,4-14-24 17:28,77.58,Payment,Mortgage Payment,1172.016979
39690,817958733,4-15-24 22:28,158.4,Payment,Mortgage Payment,1013.616979
39691,817958733,4-17-24 9:28,496.34,Deposit,Direct Deposit,1509.956979
39692,817958733,4-19-24 22:28,471.07,Deposit,Mobile Deposit,1981.026979
39693,817958733,4-23-24 9:28,234.48,Payment,Mortgage Payment,1746.546979
39694,817958733,4-23-24 18:28,251.36,Deposit,Mobile Deposit,1997.906979
39695,817958733,4-25-24 9:28,38.3,Purchase,Clothing,1959.606979
39696,817958733,4-26-24 16:28,266.71,Deposit,Direct Deposit,2226.316979
39697,817958733,4-26-24 17:28,399.98,Deposit,Cash Deposit,2626.296979
39698,817958733,4-30-24 18:28,476.6,Withdrawal,Mobile App Withdrawal,2149.696979
39699,817958733,05-02-24 21:28,3800,IncomingTransfer,Salary,5949.696979
39700,817958733,05-03-24 21:28,401.44,Deposit,Mobile Deposit,6351.136979
39701,817958733,05-03-24 21:28,203.25,Withdrawal,Mobile App Withdrawal,6147.886979
39702,817958733,05-05-24 18:28,147.44,OnlineShopping,Best Buy,6000.446979
39703,817958733,05-06-24 21:28,317.77,Payment,Bill Payment,5682.676979
39704,817958733,05-07-24 21:28,1400,Payment,Credit Card Payment,4282.676979
39705,817958733,05-08-24 18:28,259.19,OutgoingTransfer,Bank Transfer,4023.486979
39706,817958733,05-10-24 21:28,494.88,Payment,Loan Payment,3528.606979
39707,817958733,05-12-24 10:28,301.54,Deposit,Cash Deposit,3830.146979
39708,817958733,05-12-24 18:28,323.27,Purchase,Travel,3506.876979
39709,817958733,5-13-24 12:28,278.58,Withdrawal,Branch Withdrawal,3228.296979
39710,817958733,5-14-24 13:28,88.8,Return,Best Buy Return,3317.096979
39711,817958733,5-15-24 10:28,84.79,OnlineShopping,Etsy,3232.306979
39712,817958733,5-15-24 21:28,2000,Payment,Rent Payment,1232.306979
39713,817958733,5-18-24 21:28,227.32,Purchase,Gas,1004.986979
39714,817958733,5-21-24 19:28,85.19,Deposit,Check Deposit,1090.176979
39715,817958733,5-23-24 10:28,483.19,Return,Store Return,1573.366979
39716,817958733,5-28-24 19:28,92.21,Withdrawal,Branch Withdrawal,1481.156979
39717,817958733,5-28-24 20:28,244.76,Deposit,Mobile Deposit,1725.916979
39718,817958733,06-02-24 21:28,3800,IncomingTransfer,Salary,5525.916979
39719,817958733,06-03-24 20:28,156.08,OutgoingTransfer,International Transfer,5369.836979
39720,817958733,06-07-24 21:28,1400,Payment,Credit Card Payment,3969.836979
39721,817958733,06-10-24 17:28,471.07,Purchase,Furniture,3498.766979
39722,817958733,06-11-24 23:28,133.18,OnlineShopping,Best Buy,3365.586979
39723,817958733,06-12-24 21:28,1700,Payment,Rent Payment,1665.586979
39724,817958733,6-14-24 12:28,471.87,OnlineShopping,eBay,1193.716979
39725,817958733,6-22-24 13:28,220.63,Purchase,Home Improvement,973.0869792
39726,817958733,6-23-24 16:28,362.22,OnlineShopping,Etsy,610.8669792
39727,817958733,6-26-24 18:28,388.92,Withdrawal,Mobile App Withdrawal,221.9469792
39728,817958733,6-28-24 19:28,426.2,Withdrawal,Branch Withdrawal,-204.2530208
39729,817958733,07-02-24 11:28,399.13,OnlineShopping,AliExpress,-603.3830208
39730,817958733,07-02-24 18:28,86.39,Return,Walmart Return,-516.9930208
39731,817958733,07-04-24 11:28,490,Payment,Loan Payment,-1006.993021
39732,817958733,07-04-24 14:28,49.38,OutgoingTransfer,Peer-to-Peer Transfer,-1056.373021
39733,817958733,07-04-24 16:28,131.47,Payment,Loan Payment,-1187.843021
39734,817958733,07-05-24 21:28,3800,IncomingTransfer,Salary,2612.156979
39735,817958733,07-07-24 11:28,186.95,OutgoingTransfer,Bank Transfer,2425.206979
39736,817958733,07-07-24 20:28,410.9,Payment,Loan Payment,2014.306979
39737,817958733,07-10-24 21:28,1000,Payment,Credit Card Payment,1014.306979
39738,817958733,07-11-24 20:28,219.87,Withdrawal,ATM Withdrawal,794.4369792
39739,817958733,07-12-24 22:28,267.66,Deposit,Check Deposit,1062.096979
39740,817958733,7-13-24 21:28,1200,Payment,Rent Payment,-137.9030208
39741,817958733,7-15-24 16:28,74.05,Deposit,Mobile Deposit,-63.85302082
39742,818007783,1-21-24 10:28,361.87,Purchase,Grocery,793.9714946
39743,818007783,1-22-24 12:28,83.27,Withdrawal,ATM Withdrawal,710.7014946
39744,818007783,1-26-24 16:28,108.92,Withdrawal,Branch Withdrawal,601.7814946
39745,818007783,1-26-24 23:28,156.66,Payment,Bill Payment,445.1214946
39746,818007783,1-26-24 23:28,129.73,Deposit,Check Deposit,574.8514946
39747,818007783,1-27-24 12:28,236.53,Payment,Bill Payment,338.3214946
39748,818007783,1-28-24 22:28,224.08,Purchase,Travel,114.2414946
39749,818007783,1-29-24 18:28,27.69,OnlineShopping,Best Buy,86.55149464
39750,818007783,1-31-24 15:28,61.62,Purchase,Entertainment,24.93149464
39751,818007783,02-01-24 15:28,275.79,Deposit,Direct Deposit,300.7214946
39752,818007783,02-01-24 17:28,256.67,Deposit,Check Deposit,557.3914946
39753,818007783,02-03-24 21:28,3600,IncomingTransfer,Salary,4157.391495
39754,818007783,02-06-24 12:28,368.59,Purchase,Pharmacy,3788.801495
39755,818007783,02-08-24 21:28,2000,Payment,Credit Card Payment,1788.801495
39756,818007783,02-09-24 11:28,244.88,Return,Target Return,2033.681495
39757,818007783,02-09-24 18:28,211.84,Purchase,Restaurant,1821.841495
39758,818007783,02-10-24 17:28,127.28,IncomingTransfer,Freelance Payment,1949.121495
39759,818007783,02-11-24 12:28,258.24,Deposit,Mobile Deposit,2207.361495
39760,818007783,2-13-24 16:28,178.84,OutgoingTransfer,Peer-to-Peer Transfer,2028.521495
39761,818007783,2-13-24 21:28,1100,Payment,Insurance Payment,928.5214946
39762,818007783,2-14-24 17:28,227.03,Deposit,Direct Deposit,1155.551495
39763,818007783,2-15-24 11:28,384.16,Return,Amazon Return,1539.711495
39764,818007783,2-15-24 21:28,163.45,Purchase,Furniture,1376.261495
39765,818007783,2-18-24 12:28,379.83,Payment,Mortgage Payment,996.4314946
39766,818007783,2-22-24 10:28,175.7,Payment,Bill Payment,820.7314946
39767,818007783,2-23-24 10:28,156.67,OnlineShopping,Walmart,664.0614946
39768,818007783,2-23-24 19:28,333.01,Deposit,Mobile Deposit,997.0714946
39769,818007783,2-28-24 20:28,109.13,IncomingTransfer,Freelance Payment,1106.201495
39770,818007783,2-29-24 12:28,342.33,IncomingTransfer,Freelance Payment,1448.531495
39771,818007783,03-02-24 16:28,57.86,Purchase,Furniture,1390.671495
39772,818007783,03-04-24 21:28,3600,IncomingTransfer,Salary,4990.671495
39773,818007783,03-06-24 14:28,143.78,OutgoingTransfer,Bank Transfer,4846.891495
39774,818007783,03-09-24 21:28,1800,Payment,Credit Card Payment,3046.891495
39775,818007783,03-10-24 21:28,1400,Payment,Installment Payment,1646.891495
39776,818007783,3-14-24 18:28,34.76,Return,AliExpress Return,1681.651495
39777,818007783,3-15-24 9:28,293.98,Purchase,Clothing,1387.671495
39778,818007783,3-17-24 15:28,275.12,OutgoingTransfer,Bank Transfer,1112.551495
39779,818007783,3-24-24 15:28,380.33,Deposit,Check Deposit,1492.881495
39780,818007783,3-25-24 9:28,115.37,Return,Walmart Return,1608.251495
39781,818007783,3-26-24 12:28,336.93,Deposit,Direct Deposit,1945.181495
39782,818007783,04-03-24 21:28,3600,IncomingTransfer,Salary,5545.181495
39783,818007783,04-06-24 10:28,103.33,Return,Best Buy Return,5648.511495
39784,818007783,04-08-24 21:28,2300,Payment,Credit Card Payment,3348.511495
39785,818007783,04-10-24 9:28,174.73,OutgoingTransfer,Peer-to-Peer Transfer,3173.781495
39786,818007783,04-10-24 14:28,169.94,Deposit,Mobile Deposit,3343.721495
39787,818007783,4-13-24 10:28,174.63,Purchase,Grocery,3169.091495
39788,818007783,4-14-24 21:28,1300,Payment,Installment Payment,1869.091495
39789,818007783,4-15-24 10:28,313.47,Return,eBay Return,2182.561495
39790,818007783,4-21-24 11:28,138.69,Payment,Bill Payment,2043.871495
39791,818007783,4-22-24 15:28,143.57,Payment,Loan Payment,1900.301495
39792,818007783,4-23-24 11:28,356.37,Purchase,Pharmacy,1543.931495
39793,818007783,4-23-24 15:28,206.64,IncomingTransfer,Freelance Payment,1750.571495
39794,818007783,4-24-24 15:28,134.85,Deposit,Mobile Deposit,1885.421495
39795,818007783,4-26-24 21:28,170.78,Purchase,Electronics,1714.641495
39796,818007783,4-26-24 23:28,84.92,OnlineShopping,eBay,1629.721495
39797,818007783,4-27-24 14:28,231.53,Withdrawal,Branch Withdrawal,1398.191495
39798,818007783,4-27-24 19:28,335.93,Purchase,Furniture,1062.261495
39799,818007783,4-28-24 18:28,305.01,Payment,Mortgage Payment,757.2514946
39800,818007783,05-04-24 18:28,385.11,Purchase,Gas,372.1414946
39801,818007783,05-04-24 21:28,3600,IncomingTransfer,Salary,3972.141495
39802,818007783,05-07-24 17:28,388.46,Purchase,Home Improvement,3583.681495
39803,818007783,05-09-24 21:28,1800,Payment,Credit Card Payment,1783.681495
39804,818007783,05-11-24 15:28,57.56,Withdrawal,Mobile App Withdrawal,1726.121495
39805,818007783,05-11-24 19:28,397.51,Withdrawal,Branch Withdrawal,1328.611495
39806,818007783,05-12-24 13:28,311.33,OnlineShopping,Walmart,1017.281495
39807,818007783,5-14-24 13:28,353.12,Purchase,Electronics,664.1614946
39808,818007783,5-14-24 21:28,1400,Payment,Installment Payment,-735.8385054
39809,818007783,5-15-24 19:28,398.31,Payment,Loan Payment,-1134.148505
39810,818007783,5-15-24 20:28,263.94,Deposit,Mobile Deposit,-870.2085054
39811,818007783,5-16-24 13:28,49.12,Deposit,Check Deposit,-821.0885054
39812,818007783,5-17-24 13:28,89.02,Withdrawal,ATM Withdrawal,-910.1085054
39813,818007783,5-18-24 15:28,59.87,Deposit,Mobile Deposit,-850.2385054
39814,818007783,5-19-24 12:28,278.8,Purchase,Home Improvement,-1129.038505
39815,818007783,5-20-24 17:28,276.57,Deposit,Direct Deposit,-852.4685054
39816,818007783,5-21-24 21:28,244,Payment,Mortgage Payment,-1096.468505
39817,818007783,5-22-24 22:28,277.8,IncomingTransfer,Freelance Payment,-818.6685054
39818,818007783,5-25-24 17:28,243,IncomingTransfer,Freelance Payment,-575.6685054
39819,818007783,5-29-24 16:28,181.28,Withdrawal,Branch Withdrawal,-756.9485054
39820,818007783,5-30-24 10:28,258.45,OnlineShopping,Target,-1015.398505
39821,818007783,06-01-24 21:28,291.43,OutgoingTransfer,Bank Transfer,-1306.828505
39822,818007783,06-02-24 21:28,3600,IncomingTransfer,Salary,2293.171495
39823,818007783,06-03-24 11:28,390.74,Purchase,Travel,1902.431495
39824,818007783,06-03-24 14:28,195.85,Withdrawal,ATM Withdrawal,1706.581495
39825,818007783,06-03-24 15:28,239.27,Return,eBay Return,1945.851495
39826,818007783,06-06-24 14:28,369.96,Deposit,Mobile Deposit,2315.811495
39827,818007783,06-06-24 17:28,172.09,OutgoingTransfer,International Transfer,2143.721495
39828,818007783,06-07-24 21:28,2300,Payment,Credit Card Payment,-156.2785054
39829,818007783,06-08-24 15:28,49.62,Purchase,Restaurant,-205.8985054
39830,818007783,06-08-24 22:28,175.25,Payment,Mortgage Payment,-381.1485054
39831,818007783,06-11-24 23:28,391.82,OutgoingTransfer,International Transfer,-772.9685054
39832,818007783,6-13-24 14:28,119.09,Payment,Loan Payment,-892.0585054
39833,818007783,6-13-24 21:28,900,Payment,Insurance Payment,-1792.058505
39834,818007783,6-15-24 17:28,310.75,OutgoingTransfer,International Transfer,-2102.808505
39835,818007783,6-15-24 22:28,259.91,Purchase,Grocery,-2362.718505
39836,818007783,6-19-24 9:28,188.62,Return,Store Return,-2174.098505
39837,818007783,6-19-24 17:28,93.73,Return,Target Return,-2080.368505
39838,818007783,6-20-24 10:28,23.23,Withdrawal,Mobile App Withdrawal,-2103.598505
39839,818007783,6-24-24 12:28,174.54,Purchase,Entertainment,-2278.138505
39840,818007783,6-24-24 14:28,54.36,Purchase,Home Improvement,-2332.498505
39841,818007783,6-29-24 18:28,168.23,Deposit,Cash Deposit,-2164.268505
39842,818007783,07-03-24 21:28,3600,IncomingTransfer,Salary,1435.731495
39843,818007783,07-04-24 23:28,31.91,Return,eBay Return,1467.641495
39844,818007783,07-05-24 17:28,314.46,Purchase,Grocery,1153.181495
39845,818007783,07-05-24 19:28,145.53,Deposit,Cash Deposit,1298.711495
39846,818007783,07-08-24 21:28,2200,Payment,Credit Card Payment,-901.2885054
39847,818007783,07-11-24 21:28,900,Payment,Installment Payment,-1801.288505
39848,818007783,07-12-24 14:28,54.29,Deposit,Mobile Deposit,-1746.998505
39849,818248383,1-23-24 17:28,294.6,Payment,Bill Payment,-294.6
39850,818248383,02-03-24 19:28,397.35,Return,Store Return,102.75
39851,818248383,02-04-24 21:28,5650,IncomingTransfer,Salary,5752.75
39852,818248383,02-12-24 21:28,2500,Payment,Subscription Payment,3252.75
39853,818248383,2-13-24 11:28,546.35,Purchase,Electronics,2706.4
39854,818248383,2-15-24 16:28,421.75,Deposit,Check Deposit,3128.15
39855,818248383,2-15-24 19:28,534.93,Payment,Bill Payment,2593.22
39856,818248383,2-23-24 16:28,491.92,OutgoingTransfer,Wire Transfer,2101.3
39857,818248383,2-23-24 22:28,549.81,Return,Walmart Return,2651.11
39858,818248383,2-27-24 19:28,60.68,Purchase,Home Improvement,2590.43
39859,818248383,03-02-24 12:28,409.09,Deposit,Cash Deposit,2999.52
39860,818248383,03-03-24 16:28,86.99,Deposit,Cash Deposit,3086.51
39861,818248383,03-04-24 17:28,478.42,Purchase,Furniture,2608.09
39862,818248383,03-05-24 21:28,5650,IncomingTransfer,Salary,8258.09
39863,818248383,3-16-24 21:28,2500,Payment,Subscription Payment,5758.09
39864,818248383,3-24-24 21:28,178.23,Withdrawal,Branch Withdrawal,5579.86
39865,818248383,3-27-24 21:28,426.4,Purchase,Home Improvement,5153.46
39866,818248383,04-03-24 20:28,132.6,IncomingTransfer,Freelance Payment,5286.06
39867,818248383,04-03-24 21:28,5650,IncomingTransfer,Salary,10936.06
39868,818248383,4-13-24 21:28,2200,Payment,Installment Payment,8736.06
39869,818248383,4-14-24 15:28,510.66,Deposit,Cash Deposit,9246.72
39870,818248383,4-15-24 21:28,466.91,OnlineShopping,Best Buy,8779.81
39871,818248383,4-24-24 11:28,301.69,OutgoingTransfer,Bank Transfer,8478.12
39872,818248383,4-27-24 22:28,438.95,Purchase,Travel,8039.17
39873,818248383,4-28-24 13:28,518.9,Purchase,Restaurant,7520.27
39874,818248383,4-28-24 14:28,369.79,Payment,Bill Payment,7150.48
39875,818248383,4-28-24 20:28,89.71,Withdrawal,ATM Withdrawal,7060.77
39876,818248383,4-29-24 20:28,255.12,Purchase,Entertainment,6805.65
39877,818248383,4-30-24 9:28,196.17,OutgoingTransfer,Wire Transfer,6609.48
39878,818248383,05-02-24 21:28,5650,IncomingTransfer,Salary,12259.48
39879,818248383,05-11-24 21:28,2000,Payment,Insurance Payment,10259.48
39880,818248383,5-13-24 18:28,448.37,OnlineShopping,Amazon,9811.11
39881,818248383,06-02-24 14:28,249.88,Purchase,Gas,9561.23
39882,818248383,06-05-24 21:28,5650,IncomingTransfer,Salary,15211.23
39883,818248383,06-08-24 11:28,536.58,Return,Amazon Return,15747.81
39884,818248383,06-09-24 12:28,122.23,Withdrawal,Branch Withdrawal,15625.58
39885,818248383,06-10-24 21:28,2100,Payment,Subscription Payment,13525.58
39886,818248383,6-14-24 18:28,397.17,OnlineShopping,Target,13128.41
39887,818248383,6-18-24 23:28,226.27,Withdrawal,ATM Withdrawal,12902.14
39888,818248383,6-19-24 22:28,460.79,Return,Etsy Return,13362.93
39889,818248383,6-25-24 15:28,296.76,Withdrawal,Mobile App Withdrawal,13066.17
39890,818248383,07-01-24 18:28,304.11,Purchase,Restaurant,12762.06
39891,818248383,07-02-24 22:28,514.73,Withdrawal,ATM Withdrawal,12247.33
39892,818248383,07-03-24 15:28,264.49,Purchase,Travel,11982.84
39893,818248383,07-03-24 21:28,5650,IncomingTransfer,Salary,17632.84
39894,818248383,07-12-24 21:28,1400,Payment,Subscription Payment,16232.84
39895,818248383,7-16-24 11:28,535.11,OnlineShopping,Etsy,15697.73
39896,818375733,1-27-24 11:28,327.84,Withdrawal,ATM Withdrawal,256.7798397
39897,818375733,1-31-24 22:28,75.39,Payment,Loan Payment,181.3898397
39898,818375733,02-01-24 16:28,185.94,Return,AliExpress Return,367.3298397
39899,818375733,02-01-24 21:28,4050,IncomingTransfer,Salary,4417.32984
39900,818375733,02-06-24 15:28,323.41,OnlineShopping,eBay,4093.91984
39901,818375733,02-06-24 21:28,1000,Payment,Credit Card Payment,3093.91984
39902,818375733,02-07-24 11:28,29.52,Deposit,Direct Deposit,3123.43984
39903,818375733,02-08-24 17:28,24.92,Deposit,Direct Deposit,3148.35984
39904,818375733,02-12-24 21:28,1800,Payment,Rent Payment,1348.35984
39905,818375733,2-13-24 20:28,131.42,Return,Best Buy Return,1479.77984
39906,818375733,2-16-24 20:28,334.9,Purchase,Electronics,1144.87984
39907,818375733,2-19-24 16:28,122.21,OnlineShopping,Target,1022.66984
39908,818375733,2-26-24 12:28,165.55,Payment,Bill Payment,857.1198397
39909,818375733,03-04-24 21:28,4050,IncomingTransfer,Salary,4907.11984
39910,818375733,03-05-24 12:28,66.71,Purchase,Grocery,4840.40984
39911,818375733,03-05-24 16:28,274.45,Withdrawal,Mobile App Withdrawal,4565.95984
39912,818375733,03-07-24 9:28,279.52,Return,Best Buy Return,4845.47984
39913,818375733,03-08-24 14:28,28.91,OutgoingTransfer,Wire Transfer,4816.56984
39914,818375733,03-09-24 21:28,800,Payment,Credit Card Payment,4016.56984
39915,818375733,03-10-24 21:28,1300,Payment,Rent Payment,2716.56984
39916,818375733,03-12-24 10:28,107.85,Purchase,Clothing,2608.71984
39917,818375733,3-21-24 22:28,300.1,OutgoingTransfer,International Transfer,2308.61984
39918,818375733,3-22-24 11:28,295.97,Return,Target Return,2604.58984
39919,818375733,3-22-24 14:28,51.78,Payment,Loan Payment,2552.80984
39920,818375733,3-26-24 23:28,110.6,Deposit,Mobile Deposit,2663.40984
39921,818375733,3-27-24 16:28,320.97,Withdrawal,ATM Withdrawal,2342.43984
39922,818375733,3-29-24 11:28,68.77,Purchase,Electronics,2273.66984
39923,818375733,3-31-24 20:28,295.63,Deposit,Check Deposit,2569.29984
39924,818375733,04-01-24 21:28,4050,IncomingTransfer,Salary,6619.29984
39925,818375733,04-03-24 12:28,333.38,OnlineShopping,AliExpress,6285.91984
39926,818375733,04-06-24 14:28,244.53,OutgoingTransfer,Bank Transfer,6041.38984
39927,818375733,04-06-24 21:28,800,Payment,Credit Card Payment,5241.38984
39928,818375733,04-11-24 21:28,1400,Payment,Rent Payment,3841.38984
39929,818375733,04-11-24 23:28,78.48,Purchase,Travel,3762.90984
39930,818375733,04-12-24 10:28,322.42,OutgoingTransfer,Peer-to-Peer Transfer,3440.48984
39931,818375733,4-19-24 9:28,200.18,OnlineShopping,Amazon,3240.30984
39932,818375733,4-28-24 19:28,164.73,Deposit,Cash Deposit,3405.03984
39933,818375733,4-30-24 20:28,224.94,Withdrawal,Branch Withdrawal,3180.09984
39934,818375733,05-02-24 21:28,4050,IncomingTransfer,Salary,7230.09984
39935,818375733,05-04-24 11:28,147.1,OutgoingTransfer,International Transfer,7082.99984
39936,818375733,05-04-24 19:28,286.66,Payment,Bill Payment,6796.33984
39937,818375733,05-07-24 21:28,900,Payment,Credit Card Payment,5896.33984
39938,818375733,05-08-24 15:28,139.07,Purchase,Grocery,5757.26984
39939,818375733,05-12-24 21:28,1100,Payment,Rent Payment,4657.26984
39940,818375733,5-15-24 14:28,258.14,Return,eBay Return,4915.40984
39941,818375733,5-19-24 11:28,133.69,Withdrawal,ATM Withdrawal,4781.71984
39942,818375733,5-21-24 22:28,293.22,Purchase,Grocery,4488.49984
39943,818375733,5-27-24 15:28,253.01,Deposit,Direct Deposit,4741.50984
39944,818375733,5-29-24 18:28,24.8,OutgoingTransfer,International Transfer,4716.70984
39945,818375733,06-02-24 21:28,4050,IncomingTransfer,Salary,8766.70984
39946,818375733,06-07-24 21:28,1000,Payment,Credit Card Payment,7766.70984
39947,818375733,06-10-24 16:28,287.37,Withdrawal,Mobile App Withdrawal,7479.33984
39948,818375733,06-11-24 21:28,2200,Payment,Rent Payment,5279.33984
39949,818375733,6-16-24 17:28,270.16,Withdrawal,ATM Withdrawal,5009.17984
39950,818375733,6-23-24 12:28,361.54,Withdrawal,Mobile App Withdrawal,4647.63984
39951,818375733,6-24-24 16:28,282.96,Purchase,Entertainment,4364.67984
39952,818375733,07-05-24 21:28,4050,IncomingTransfer,Salary,8414.67984
39953,818375733,07-10-24 21:28,900,Payment,Credit Card Payment,7514.67984
39954,818375733,07-10-24 22:28,252.45,Withdrawal,ATM Withdrawal,7262.22984
39955,818375733,07-11-24 14:28,103.44,Withdrawal,Mobile App Withdrawal,7158.78984
39956,818375733,7-13-24 21:28,2200,Payment,Rent Payment,4958.78984
39957,818375733,7-14-24 12:28,91.31,Withdrawal,ATM Withdrawal,4867.47984
39958,818903583,1-27-24 14:28,411.61,OutgoingTransfer,Peer-to-Peer Transfer,697.3081024
39959,818903583,1-29-24 14:28,360.15,Payment,Mortgage Payment,337.1581024
39960,818903583,1-30-24 20:28,339.13,Purchase,Entertainment,-1.971897599
39961,818903583,1-31-24 18:28,238.31,Payment,Loan Payment,-240.2818976
39962,818903583,02-02-24 17:28,219.43,Withdrawal,ATM Withdrawal,-459.7118976
39963,818903583,02-02-24 21:28,5850,IncomingTransfer,Salary,5390.288102
39964,818903583,02-07-24 21:28,1700,Payment,Credit Card Payment,3690.288102
39965,818903583,02-07-24 21:28,149.3,Withdrawal,ATM Withdrawal,3540.988102
39966,818903583,02-08-24 11:28,260.7,Purchase,Home Improvement,3280.288102
39967,818903583,02-10-24 11:28,459.22,OnlineShopping,Best Buy,2821.068102
39968,818903583,02-10-24 22:28,132.42,Deposit,Cash Deposit,2953.488102
39969,818903583,2-14-24 13:28,469.06,Purchase,Clothing,2484.428102
39970,818903583,2-15-24 21:28,2300,Payment,Installment Payment,184.4281024
39971,818903583,2-18-24 15:28,335.44,Withdrawal,Branch Withdrawal,-151.0118976
39972,818903583,2-18-24 18:28,402.21,Withdrawal,Branch Withdrawal,-553.2218976
39973,818903583,2-19-24 9:28,230.29,Purchase,Entertainment,-783.5118976
39974,818903583,2-22-24 15:28,424.68,OutgoingTransfer,Bank Transfer,-1208.191898
39975,818903583,2-23-24 13:28,169.42,Deposit,Check Deposit,-1038.771898
39976,818903583,2-26-24 12:28,394.35,OutgoingTransfer,International Transfer,-1433.121898
39977,818903583,03-01-24 12:28,257.71,OnlineShopping,Amazon,-1690.831898
39978,818903583,03-03-24 21:28,297.22,Deposit,Mobile Deposit,-1393.611898
39979,818903583,03-05-24 21:28,5850,IncomingTransfer,Salary,4456.388102
39980,818903583,03-10-24 15:28,341.64,Payment,Loan Payment,4114.748102
39981,818903583,03-10-24 21:28,2300,Payment,Credit Card Payment,1814.748102
39982,818903583,03-12-24 17:28,169.46,Return,Best Buy Return,1984.208102
39983,818903583,3-13-24 21:28,2300,Payment,Installment Payment,-315.7918976
39984,818903583,3-14-24 21:28,422.01,Deposit,Cash Deposit,106.2181024
39985,818903583,3-15-24 14:28,535.58,OnlineShopping,Etsy,-429.3618976
39986,818903583,3-18-24 21:28,498,Return,Amazon Return,68.6381024
39987,818903583,3-22-24 15:28,77.66,OutgoingTransfer,Peer-to-Peer Transfer,-9.021897599
39988,818903583,3-24-24 19:28,526.57,Purchase,Electronics,-535.5918976
39989,818903583,3-26-24 10:28,386.17,Purchase,Travel,-921.7618976
39990,818903583,3-28-24 21:28,237.01,OnlineShopping,Etsy,-1158.771898
39991,818903583,04-01-24 21:28,5850,IncomingTransfer,Salary,4691.228102
39992,818903583,04-01-24 21:28,510.48,Purchase,Furniture,4180.748102
39993,818903583,04-02-24 22:28,199.64,Withdrawal,Mobile App Withdrawal,3981.108102
39994,818903583,04-06-24 14:28,515.11,OutgoingTransfer,Bank Transfer,3465.998102
39995,818903583,04-06-24 21:28,2300,Payment,Credit Card Payment,1165.998102
39996,818903583,04-09-24 16:28,91.07,OnlineShopping,Target,1074.928102
39997,818903583,04-12-24 9:28,213.12,Deposit,Cash Deposit,1288.048102
39998,818903583,4-18-24 21:28,2600,Payment,Installment Payment,-1311.951898
39999,818903583,4-19-24 11:28,367.98,Return,Etsy Return,-943.9718976
40000,818903583,4-21-24 17:28,96.73,OnlineShopping,Target,-1040.701898
40001,818903583,05-01-24 23:28,527.33,Payment,Bill Payment,-1568.031898
40002,818903583,05-02-24 22:28,466.6,Payment,Loan Payment,-2034.631898
40003,818903583,05-04-24 21:28,5850,IncomingTransfer,Salary,3815.368102
40004,818903583,05-08-24 10:28,401.49,OutgoingTransfer,Wire Transfer,3413.878102
40005,818903583,05-09-24 21:28,1600,Payment,Credit Card Payment,1813.878102
40006,818903583,5-17-24 21:28,1600,Payment,Installment Payment,213.8781024
40007,818903583,5-20-24 9:28,409.25,Payment,Bill Payment,-195.3718976
40008,818903583,5-26-24 10:28,472.29,Deposit,Mobile Deposit,276.9181024
40009,818903583,5-26-24 14:28,376.35,Payment,Loan Payment,-99.4318976
40010,818903583,5-28-24 20:28,250,Withdrawal,Branch Withdrawal,-349.4318976
40011,818903583,5-29-24 20:28,226.83,IncomingTransfer,Freelance Payment,-122.6018976
40012,818903583,06-02-24 21:28,5850,IncomingTransfer,Salary,5727.398102
40013,818903583,06-03-24 17:28,185.17,Deposit,Direct Deposit,5912.568102
40014,818903583,06-05-24 16:28,421.48,Withdrawal,Mobile App Withdrawal,5491.088102
40015,818903583,06-06-24 14:28,401.02,Withdrawal,Branch Withdrawal,5090.068102
40016,818903583,06-06-24 17:28,462.31,Purchase,Furniture,4627.758102
40017,818903583,06-07-24 21:28,1600,Payment,Credit Card Payment,3027.758102
40018,818903583,06-07-24 23:28,112.93,Withdrawal,ATM Withdrawal,2914.828102
40019,818903583,6-14-24 21:28,1900,Payment,Installment Payment,1014.828102
40020,818903583,6-15-24 18:28,188.07,OnlineShopping,Etsy,826.7581024
40021,818903583,6-19-24 19:28,285.4,Purchase,Restaurant,541.3581024
40022,818903583,6-29-24 20:28,153.1,Withdrawal,Mobile App Withdrawal,388.2581024
40023,818903583,07-02-24 10:28,173.69,Withdrawal,Branch Withdrawal,214.5681024
40024,818903583,07-02-24 16:28,373.86,OnlineShopping,AliExpress,-159.2918976
40025,818903583,07-03-24 21:28,5850,IncomingTransfer,Salary,5690.708102
40026,818903583,07-05-24 21:28,280.11,Purchase,Grocery,5410.598102
40027,818903583,07-07-24 13:28,74.37,Deposit,Cash Deposit,5484.968102
40028,818903583,07-07-24 15:28,73.55,Deposit,Direct Deposit,5558.518102
40029,818903583,07-08-24 21:28,2100,Payment,Credit Card Payment,3458.518102
40030,818903583,07-11-24 9:28,349.51,Return,Walmart Return,3808.028102
40031,818903583,7-13-24 12:28,121.84,OnlineShopping,AliExpress,3686.188102
40032,818903583,7-13-24 22:28,128.06,OnlineShopping,Amazon,3558.128102
40033,818903583,7-15-24 15:28,375.61,Withdrawal,Branch Withdrawal,3182.518102
40034,818903583,7-15-24 21:28,2500,Payment,Installment Payment,682.5181024
40035,819214233,1-24-24 15:28,158.6,OutgoingTransfer,Bank Transfer,-158.6
40036,819214233,1-29-24 15:28,104.15,Deposit,Check Deposit,-54.45
40037,819214233,1-31-24 18:28,20.91,Deposit,Direct Deposit,-33.54
40038,819214233,02-01-24 11:28,45.92,Purchase,Restaurant,-79.46
40039,819214233,02-04-24 18:28,244.41,Return,Etsy Return,164.95
40040,819214233,02-04-24 21:28,1750,IncomingTransfer,Salary,1914.95
40041,819214233,02-06-24 21:28,42.86,Payment,Loan Payment,1872.09
40042,819214233,02-12-24 16:28,227.65,Purchase,Clothing,1644.44
40043,819214233,2-14-24 11:28,162.03,Payment,Mortgage Payment,1482.41
40044,819214233,2-14-24 23:28,212.59,Withdrawal,Mobile App Withdrawal,1269.82
40045,819214233,2-15-24 14:28,99.84,Purchase,Gas,1169.98
40046,819214233,2-15-24 20:28,63.48,Withdrawal,Mobile App Withdrawal,1106.5
40047,819214233,2-17-24 21:28,1000,Payment,Rent Payment,106.5
40048,819214233,2-19-24 9:28,108.48,OutgoingTransfer,Wire Transfer,-1.98
40049,819214233,2-19-24 23:28,233.14,Payment,Bill Payment,-235.12
40050,819214233,2-20-24 10:28,104.88,Withdrawal,Mobile App Withdrawal,-340
40051,819214233,2-20-24 16:28,103.76,Purchase,Home Improvement,-443.76
40052,819214233,2-21-24 12:28,228.1,Purchase,Clothing,-671.86
40053,819214233,2-21-24 16:28,16.65,Deposit,Direct Deposit,-655.21
40054,819214233,2-21-24 17:28,231.8,Purchase,Electronics,-887.01
40055,819214233,2-22-24 15:28,75.24,Withdrawal,Mobile App Withdrawal,-962.25
40056,819214233,2-23-24 18:28,246,OutgoingTransfer,Bank Transfer,-1208.25
40057,819214233,2-25-24 17:28,34.14,Purchase,Electronics,-1242.39
40058,819214233,2-26-24 14:28,134.48,Payment,Bill Payment,-1376.87
40059,819214233,2-26-24 17:28,24.21,Deposit,Check Deposit,-1352.66
40060,819214233,2-26-24 20:28,196.33,Purchase,Entertainment,-1548.99
40061,819214233,2-28-24 22:28,73.39,Deposit,Check Deposit,-1475.6
40062,819214233,03-01-24 21:28,1750,IncomingTransfer,Salary,274.4
40063,819214233,03-06-24 16:28,233.63,OnlineShopping,Walmart,40.77
40064,819214233,03-06-24 18:28,201.88,OnlineShopping,Target,-161.11
40065,819214233,03-10-24 21:28,700,Payment,Rent Payment,-861.11
40066,819214233,3-19-24 21:28,223.83,OnlineShopping,Target,-1084.94
40067,819214233,3-22-24 23:28,179.83,Withdrawal,Mobile App Withdrawal,-1264.77
40068,819214233,3-24-24 18:28,164.41,Purchase,Furniture,-1429.18
40069,819214233,04-01-24 21:28,1750,IncomingTransfer,Salary,320.82
40070,819214233,04-03-24 9:28,33.02,Deposit,Direct Deposit,353.84
40071,819214233,04-03-24 20:28,97,Withdrawal,Mobile App Withdrawal,256.84
40072,819214233,04-04-24 13:28,196.49,OnlineShopping,Walmart,60.35
40073,819214233,04-04-24 15:28,175.57,Deposit,Direct Deposit,235.92
40074,819214233,04-04-24 19:28,161.07,Purchase,Grocery,74.85
40075,819214233,04-06-24 16:28,39.22,OnlineShopping,AliExpress,35.63
40076,819214233,04-07-24 10:28,128.63,Return,Amazon Return,164.26
40077,819214233,04-07-24 15:28,199.82,Deposit,Check Deposit,364.08
40078,819214233,04-08-24 9:28,26.55,Payment,Mortgage Payment,337.53
40079,819214233,04-08-24 17:28,148.55,Withdrawal,Mobile App Withdrawal,188.98
40080,819214233,04-11-24 15:28,185.86,Return,Walmart Return,374.84
40081,819214233,4-14-24 21:28,1100,Payment,Rent Payment,-725.16
40082,819214233,4-16-24 21:28,113.73,Deposit,Check Deposit,-611.43
40083,819214233,4-17-24 17:28,150.7,Return,Amazon Return,-460.73
40084,819214233,4-18-24 19:28,80.84,Withdrawal,ATM Withdrawal,-541.57
40085,819214233,4-24-24 10:28,240.5,Purchase,Entertainment,-782.07
40086,819214233,4-26-24 11:28,56.48,Purchase,Restaurant,-838.55
40087,819214233,4-27-24 22:28,231.54,Return,Best Buy Return,-607.01
40088,819214233,4-28-24 17:28,27.88,Purchase,Pharmacy,-634.89
40089,819214233,4-30-24 12:28,221.69,Withdrawal,Mobile App Withdrawal,-856.58
40090,819214233,05-05-24 20:28,148.7,Withdrawal,ATM Withdrawal,-1005.28
40091,819214233,05-05-24 21:28,1750,IncomingTransfer,Salary,744.72
40092,819214233,05-08-24 13:28,246.69,Purchase,Restaurant,498.03
40093,819214233,05-09-24 13:28,46.46,Withdrawal,ATM Withdrawal,451.57
40094,819214233,05-10-24 21:28,700,Payment,Rent Payment,-248.43
40095,819214233,05-11-24 10:28,232.97,OnlineShopping,Target,-481.4
40096,819214233,05-12-24 10:28,229.02,OnlineShopping,Amazon,-710.42
40097,819214233,5-13-24 10:28,64.57,Payment,Loan Payment,-774.99
40098,819214233,5-13-24 20:28,36.48,Deposit,Direct Deposit,-738.51
40099,819214233,5-14-24 18:28,63.18,OnlineShopping,Walmart,-801.69
40100,819214233,5-24-24 16:28,40.23,OutgoingTransfer,Wire Transfer,-841.92
40101,819214233,5-24-24 20:28,61.24,OnlineShopping,Target,-903.16
40102,819214233,06-02-24 12:28,21.72,Withdrawal,Mobile App Withdrawal,-924.88
40103,819214233,06-02-24 21:28,1750,IncomingTransfer,Salary,825.12
40104,819214233,06-04-24 11:28,238.42,OnlineShopping,AliExpress,586.7
40105,819214233,06-05-24 12:28,220.45,OutgoingTransfer,Bank Transfer,366.25
40106,819214233,06-05-24 13:28,240.37,Purchase,Pharmacy,125.88
40107,819214233,06-07-24 14:28,126.7,Return,Walmart Return,252.58
40108,819214233,6-13-24 18:28,191.52,Withdrawal,ATM Withdrawal,61.06
40109,819214233,6-14-24 22:28,243.27,Deposit,Mobile Deposit,304.33
40110,819214233,6-14-24 23:28,78.51,Deposit,Check Deposit,382.84
40111,819214233,6-18-24 21:28,1100,Payment,Rent Payment,-717.16
40112,819214233,6-20-24 13:28,40.18,Purchase,Clothing,-757.34
40113,819214233,6-21-24 19:28,204.28,Deposit,Check Deposit,-553.06
40114,819214233,6-24-24 15:28,108.22,Deposit,Check Deposit,-444.84
40115,819214233,6-26-24 10:28,63.91,Withdrawal,Branch Withdrawal,-508.75
40116,819214233,6-29-24 14:28,220.15,Return,AliExpress Return,-288.6
40117,819214233,6-29-24 18:28,146.01,OutgoingTransfer,Bank Transfer,-434.61
40118,819214233,6-30-24 14:28,22.64,OnlineShopping,Target,-457.25
40119,819214233,6-30-24 16:28,157.77,OutgoingTransfer,Wire Transfer,-615.02
40120,819214233,07-04-24 21:28,1750,IncomingTransfer,Salary,1134.98
40121,819214233,07-05-24 10:28,156.1,Withdrawal,ATM Withdrawal,978.88
40122,819214233,07-06-24 19:28,241.2,OutgoingTransfer,International Transfer,737.68
40123,819214233,07-08-24 14:28,226.62,Payment,Loan Payment,511.06
40124,819214233,07-08-24 14:28,26.56,OutgoingTransfer,Bank Transfer,484.5
40125,819214233,07-09-24 16:28,11.76,Withdrawal,Mobile App Withdrawal,472.74
40126,819214233,07-10-24 18:28,152.76,OutgoingTransfer,International Transfer,319.98
40127,819214233,7-13-24 12:28,16.02,Withdrawal,ATM Withdrawal,303.96
40128,819214233,7-13-24 15:28,195.53,Purchase,Pharmacy,108.43
40129,819214233,7-13-24 15:28,84.88,Withdrawal,ATM Withdrawal,23.55
40130,819214233,7-13-24 21:28,900,Payment,Rent Payment,-876.45
40131,819363708,1-22-24 10:28,499.58,Deposit,Cash Deposit,1778.945879
40132,819363708,1-23-24 10:28,491.51,OutgoingTransfer,Wire Transfer,1287.435879
40133,819363708,1-23-24 10:28,67.32,Purchase,Grocery,1220.115879
40134,819363708,02-01-24 21:28,5300,IncomingTransfer,Salary,6520.115879
40135,819363708,02-02-24 15:28,547.54,Payment,Mortgage Payment,5972.575879
40136,819363708,02-03-24 22:28,469.15,Deposit,Direct Deposit,6441.725879
40137,819363708,02-06-24 21:28,1900,Payment,Credit Card Payment,4541.725879
40138,819363708,02-08-24 17:28,540.58,OnlineShopping,Amazon,4001.145879
40139,819363708,02-11-24 20:28,402.95,Purchase,Restaurant,3598.195879
40140,819363708,02-12-24 9:28,471.91,Deposit,Mobile Deposit,4070.105879
40141,819363708,02-12-24 11:28,201.54,Return,Amazon Return,4271.645879
40142,819363708,2-14-24 19:28,448.04,Purchase,Electronics,3823.605879
40143,819363708,2-16-24 15:28,360.54,Deposit,Check Deposit,4184.145879
40144,819363708,2-18-24 14:28,205.76,Withdrawal,ATM Withdrawal,3978.385879
40145,819363708,2-18-24 21:28,1800,Payment,Rent Payment,2178.385879
40146,819363708,2-19-24 12:28,544.9,IncomingTransfer,Freelance Payment,2723.285879
40147,819363708,2-21-24 11:28,83.5,Purchase,Grocery,2639.785879
40148,819363708,03-01-24 21:28,5300,IncomingTransfer,Salary,7939.785879
40149,819363708,03-04-24 9:28,415.06,OutgoingTransfer,Wire Transfer,7524.725879
40150,819363708,03-06-24 21:28,1900,Payment,Credit Card Payment,5624.725879
40151,819363708,03-07-24 9:28,191.09,Deposit,Direct Deposit,5815.815879
40152,819363708,03-08-24 10:28,99.97,Payment,Loan Payment,5715.845879
40153,819363708,03-10-24 15:28,259.83,OutgoingTransfer,Wire Transfer,5456.015879
40154,819363708,03-10-24 16:28,457.7,Deposit,Mobile Deposit,5913.715879
40155,819363708,03-10-24 21:28,3200,Payment,Rent Payment,2713.715879
40156,819363708,3-13-24 12:28,241.96,Withdrawal,Mobile App Withdrawal,2471.755879
40157,819363708,3-15-24 15:28,516.92,Return,Best Buy Return,2988.675879
40158,819363708,3-22-24 23:28,339.31,Purchase,Pharmacy,2649.365879
40159,819363708,3-23-24 20:28,297.72,Return,Target Return,2947.085879
40160,819363708,3-29-24 10:28,451.22,Deposit,Direct Deposit,3398.305879
40161,819363708,3-31-24 16:28,321.98,Payment,Mortgage Payment,3076.325879
40162,819363708,3-31-24 17:28,210.22,OutgoingTransfer,Peer-to-Peer Transfer,2866.105879
40163,819363708,04-01-24 17:28,89.23,Deposit,Direct Deposit,2955.335879
40164,819363708,04-05-24 18:28,72.57,Purchase,Grocery,2882.765879
40165,819363708,04-05-24 21:28,5300,IncomingTransfer,Salary,8182.765879
40166,819363708,04-10-24 21:28,2200,Payment,Credit Card Payment,5982.765879
40167,819363708,04-12-24 18:28,55.75,OnlineShopping,AliExpress,5927.015879
40168,819363708,04-12-24 21:28,2400,Payment,Rent Payment,3527.015879
40169,819363708,4-13-24 22:28,308.48,Deposit,Cash Deposit,3835.495879
40170,819363708,4-17-24 11:28,147.57,OutgoingTransfer,Bank Transfer,3687.925879
40171,819363708,4-17-24 18:28,357.6,Payment,Mortgage Payment,3330.325879
40172,819363708,4-17-24 19:28,370.29,OutgoingTransfer,Peer-to-Peer Transfer,2960.035879
40173,819363708,4-23-24 20:28,481.51,Withdrawal,Mobile App Withdrawal,2478.525879
40174,819363708,4-25-24 9:28,171.64,Payment,Bill Payment,2306.885879
40175,819363708,4-26-24 18:28,446.65,Withdrawal,ATM Withdrawal,1860.235879
40176,819363708,4-27-24 14:28,537.38,Purchase,Furniture,1322.855879
40177,819363708,4-29-24 12:28,71.22,Return,eBay Return,1394.075879
40178,819363708,4-30-24 13:28,177.85,Deposit,Direct Deposit,1571.925879
40179,819363708,05-01-24 16:28,386.22,Withdrawal,Branch Withdrawal,1185.705879
40180,819363708,05-02-24 10:28,240.13,Deposit,Direct Deposit,1425.835879
40181,819363708,05-05-24 21:28,5300,IncomingTransfer,Salary,6725.835879
40182,819363708,05-10-24 10:28,482.35,Withdrawal,Branch Withdrawal,6243.485879
40183,819363708,05-10-24 21:28,1900,Payment,Credit Card Payment,4343.485879
40184,819363708,05-11-24 15:28,53.96,OnlineShopping,Best Buy,4289.525879
40185,819363708,5-14-24 18:28,468.91,Purchase,Clothing,3820.615879
40186,819363708,5-16-24 21:28,3100,Payment,Rent Payment,720.6158793
40187,819363708,5-19-24 21:28,149.99,Return,eBay Return,870.6058793
40188,819363708,5-20-24 11:28,544.15,Purchase,Pharmacy,326.4558793
40189,819363708,5-21-24 12:28,394.66,OnlineShopping,Target,-68.20412067
40190,819363708,5-21-24 18:28,417.03,Deposit,Cash Deposit,348.8258793
40191,819363708,5-22-24 13:28,84.91,Purchase,Gas,263.9158793
40192,819363708,5-23-24 18:28,51.95,OutgoingTransfer,International Transfer,211.9658793
40193,819363708,5-25-24 10:28,516.66,Payment,Bill Payment,-304.6941207
40194,819363708,5-29-24 17:28,266.15,Deposit,Mobile Deposit,-38.54412067
40195,819363708,5-30-24 10:28,457.65,OutgoingTransfer,Peer-to-Peer Transfer,-496.1941207
40196,819363708,5-31-24 21:28,188.25,Withdrawal,Mobile App Withdrawal,-684.4441207
40197,819363708,06-02-24 22:28,211.27,Purchase,Restaurant,-895.7141207
40198,819363708,06-03-24 23:28,354.7,Purchase,Restaurant,-1250.414121
40199,819363708,06-05-24 21:28,5300,IncomingTransfer,Salary,4049.585879
40200,819363708,06-06-24 23:28,548.88,OnlineShopping,Target,3500.705879
40201,819363708,06-10-24 21:28,1700,Payment,Credit Card Payment,1800.705879
40202,819363708,06-12-24 9:28,529.41,Deposit,Mobile Deposit,2330.115879
40203,819363708,6-14-24 21:28,2900,Payment,Rent Payment,-569.8841207
40204,819363708,6-25-24 23:28,269.31,Purchase,Pharmacy,-839.1941207
40205,819363708,6-26-24 10:28,462.05,Deposit,Mobile Deposit,-377.1441207
40206,819363708,6-28-24 23:28,481.68,Deposit,Mobile Deposit,104.5358793
40207,819363708,07-01-24 21:28,5300,IncomingTransfer,Salary,5404.535879
40208,819363708,07-03-24 14:28,525.01,IncomingTransfer,Freelance Payment,5929.545879
40209,819363708,07-03-24 16:28,166.93,OutgoingTransfer,Peer-to-Peer Transfer,5762.615879
40210,819363708,07-06-24 18:28,439.82,IncomingTransfer,Freelance Payment,6202.435879
40211,819363708,07-06-24 21:28,1900,Payment,Credit Card Payment,4302.435879
40212,819363708,07-07-24 14:28,409.08,OnlineShopping,Target,3893.355879
40213,819363708,07-12-24 15:28,413.94,Withdrawal,Mobile App Withdrawal,3479.415879
40214,819363708,7-13-24 21:28,3300,Payment,Rent Payment,179.4158793
40215,819363708,7-17-24 13:28,461.63,Payment,Loan Payment,-282.2141207
40216,819752133,1-20-24 14:28,331.93,Purchase,Electronics,492.8853755
40217,819752133,1-20-24 16:28,549.87,OnlineShopping,Target,-56.98462449
40218,819752133,1-22-24 14:28,290.58,Purchase,Grocery,-347.5646245
40219,819752133,1-22-24 16:28,216.7,Purchase,Clothing,-564.2646245
40220,819752133,1-27-24 11:28,377.44,Withdrawal,ATM Withdrawal,-941.7046245
40221,819752133,1-30-24 9:28,673.96,Deposit,Direct Deposit,-267.7446245
40222,819752133,02-01-24 23:28,418,IncomingTransfer,Freelance Payment,150.2553755
40223,819752133,02-02-24 21:28,7300,IncomingTransfer,Salary,7450.255376
40224,819752133,02-06-24 21:28,700.56,Withdrawal,ATM Withdrawal,6749.695376
40225,819752133,02-07-24 21:28,1300,Payment,Credit Card Payment,5449.695376
40226,819752133,02-10-24 21:28,3300,Payment,Rent Payment,2149.695376
40227,819752133,2-13-24 12:28,217.91,Return,Etsy Return,2367.605376
40228,819752133,2-15-24 19:28,253.88,Deposit,Cash Deposit,2621.485376
40229,819752133,2-17-24 20:28,160.17,OutgoingTransfer,Wire Transfer,2461.315376
40230,819752133,2-18-24 14:28,352.55,OnlineShopping,AliExpress,2108.765376
40231,819752133,2-22-24 15:28,490.8,Purchase,Pharmacy,1617.965376
40232,819752133,2-26-24 15:28,172.15,OutgoingTransfer,International Transfer,1445.815376
40233,819752133,2-27-24 11:28,731.25,Withdrawal,ATM Withdrawal,714.5653755
40234,819752133,2-28-24 23:28,193.54,Purchase,Home Improvement,521.0253755
40235,819752133,2-29-24 10:28,679.77,Withdrawal,ATM Withdrawal,-158.7446245
40236,819752133,03-01-24 23:28,555.43,Withdrawal,Mobile App Withdrawal,-714.1746245
40237,819752133,03-02-24 22:28,673.7,Purchase,Electronics,-1387.874624
40238,819752133,03-03-24 13:28,451,OnlineShopping,Target,-1838.874624
40239,819752133,03-04-24 21:28,7300,IncomingTransfer,Salary,5461.125376
40240,819752133,03-09-24 11:28,535.52,Withdrawal,Mobile App Withdrawal,4925.605376
40241,819752133,03-09-24 21:28,1200,Payment,Credit Card Payment,3725.605376
40242,819752133,03-10-24 11:28,470.44,Deposit,Cash Deposit,4196.045376
40243,819752133,03-10-24 17:28,726.01,IncomingTransfer,Freelance Payment,4922.055376
40244,819752133,3-13-24 14:28,195.14,Purchase,Pharmacy,4726.915376
40245,819752133,3-15-24 20:28,725.9,OutgoingTransfer,Wire Transfer,4001.015376
40246,819752133,3-15-24 21:28,4600,Payment,Rent Payment,-598.9846245
40247,819752133,3-16-24 10:28,410.01,OutgoingTransfer,Bank Transfer,-1008.994624
40248,819752133,3-16-24 16:28,624.74,OutgoingTransfer,Wire Transfer,-1633.734624
40249,819752133,3-17-24 14:28,177.38,OnlineShopping,Etsy,-1811.114624
40250,819752133,3-18-24 16:28,207.53,Deposit,Mobile Deposit,-1603.584624
40251,819752133,3-20-24 12:28,735.52,Deposit,Check Deposit,-868.0646245
40252,819752133,3-22-24 17:28,327.07,IncomingTransfer,Freelance Payment,-540.9946245
40253,819752133,3-23-24 19:28,128.25,Deposit,Mobile Deposit,-412.7446245
40254,819752133,3-24-24 11:28,437.94,OnlineShopping,Amazon,-850.6846245
40255,819752133,3-26-24 18:28,105.39,Deposit,Cash Deposit,-745.2946245
40256,819752133,3-27-24 12:28,707.19,OnlineShopping,Best Buy,-1452.484624
40257,819752133,3-29-24 19:28,385.87,Return,Amazon Return,-1066.614624
40258,819752133,3-29-24 22:28,661.35,Payment,Bill Payment,-1727.964624
40259,819752133,3-30-24 15:28,279.73,Return,Store Return,-1448.234624
40260,819752133,04-04-24 14:28,240.77,Withdrawal,ATM Withdrawal,-1689.004624
40261,819752133,04-05-24 21:28,7300,IncomingTransfer,Salary,5610.995376
40262,819752133,04-09-24 11:28,650.71,IncomingTransfer,Freelance Payment,6261.705376
40263,819752133,04-10-24 21:28,1200,Payment,Credit Card Payment,5061.705376
40264,819752133,4-14-24 21:28,3700,Payment,Rent Payment,1361.705376
40265,819752133,4-15-24 14:28,105.77,OutgoingTransfer,International Transfer,1255.935376
40266,819752133,4-15-24 20:28,727.53,Purchase,Furniture,528.4053755
40267,819752133,4-15-24 20:28,275.51,Deposit,Direct Deposit,803.9153755
40268,819752133,4-18-24 22:28,130.31,OnlineShopping,Amazon,673.6053755
40269,819752133,4-21-24 13:28,296.61,OutgoingTransfer,Bank Transfer,376.9953755
40270,819752133,4-21-24 15:28,544.84,Deposit,Mobile Deposit,921.8353755
40271,819752133,4-26-24 22:28,243.52,Purchase,Gas,678.3153755
40272,819752133,05-05-24 10:28,159.33,Withdrawal,Branch Withdrawal,518.9853755
40273,819752133,05-05-24 21:28,7300,IncomingTransfer,Salary,7818.985376
40274,819752133,05-07-24 22:28,152.06,Deposit,Check Deposit,7971.045376
40275,819752133,05-10-24 21:28,1000,Payment,Credit Card Payment,6971.045376
40276,819752133,5-14-24 22:28,639.71,OnlineShopping,AliExpress,6331.335376
40277,819752133,5-15-24 12:28,345.89,Withdrawal,ATM Withdrawal,5985.445376
40278,819752133,5-15-24 18:28,225.87,OutgoingTransfer,Wire Transfer,5759.575376
40279,819752133,5-15-24 21:28,3800,Payment,Rent Payment,1959.575376
40280,819752133,5-16-24 17:28,608.46,Purchase,Home Improvement,1351.115376
40281,819752133,5-21-24 17:28,473.97,Purchase,Clothing,877.1453755
40282,819752133,5-21-24 19:28,451.04,Payment,Bill Payment,426.1053755
40283,819752133,5-23-24 19:28,281.7,Purchase,Clothing,144.4053755
40284,819752133,5-27-24 10:28,500.17,Purchase,Restaurant,-355.7646245
40285,819752133,5-29-24 18:28,227.46,OutgoingTransfer,Bank Transfer,-583.2246245
40286,819752133,06-01-24 21:28,7300,IncomingTransfer,Salary,6716.775376
40287,819752133,06-06-24 21:28,1300,Payment,Credit Card Payment,5416.775376
40288,819752133,06-07-24 12:28,265.31,Deposit,Direct Deposit,5682.085376
40289,819752133,06-07-24 23:28,141.69,OutgoingTransfer,International Transfer,5540.395376
40290,819752133,06-10-24 21:28,3800,Payment,Rent Payment,1740.395376
40291,819752133,6-13-24 20:28,702.75,Purchase,Pharmacy,1037.645376
40292,819752133,6-16-24 11:28,585.56,Return,Etsy Return,1623.205376
40293,819752133,6-17-24 12:28,490.37,Purchase,Grocery,1132.835376
40294,819752133,6-18-24 20:28,667.29,Payment,Mortgage Payment,465.5453755
40295,819752133,6-27-24 12:28,593.25,OutgoingTransfer,International Transfer,-127.7046245
40296,819752133,6-27-24 14:28,404.68,Purchase,Pharmacy,-532.3846245
40297,819752133,6-29-24 17:28,243.88,Payment,Bill Payment,-776.2646245
40298,819752133,07-03-24 21:28,7300,IncomingTransfer,Salary,6523.735376
40299,819752133,07-05-24 18:28,129.38,OutgoingTransfer,Wire Transfer,6394.355376
40300,819752133,07-08-24 21:28,1200,Payment,Credit Card Payment,5194.355376
40301,819752133,07-09-24 17:28,373.25,Purchase,Travel,4821.105376
40302,819752133,07-10-24 11:28,110.67,Purchase,Grocery,4710.435376
40303,819752133,07-10-24 22:28,221.55,Deposit,Check Deposit,4931.985376
40304,819752133,7-13-24 21:28,4600,Payment,Rent Payment,331.9853755
40305,819752133,7-13-24 21:28,548.32,Purchase,Travel,-216.3346245
40306,819752133,7-15-24 17:28,590.98,Withdrawal,ATM Withdrawal,-807.3146245
40307,820036533,1-24-24 21:28,569.97,OutgoingTransfer,Wire Transfer,413.1580823
40308,820036533,1-27-24 12:28,657.19,Deposit,Check Deposit,1070.348082
40309,820036533,1-29-24 22:28,447.86,Payment,Bill Payment,622.4880823
40310,820036533,1-30-24 17:28,574.89,Purchase,Home Improvement,47.5980823
40311,820036533,02-01-24 13:28,222.3,Withdrawal,ATM Withdrawal,-174.7019177
40312,820036533,02-04-24 21:28,8600,IncomingTransfer,Salary,8425.298082
40313,820036533,02-06-24 12:28,584.83,Return,AliExpress Return,9010.128082
40314,820036533,02-06-24 14:28,146.28,Purchase,Pharmacy,8863.848082
40315,820036533,02-08-24 17:28,539.22,OutgoingTransfer,Wire Transfer,8324.628082
40316,820036533,02-09-24 21:28,1700,Payment,Credit Card Payment,6624.628082
40317,820036533,02-09-24 22:28,142.17,Purchase,Home Improvement,6482.458082
40318,820036533,02-10-24 21:28,123.19,Deposit,Mobile Deposit,6605.648082
40319,820036533,02-11-24 22:28,334.1,Purchase,Travel,6271.548082
40320,820036533,02-12-24 18:28,606.3,Return,Amazon Return,6877.848082
40321,820036533,2-13-24 10:28,228.81,Payment,Loan Payment,6649.038082
40322,820036533,2-14-24 13:28,622.35,Withdrawal,ATM Withdrawal,6026.688082
40323,820036533,2-14-24 21:28,3300,Payment,Rent Payment,2726.688082
40324,820036533,2-14-24 22:28,581.05,OutgoingTransfer,Wire Transfer,2145.638082
40325,820036533,2-16-24 22:28,545.79,Deposit,Cash Deposit,2691.428082
40326,820036533,2-17-24 14:28,360.58,Purchase,Restaurant,2330.848082
40327,820036533,2-18-24 21:28,279.31,Return,Walmart Return,2610.158082
40328,820036533,2-19-24 16:28,682.58,Deposit,Direct Deposit,3292.738082
40329,820036533,2-20-24 13:28,582.75,Return,Target Return,3875.488082
40330,820036533,2-27-24 16:28,327.63,OnlineShopping,Amazon,3547.858082
40331,820036533,2-29-24 20:28,662.47,Purchase,Furniture,2885.388082
40332,820036533,03-01-24 21:28,8600,IncomingTransfer,Salary,11485.38808
40333,820036533,03-06-24 11:28,453.48,Purchase,Restaurant,11031.90808
40334,820036533,03-06-24 15:28,510.73,Withdrawal,Mobile App Withdrawal,10521.17808
40335,820036533,03-06-24 21:28,1800,Payment,Credit Card Payment,8721.178082
40336,820036533,03-08-24 16:28,382.59,OnlineShopping,Target,8338.588082
40337,820036533,03-09-24 10:28,200.47,Withdrawal,Mobile App Withdrawal,8138.118082
40338,820036533,03-10-24 12:28,744.18,Return,Store Return,8882.298082
40339,820036533,03-10-24 21:28,4400,Payment,Rent Payment,4482.298082
40340,820036533,03-12-24 16:28,188.91,Return,Best Buy Return,4671.208082
40341,820036533,3-15-24 18:28,211.81,Withdrawal,Branch Withdrawal,4459.398082
40342,820036533,3-16-24 22:28,386.54,OutgoingTransfer,International Transfer,4072.858082
40343,820036533,3-19-24 18:28,533.11,Deposit,Direct Deposit,4605.968082
40344,820036533,3-20-24 13:28,528.03,OnlineShopping,Amazon,4077.938082
40345,820036533,3-22-24 12:28,195.61,OnlineShopping,AliExpress,3882.328082
40346,820036533,3-24-24 22:28,165.35,OnlineShopping,Amazon,3716.978082
40347,820036533,3-26-24 10:28,419.75,Withdrawal,Branch Withdrawal,3297.228082
40348,820036533,3-26-24 20:28,700.97,Payment,Loan Payment,2596.258082
40349,820036533,3-28-24 19:28,313.97,Deposit,Direct Deposit,2910.228082
40350,820036533,3-28-24 20:28,523.61,Purchase,Furniture,2386.618082
40351,820036533,3-29-24 10:28,693.23,Purchase,Home Improvement,1693.388082
40352,820036533,3-29-24 13:28,403.38,IncomingTransfer,Freelance Payment,2096.768082
40353,820036533,3-30-24 21:28,313.77,Deposit,Direct Deposit,2410.538082
40354,820036533,04-01-24 21:28,8600,IncomingTransfer,Salary,11010.53808
40355,820036533,04-02-24 10:28,382.61,IncomingTransfer,Freelance Payment,11393.14808
40356,820036533,04-04-24 11:28,699.74,Deposit,Cash Deposit,12092.88808
40357,820036533,04-05-24 10:28,432.35,Withdrawal,ATM Withdrawal,11660.53808
40358,820036533,04-06-24 21:28,2000,Payment,Credit Card Payment,9660.538082
40359,820036533,04-10-24 15:28,627.17,Payment,Bill Payment,9033.368082
40360,820036533,4-15-24 21:28,2800,Payment,Rent Payment,6233.368082
40361,820036533,4-17-24 11:28,628.86,Payment,Mortgage Payment,5604.508082
40362,820036533,4-27-24 13:28,507.03,Deposit,Mobile Deposit,6111.538082
40363,820036533,4-27-24 16:28,557.9,Return,Target Return,6669.438082
40364,820036533,4-28-24 12:28,398.89,Deposit,Cash Deposit,7068.328082
40365,820036533,4-28-24 13:28,461.31,Deposit,Direct Deposit,7529.638082
40366,820036533,4-29-24 22:28,705.16,Deposit,Check Deposit,8234.798082
40367,820036533,4-30-24 14:28,483.72,Withdrawal,Branch Withdrawal,7751.078082
40368,820036533,05-03-24 12:28,610.82,Payment,Mortgage Payment,7140.258082
40369,820036533,05-04-24 13:28,264.52,Deposit,Cash Deposit,7404.778082
40370,820036533,05-05-24 21:28,8600,IncomingTransfer,Salary,16004.77808
40371,820036533,05-09-24 16:28,502.02,Return,Walmart Return,16506.79808
40372,820036533,05-10-24 21:28,1900,Payment,Credit Card Payment,14606.79808
40373,820036533,05-11-24 21:28,3500,Payment,Rent Payment,11106.79808
40374,820036533,5-13-24 13:28,146,IncomingTransfer,Freelance Payment,11252.79808
40375,820036533,5-14-24 14:28,376.16,Purchase,Travel,10876.63808
40376,820036533,5-14-24 20:28,342.89,Purchase,Home Improvement,10533.74808
40377,820036533,5-14-24 23:28,152.41,Deposit,Check Deposit,10686.15808
40378,820036533,5-15-24 14:28,521.16,Return,Target Return,11207.31808
40379,820036533,5-18-24 20:28,525.79,Deposit,Mobile Deposit,11733.10808
40380,820036533,5-20-24 21:28,514.24,Purchase,Electronics,11218.86808
40381,820036533,5-22-24 19:28,254.64,Withdrawal,ATM Withdrawal,10964.22808
40382,820036533,5-23-24 18:28,130.38,Purchase,Home Improvement,10833.84808
40383,820036533,5-27-24 23:28,613.32,OutgoingTransfer,Wire Transfer,10220.52808
40384,820036533,5-28-24 14:28,361.43,Withdrawal,Branch Withdrawal,9859.098082
40385,820036533,5-29-24 10:28,546.08,Purchase,Home Improvement,9313.018082
40386,820036533,5-29-24 12:28,318.74,OutgoingTransfer,Bank Transfer,8994.278082
40387,820036533,06-01-24 10:28,474.2,Purchase,Gas,8520.078082
40388,820036533,06-01-24 15:28,311.88,Withdrawal,Branch Withdrawal,8208.198082
40389,820036533,06-03-24 18:28,398.12,Payment,Loan Payment,7810.078082
40390,820036533,06-05-24 21:28,8600,IncomingTransfer,Salary,16410.07808
40391,820036533,06-10-24 18:28,216.34,Withdrawal,ATM Withdrawal,16193.73808
40392,820036533,06-10-24 21:28,1700,Payment,Credit Card Payment,14493.73808
40393,820036533,06-11-24 11:28,437.77,OnlineShopping,Best Buy,14055.96808
40394,820036533,06-12-24 21:28,487.33,Payment,Bill Payment,13568.63808
40395,820036533,6-14-24 13:28,693.31,Purchase,Entertainment,12875.32808
40396,820036533,6-18-24 17:28,371.46,Purchase,Pharmacy,12503.86808
40397,820036533,6-18-24 21:28,3100,Payment,Rent Payment,9403.868082
40398,820036533,6-19-24 16:28,574.04,OutgoingTransfer,Wire Transfer,8829.828082
40399,820036533,6-20-24 10:28,592.6,OnlineShopping,eBay,8237.228082
40400,820036533,6-20-24 21:28,344.69,Return,Target Return,8581.918082
40401,820036533,6-21-24 22:28,642.93,OutgoingTransfer,Peer-to-Peer Transfer,7938.988082
40402,820036533,6-26-24 12:28,234.28,IncomingTransfer,Freelance Payment,8173.268082
40403,820036533,6-28-24 19:28,622.39,Deposit,Cash Deposit,8795.658082
40404,820036533,07-02-24 21:28,8600,IncomingTransfer,Salary,17395.65808
40405,820036533,07-04-24 13:28,477.89,Return,Walmart Return,17873.54808
40406,820036533,07-06-24 12:28,136.86,Deposit,Mobile Deposit,18010.40808
40407,820036533,07-07-24 21:28,1900,Payment,Credit Card Payment,16110.40808
40408,820036533,07-11-24 15:28,481.47,Deposit,Check Deposit,16591.87808
40409,820036533,07-12-24 23:28,174.83,Payment,Mortgage Payment,16417.04808
40410,820036533,7-16-24 21:28,3200,Payment,Rent Payment,13217.04808
40411,820036533,7-17-24 13:28,339.4,Return,Best Buy Return,13556.44808
40412,820085808,1-21-24 21:28,27.75,Deposit,Check Deposit,898.0470963
40413,820085808,1-22-24 11:28,49.74,Purchase,Furniture,848.3070963
40414,820085808,1-22-24 16:28,107.71,Withdrawal,Mobile App Withdrawal,740.5970963
40415,820085808,1-23-24 13:28,24.7,Purchase,Grocery,715.8970963
40416,820085808,02-01-24 12:28,221.98,Withdrawal,ATM Withdrawal,493.9170963
40417,820085808,02-01-24 12:28,79.82,Purchase,Entertainment,414.0970963
40418,820085808,02-02-24 10:28,121.37,Purchase,Electronics,292.7270963
40419,820085808,02-02-24 16:28,244.86,Deposit,Direct Deposit,537.5870963
40420,820085808,02-03-24 20:28,115.02,Deposit,Check Deposit,652.6070963
40421,820085808,02-03-24 21:28,2250,IncomingTransfer,Salary,2902.607096
40422,820085808,02-05-24 19:28,201.36,Purchase,Gas,2701.247096
40423,820085808,02-07-24 16:28,17.88,Deposit,Cash Deposit,2719.127096
40424,820085808,02-08-24 21:28,1800,Payment,Credit Card Payment,919.1270963
40425,820085808,02-09-24 17:28,173.61,OutgoingTransfer,International Transfer,745.5170963
40426,820085808,02-09-24 19:28,86.06,Purchase,Gas,659.4570963
40427,820085808,02-12-24 18:28,164.17,Payment,Mortgage Payment,495.2870963
40428,820085808,2-13-24 21:28,29.62,OnlineShopping,Best Buy,465.6670963
40429,820085808,2-13-24 23:28,107.1,Payment,Mortgage Payment,358.5670963
40430,820085808,2-14-24 23:28,40.97,OutgoingTransfer,Wire Transfer,317.5970963
40431,820085808,2-16-24 21:28,1100,Payment,Rent Payment,-782.4029037
40432,820085808,2-19-24 18:28,184.19,Purchase,Entertainment,-966.5929037
40433,820085808,2-21-24 14:28,10.11,Return,Walmart Return,-956.4829037
40434,820085808,03-03-24 11:28,41.04,Purchase,Furniture,-997.5229037
40435,820085808,03-03-24 21:28,2250,IncomingTransfer,Salary,1252.477096
40436,820085808,03-04-24 13:28,77.08,Purchase,Grocery,1175.397096
40437,820085808,03-04-24 18:28,49.74,Deposit,Direct Deposit,1225.137096
40438,820085808,03-08-24 21:28,1600,Payment,Credit Card Payment,-374.8629037
40439,820085808,03-10-24 22:28,157.24,OutgoingTransfer,Bank Transfer,-532.1029037
40440,820085808,3-13-24 23:28,53.25,Deposit,Check Deposit,-478.8529037
40441,820085808,3-16-24 12:28,228.74,Purchase,Gas,-707.5929037
40442,820085808,3-17-24 11:28,207.04,OnlineShopping,AliExpress,-914.6329037
40443,820085808,3-17-24 21:28,600,Payment,Rent Payment,-1514.632904
40444,820085808,3-18-24 16:28,217.01,Payment,Loan Payment,-1731.642904
40445,820085808,3-20-24 13:28,198.71,IncomingTransfer,Freelance Payment,-1532.932904
40446,820085808,3-23-24 10:28,69.82,Deposit,Cash Deposit,-1463.112904
40447,820085808,3-23-24 17:28,21.94,Payment,Bill Payment,-1485.052904
40448,820085808,3-26-24 15:28,93.38,Purchase,Grocery,-1578.432904
40449,820085808,3-26-24 21:28,140.04,Return,Target Return,-1438.392904
40450,820085808,3-27-24 18:28,90.36,Withdrawal,Branch Withdrawal,-1528.752904
40451,820085808,3-30-24 16:28,128.72,Payment,Mortgage Payment,-1657.472904
40452,820085808,3-30-24 17:28,136.27,Return,Etsy Return,-1521.202904
40453,820085808,3-31-24 22:28,119.65,Payment,Bill Payment,-1640.852904
40454,820085808,04-03-24 16:28,70.42,Deposit,Cash Deposit,-1570.432904
40455,820085808,04-04-24 21:28,2250,IncomingTransfer,Salary,679.5670963
40456,820085808,04-05-24 20:28,229.35,Withdrawal,ATM Withdrawal,450.2170963
40457,820085808,04-07-24 22:28,210.53,Deposit,Direct Deposit,660.7470963
40458,820085808,04-09-24 21:28,1800,Payment,Credit Card Payment,-1139.252904
40459,820085808,04-09-24 21:28,36.76,Purchase,Gas,-1176.012904
40460,820085808,04-12-24 16:28,223.9,Return,eBay Return,-952.1129037
40461,820085808,04-12-24 18:28,11.77,Purchase,Pharmacy,-963.8829037
40462,820085808,4-13-24 20:28,141.37,IncomingTransfer,Freelance Payment,-822.5129037
40463,820085808,4-14-24 12:28,163.16,Return,eBay Return,-659.3529037
40464,820085808,4-15-24 21:28,1000,Payment,Rent Payment,-1659.352904
40465,820085808,4-16-24 13:28,110.02,Payment,Bill Payment,-1769.372904
40466,820085808,4-17-24 13:28,199.36,Deposit,Direct Deposit,-1570.012904
40467,820085808,4-17-24 15:28,94.61,Deposit,Cash Deposit,-1475.402904
40468,820085808,4-17-24 20:28,214.84,Deposit,Cash Deposit,-1260.562904
40469,820085808,4-19-24 9:28,25.67,Purchase,Pharmacy,-1286.232904
40470,820085808,4-25-24 16:28,208.54,Payment,Bill Payment,-1494.772904
40471,820085808,05-01-24 22:28,46.88,OnlineShopping,Best Buy,-1541.652904
40472,820085808,05-02-24 20:28,225.07,Withdrawal,ATM Withdrawal,-1766.722904
40473,820085808,05-03-24 21:28,2250,IncomingTransfer,Salary,483.2770963
40474,820085808,05-04-24 10:28,164.38,Withdrawal,Branch Withdrawal,318.8970963
40475,820085808,05-06-24 16:28,244.97,IncomingTransfer,Freelance Payment,563.8670963
40476,820085808,05-08-24 21:28,1900,Payment,Credit Card Payment,-1336.132904
40477,820085808,05-11-24 13:28,150.42,Payment,Mortgage Payment,-1486.552904
40478,820085808,5-15-24 21:28,900,Payment,Rent Payment,-2386.552904
40479,820085808,5-15-24 23:28,66.78,Deposit,Cash Deposit,-2319.772904
40480,820085808,5-21-24 12:28,33.38,Return,Best Buy Return,-2286.392904
40481,820085808,5-21-24 16:28,97.86,Payment,Bill Payment,-2384.252904
40482,820085808,5-25-24 15:28,217.74,Purchase,Furniture,-2601.992904
40483,820085808,5-28-24 9:28,79.79,Deposit,Check Deposit,-2522.202904
40484,820085808,5-28-24 20:28,185.64,OnlineShopping,Target,-2707.842904
40485,820085808,5-30-24 17:28,39.8,Return,Target Return,-2668.042904
40486,820085808,06-01-24 19:28,52.4,OnlineShopping,Etsy,-2720.442904
40487,820085808,06-02-24 14:28,35.13,Deposit,Mobile Deposit,-2685.312904
40488,820085808,06-03-24 19:28,173.59,Deposit,Check Deposit,-2511.722904
40489,820085808,06-04-24 14:28,55.57,OutgoingTransfer,Peer-to-Peer Transfer,-2567.292904
40490,820085808,06-04-24 21:28,2250,IncomingTransfer,Salary,-317.2929037
40491,820085808,06-09-24 21:28,1700,Payment,Credit Card Payment,-2017.292904
40492,820085808,06-11-24 12:28,207.07,Withdrawal,Branch Withdrawal,-2224.362904
40493,820085808,06-11-24 21:28,900,Payment,Rent Payment,-3124.362904
40494,820085808,6-15-24 20:28,95.79,OutgoingTransfer,International Transfer,-3220.152904
40495,820085808,6-17-24 17:28,229.08,Deposit,Cash Deposit,-2991.072904
40496,820085808,6-18-24 17:28,75.18,OnlineShopping,AliExpress,-3066.252904
40497,820085808,6-20-24 10:28,139.47,Purchase,Clothing,-3205.722904
40498,820085808,6-22-24 10:28,134.8,Withdrawal,Mobile App Withdrawal,-3340.522904
40499,820085808,6-22-24 17:28,72.19,IncomingTransfer,Freelance Payment,-3268.332904
40500,820085808,6-25-24 16:28,25.09,Deposit,Mobile Deposit,-3243.242904
40501,820085808,6-26-24 14:28,112.94,OnlineShopping,eBay,-3356.182904
40502,820085808,6-27-24 11:28,68.16,OutgoingTransfer,Peer-to-Peer Transfer,-3424.342904
40503,820085808,6-29-24 11:28,21.02,Payment,Loan Payment,-3445.362904
40504,820085808,07-05-24 14:28,152.53,Deposit,Check Deposit,-3292.832904
40505,820085808,07-05-24 21:28,2250,IncomingTransfer,Salary,-1042.832904
40506,820085808,07-07-24 10:28,56.62,Deposit,Mobile Deposit,-986.2129037
40507,820085808,07-07-24 10:28,134.64,Purchase,Gas,-1120.852904
40508,820085808,07-08-24 17:28,179.84,Deposit,Cash Deposit,-941.0129037
40509,820085808,07-10-24 15:28,196.04,IncomingTransfer,Freelance Payment,-744.9729037
40510,820085808,07-10-24 21:28,1600,Payment,Credit Card Payment,-2344.972904
40511,820085808,07-11-24 9:28,111.55,Return,Etsy Return,-2233.422904
40512,820085808,07-12-24 16:28,143.29,OutgoingTransfer,Wire Transfer,-2376.712904
40513,820085808,7-13-24 14:28,135.21,Return,Walmart Return,-2241.502904
40514,820085808,7-14-24 18:28,45.63,Payment,Mortgage Payment,-2287.132904
40515,820085808,7-14-24 21:28,1100,Payment,Rent Payment,-3387.132904
40516,820639908,1-24-24 22:28,62.02,Purchase,Pharmacy,1822.543204
40517,820639908,1-25-24 9:28,451.1,Return,Target Return,2273.643204
40518,820639908,02-01-24 11:28,286.45,Return,Etsy Return,2560.093204
40519,820639908,02-02-24 17:28,211.8,OnlineShopping,Best Buy,2348.293204
40520,820639908,02-02-24 21:28,446.12,Purchase,Electronics,1902.173204
40521,820639908,02-04-24 14:28,110.68,Withdrawal,Mobile App Withdrawal,1791.493204
40522,820639908,02-04-24 20:28,230.96,Purchase,Restaurant,1560.533204
40523,820639908,02-05-24 18:28,17.16,Withdrawal,Branch Withdrawal,1543.373204
40524,820639908,02-07-24 16:28,270.22,Withdrawal,Branch Withdrawal,1273.153204
40525,820639908,02-07-24 18:28,201.29,Return,Store Return,1474.443204
40526,820639908,02-08-24 14:28,73.05,Deposit,Mobile Deposit,1547.493204
40527,820639908,02-09-24 13:28,276.97,Deposit,Cash Deposit,1824.463204
40528,820639908,02-10-24 17:28,255.45,Deposit,Direct Deposit,2079.913204
40529,820639908,2-13-24 14:28,250.25,Return,Etsy Return,2330.163204
40530,820639908,2-13-24 18:28,498.33,Purchase,Electronics,1831.833204
40531,820639908,2-14-24 14:28,220.2,OnlineShopping,Etsy,1611.633204
40532,820639908,2-21-24 17:28,26.81,Return,AliExpress Return,1638.443204
40533,820639908,2-24-24 13:28,419.29,Withdrawal,ATM Withdrawal,1219.153204
40534,820639908,2-25-24 18:28,471.46,Purchase,Furniture,747.6932036
40535,820639908,2-25-24 21:28,220.76,Deposit,Direct Deposit,968.4532036
40536,820639908,2-25-24 22:28,407.74,IncomingTransfer,Freelance Payment,1376.193204
40537,820639908,03-06-24 11:28,16.78,OutgoingTransfer,International Transfer,1359.413204
40538,820639908,03-07-24 10:28,305.56,Return,Etsy Return,1664.973204
40539,820639908,03-09-24 15:28,129.8,Deposit,Cash Deposit,1794.773204
40540,820639908,3-16-24 12:28,279.93,Purchase,Gas,1514.843204
40541,820639908,3-16-24 20:28,316.6,Deposit,Check Deposit,1831.443204
40542,820639908,3-16-24 20:28,311.1,Deposit,Check Deposit,2142.543204
40543,820639908,3-19-24 11:28,337.22,Purchase,Clothing,1805.323204
40544,820639908,3-20-24 14:28,417.86,Withdrawal,Branch Withdrawal,1387.463204
40545,820639908,04-03-24 16:28,456.74,IncomingTransfer,Freelance Payment,1844.203204
40546,820639908,04-04-24 22:28,362.42,IncomingTransfer,Freelance Payment,2206.623204
40547,820639908,04-06-24 14:28,325.51,Purchase,Pharmacy,1881.113204
40548,820639908,04-06-24 15:28,231.93,OutgoingTransfer,Bank Transfer,1649.183204
40549,820639908,04-06-24 16:28,30.43,Deposit,Check Deposit,1679.613204
40550,820639908,04-09-24 21:28,43.3,Purchase,Furniture,1636.313204
40551,820639908,04-12-24 14:28,320.68,Return,AliExpress Return,1956.993204
40552,820639908,4-14-24 15:28,479.99,IncomingTransfer,Freelance Payment,2436.983204
40553,820639908,4-15-24 20:28,491.41,Purchase,Pharmacy,1945.573204
40554,820639908,4-17-24 20:28,437.19,Deposit,Mobile Deposit,2382.763204
40555,820639908,4-18-24 22:28,471.76,OnlineShopping,Target,1911.003204
40556,820639908,4-19-24 11:28,365.33,OnlineShopping,eBay,1545.673204
40557,820639908,4-20-24 13:28,370.69,Purchase,Travel,1174.983204
40558,820639908,4-22-24 13:28,307.55,Payment,Bill Payment,867.4332036
40559,820639908,4-23-24 21:28,120.81,OutgoingTransfer,Peer-to-Peer Transfer,746.6232036
40560,820639908,4-25-24 22:28,377.17,Withdrawal,Branch Withdrawal,369.4532036
40561,820639908,4-28-24 14:28,32.71,Deposit,Direct Deposit,402.1632036
40562,820639908,05-01-24 9:28,59.43,OnlineShopping,AliExpress,342.7332036
40563,820639908,05-02-24 19:28,113.91,Withdrawal,Mobile App Withdrawal,228.8232036
40564,820639908,05-03-24 18:28,382.51,OutgoingTransfer,Wire Transfer,-153.6867964
40565,820639908,05-05-24 20:28,392.06,Deposit,Cash Deposit,238.3732036
40566,820639908,05-06-24 18:28,485.99,OnlineShopping,Best Buy,-247.6167964
40567,820639908,05-08-24 11:28,379.47,Withdrawal,Branch Withdrawal,-627.0867964
40568,820639908,05-09-24 9:28,131.96,Payment,Bill Payment,-759.0467964
40569,820639908,5-18-24 12:28,10.51,Return,AliExpress Return,-748.5367964
40570,820639908,5-24-24 13:28,383.31,OutgoingTransfer,Bank Transfer,-1131.846796
40571,820639908,5-25-24 16:28,497.93,Return,Store Return,-633.9167964
40572,820639908,5-26-24 19:28,79.68,OutgoingTransfer,Wire Transfer,-713.5967964
40573,820639908,5-29-24 10:28,342.37,IncomingTransfer,Freelance Payment,-371.2267964
40574,820639908,5-31-24 13:28,198.4,Withdrawal,ATM Withdrawal,-569.6267964
40575,820639908,5-31-24 21:28,392.84,Withdrawal,ATM Withdrawal,-962.4667964
40576,820639908,06-02-24 12:28,465.21,Purchase,Gas,-1427.676796
40577,820639908,06-05-24 9:28,75.08,Deposit,Check Deposit,-1352.596796
40578,820639908,06-11-24 17:28,208.94,Return,Walmart Return,-1143.656796
40579,820639908,06-12-24 23:28,92.72,Payment,Mortgage Payment,-1236.376796
40580,820639908,6-13-24 15:28,259.82,Deposit,Cash Deposit,-976.5567964
40581,820639908,6-17-24 11:28,60.16,Purchase,Travel,-1036.716796
40582,820639908,6-20-24 18:28,22.37,Purchase,Pharmacy,-1059.086796
40583,820639908,6-22-24 19:28,383.31,Purchase,Clothing,-1442.396796
40584,820639908,6-24-24 18:28,239.85,Purchase,Entertainment,-1682.246796
40585,820639908,6-25-24 12:28,53.07,Payment,Mortgage Payment,-1735.316796
40586,820639908,6-29-24 13:28,359.26,Payment,Mortgage Payment,-2094.576796
40587,820639908,6-30-24 14:28,462.67,IncomingTransfer,Freelance Payment,-1631.906796
40588,820639908,6-30-24 21:28,469.78,Withdrawal,ATM Withdrawal,-2101.686796
40589,820639908,07-03-24 19:28,16.61,Purchase,Entertainment,-2118.296796
40590,820639908,07-05-24 13:28,115.11,OnlineShopping,Target,-2233.406796
40591,820639908,07-10-24 11:28,315.77,OutgoingTransfer,Peer-to-Peer Transfer,-2549.176796
40592,820639908,07-10-24 13:28,484.38,OnlineShopping,Etsy,-3033.556796
40593,820639908,07-11-24 13:28,29.57,Deposit,Check Deposit,-3003.986796
40594,820639908,7-13-24 15:28,103.89,Purchase,Gas,-3107.876796
40595,820639908,7-14-24 14:28,176.32,OnlineShopping,eBay,-3284.196796
40596,820639908,7-15-24 23:28,296.22,Purchase,Pharmacy,-3580.416796
40597,823848183,1-23-24 18:28,159.46,Withdrawal,ATM Withdrawal,634.0495486
40598,823848183,1-27-24 12:28,140.85,Deposit,Direct Deposit,774.8995486
40599,823848183,1-29-24 10:28,178.52,OutgoingTransfer,Wire Transfer,596.3795486
40600,823848183,1-31-24 17:28,57.94,Return,eBay Return,654.3195486
40601,823848183,02-02-24 11:28,105.92,Payment,Loan Payment,548.3995486
40602,823848183,02-05-24 15:28,57.66,OutgoingTransfer,International Transfer,490.7395486
40603,823848183,02-05-24 21:28,2600,IncomingTransfer,Salary,3090.739549
40604,823848183,02-06-24 20:28,92.85,OutgoingTransfer,Bank Transfer,2997.889549
40605,823848183,02-07-24 11:28,120.72,Return,AliExpress Return,3118.609549
40606,823848183,02-08-24 12:28,87.78,Withdrawal,Branch Withdrawal,3030.829549
40607,823848183,02-09-24 21:28,32.83,Return,AliExpress Return,3063.659549
40608,823848183,02-10-24 21:28,2100,Payment,Credit Card Payment,963.6595486
40609,823848183,02-10-24 21:28,241.45,Return,Etsy Return,1205.109549
40610,823848183,02-11-24 17:28,232.67,Purchase,Grocery,972.4395486
40611,823848183,2-13-24 23:28,104.92,Deposit,Check Deposit,1077.359549
40612,823848183,2-14-24 15:28,40.55,Purchase,Electronics,1036.809549
40613,823848183,2-15-24 16:28,45.22,Return,Best Buy Return,1082.029549
40614,823848183,2-15-24 21:28,1100,Payment,Rent Payment,-17.97045143
40615,823848183,2-17-24 19:28,121.81,OnlineShopping,Best Buy,-139.7804514
40616,823848183,2-20-24 11:28,188.31,Withdrawal,Branch Withdrawal,-328.0904514
40617,823848183,2-23-24 16:28,207.38,Purchase,Home Improvement,-535.4704514
40618,823848183,2-24-24 19:28,50.7,Return,eBay Return,-484.7704514
40619,823848183,2-28-24 12:28,87.24,Withdrawal,ATM Withdrawal,-572.0104514
40620,823848183,2-29-24 21:28,110.14,Return,Etsy Return,-461.8704514
40621,823848183,03-01-24 21:28,2600,IncomingTransfer,Salary,2138.129549
40622,823848183,03-02-24 18:28,88.4,Withdrawal,Mobile App Withdrawal,2049.729549
40623,823848183,03-03-24 18:28,48.04,IncomingTransfer,Freelance Payment,2097.769549
40624,823848183,03-04-24 15:28,176.27,Deposit,Check Deposit,2274.039549
40625,823848183,03-06-24 10:28,174.59,Withdrawal,Branch Withdrawal,2099.449549
40626,823848183,03-06-24 21:28,1500,Payment,Credit Card Payment,599.4495486
40627,823848183,03-08-24 23:28,178.49,Deposit,Direct Deposit,777.9395486
40628,823848183,03-09-24 12:28,66.27,Withdrawal,Branch Withdrawal,711.6695486
40629,823848183,03-09-24 18:28,136.11,IncomingTransfer,Freelance Payment,847.7795486
40630,823848183,03-12-24 12:28,178.22,Withdrawal,Branch Withdrawal,669.5595486
40631,823848183,3-15-24 15:28,66.1,IncomingTransfer,Freelance Payment,735.6595486
40632,823848183,3-15-24 22:28,232.24,Deposit,Check Deposit,967.8995486
40633,823848183,3-16-24 18:28,20.47,Deposit,Direct Deposit,988.3695486
40634,823848183,3-17-24 10:28,226.46,OutgoingTransfer,Peer-to-Peer Transfer,761.9095486
40635,823848183,3-18-24 9:28,40.5,Deposit,Direct Deposit,802.4095486
40636,823848183,3-18-24 21:28,800,Payment,Rent Payment,2.409548567
40637,823848183,3-23-24 18:28,66.67,OnlineShopping,Amazon,-64.26045143
40638,823848183,3-24-24 11:28,169,Purchase,Furniture,-233.2604514
40639,823848183,3-24-24 16:28,192.21,IncomingTransfer,Freelance Payment,-41.05045143
40640,823848183,3-26-24 21:28,107.93,IncomingTransfer,Freelance Payment,66.87954857
40641,823848183,3-30-24 11:28,65.04,Purchase,Entertainment,1.839548567
40642,823848183,3-31-24 21:28,178.34,Deposit,Direct Deposit,180.1795486
40643,823848183,04-01-24 12:28,16.3,OnlineShopping,AliExpress,163.8795486
40644,823848183,04-01-24 16:28,51.24,Purchase,Furniture,112.6395486
40645,823848183,04-01-24 19:28,53.51,Withdrawal,Branch Withdrawal,59.12954857
40646,823848183,04-01-24 23:28,42.3,IncomingTransfer,Freelance Payment,101.4295486
40647,823848183,04-02-24 13:28,56.15,Withdrawal,Branch Withdrawal,45.27954857
40648,823848183,04-03-24 21:28,2600,IncomingTransfer,Salary,2645.279549
40649,823848183,04-07-24 17:28,73.98,Withdrawal,Branch Withdrawal,2571.299549
40650,823848183,04-08-24 21:28,1500,Payment,Credit Card Payment,1071.299549
40651,823848183,04-09-24 9:28,35.28,Purchase,Gas,1036.019549
40652,823848183,04-09-24 12:28,43.45,OnlineShopping,Best Buy,992.5695486
40653,823848183,04-09-24 15:28,180.26,Return,Best Buy Return,1172.829549
40654,823848183,04-10-24 21:28,1000,Payment,Rent Payment,172.8295486
40655,823848183,04-12-24 20:28,232.57,Deposit,Check Deposit,405.3995486
40656,823848183,4-14-24 12:28,231.1,Return,Etsy Return,636.4995486
40657,823848183,4-22-24 13:28,20.06,Deposit,Check Deposit,656.5595486
40658,823848183,4-23-24 9:28,92.47,OnlineShopping,eBay,564.0895486
40659,823848183,4-23-24 9:28,86.07,IncomingTransfer,Freelance Payment,650.1595486
40660,823848183,4-23-24 14:28,203.6,Payment,Bill Payment,446.5595486
40661,823848183,4-26-24 11:28,49.08,OnlineShopping,Target,397.4795486
40662,823848183,4-27-24 20:28,180.57,OnlineShopping,AliExpress,216.9095486
40663,823848183,4-28-24 19:28,175.55,Deposit,Cash Deposit,392.4595486
40664,823848183,4-29-24 22:28,19.8,Withdrawal,ATM Withdrawal,372.6595486
40665,823848183,05-01-24 22:28,59.37,OnlineShopping,Target,313.2895486
40666,823848183,05-02-24 11:28,71.77,Withdrawal,Mobile App Withdrawal,241.5195486
40667,823848183,05-03-24 20:28,27.44,Deposit,Cash Deposit,268.9595486
40668,823848183,05-04-24 11:28,127.8,OutgoingTransfer,Wire Transfer,141.1595486
40669,823848183,05-05-24 21:28,2600,IncomingTransfer,Salary,2741.159549
40670,823848183,05-07-24 19:28,81.69,Withdrawal,Mobile App Withdrawal,2659.469549
40671,823848183,05-10-24 12:28,207.35,OutgoingTransfer,Peer-to-Peer Transfer,2452.119549
40672,823848183,05-10-24 21:28,1800,Payment,Credit Card Payment,652.1195486
40673,823848183,05-10-24 21:28,1200,Payment,Rent Payment,-547.8804514
40674,823848183,05-12-24 17:28,20.64,Purchase,Electronics,-568.5204514
40675,823848183,5-16-24 14:28,164.08,Payment,Bill Payment,-732.6004514
40676,823848183,5-17-24 11:28,120.31,OutgoingTransfer,International Transfer,-852.9104514
40677,823848183,5-17-24 23:28,39.07,OutgoingTransfer,Bank Transfer,-891.9804514
40678,823848183,5-20-24 15:28,71.65,Deposit,Direct Deposit,-820.3304514
40679,823848183,5-20-24 20:28,58.15,OnlineShopping,AliExpress,-878.4804514
40680,823848183,5-21-24 14:28,43.61,Deposit,Check Deposit,-834.8704514
40681,823848183,5-23-24 17:28,101.69,OutgoingTransfer,Wire Transfer,-936.5604514
40682,823848183,5-24-24 12:28,21.46,Purchase,Home Improvement,-958.0204514
40683,823848183,5-24-24 16:28,163.57,Withdrawal,Branch Withdrawal,-1121.590451
40684,823848183,06-02-24 10:28,59.27,Deposit,Cash Deposit,-1062.320451
40685,823848183,06-04-24 18:28,187.06,Deposit,Mobile Deposit,-875.2604514
40686,823848183,06-04-24 21:28,2600,IncomingTransfer,Salary,1724.739549
40687,823848183,06-09-24 18:28,72.02,OnlineShopping,Walmart,1652.719549
40688,823848183,06-09-24 21:28,1800,Payment,Credit Card Payment,-147.2804514
40689,823848183,6-13-24 18:28,132.23,Withdrawal,Mobile App Withdrawal,-279.5104514
40690,823848183,6-14-24 21:28,1000,Payment,Rent Payment,-1279.510451
40691,823848183,6-18-24 12:28,229.35,OnlineShopping,AliExpress,-1508.860451
40692,823848183,6-20-24 15:28,171.83,OutgoingTransfer,International Transfer,-1680.690451
40693,823848183,6-22-24 22:28,108.43,Return,eBay Return,-1572.260451
40694,823848183,6-28-24 19:28,174.16,Payment,Mortgage Payment,-1746.420451
40695,823848183,6-30-24 13:28,115.55,IncomingTransfer,Freelance Payment,-1630.870451
40696,823848183,07-02-24 21:28,2600,IncomingTransfer,Salary,969.1295486
40697,823848183,07-05-24 16:28,245.47,Payment,Bill Payment,723.6595486
40698,823848183,07-06-24 16:28,65.52,Deposit,Cash Deposit,789.1795486
40699,823848183,07-07-24 21:28,1900,Payment,Credit Card Payment,-1110.820451
40700,823848183,07-08-24 16:28,151.55,Deposit,Cash Deposit,-959.2704514
40701,823848183,07-08-24 20:28,74.51,OutgoingTransfer,Bank Transfer,-1033.780451
40702,823848183,07-09-24 18:28,153.62,Payment,Bill Payment,-1187.400451
40703,823848183,07-11-24 21:28,900,Payment,Rent Payment,-2087.400451
40704,823848183,7-14-24 12:28,81.55,Withdrawal,ATM Withdrawal,-2168.950451
40705,823848183,7-15-24 11:28,173.05,OnlineShopping,AliExpress,-2342.000451
40706,823848183,7-17-24 10:28,147.13,IncomingTransfer,Freelance Payment,-2194.870451
40707,826130133,02-04-24 21:28,11950,IncomingTransfer,Salary,13061.00634
40708,826130133,02-09-24 21:28,2700,Payment,Credit Card Payment,10361.00634
40709,826130133,2-18-24 21:28,5700,Payment,Rent Payment,4661.006345
40710,826130133,2-28-24 16:28,222.68,OutgoingTransfer,International Transfer,4438.326345
40711,826130133,03-03-24 18:28,811.85,Purchase,Grocery,3626.476345
40712,826130133,03-03-24 21:28,11950,IncomingTransfer,Salary,15576.47634
40713,826130133,03-07-24 17:28,760.87,Withdrawal,Mobile App Withdrawal,14815.60634
40714,826130133,03-08-24 21:28,1900,Payment,Credit Card Payment,12915.60634
40715,826130133,03-11-24 21:28,245.14,Deposit,Cash Deposit,13160.74634
40716,826130133,3-16-24 21:28,4400,Payment,Rent Payment,8760.746345
40717,826130133,3-18-24 13:28,872.35,Return,Store Return,9633.096345
40718,826130133,3-23-24 17:28,443.76,Purchase,Restaurant,9189.336345
40719,826130133,3-28-24 20:28,815.2,Purchase,Clothing,8374.136345
40720,826130133,04-02-24 12:28,485.71,OutgoingTransfer,Wire Transfer,7888.426345
40721,826130133,04-05-24 21:28,11950,IncomingTransfer,Salary,19838.42634
40722,826130133,04-09-24 9:28,759.29,Payment,Bill Payment,19079.13634
40723,826130133,04-10-24 21:28,2000,Payment,Credit Card Payment,17079.13634
40724,826130133,04-12-24 23:28,885.45,OutgoingTransfer,Peer-to-Peer Transfer,16193.68634
40725,826130133,4-13-24 13:28,285.34,Purchase,Furniture,15908.34634
40726,826130133,4-13-24 21:28,7300,Payment,Rent Payment,8608.346345
40727,826130133,05-01-24 22:28,944.38,Payment,Loan Payment,7663.966345
40728,826130133,05-02-24 21:28,11950,IncomingTransfer,Salary,19613.96634
40729,826130133,05-07-24 21:28,2100,Payment,Credit Card Payment,17513.96634
40730,826130133,5-14-24 21:28,7500,Payment,Rent Payment,10013.96634
40731,826130133,5-30-24 22:28,313.79,OnlineShopping,Target,9700.176345
40732,826130133,5-31-24 15:28,605.1,Payment,Bill Payment,9095.076345
40733,826130133,06-03-24 21:28,11950,IncomingTransfer,Salary,21045.07634
40734,826130133,06-08-24 21:28,2200,Payment,Credit Card Payment,18845.07634
40735,826130133,06-10-24 14:28,584.37,Withdrawal,Branch Withdrawal,18260.70634
40736,826130133,06-11-24 10:28,305.25,OutgoingTransfer,International Transfer,17955.45634
40737,826130133,06-11-24 21:28,3800,Payment,Rent Payment,14155.45634
40738,826130133,6-18-24 16:28,682.07,Deposit,Check Deposit,14837.52634
40739,826130133,6-23-24 12:28,226.24,Deposit,Cash Deposit,15063.76634
40740,826130133,6-27-24 17:28,731.81,Purchase,Pharmacy,14331.95634
40741,826130133,6-28-24 21:28,937.63,Deposit,Direct Deposit,15269.58634
40742,826130133,6-30-24 18:28,388.45,Return,AliExpress Return,15658.03634
40743,826130133,6-30-24 22:28,240.68,Purchase,Electronics,15417.35634
40744,826130133,07-04-24 21:28,11950,IncomingTransfer,Salary,27367.35634
40745,826130133,07-07-24 22:28,760.15,Purchase,Furniture,26607.20634
40746,826130133,07-09-24 21:28,2200,Payment,Credit Card Payment,24407.20634
40747,826130133,7-13-24 21:28,6900,Payment,Rent Payment,17507.20634
40748,826130133,7-15-24 17:28,309.76,Purchase,Travel,17197.44634
40749,826130133,7-16-24 21:28,378.49,Purchase,Furniture,16818.95634
40750,826417233,1-21-24 13:28,108.43,Purchase,Travel,593.4965017
40751,826417233,1-21-24 17:28,247.89,Payment,Loan Payment,345.6065017
40752,826417233,1-22-24 11:28,243.21,Payment,Mortgage Payment,102.3965017
40753,826417233,1-22-24 23:28,201.93,Deposit,Direct Deposit,304.3265017
40754,826417233,1-23-24 11:28,196.01,Withdrawal,Mobile App Withdrawal,108.3165017
40755,826417233,1-23-24 14:28,31.04,OnlineShopping,Target,77.27650169
40756,826417233,1-30-24 23:28,181.21,OutgoingTransfer,Bank Transfer,-103.9334983
40757,826417233,1-31-24 12:28,34.97,Payment,Loan Payment,-138.9034983
40758,826417233,1-31-24 21:28,183.09,IncomingTransfer,Freelance Payment,44.18650169
40759,826417233,02-01-24 21:28,2250,IncomingTransfer,Salary,2294.186502
40760,826417233,02-01-24 22:28,107.27,Withdrawal,Branch Withdrawal,2186.916502
40761,826417233,02-03-24 10:28,109.15,Return,Etsy Return,2296.066502
40762,826417233,02-06-24 21:28,1100,Payment,Credit Card Payment,1196.066502
40763,826417233,02-06-24 22:28,41.03,Deposit,Cash Deposit,1237.096502
40764,826417233,02-07-24 11:28,85.93,Payment,Bill Payment,1151.166502
40765,826417233,02-12-24 17:28,44.52,Deposit,Cash Deposit,1195.686502
40766,826417233,2-13-24 21:28,900,Payment,Subscription Payment,295.6865017
40767,826417233,2-14-24 9:28,191.54,Purchase,Entertainment,104.1465017
40768,826417233,2-14-24 17:28,104.75,Payment,Bill Payment,-0.603498308
40769,826417233,2-16-24 16:28,101.51,Withdrawal,Mobile App Withdrawal,-102.1134983
40770,826417233,2-17-24 11:28,62.08,Purchase,Pharmacy,-164.1934983
40771,826417233,2-20-24 19:28,188.73,IncomingTransfer,Freelance Payment,24.53650169
40772,826417233,2-21-24 21:28,75.59,Withdrawal,Branch Withdrawal,-51.05349831
40773,826417233,2-23-24 23:28,55.59,Purchase,Furniture,-106.6434983
40774,826417233,2-27-24 19:28,199.02,Purchase,Entertainment,-305.6634983
40775,826417233,2-28-24 21:28,150.19,Return,Target Return,-155.4734983
40776,826417233,2-29-24 19:28,22.85,OnlineShopping,Walmart,-178.3234983
40777,826417233,03-03-24 20:28,205.83,Purchase,Entertainment,-384.1534983
40778,826417233,03-03-24 21:28,2250,IncomingTransfer,Salary,1865.846502
40779,826417233,03-04-24 23:28,175.28,Withdrawal,ATM Withdrawal,1690.566502
40780,826417233,03-05-24 23:28,10.97,Deposit,Direct Deposit,1701.536502
40781,826417233,03-07-24 14:28,73.19,Purchase,Entertainment,1628.346502
40782,826417233,03-08-24 21:28,1200,Payment,Credit Card Payment,428.3465017
40783,826417233,3-13-24 19:28,98.08,Purchase,Home Improvement,330.2665017
40784,826417233,3-14-24 21:28,900,Payment,Installment Payment,-569.7334983
40785,826417233,3-17-24 21:28,124.52,OnlineShopping,Walmart,-694.2534983
40786,826417233,3-21-24 23:28,12.63,Withdrawal,Branch Withdrawal,-706.8834983
40787,826417233,3-22-24 19:28,198.49,OutgoingTransfer,Bank Transfer,-905.3734983
40788,826417233,3-23-24 21:28,108.98,Deposit,Check Deposit,-796.3934983
40789,826417233,3-26-24 10:28,85.79,Withdrawal,Mobile App Withdrawal,-882.1834983
40790,826417233,3-28-24 9:28,130.71,OutgoingTransfer,International Transfer,-1012.893498
40791,826417233,3-30-24 11:28,46.8,Purchase,Restaurant,-1059.693498
40792,826417233,04-02-24 13:28,67.53,Purchase,Furniture,-1127.223498
40793,826417233,04-05-24 11:28,164.42,OutgoingTransfer,Peer-to-Peer Transfer,-1291.643498
40794,826417233,04-05-24 21:28,2250,IncomingTransfer,Salary,958.3565017
40795,826417233,04-05-24 22:28,182.57,Withdrawal,ATM Withdrawal,775.7865017
40796,826417233,04-06-24 12:28,51.29,OnlineShopping,Etsy,724.4965017
40797,826417233,04-07-24 17:28,59.96,Return,AliExpress Return,784.4565017
40798,826417233,04-10-24 11:28,206.74,OnlineShopping,Etsy,577.7165017
40799,826417233,04-10-24 21:28,1100,Payment,Credit Card Payment,-522.2834983
40800,826417233,04-12-24 21:28,1000,Payment,Subscription Payment,-1522.283498
40801,826417233,4-15-24 23:28,142.77,Return,eBay Return,-1379.513498
40802,826417233,4-18-24 17:28,116.82,IncomingTransfer,Freelance Payment,-1262.693498
40803,826417233,4-18-24 18:28,182.46,Payment,Loan Payment,-1445.153498
40804,826417233,4-21-24 14:28,73.11,Deposit,Direct Deposit,-1372.043498
40805,826417233,4-21-24 19:28,123.58,OnlineShopping,Etsy,-1495.623498
40806,826417233,4-22-24 9:28,236.48,Return,Etsy Return,-1259.143498
40807,826417233,4-29-24 16:28,110.29,Deposit,Check Deposit,-1148.853498
40808,826417233,05-02-24 14:28,246.46,Withdrawal,Mobile App Withdrawal,-1395.313498
40809,826417233,05-05-24 21:28,2250,IncomingTransfer,Salary,854.6865017
40810,826417233,05-06-24 14:28,171.95,Purchase,Furniture,682.7365017
40811,826417233,05-09-24 23:28,115.54,OutgoingTransfer,Bank Transfer,567.1965017
40812,826417233,05-10-24 21:28,1100,Payment,Credit Card Payment,-532.8034983
40813,826417233,05-12-24 21:28,1000,Payment,Subscription Payment,-1532.803498
40814,826417233,5-16-24 9:28,156.12,OutgoingTransfer,Wire Transfer,-1688.923498
40815,826417233,5-18-24 19:28,177.71,OutgoingTransfer,International Transfer,-1866.633498
40816,826417233,5-26-24 12:28,102.41,Deposit,Direct Deposit,-1764.223498
40817,826417233,5-26-24 17:28,63.71,Return,Etsy Return,-1700.513498
40818,826417233,5-28-24 21:28,190.68,Deposit,Direct Deposit,-1509.833498
40819,826417233,5-31-24 18:28,101.34,OnlineShopping,Target,-1611.173498
40820,826417233,06-01-24 21:28,2250,IncomingTransfer,Salary,638.8265017
40821,826417233,06-02-24 21:28,179.79,Deposit,Check Deposit,818.6165017
40822,826417233,06-06-24 21:28,1400,Payment,Credit Card Payment,-581.3834983
40823,826417233,06-11-24 9:28,226.25,Purchase,Home Improvement,-807.6334983
40824,826417233,6-13-24 21:28,700,Payment,Subscription Payment,-1507.633498
40825,826417233,6-16-24 11:28,110.44,OutgoingTransfer,International Transfer,-1618.073498
40826,826417233,6-17-24 22:28,236.97,Deposit,Mobile Deposit,-1381.103498
40827,826417233,6-18-24 15:28,112.6,Return,Walmart Return,-1268.503498
40828,826417233,6-25-24 16:28,55.65,Payment,Bill Payment,-1324.153498
40829,826417233,6-26-24 12:28,171.18,Purchase,Travel,-1495.333498
40830,826417233,6-27-24 10:28,208.08,OnlineShopping,Etsy,-1703.413498
40831,826417233,6-29-24 20:28,53.11,Purchase,Entertainment,-1756.523498
40832,826417233,07-01-24 23:28,86.65,Payment,Mortgage Payment,-1843.173498
40833,826417233,07-03-24 21:28,2250,IncomingTransfer,Salary,406.8265017
40834,826417233,07-04-24 14:28,211.7,OutgoingTransfer,Bank Transfer,195.1265017
40835,826417233,07-04-24 23:28,54.3,IncomingTransfer,Freelance Payment,249.4265017
40836,826417233,07-08-24 21:28,1300,Payment,Credit Card Payment,-1050.573498
40837,826417233,7-16-24 23:28,179.81,Deposit,Check Deposit,-870.7634983
40838,826417233,7-17-24 21:28,1000,Payment,Subscription Payment,-1870.763498
40839,826473858,1-20-24 18:28,370.45,Purchase,Pharmacy,732.1469587
40840,826473858,1-27-24 16:28,280.75,OutgoingTransfer,Peer-to-Peer Transfer,451.3969587
40841,826473858,1-27-24 21:28,307.46,OnlineShopping,Best Buy,143.9369587
40842,826473858,02-03-24 21:28,4350,IncomingTransfer,Salary,4493.936959
40843,826473858,02-06-24 9:28,87.89,Withdrawal,ATM Withdrawal,4406.046959
40844,826473858,02-07-24 19:28,45.35,Return,Amazon Return,4451.396959
40845,826473858,02-08-24 21:28,2400,Payment,Credit Card Payment,2051.396959
40846,826473858,2-14-24 21:28,2000,Payment,Rent Payment,51.39695867
40847,826473858,2-19-24 19:28,291.57,Withdrawal,Mobile App Withdrawal,-240.1730413
40848,826473858,2-26-24 10:28,214.41,Payment,Bill Payment,-454.5830413
40849,826473858,2-27-24 15:28,79.6,Return,eBay Return,-374.9830413
40850,826473858,03-01-24 10:28,76.9,OutgoingTransfer,Peer-to-Peer Transfer,-451.8830413
40851,826473858,03-02-24 22:28,398.8,Return,Store Return,-53.08304133
40852,826473858,03-03-24 14:28,47.27,Payment,Mortgage Payment,-100.3530413
40853,826473858,03-04-24 21:28,4350,IncomingTransfer,Salary,4249.646959
40854,826473858,03-06-24 20:28,30.41,Payment,Mortgage Payment,4219.236959
40855,826473858,03-09-24 18:28,43.85,Return,Amazon Return,4263.086959
40856,826473858,03-09-24 21:28,2400,Payment,Credit Card Payment,1863.086959
40857,826473858,03-10-24 17:28,221.02,Withdrawal,ATM Withdrawal,1642.066959
40858,826473858,03-11-24 21:28,2700,Payment,Rent Payment,-1057.933041
40859,826473858,3-13-24 15:28,307.09,OnlineShopping,Target,-1365.023041
40860,826473858,3-13-24 17:28,399.71,OutgoingTransfer,International Transfer,-1764.733041
40861,826473858,3-15-24 19:28,377.7,Purchase,Electronics,-2142.433041
40862,826473858,3-19-24 18:28,355.48,Purchase,Clothing,-2497.913041
40863,826473858,3-20-24 20:28,152.62,OnlineShopping,AliExpress,-2650.533041
40864,826473858,3-24-24 10:28,111.47,Deposit,Direct Deposit,-2539.063041
40865,826473858,3-24-24 16:28,252.57,Withdrawal,Mobile App Withdrawal,-2791.633041
40866,826473858,3-28-24 19:28,54.12,OnlineShopping,AliExpress,-2845.753041
40867,826473858,04-01-24 11:28,327.1,Withdrawal,Mobile App Withdrawal,-3172.853041
40868,826473858,04-03-24 21:28,4350,IncomingTransfer,Salary,1177.146959
40869,826473858,04-06-24 10:28,291.58,OnlineShopping,Walmart,885.5669587
40870,826473858,04-08-24 16:28,140.4,Payment,Bill Payment,745.1669587
40871,826473858,04-08-24 21:28,1900,Payment,Credit Card Payment,-1154.833041
40872,826473858,04-09-24 18:28,120.9,IncomingTransfer,Freelance Payment,-1033.933041
40873,826473858,04-11-24 19:28,327.88,OnlineShopping,Walmart,-1361.813041
40874,826473858,4-13-24 21:28,78,Deposit,Mobile Deposit,-1283.813041
40875,826473858,4-14-24 19:28,305.34,Deposit,Cash Deposit,-978.4730413
40876,826473858,4-15-24 23:28,115.38,Return,Best Buy Return,-863.0930413
40877,826473858,4-16-24 21:28,103.5,OutgoingTransfer,Bank Transfer,-966.5930413
40878,826473858,4-17-24 22:28,107.02,Payment,Loan Payment,-1073.613041
40879,826473858,4-18-24 21:28,2500,Payment,Rent Payment,-3573.613041
40880,826473858,4-21-24 16:28,147.65,Purchase,Home Improvement,-3721.263041
40881,826473858,4-29-24 12:28,73.22,Deposit,Mobile Deposit,-3648.043041
40882,826473858,4-29-24 18:28,385.25,Withdrawal,ATM Withdrawal,-4033.293041
40883,826473858,4-30-24 13:28,239.69,Return,Amazon Return,-3793.603041
40884,826473858,05-01-24 14:28,206.83,Return,AliExpress Return,-3586.773041
40885,826473858,05-01-24 21:28,4350,IncomingTransfer,Salary,763.2269587
40886,826473858,05-04-24 14:28,390.9,IncomingTransfer,Freelance Payment,1154.126959
40887,826473858,05-06-24 21:28,2000,Payment,Credit Card Payment,-845.8730413
40888,826473858,05-08-24 12:28,301.05,OnlineShopping,Walmart,-1146.923041
40889,826473858,05-10-24 21:28,1200,Payment,Rent Payment,-2346.923041
40890,826473858,05-12-24 11:28,328.43,Deposit,Check Deposit,-2018.493041
40891,826473858,5-13-24 22:28,310.07,Payment,Mortgage Payment,-2328.563041
40892,826473858,5-20-24 19:28,316.3,Purchase,Furniture,-2644.863041
40893,826473858,5-23-24 23:28,48.93,Purchase,Pharmacy,-2693.793041
40894,826473858,5-28-24 12:28,379.75,OutgoingTransfer,Bank Transfer,-3073.543041
40895,826473858,5-28-24 22:28,363.83,Deposit,Direct Deposit,-2709.713041
40896,826473858,06-01-24 21:28,4350,IncomingTransfer,Salary,1640.286959
40897,826473858,06-03-24 22:28,47.63,Purchase,Electronics,1592.656959
40898,826473858,06-05-24 16:28,262.83,Deposit,Check Deposit,1855.486959
40899,826473858,06-06-24 21:28,2000,Payment,Credit Card Payment,-144.5130413
40900,826473858,06-08-24 15:28,239.73,Withdrawal,Branch Withdrawal,-384.2430413
40901,826473858,06-10-24 16:28,229.38,Return,Target Return,-154.8630413
40902,826473858,6-14-24 17:28,322.62,Payment,Mortgage Payment,-477.4830413
40903,826473858,6-18-24 21:28,2300,Payment,Rent Payment,-2777.483041
40904,826473858,6-20-24 11:28,141.12,Deposit,Mobile Deposit,-2636.363041
40905,826473858,6-23-24 13:28,313.71,Deposit,Check Deposit,-2322.653041
40906,826473858,6-25-24 20:28,373.05,Payment,Bill Payment,-2695.703041
40907,826473858,6-27-24 13:28,315.12,Purchase,Electronics,-3010.823041
40908,826473858,07-01-24 14:28,378.8,IncomingTransfer,Freelance Payment,-2632.023041
40909,826473858,07-04-24 20:28,271.84,Payment,Loan Payment,-2903.863041
40910,826473858,07-05-24 21:28,4350,IncomingTransfer,Salary,1446.136959
40911,826473858,07-10-24 21:28,2100,Payment,Credit Card Payment,-653.8630413
40912,826473858,07-11-24 20:28,29.52,OnlineShopping,Best Buy,-683.3830413
40913,826473858,7-13-24 14:28,249.22,Payment,Loan Payment,-932.6030413
40914,826473858,7-14-24 12:28,321.19,Withdrawal,ATM Withdrawal,-1253.793041
40915,826473858,7-15-24 21:28,1400,Payment,Rent Payment,-2653.793041
40916,826473858,7-16-24 19:28,381.92,Purchase,Restaurant,-3035.713041
40917,826775058,1-26-24 15:28,98.77,Purchase,Furniture,1313.148252
40918,826775058,1-27-24 22:28,159.64,OutgoingTransfer,Wire Transfer,1153.508252
40919,826775058,02-05-24 21:28,1800,IncomingTransfer,Salary,2953.508252
40920,826775058,02-10-24 21:28,3100,Payment,Credit Card Payment,-146.4917479
40921,826775058,02-11-24 19:28,11.25,OutgoingTransfer,International Transfer,-157.7417479
40922,826775058,02-12-24 21:28,1000,Payment,Rent Payment,-1157.741748
40923,826775058,2-15-24 16:28,66.51,OnlineShopping,eBay,-1224.251748
40924,826775058,2-25-24 19:28,12.9,Withdrawal,Mobile App Withdrawal,-1237.151748
40925,826775058,2-29-24 13:28,23.24,OnlineShopping,AliExpress,-1260.391748
40926,826775058,2-29-24 16:28,29.05,Return,Amazon Return,-1231.341748
40927,826775058,03-01-24 13:28,72.22,Deposit,Mobile Deposit,-1159.121748
40928,826775058,03-03-24 21:28,1800,IncomingTransfer,Salary,640.8782521
40929,826775058,03-08-24 21:28,3400,Payment,Credit Card Payment,-2759.121748
40930,826775058,3-17-24 21:28,600,Payment,Rent Payment,-3359.121748
40931,826775058,3-19-24 11:28,40.8,OutgoingTransfer,International Transfer,-3399.921748
40932,826775058,3-21-24 20:28,84.63,OutgoingTransfer,Bank Transfer,-3484.551748
40933,826775058,3-24-24 22:28,144.4,Withdrawal,Branch Withdrawal,-3628.951748
40934,826775058,3-25-24 14:28,161.85,Deposit,Check Deposit,-3467.101748
40935,826775058,3-26-24 14:28,34.72,Payment,Loan Payment,-3501.821748
40936,826775058,3-30-24 19:28,52.15,OutgoingTransfer,International Transfer,-3553.971748
40937,826775058,04-05-24 21:28,1800,IncomingTransfer,Salary,-1753.971748
40938,826775058,04-10-24 21:28,3700,Payment,Credit Card Payment,-5453.971748
40939,826775058,4-15-24 10:28,219.66,Withdrawal,ATM Withdrawal,-5673.631748
40940,826775058,4-16-24 21:28,237.47,IncomingTransfer,Freelance Payment,-5436.161748
40941,826775058,4-17-24 21:28,700,Payment,Rent Payment,-6136.161748
40942,826775058,4-20-24 14:28,212.94,IncomingTransfer,Freelance Payment,-5923.221748
40943,826775058,4-23-24 19:28,49.86,Withdrawal,ATM Withdrawal,-5973.081748
40944,826775058,4-29-24 10:28,242.53,Payment,Mortgage Payment,-6215.611748
40945,826775058,05-02-24 19:28,27.39,Deposit,Mobile Deposit,-6188.221748
40946,826775058,05-03-24 16:28,167.81,Withdrawal,Branch Withdrawal,-6356.031748
40947,826775058,05-04-24 16:28,208.4,Purchase,Electronics,-6564.431748
40948,826775058,05-04-24 21:28,1800,IncomingTransfer,Salary,-4764.431748
40949,826775058,05-08-24 23:28,87.85,Purchase,Clothing,-4852.281748
40950,826775058,05-09-24 12:28,27.86,Withdrawal,ATM Withdrawal,-4880.141748
40951,826775058,05-09-24 21:28,2800,Payment,Credit Card Payment,-7680.141748
40952,826775058,5-14-24 22:28,149.81,Payment,Mortgage Payment,-7829.951748
40953,826775058,5-16-24 19:28,130.41,Return,Store Return,-7699.541748
40954,826775058,5-17-24 21:28,700,Payment,Rent Payment,-8399.541748
40955,826775058,5-21-24 15:28,51.65,Purchase,Entertainment,-8451.191748
40956,826775058,5-28-24 12:28,235.07,OnlineShopping,eBay,-8686.261748
40957,826775058,5-28-24 20:28,72.18,Payment,Mortgage Payment,-8758.441748
40958,826775058,06-01-24 21:28,1800,IncomingTransfer,Salary,-6958.441748
40959,826775058,06-06-24 21:28,2500,Payment,Credit Card Payment,-9458.441748
40960,826775058,06-10-24 21:28,1000,Payment,Rent Payment,-10458.44175
40961,826775058,6-17-24 11:28,140.44,Deposit,Cash Deposit,-10318.00175
40962,826775058,6-19-24 21:28,188.42,Return,eBay Return,-10129.58175
40963,826775058,6-26-24 18:28,238.09,Payment,Mortgage Payment,-10367.67175
40964,826775058,07-03-24 21:28,1800,IncomingTransfer,Salary,-8567.671748
40965,826775058,07-04-24 9:28,183.66,Payment,Mortgage Payment,-8751.331748
40966,826775058,07-07-24 13:28,35.51,Deposit,Direct Deposit,-8715.821748
40967,826775058,07-08-24 21:28,3600,Payment,Credit Card Payment,-12315.82175
40968,826775058,07-10-24 15:28,115.78,Payment,Mortgage Payment,-12431.60175
40969,826775058,07-12-24 21:28,248.83,Withdrawal,Mobile App Withdrawal,-12680.43175
40970,826775058,7-14-24 21:28,700,Payment,Rent Payment,-13380.43175
40971,827440458,1-26-24 16:28,592.95,Withdrawal,Mobile App Withdrawal,173.769169
40972,827440458,1-30-24 15:28,464.55,IncomingTransfer,Freelance Payment,638.319169
40973,827440458,02-01-24 20:28,484.16,OutgoingTransfer,International Transfer,154.159169
40974,827440458,02-01-24 21:28,8050,IncomingTransfer,Salary,8204.159169
40975,827440458,02-06-24 21:28,2200,Payment,Credit Card Payment,6004.159169
40976,827440458,02-07-24 22:28,383.86,Purchase,Clothing,5620.299169
40977,827440458,02-10-24 12:28,730.84,OutgoingTransfer,Bank Transfer,4889.459169
40978,827440458,2-15-24 13:28,716.76,Purchase,Clothing,4172.699169
40979,827440458,2-16-24 23:28,544.48,Deposit,Direct Deposit,4717.179169
40980,827440458,2-18-24 21:28,3700,Payment,Rent Payment,1017.179169
40981,827440458,2-19-24 15:28,223.39,Payment,Mortgage Payment,793.789169
40982,827440458,2-20-24 15:28,287.51,Deposit,Check Deposit,1081.299169
40983,827440458,2-26-24 16:28,123.75,Payment,Loan Payment,957.549169
40984,827440458,2-27-24 14:28,219.86,OutgoingTransfer,International Transfer,737.689169
40985,827440458,03-03-24 21:28,8050,IncomingTransfer,Salary,8787.689169
40986,827440458,03-04-24 23:28,206.01,Purchase,Grocery,8581.679169
40987,827440458,03-08-24 21:28,1600,Payment,Credit Card Payment,6981.679169
40988,827440458,03-10-24 11:28,136.3,Purchase,Gas,6845.379169
40989,827440458,03-10-24 16:28,623.34,IncomingTransfer,Freelance Payment,7468.719169
40990,827440458,03-10-24 21:28,4600,Payment,Rent Payment,2868.719169
40991,827440458,03-11-24 23:28,303.61,Withdrawal,ATM Withdrawal,2565.109169
40992,827440458,03-12-24 14:28,530.76,Deposit,Direct Deposit,3095.869169
40993,827440458,3-14-24 11:28,525.8,Purchase,Gas,2570.069169
40994,827440458,3-21-24 20:28,591.61,Payment,Bill Payment,1978.459169
40995,827440458,3-22-24 23:28,740.01,Withdrawal,Mobile App Withdrawal,1238.449169
40996,827440458,3-24-24 17:28,430.83,Payment,Mortgage Payment,807.619169
40997,827440458,3-26-24 10:28,465.09,Deposit,Cash Deposit,1272.709169
40998,827440458,3-28-24 13:28,167.48,Deposit,Direct Deposit,1440.189169
40999,827440458,3-28-24 22:28,679.29,Deposit,Cash Deposit,2119.479169
41000,827440458,04-01-24 18:28,542.88,Deposit,Mobile Deposit,2662.359169
41001,827440458,04-02-24 17:28,371.03,Withdrawal,Branch Withdrawal,2291.329169
41002,827440458,04-05-24 21:28,8050,IncomingTransfer,Salary,10341.32917
41003,827440458,04-07-24 15:28,226.46,Withdrawal,Branch Withdrawal,10114.86917
41004,827440458,04-07-24 22:28,677.48,Return,Target Return,10792.34917
41005,827440458,04-10-24 21:28,1900,Payment,Credit Card Payment,8892.349169
41006,827440458,4-16-24 21:28,3800,Payment,Rent Payment,5092.349169
41007,827440458,4-18-24 16:28,597.42,Purchase,Electronics,4494.929169
41008,827440458,4-20-24 18:28,580.21,Deposit,Mobile Deposit,5075.139169
41009,827440458,4-23-24 15:28,671.43,Payment,Mortgage Payment,4403.709169
41010,827440458,4-23-24 19:28,614.54,Return,Store Return,5018.249169
41011,827440458,4-27-24 11:28,207.22,Deposit,Direct Deposit,5225.469169
41012,827440458,4-28-24 15:28,683.17,Deposit,Check Deposit,5908.639169
41013,827440458,05-01-24 21:28,8050,IncomingTransfer,Salary,13958.63917
41014,827440458,05-04-24 20:28,401.44,Purchase,Pharmacy,13557.19917
41015,827440458,05-06-24 21:28,2200,Payment,Credit Card Payment,11357.19917
41016,827440458,05-06-24 22:28,240.9,Withdrawal,Mobile App Withdrawal,11116.29917
41017,827440458,05-12-24 21:28,3500,Payment,Rent Payment,7616.299169
41018,827440458,5-13-24 12:28,327.97,OutgoingTransfer,Bank Transfer,7288.329169
41019,827440458,5-14-24 13:28,295.66,OutgoingTransfer,Wire Transfer,6992.669169
41020,827440458,5-24-24 12:28,495.56,Deposit,Cash Deposit,7488.229169
41021,827440458,5-25-24 11:28,394.63,OnlineShopping,Best Buy,7093.599169
41022,827440458,5-26-24 21:28,376.84,OutgoingTransfer,International Transfer,6716.759169
41023,827440458,5-27-24 14:28,620.58,OutgoingTransfer,Peer-to-Peer Transfer,6096.179169
41024,827440458,5-31-24 21:28,103.68,OutgoingTransfer,Peer-to-Peer Transfer,5992.499169
41025,827440458,06-02-24 21:28,8050,IncomingTransfer,Salary,14042.49917
41026,827440458,06-02-24 22:28,100.16,Purchase,Furniture,13942.33917
41027,827440458,06-04-24 22:28,429.61,OutgoingTransfer,Bank Transfer,13512.72917
41028,827440458,06-06-24 10:28,582.75,Withdrawal,ATM Withdrawal,12929.97917
41029,827440458,06-07-24 21:28,2000,Payment,Credit Card Payment,10929.97917
41030,827440458,06-10-24 19:28,456.77,Withdrawal,ATM Withdrawal,10473.20917
41031,827440458,06-11-24 16:28,725.02,Deposit,Cash Deposit,11198.22917
41032,827440458,06-12-24 20:28,635.48,OnlineShopping,eBay,10562.74917
41033,827440458,6-13-24 21:28,4000,Payment,Rent Payment,6562.749169
41034,827440458,6-15-24 14:28,215.72,OnlineShopping,Amazon,6347.029169
41035,827440458,6-18-24 20:28,731.27,OutgoingTransfer,Bank Transfer,5615.759169
41036,827440458,6-19-24 16:28,741.4,OutgoingTransfer,Bank Transfer,4874.359169
41037,827440458,6-20-24 22:28,691.74,Deposit,Check Deposit,5566.099169
41038,827440458,6-28-24 15:28,652.45,Deposit,Direct Deposit,6218.549169
41039,827440458,07-05-24 21:28,8050,IncomingTransfer,Salary,14268.54917
41040,827440458,07-06-24 11:28,739.66,Purchase,Travel,13528.88917
41041,827440458,07-10-24 21:28,2100,Payment,Credit Card Payment,11428.88917
41042,827440458,07-11-24 21:28,4200,Payment,Rent Payment,7228.889169
41043,827440458,7-13-24 12:28,717.01,Deposit,Check Deposit,7945.899169
41044,827440458,7-13-24 22:28,661.27,Payment,Mortgage Payment,7284.629169
41045,827440458,7-15-24 9:28,590.17,Return,AliExpress Return,7874.799169
41046,827440458,7-16-24 14:28,453.5,Purchase,Grocery,7421.299169
41047,827890758,1-20-24 19:28,93.07,Withdrawal,Branch Withdrawal,1001.354299
41048,827890758,1-22-24 12:28,232.13,Purchase,Grocery,769.2242993
41049,827890758,1-22-24 12:28,41.72,Purchase,Furniture,727.5042993
41050,827890758,1-23-24 9:28,49.4,OutgoingTransfer,Wire Transfer,678.1042993
41051,827890758,1-24-24 21:28,220.75,Payment,Loan Payment,457.3542993
41052,827890758,1-26-24 13:28,81.96,Purchase,Restaurant,375.3942993
41053,827890758,1-28-24 10:28,213.29,Withdrawal,Branch Withdrawal,162.1042993
41054,827890758,1-29-24 12:28,234.89,Purchase,Home Improvement,-72.7857007
41055,827890758,02-01-24 15:28,222.02,Deposit,Check Deposit,149.2342993
41056,827890758,02-01-24 21:28,3050,IncomingTransfer,Salary,3199.234299
41057,827890758,02-06-24 20:28,206.59,Purchase,Travel,2992.644299
41058,827890758,02-06-24 21:28,1900,Payment,Credit Card Payment,1092.644299
41059,827890758,2-14-24 15:28,67.57,OutgoingTransfer,Peer-to-Peer Transfer,1025.074299
41060,827890758,2-18-24 21:28,1300,Payment,Rent Payment,-274.9257007
41061,827890758,2-29-24 13:28,27.05,Withdrawal,Branch Withdrawal,-301.9757007
41062,827890758,03-02-24 20:28,169.22,Payment,Bill Payment,-471.1957007
41063,827890758,03-04-24 21:28,3050,IncomingTransfer,Salary,2578.804299
41064,827890758,03-07-24 11:28,238.61,Purchase,Gas,2340.194299
41065,827890758,03-07-24 11:28,195.15,Purchase,Furniture,2145.044299
41066,827890758,03-09-24 21:28,1400,Payment,Credit Card Payment,745.0442993
41067,827890758,03-10-24 17:28,131.95,OnlineShopping,Target,613.0942993
41068,827890758,03-12-24 21:28,800,Payment,Rent Payment,-186.9057007
41069,827890758,3-13-24 10:28,165.1,Withdrawal,ATM Withdrawal,-352.0057007
41070,827890758,3-16-24 19:28,143.63,Purchase,Pharmacy,-495.6357007
41071,827890758,3-20-24 13:28,135.07,Deposit,Direct Deposit,-360.5657007
41072,827890758,3-21-24 9:28,44.83,Return,Store Return,-315.7357007
41073,827890758,3-29-24 12:28,28.68,Purchase,Restaurant,-344.4157007
41074,827890758,04-01-24 20:28,249.37,OutgoingTransfer,Wire Transfer,-593.7857007
41075,827890758,04-02-24 21:28,3050,IncomingTransfer,Salary,2456.214299
41076,827890758,04-02-24 21:28,144.27,Withdrawal,Mobile App Withdrawal,2311.944299
41077,827890758,04-03-24 11:28,152.11,Withdrawal,Branch Withdrawal,2159.834299
41078,827890758,04-06-24 15:28,225.89,Return,Etsy Return,2385.724299
41079,827890758,04-07-24 13:28,118.96,Deposit,Direct Deposit,2504.684299
41080,827890758,04-07-24 21:28,1800,Payment,Credit Card Payment,704.6842993
41081,827890758,04-12-24 17:28,52.64,Deposit,Mobile Deposit,757.3242993
41082,827890758,04-12-24 22:28,75.65,Withdrawal,Mobile App Withdrawal,681.6742993
41083,827890758,4-13-24 21:28,1600,Payment,Rent Payment,-918.3257007
41084,827890758,4-14-24 17:28,167.04,Payment,Bill Payment,-1085.365701
41085,827890758,4-16-24 18:28,27.76,IncomingTransfer,Freelance Payment,-1057.605701
41086,827890758,4-22-24 13:28,248.14,Deposit,Direct Deposit,-809.4657007
41087,827890758,4-25-24 23:28,131.67,Deposit,Mobile Deposit,-677.7957007
41088,827890758,05-03-24 12:28,118.37,OnlineShopping,eBay,-796.1657007
41089,827890758,05-03-24 21:28,3050,IncomingTransfer,Salary,2253.834299
41090,827890758,05-04-24 21:28,35.45,OnlineShopping,Etsy,2218.384299
41091,827890758,05-04-24 22:28,231.64,Return,Walmart Return,2450.024299
41092,827890758,05-08-24 21:28,1600,Payment,Credit Card Payment,850.0242993
41093,827890758,05-10-24 20:28,10.33,Purchase,Restaurant,839.6942993
41094,827890758,5-14-24 21:28,1400,Payment,Rent Payment,-560.3057007
41095,827890758,5-16-24 9:28,34.65,Payment,Mortgage Payment,-594.9557007
41096,827890758,5-21-24 13:28,79.92,Purchase,Home Improvement,-674.8757007
41097,827890758,5-21-24 14:28,167.03,Deposit,Direct Deposit,-507.8457007
41098,827890758,5-24-24 9:28,85.35,Withdrawal,Branch Withdrawal,-593.1957007
41099,827890758,5-28-24 13:28,147.44,OnlineShopping,Etsy,-740.6357007
41100,827890758,5-29-24 18:28,68,OutgoingTransfer,Peer-to-Peer Transfer,-808.6357007
41101,827890758,06-02-24 10:28,241.85,Payment,Loan Payment,-1050.485701
41102,827890758,06-02-24 11:28,204.58,OnlineShopping,Target,-1255.065701
41103,827890758,06-02-24 21:28,3050,IncomingTransfer,Salary,1794.934299
41104,827890758,06-03-24 22:28,115.02,Payment,Loan Payment,1679.914299
41105,827890758,06-05-24 12:28,213.28,Deposit,Cash Deposit,1893.194299
41106,827890758,06-05-24 17:28,75.15,Purchase,Electronics,1818.044299
41107,827890758,06-05-24 19:28,223.53,Deposit,Check Deposit,2041.574299
41108,827890758,06-06-24 19:28,149.99,Deposit,Cash Deposit,2191.564299
41109,827890758,06-07-24 21:28,1400,Payment,Credit Card Payment,791.5642993
41110,827890758,06-08-24 13:28,64.06,Return,Target Return,855.6242993
41111,827890758,06-09-24 15:28,232.67,Purchase,Home Improvement,622.9542993
41112,827890758,06-10-24 18:28,79.4,Purchase,Furniture,543.5542993
41113,827890758,06-10-24 21:28,1400,Payment,Rent Payment,-856.4457007
41114,827890758,06-12-24 21:28,109.67,Return,AliExpress Return,-746.7757007
41115,827890758,6-18-24 20:28,68.57,Deposit,Direct Deposit,-678.2057007
41116,827890758,6-19-24 12:28,183.71,Deposit,Check Deposit,-494.4957007
41117,827890758,6-19-24 15:28,109.99,IncomingTransfer,Freelance Payment,-384.5057007
41118,827890758,6-28-24 13:28,35.3,Purchase,Furniture,-419.8057007
41119,827890758,6-30-24 12:28,157.16,Deposit,Check Deposit,-262.6457007
41120,827890758,07-03-24 21:28,3050,IncomingTransfer,Salary,2787.354299
41121,827890758,07-04-24 17:28,153.43,OnlineShopping,Best Buy,2633.924299
41122,827890758,07-08-24 21:28,1600,Payment,Credit Card Payment,1033.924299
41123,827890758,07-12-24 16:28,117.9,Payment,Bill Payment,916.0242993
41124,827890758,7-15-24 21:28,154.87,Payment,Mortgage Payment,761.1542993
41125,827890758,7-16-24 21:28,1900,Payment,Rent Payment,-1138.845701
41126,827890758,7-17-24 16:28,31.26,Purchase,Grocery,-1170.105701
41127,827890758,7-17-24 23:28,125.36,OnlineShopping,Walmart,-1295.465701
