TransactionID,CustomerID,TransactionDate,Amount,TransactionType,Description,UpdatedBalance
3821,709831983,1-20-24 20:28,523.18,OutgoingTransfer,Peer-to-Peer Transfer,232.6775579
3822,709831983,1-21-24 11:28,479.28,OnlineShopping,AliExpress,-246.6024421
3823,709831983,1-21-24 16:28,213.08,OutgoingTransfer,Peer-to-Peer Transfer,-459.6824421
3824,709831983,1-21-24 18:28,946.05,Deposit,Cash Deposit,486.3675579
3825,709831983,1-22-24 12:28,921.09,OutgoingTransfer,International Transfer,-434.7224421
3826,709831983,1-23-24 18:28,583.64,Purchase,Travel,-1018.362442
3827,709831983,1-24-24 20:28,560.77,Payment,Bill Payment,-1579.132442
3828,709831983,1-30-24 22:28,481.15,Withdrawal,ATM Withdrawal,-2060.282442
3829,709831983,02-02-24 14:28,861.86,IncomingTransfer,Freelance Payment,-1198.422442
3830,709831983,02-05-24 12:28,943.87,Deposit,Direct Deposit,-254.5524421
3831,709831983,02-05-24 21:28,15800,IncomingTransfer,Salary,15545.44756
3832,709831983,02-08-24 12:28,283.26,Deposit,Cash Deposit,15828.70756
3833,709831983,02-08-24 23:28,832.18,Withdrawal,ATM Withdrawal,14996.52756
3834,709831983,02-09-24 10:28,618.29,OutgoingTransfer,Peer-to-Peer Transfer,14378.23756
3835,709831983,02-10-24 19:28,603.67,Withdrawal,Mobile App Withdrawal,13774.56756
3836,709831983,02-10-24 21:28,1400,Payment,Credit Card Payment,12374.56756
3837,709831983,2-14-24 19:28,777.73,Return,Etsy Return,13152.29756
3838,709831983,2-18-24 21:28,5500,Payment,Rent Payment,7652.297558
3839,709831983,2-19-24 12:28,395.65,Return,Store Return,8047.947558
3840,709831983,2-19-24 18:28,728.18,Withdrawal,Mobile App Withdrawal,7319.767558
3841,709831983,2-20-24 15:28,442.51,OutgoingTransfer,Peer-to-Peer Transfer,6877.257558
3842,709831983,2-20-24 17:28,677.36,Purchase,Electronics,6199.897558
3843,709831983,2-22-24 19:28,397.51,Withdrawal,ATM Withdrawal,5802.387558
3844,709831983,2-22-24 19:28,702.24,Return,Target Return,6504.627558
3845,709831983,2-22-24 22:28,906.25,OutgoingTransfer,Peer-to-Peer Transfer,5598.377558
3846,709831983,2-23-24 21:28,723.08,Withdrawal,ATM Withdrawal,4875.297558
3847,709831983,2-26-24 19:28,491.56,OutgoingTransfer,Wire Transfer,4383.737558
3848,709831983,2-28-24 10:28,528.17,OnlineShopping,AliExpress,3855.567558
3849,709831983,2-28-24 21:28,540.84,Withdrawal,Branch Withdrawal,3314.727558
3850,709831983,2-29-24 13:28,337.89,Purchase,Pharmacy,2976.837558
3851,709831983,2-29-24 21:28,501.61,Withdrawal,Branch Withdrawal,2475.227558
3852,709831983,03-01-24 9:28,292.46,Purchase,Restaurant,2182.767558
3853,709831983,03-02-24 14:28,241.49,Purchase,Travel,1941.277558
3854,709831983,03-02-24 21:28,15800,IncomingTransfer,Salary,17741.27756
3855,709831983,03-07-24 21:28,1700,Payment,Credit Card Payment,16041.27756
3856,709831983,03-09-24 14:28,879.82,Return,AliExpress Return,16921.09756
3857,709831983,03-11-24 14:28,311.32,Purchase,Entertainment,16609.77756
3858,709831983,03-12-24 15:28,576.69,Payment,Bill Payment,16033.08756
3859,709831983,03-12-24 18:28,325.97,OnlineShopping,Walmart,15707.11756
3860,709831983,3-13-24 12:28,333.46,Deposit,Direct Deposit,16040.57756
3861,709831983,3-14-24 10:28,607.3,Purchase,Home Improvement,15433.27756
3862,709831983,3-15-24 23:28,863.36,Purchase,Clothing,14569.91756
3863,709831983,3-16-24 19:28,837.13,Withdrawal,Branch Withdrawal,13732.78756
3864,709831983,3-16-24 21:28,612.94,Purchase,Furniture,13119.84756
3865,709831983,3-17-24 11:28,816.07,Return,Target Return,13935.91756
3866,709831983,3-17-24 15:28,735.26,OutgoingTransfer,Peer-to-Peer Transfer,13200.65756
3867,709831983,3-18-24 17:28,761.45,IncomingTransfer,Freelance Payment,13962.10756
3868,709831983,3-18-24 21:28,7500,Payment,Rent Payment,6462.107558
3869,709831983,3-20-24 18:28,687.57,IncomingTransfer,Freelance Payment,7149.677558
3870,709831983,3-21-24 12:28,520.31,OutgoingTransfer,Peer-to-Peer Transfer,6629.367558
3871,709831983,3-23-24 22:28,629.94,OutgoingTransfer,Peer-to-Peer Transfer,5999.427558
3872,709831983,3-24-24 18:28,547.23,Purchase,Pharmacy,5452.197558
3873,709831983,3-29-24 13:28,788.38,OnlineShopping,Best Buy,4663.817558
3874,709831983,3-30-24 21:28,891.63,Purchase,Restaurant,3772.187558
3875,709831983,3-31-24 13:28,389.55,Purchase,Electronics,3382.637558
3876,709831983,04-01-24 22:28,323.06,Deposit,Check Deposit,3705.697558
3877,709831983,04-01-24 23:28,429.57,Purchase,Travel,3276.127558
3878,709831983,04-02-24 11:28,220.46,Deposit,Cash Deposit,3496.587558
3879,709831983,04-02-24 21:28,15800,IncomingTransfer,Salary,19296.58756
3880,709831983,04-06-24 21:28,882.21,OnlineShopping,Amazon,18414.37756
3881,709831983,04-07-24 21:28,1400,Payment,Credit Card Payment,17014.37756
3882,709831983,04-09-24 13:28,495.27,Purchase,Grocery,16519.10756
3883,709831983,04-10-24 18:28,914.57,OutgoingTransfer,International Transfer,15604.53756
3884,709831983,04-12-24 21:28,9700,Payment,Rent Payment,5904.537558
3885,709831983,4-13-24 19:28,736.7,Purchase,Clothing,5167.837558
3886,709831983,4-14-24 17:28,699.72,Purchase,Clothing,4468.117558
3887,709831983,4-15-24 15:28,295.3,Payment,Bill Payment,4172.817558
3888,709831983,4-16-24 17:28,237.31,Return,Best Buy Return,4410.127558
3889,709831983,4-17-24 20:28,291.63,Withdrawal,Branch Withdrawal,4118.497558
3890,709831983,4-18-24 11:28,312.28,Purchase,Travel,3806.217558
3891,709831983,4-19-24 19:28,835.51,Withdrawal,Branch Withdrawal,2970.707558
3892,709831983,4-20-24 21:28,698.06,Deposit,Cash Deposit,3668.767558
3893,709831983,4-25-24 10:28,571.21,Deposit,Mobile Deposit,4239.977558
3894,709831983,4-25-24 23:28,772.88,Purchase,Grocery,3467.097558
3895,709831983,4-26-24 10:28,463.13,Return,Target Return,3930.227558
3896,709831983,4-26-24 22:28,716.8,Purchase,Travel,3213.427558
3897,709831983,4-26-24 22:28,443.99,OnlineShopping,Target,2769.437558
3898,709831983,4-27-24 14:28,301.26,Withdrawal,Mobile App Withdrawal,2468.177558
3899,709831983,4-27-24 19:28,431.51,Purchase,Entertainment,2036.667558
3900,709831983,4-29-24 12:28,468.07,Purchase,Entertainment,1568.597558
3901,709831983,05-03-24 23:28,875.17,Return,AliExpress Return,2443.767558
3902,709831983,05-04-24 21:28,15800,IncomingTransfer,Salary,18243.76756
3903,709831983,05-09-24 21:28,1800,Payment,Credit Card Payment,16443.76756
3904,709831983,05-10-24 10:28,566.4,Withdrawal,Mobile App Withdrawal,15877.36756
3905,709831983,05-11-24 17:28,203.25,Purchase,Electronics,15674.11756
3906,709831983,05-12-24 15:28,375.67,Return,Best Buy Return,16049.78756
3907,709831983,5-13-24 19:28,828.85,OutgoingTransfer,Bank Transfer,15220.93756
3908,709831983,5-14-24 14:28,696.58,Withdrawal,Branch Withdrawal,14524.35756
3909,709831983,5-14-24 20:28,890.22,Deposit,Cash Deposit,15414.57756
3910,709831983,5-16-24 19:28,901.44,Deposit,Direct Deposit,16316.01756
3911,709831983,5-17-24 20:28,338.78,Payment,Mortgage Payment,15977.23756
3912,709831983,5-18-24 11:28,901.81,Withdrawal,Mobile App Withdrawal,15075.42756
3913,709831983,5-18-24 14:28,642.3,Purchase,Electronics,14433.12756
3914,709831983,5-18-24 20:28,682.49,Return,AliExpress Return,15115.61756
3915,709831983,5-18-24 21:28,6300,Payment,Rent Payment,8815.617558
3916,709831983,5-19-24 22:28,485.61,Deposit,Mobile Deposit,9301.227558
3917,709831983,5-21-24 21:28,797.38,Payment,Mortgage Payment,8503.847558
3918,709831983,5-22-24 22:28,489.33,Return,Etsy Return,8993.177558
3919,709831983,5-23-24 10:28,856.26,Payment,Bill Payment,8136.917558
3920,709831983,5-24-24 21:28,702.44,OnlineShopping,eBay,7434.477558
3921,709831983,5-25-24 10:28,896.36,Deposit,Check Deposit,8330.837558
3922,709831983,5-29-24 14:28,231.72,Purchase,Restaurant,8099.117558
3923,709831983,5-30-24 19:28,715.89,Withdrawal,Mobile App Withdrawal,7383.227558
3924,709831983,5-31-24 9:28,602.7,OnlineShopping,Best Buy,6780.527558
3925,709831983,06-01-24 14:28,402.86,Return,Best Buy Return,7183.387558
3926,709831983,06-04-24 10:28,459.24,IncomingTransfer,Freelance Payment,7642.627558
3927,709831983,06-04-24 21:28,15800,IncomingTransfer,Salary,23442.62756
3928,709831983,06-04-24 22:28,580.91,Payment,Mortgage Payment,22861.71756
3929,709831983,06-05-24 14:28,704.27,Payment,Mortgage Payment,22157.44756
3930,709831983,06-06-24 17:28,523.21,Purchase,Furniture,21634.23756
3931,709831983,06-07-24 11:28,219.45,IncomingTransfer,Freelance Payment,21853.68756
3932,709831983,06-09-24 21:28,1700,Payment,Credit Card Payment,20153.68756
3933,709831983,06-11-24 10:28,425.96,Purchase,Entertainment,19727.72756
3934,709831983,06-11-24 19:28,396.56,Return,Walmart Return,20124.28756
3935,709831983,6-13-24 18:28,259.62,Return,Store Return,20383.90756
3936,709831983,6-14-24 16:28,605.53,Purchase,Furniture,19778.37756
3937,709831983,6-16-24 21:28,5900,Payment,Rent Payment,13878.37756
3938,709831983,6-19-24 11:28,206.32,IncomingTransfer,Freelance Payment,14084.69756
3939,709831983,6-22-24 16:28,621.92,Purchase,Grocery,13462.77756
3940,709831983,6-25-24 10:28,848.95,Withdrawal,Branch Withdrawal,12613.82756
3941,709831983,6-25-24 10:28,486.12,OnlineShopping,Walmart,12127.70756
3942,709831983,6-25-24 17:28,343.46,Withdrawal,Branch Withdrawal,11784.24756
3943,709831983,6-25-24 23:28,633.21,IncomingTransfer,Freelance Payment,12417.45756
3944,709831983,6-26-24 14:28,244.98,Withdrawal,ATM Withdrawal,12172.47756
3945,709831983,6-26-24 15:28,549.43,OnlineShopping,Amazon,11623.04756
3946,709831983,6-26-24 23:28,414.75,Withdrawal,Branch Withdrawal,11208.29756
3947,709831983,6-27-24 21:28,896.81,IncomingTransfer,Freelance Payment,12105.10756
3948,709831983,6-28-24 11:28,737.61,Deposit,Cash Deposit,12842.71756
3949,709831983,6-28-24 17:28,350.74,Withdrawal,ATM Withdrawal,12491.97756
3950,709831983,6-28-24 18:28,484.24,Return,Etsy Return,12976.21756
3951,709831983,6-28-24 21:28,858.74,IncomingTransfer,Freelance Payment,13834.95756
3952,709831983,07-02-24 14:28,559.45,Purchase,Travel,13275.50756
3953,709831983,07-04-24 21:28,15800,IncomingTransfer,Salary,29075.50756
3954,709831983,07-06-24 21:28,555.56,Return,Etsy Return,29631.06756
3955,709831983,07-08-24 9:28,692.48,Purchase,Furniture,28938.58756
3956,709831983,07-09-24 11:28,305.09,Return,Amazon Return,29243.67756
3957,709831983,07-09-24 21:28,1400,Payment,Credit Card Payment,27843.67756
3958,709831983,07-10-24 21:28,303.98,OutgoingTransfer,International Transfer,27539.69756
3959,709831983,07-11-24 12:28,931.4,Withdrawal,Mobile App Withdrawal,26608.29756
3960,709831983,07-12-24 16:28,792.36,OnlineShopping,Target,25815.93756
3961,709831983,7-13-24 10:28,930.62,OutgoingTransfer,Peer-to-Peer Transfer,24885.31756
3962,709831983,7-13-24 21:28,4700,Payment,Rent Payment,20185.31756
3963,709831983,7-14-24 20:28,373.51,Withdrawal,Branch Withdrawal,19811.80756
3964,709831983,7-15-24 13:28,319.67,Withdrawal,Mobile App Withdrawal,19492.13756
27523,766131033,1-20-24 22:28,206.68,Deposit,Mobile Deposit,954.6423893
27524,766131033,1-22-24 10:28,63.23,Withdrawal,Branch Withdrawal,891.4123893
27525,766131033,1-25-24 12:28,164.04,Purchase,Electronics,727.3723893
27526,766131033,1-31-24 12:28,99.26,OutgoingTransfer,International Transfer,628.1123893
27527,766131033,02-01-24 15:28,24.29,Deposit,Mobile Deposit,652.4023893
27528,766131033,02-02-24 21:28,1750,IncomingTransfer,Salary,2402.402389
27529,766131033,02-05-24 21:28,76.5,Purchase,Restaurant,2325.902389
27530,766131033,02-06-24 20:28,136.66,Withdrawal,Branch Withdrawal,2189.242389
27531,766131033,02-07-24 21:28,1200,Payment,Credit Card Payment,989.2423893
27532,766131033,02-09-24 18:28,89.42,Purchase,Clothing,899.8223893
27533,766131033,02-09-24 22:28,76.77,Purchase,Travel,823.0523893
27534,766131033,02-11-24 17:28,120.17,OutgoingTransfer,International Transfer,702.8823893
27535,766131033,02-11-24 21:28,500,Payment,Insurance Payment,202.8823893
27536,766131033,02-12-24 13:28,148.08,OnlineShopping,Amazon,54.80238934
27537,766131033,2-14-24 23:28,160.29,Payment,Loan Payment,-105.4876107
27538,766131033,2-16-24 10:28,79.91,OutgoingTransfer,Peer-to-Peer Transfer,-185.3976107
27539,766131033,2-17-24 21:28,224.86,Payment,Loan Payment,-410.2576107
27540,766131033,2-26-24 9:28,42.91,OnlineShopping,eBay,-453.1676107
27541,766131033,2-26-24 12:28,197.47,Purchase,Furniture,-650.6376107
27542,766131033,2-27-24 10:28,148.02,Withdrawal,Branch Withdrawal,-798.6576107
27543,766131033,2-27-24 13:28,49.96,IncomingTransfer,Freelance Payment,-748.6976107
27544,766131033,2-27-24 14:28,150.3,Return,Walmart Return,-598.3976107
27545,766131033,03-01-24 11:28,123.35,Return,eBay Return,-475.0476107
27546,766131033,03-02-24 21:28,1750,IncomingTransfer,Salary,1274.952389
27547,766131033,03-07-24 21:28,1200,Payment,Credit Card Payment,74.95238934
27548,766131033,03-08-24 12:28,129.27,Purchase,Restaurant,-54.31761066
27549,766131033,03-09-24 17:28,232.02,OutgoingTransfer,International Transfer,-286.3376107
27550,766131033,03-11-24 21:28,700,Payment,Subscription Payment,-986.3376107
27551,766131033,03-12-24 16:28,73.3,IncomingTransfer,Freelance Payment,-913.0376107
27552,766131033,3-16-24 13:28,38.09,IncomingTransfer,Freelance Payment,-874.9476107
27553,766131033,3-20-24 11:28,196.98,Purchase,Grocery,-1071.927611
27554,766131033,3-21-24 15:28,243.31,Payment,Loan Payment,-1315.237611
27555,766131033,3-29-24 17:28,217.94,IncomingTransfer,Freelance Payment,-1097.297611
27556,766131033,3-31-24 18:28,66.91,Return,AliExpress Return,-1030.387611
27557,766131033,04-01-24 14:28,152.54,Deposit,Cash Deposit,-877.8476107
27558,766131033,04-01-24 21:28,1750,IncomingTransfer,Salary,872.1523893
27559,766131033,04-02-24 12:28,118.56,OnlineShopping,Etsy,753.5923893
27560,766131033,04-03-24 14:28,167.15,Purchase,Clothing,586.4423893
27561,766131033,04-06-24 21:28,1100,Payment,Credit Card Payment,-513.5576107
27562,766131033,04-09-24 18:28,17.58,Deposit,Direct Deposit,-495.9776107
27563,766131033,04-10-24 13:28,228.23,OutgoingTransfer,Wire Transfer,-724.2076107
27564,766131033,04-10-24 21:28,600,Payment,Subscription Payment,-1324.207611
27565,766131033,04-11-24 16:28,154.83,Purchase,Restaurant,-1479.037611
27566,766131033,4-16-24 15:28,179.37,Return,AliExpress Return,-1299.667611
27567,766131033,4-19-24 17:28,180.38,Purchase,Restaurant,-1480.047611
27568,766131033,4-19-24 18:28,22.47,Payment,Mortgage Payment,-1502.517611
27569,766131033,4-23-24 15:28,75,Purchase,Grocery,-1577.517611
27570,766131033,4-25-24 16:28,52.63,Deposit,Direct Deposit,-1524.887611
27571,766131033,05-02-24 17:28,136.17,Withdrawal,ATM Withdrawal,-1661.057611
27572,766131033,05-02-24 21:28,1750,IncomingTransfer,Salary,88.94238934
27573,766131033,05-03-24 18:28,55.97,Purchase,Furniture,32.97238934
27574,766131033,05-04-24 21:28,99.07,IncomingTransfer,Freelance Payment,132.0423893
27575,766131033,05-06-24 22:28,185.71,Payment,Loan Payment,-53.66761066
27576,766131033,05-07-24 21:28,1100,Payment,Credit Card Payment,-1153.667611
27577,766131033,05-09-24 16:28,197.55,Deposit,Direct Deposit,-956.1176107
27578,766131033,05-10-24 21:28,219.32,Deposit,Direct Deposit,-736.7976107
27579,766131033,05-12-24 21:28,600,Payment,Subscription Payment,-1336.797611
27580,766131033,5-16-24 9:28,138.95,Purchase,Pharmacy,-1475.747611
27581,766131033,5-17-24 23:28,196.54,Return,Best Buy Return,-1279.207611
27582,766131033,5-20-24 10:28,222.14,Return,Target Return,-1057.067611
27583,766131033,5-22-24 18:28,88.42,Deposit,Cash Deposit,-968.6476107
27584,766131033,06-02-24 21:28,1750,IncomingTransfer,Salary,781.3523893
27585,766131033,06-05-24 17:28,134.62,Purchase,Grocery,646.7323893
27586,766131033,06-07-24 21:28,1100,Payment,Credit Card Payment,-453.2676107
27587,766131033,06-08-24 11:28,22.55,Purchase,Home Improvement,-475.8176107
27588,766131033,06-10-24 9:28,238.65,Withdrawal,ATM Withdrawal,-714.4676107
27589,766131033,06-10-24 21:28,249.88,Purchase,Gas,-964.3476107
27590,766131033,06-11-24 20:28,231.95,IncomingTransfer,Freelance Payment,-732.3976107
27591,766131033,6-14-24 18:28,58.74,Deposit,Check Deposit,-673.6576107
27592,766131033,6-14-24 21:28,500,Payment,Insurance Payment,-1173.657611
27593,766131033,6-16-24 22:28,242.64,Deposit,Cash Deposit,-931.0176107
27594,766131033,07-01-24 11:28,224.5,OnlineShopping,eBay,-1155.517611
27595,766131033,07-01-24 18:28,243.27,Purchase,Entertainment,-1398.787611
27596,766131033,07-02-24 21:28,1750,IncomingTransfer,Salary,351.2123893
27597,766131033,07-05-24 14:28,42.46,IncomingTransfer,Freelance Payment,393.6723893
27598,766131033,07-07-24 21:28,1200,Payment,Credit Card Payment,-806.3276107
27599,766131033,7-15-24 17:28,139.01,IncomingTransfer,Freelance Payment,-667.3176107
27600,766131033,7-18-24 21:28,700,Payment,Installment Payment,-1367.317611
22716,720067083,1-22-24 17:28,200.76,OutgoingTransfer,Bank Transfer,458.803237
22717,720067083,1-23-24 16:28,75.72,Payment,Bill Payment,383.083237
22718,720067083,1-28-24 16:28,132.89,Payment,Mortgage Payment,250.193237
22719,720067083,1-29-24 14:28,31.61,Return,Etsy Return,281.803237
22720,720067083,1-29-24 20:28,175.24,Purchase,Gas,106.563237
22721,720067083,02-01-24 14:28,117.05,Purchase,Entertainment,-10.48676301
22722,720067083,02-03-24 21:28,2600,IncomingTransfer,Salary,2589.513237
22723,720067083,02-04-24 22:28,121.09,IncomingTransfer,Freelance Payment,2710.603237
22724,720067083,02-06-24 12:28,226.14,Purchase,Gas,2484.463237
22725,720067083,02-07-24 17:28,66.76,Purchase,Electronics,2417.703237
22726,720067083,02-08-24 21:28,900,Payment,Credit Card Payment,1517.703237
22727,720067083,02-11-24 12:28,210.72,Return,Target Return,1728.423237
22728,720067083,02-12-24 21:28,52.12,OnlineShopping,AliExpress,1676.303237
22729,720067083,02-12-24 22:28,65.97,Purchase,Grocery,1610.333237
22730,720067083,2-15-24 21:28,1700,Payment,Rent Payment,-89.66676301
22731,720067083,2-18-24 21:28,95.5,Deposit,Direct Deposit,5.833236986
22732,720067083,2-19-24 14:28,85.87,Deposit,Direct Deposit,91.70323699
22733,720067083,2-21-24 9:28,140.28,Deposit,Cash Deposit,231.983237
22734,720067083,2-23-24 14:28,48.15,Deposit,Direct Deposit,280.133237
22735,720067083,2-23-24 17:28,130.6,OutgoingTransfer,International Transfer,149.533237
22736,720067083,03-01-24 15:28,106.82,Payment,Mortgage Payment,42.71323699
22737,720067083,03-02-24 21:28,207.56,Withdrawal,ATM Withdrawal,-164.846763
22738,720067083,03-03-24 21:28,2600,IncomingTransfer,Salary,2435.153237
22739,720067083,03-06-24 16:28,160.56,Purchase,Travel,2274.593237
22740,720067083,03-07-24 21:28,72.55,Deposit,Direct Deposit,2347.143237
22741,720067083,03-08-24 21:28,1200,Payment,Credit Card Payment,1147.143237
22742,720067083,03-09-24 17:28,62.38,Deposit,Direct Deposit,1209.523237
22743,720067083,03-12-24 22:28,247.45,IncomingTransfer,Freelance Payment,1456.973237
22744,720067083,3-13-24 9:28,132.32,Return,Walmart Return,1589.293237
22745,720067083,3-16-24 21:28,1000,Payment,Rent Payment,589.293237
22746,720067083,3-21-24 20:28,113.51,Return,Walmart Return,702.803237
22747,720067083,3-23-24 22:28,59.34,Payment,Mortgage Payment,643.463237
22748,720067083,3-25-24 10:28,242.38,Withdrawal,Mobile App Withdrawal,401.083237
22749,720067083,3-27-24 10:28,227.03,OnlineShopping,Etsy,174.053237
22750,720067083,04-01-24 18:28,171.05,Payment,Loan Payment,3.003236986
22751,720067083,04-04-24 18:28,238.21,OutgoingTransfer,Bank Transfer,-235.206763
22752,720067083,04-05-24 21:28,2600,IncomingTransfer,Salary,2364.793237
22753,720067083,04-09-24 21:28,11.53,Withdrawal,Branch Withdrawal,2353.263237
22754,720067083,04-10-24 21:28,1000,Payment,Credit Card Payment,1353.263237
22755,720067083,04-12-24 14:28,88.7,IncomingTransfer,Freelance Payment,1441.963237
22756,720067083,4-13-24 18:28,99.63,Purchase,Furniture,1342.333237
22757,720067083,4-15-24 19:28,243.38,Return,Best Buy Return,1585.713237
22758,720067083,4-16-24 15:28,97.77,Deposit,Cash Deposit,1683.483237
22759,720067083,4-17-24 21:28,1200,Payment,Rent Payment,483.483237
22760,720067083,4-18-24 13:28,223.12,Deposit,Mobile Deposit,706.603237
22761,720067083,4-24-24 23:28,139.18,Withdrawal,Branch Withdrawal,567.423237
22762,720067083,4-28-24 10:28,218.09,Payment,Loan Payment,349.333237
22763,720067083,05-01-24 18:28,31.38,Deposit,Mobile Deposit,380.713237
22764,720067083,05-01-24 23:28,229.16,Payment,Mortgage Payment,151.553237
22765,720067083,05-02-24 9:28,170.24,OutgoingTransfer,Wire Transfer,-18.68676301
22766,720067083,05-03-24 21:28,2600,IncomingTransfer,Salary,2581.313237
22767,720067083,05-08-24 21:28,1000,Payment,Credit Card Payment,1581.313237
22768,720067083,05-12-24 18:28,241.74,OutgoingTransfer,Peer-to-Peer Transfer,1339.573237
22769,720067083,5-15-24 21:28,1600,Payment,Rent Payment,-260.426763
22770,720067083,5-15-24 21:28,193.21,Withdrawal,Branch Withdrawal,-453.636763
22771,720067083,5-16-24 21:28,158.47,Purchase,Gas,-612.106763
22772,720067083,5-17-24 21:28,102.68,Withdrawal,Mobile App Withdrawal,-714.786763
22773,720067083,06-03-24 21:28,2600,IncomingTransfer,Salary,1885.213237
22774,720067083,06-03-24 21:28,83.4,Purchase,Restaurant,1801.813237
22775,720067083,06-06-24 13:28,145.84,Purchase,Clothing,1655.973237
22776,720067083,06-06-24 16:28,153.37,Payment,Mortgage Payment,1502.603237
22777,720067083,06-07-24 12:28,232.37,Payment,Bill Payment,1270.233237
22778,720067083,06-08-24 21:28,1100,Payment,Credit Card Payment,170.233237
22779,720067083,06-11-24 16:28,10.37,Purchase,Electronics,159.863237
22780,720067083,06-11-24 17:28,90.97,Purchase,Entertainment,68.89323699
22781,720067083,06-12-24 14:28,231.02,Purchase,Clothing,-162.126763
22782,720067083,06-12-24 23:28,245.56,Deposit,Direct Deposit,83.43323699
22783,720067083,6-13-24 15:28,148.09,OutgoingTransfer,Wire Transfer,-64.65676301
22784,720067083,6-14-24 21:28,1000,Payment,Rent Payment,-1064.656763
22785,720067083,6-16-24 14:28,90.69,Payment,Bill Payment,-1155.346763
22786,720067083,6-17-24 21:28,72.33,OutgoingTransfer,Peer-to-Peer Transfer,-1227.676763
22787,720067083,6-18-24 20:28,78.49,Purchase,Travel,-1306.166763
22788,720067083,6-20-24 13:28,64.83,IncomingTransfer,Freelance Payment,-1241.336763
22789,720067083,6-22-24 14:28,217.45,Purchase,Restaurant,-1458.786763
22790,720067083,6-22-24 14:28,249.11,Purchase,Electronics,-1707.896763
22791,720067083,6-23-24 13:28,40.9,Withdrawal,Branch Withdrawal,-1748.796763
22792,720067083,6-25-24 10:28,125.49,Withdrawal,Mobile App Withdrawal,-1874.286763
22793,720067083,6-28-24 16:28,108.61,OnlineShopping,Amazon,-1982.896763
22794,720067083,07-01-24 14:28,46.74,Deposit,Mobile Deposit,-1936.156763
22795,720067083,07-01-24 20:28,197.6,Deposit,Check Deposit,-1738.556763
22796,720067083,07-03-24 22:28,69.56,OutgoingTransfer,International Transfer,-1808.116763
22797,720067083,07-05-24 21:28,2600,IncomingTransfer,Salary,791.883237
22798,720067083,07-09-24 11:28,199.25,Deposit,Cash Deposit,991.133237
22799,720067083,07-10-24 21:28,1100,Payment,Credit Card Payment,-108.866763
22800,720067083,07-11-24 17:28,153.92,IncomingTransfer,Freelance Payment,45.05323699
22801,720067083,07-11-24 23:28,110.39,Deposit,Mobile Deposit,155.443237
22802,720067083,07-12-24 23:28,12.41,Purchase,Electronics,143.033237
22803,720067083,7-13-24 21:28,800,Payment,Rent Payment,-656.966763
22804,720067083,7-13-24 21:28,102.58,Payment,Bill Payment,-759.546763
22805,720067083,7-14-24 12:28,158.75,Withdrawal,ATM Withdrawal,-918.296763
22806,720067083,7-15-24 9:28,120.23,OutgoingTransfer,Bank Transfer,-1038.526763
22807,720067083,7-17-24 13:28,63.22,Withdrawal,Mobile App Withdrawal,-1101.746763
17660,716790633,1-25-24 10:28,372,OnlineShopping,Best Buy,-372
17661,716790633,02-02-24 15:28,300.64,OutgoingTransfer,Bank Transfer,-672.64
17662,716790633,02-03-24 21:28,5300,IncomingTransfer,Salary,4627.36
17663,716790633,02-08-24 14:28,514.96,Purchase,Home Improvement,4112.4
17664,716790633,02-10-24 18:28,476.58,Deposit,Direct Deposit,4588.98
17665,716790633,02-11-24 14:28,110.97,Payment,Bill Payment,4478.01
17666,716790633,02-12-24 19:28,121.64,Deposit,Cash Deposit,4599.65
17667,716790633,2-16-24 21:28,2100,Payment,Rent Payment,2499.65
17668,716790633,2-21-24 19:28,478.4,OnlineShopping,Best Buy,2021.25
17669,716790633,2-23-24 19:28,112.5,Return,Best Buy Return,2133.75
17670,716790633,2-24-24 20:28,85.73,Purchase,Home Improvement,2048.02
17671,716790633,2-25-24 22:28,244.13,Return,Best Buy Return,2292.15
17672,716790633,2-27-24 20:28,511.43,Withdrawal,Branch Withdrawal,1780.72
17673,716790633,2-29-24 20:28,521.56,OnlineShopping,Target,1259.16
17674,716790633,03-03-24 21:28,5300,IncomingTransfer,Salary,6559.16
17675,716790633,3-13-24 21:28,3100,Payment,Rent Payment,3459.16
17676,716790633,3-16-24 19:28,154.1,IncomingTransfer,Freelance Payment,3613.26
17677,716790633,3-18-24 17:28,329.63,IncomingTransfer,Freelance Payment,3942.89
17678,716790633,3-26-24 13:28,72.36,Purchase,Grocery,3870.53
17679,716790633,3-31-24 10:28,482.06,OnlineShopping,eBay,3388.47
17680,716790633,04-01-24 21:28,5300,IncomingTransfer,Salary,8688.47
17681,716790633,04-02-24 14:28,523.97,Return,AliExpress Return,9212.44
17682,716790633,04-05-24 22:28,494.07,Payment,Loan Payment,8718.37
17683,716790633,04-10-24 11:28,548.36,Withdrawal,ATM Withdrawal,8170.01
17684,716790633,04-11-24 23:28,168.5,Purchase,Restaurant,8001.51
17685,716790633,4-17-24 21:28,1600,Payment,Rent Payment,6401.51
17686,716790633,4-28-24 22:28,158.88,Purchase,Grocery,6242.63
17687,716790633,05-05-24 21:28,5300,IncomingTransfer,Salary,11542.63
17688,716790633,05-10-24 12:28,199.57,OutgoingTransfer,International Transfer,11343.06
17689,716790633,05-11-24 21:28,1400,Payment,Rent Payment,9943.06
17690,716790633,5-13-24 17:28,152.32,Deposit,Cash Deposit,10095.38
17691,716790633,5-15-24 10:28,516.7,OutgoingTransfer,Wire Transfer,9578.68
17692,716790633,5-19-24 11:28,212.27,IncomingTransfer,Freelance Payment,9790.95
17693,716790633,5-20-24 11:28,504.59,Purchase,Home Improvement,9286.36
17694,716790633,5-21-24 16:28,410.49,Payment,Bill Payment,8875.87
17695,716790633,5-22-24 16:28,329.43,IncomingTransfer,Freelance Payment,9205.3
17696,716790633,5-26-24 18:28,198.57,Purchase,Clothing,9006.73
17697,716790633,5-27-24 22:28,122.7,Deposit,Mobile Deposit,9129.43
17698,716790633,5-29-24 18:28,240.25,OutgoingTransfer,International Transfer,8889.18
17699,716790633,06-02-24 21:28,5300,IncomingTransfer,Salary,14189.18
17700,716790633,6-15-24 18:28,547.8,OutgoingTransfer,Wire Transfer,13641.38
17701,716790633,6-16-24 21:28,381.19,IncomingTransfer,Freelance Payment,14022.57
17702,716790633,6-17-24 21:28,3200,Payment,Rent Payment,10822.57
17703,716790633,6-17-24 22:28,311.75,Purchase,Restaurant,10510.82
17704,716790633,6-25-24 9:28,242.22,Deposit,Check Deposit,10753.04
17705,716790633,6-28-24 14:28,73.94,Withdrawal,Mobile App Withdrawal,10679.1
17706,716790633,6-28-24 22:28,528.08,OutgoingTransfer,Peer-to-Peer Transfer,10151.02
17707,716790633,07-04-24 21:28,5300,IncomingTransfer,Salary,15451.02
17708,716790633,07-12-24 15:28,520.46,Withdrawal,ATM Withdrawal,14930.56
17709,716790633,7-15-24 21:28,2500,Payment,Rent Payment,12430.56
40412,820085808,1-21-24 21:28,27.75,Deposit,Check Deposit,898.0470963
40413,820085808,1-22-24 11:28,49.74,Purchase,Furniture,848.3070963
40414,820085808,1-22-24 16:28,107.71,Withdrawal,Mobile App Withdrawal,740.5970963
40415,820085808,1-23-24 13:28,24.7,Purchase,Grocery,715.8970963
40416,820085808,02-01-24 12:28,221.98,Withdrawal,ATM Withdrawal,493.9170963
40417,820085808,02-01-24 12:28,79.82,Purchase,Entertainment,414.0970963
40418,820085808,02-02-24 10:28,121.37,Purchase,Electronics,292.7270963
40419,820085808,02-02-24 16:28,244.86,Deposit,Direct Deposit,537.5870963
40420,820085808,02-03-24 20:28,115.02,Deposit,Check Deposit,652.6070963
40421,820085808,02-03-24 21:28,2250,IncomingTransfer,Salary,2902.607096
40422,820085808,02-05-24 19:28,201.36,Purchase,Gas,2701.247096
40423,820085808,02-07-24 16:28,17.88,Deposit,Cash Deposit,2719.127096
40424,820085808,02-08-24 21:28,1800,Payment,Credit Card Payment,919.1270963
40425,820085808,02-09-24 17:28,173.61,OutgoingTransfer,International Transfer,745.5170963
40426,820085808,02-09-24 19:28,86.06,Purchase,Gas,659.4570963
40427,820085808,02-12-24 18:28,164.17,Payment,Mortgage Payment,495.2870963
40428,820085808,2-13-24 21:28,29.62,OnlineShopping,Best Buy,465.6670963
40429,820085808,2-13-24 23:28,107.1,Payment,Mortgage Payment,358.5670963
40430,820085808,2-14-24 23:28,40.97,OutgoingTransfer,Wire Transfer,317.5970963
40431,820085808,2-16-24 21:28,1100,Payment,Rent Payment,-782.4029037
40432,820085808,2-19-24 18:28,184.19,Purchase,Entertainment,-966.5929037
40433,820085808,2-21-24 14:28,10.11,Return,Walmart Return,-956.4829037
40434,820085808,03-03-24 11:28,41.04,Purchase,Furniture,-997.5229037
40435,820085808,03-03-24 21:28,2250,IncomingTransfer,Salary,1252.477096
40436,820085808,03-04-24 13:28,77.08,Purchase,Grocery,1175.397096
40437,820085808,03-04-24 18:28,49.74,Deposit,Direct Deposit,1225.137096
40438,820085808,03-08-24 21:28,1600,Payment,Credit Card Payment,-374.8629037
40439,820085808,03-10-24 22:28,157.24,OutgoingTransfer,Bank Transfer,-532.1029037
40440,820085808,3-13-24 23:28,53.25,Deposit,Check Deposit,-478.8529037
40441,820085808,3-16-24 12:28,228.74,Purchase,Gas,-707.5929037
40442,820085808,3-17-24 11:28,207.04,OnlineShopping,AliExpress,-914.6329037
40443,820085808,3-17-24 21:28,600,Payment,Rent Payment,-1514.632904
40444,820085808,3-18-24 16:28,217.01,Payment,Loan Payment,-1731.642904
40445,820085808,3-20-24 13:28,198.71,IncomingTransfer,Freelance Payment,-1532.932904
40446,820085808,3-23-24 10:28,69.82,Deposit,Cash Deposit,-1463.112904
40447,820085808,3-23-24 17:28,21.94,Payment,Bill Payment,-1485.052904
40448,820085808,3-26-24 15:28,93.38,Purchase,Grocery,-1578.432904
40449,820085808,3-26-24 21:28,140.04,Return,Target Return,-1438.392904
40450,820085808,3-27-24 18:28,90.36,Withdrawal,Branch Withdrawal,-1528.752904
40451,820085808,3-30-24 16:28,128.72,Payment,Mortgage Payment,-1657.472904
40452,820085808,3-30-24 17:28,136.27,Return,Etsy Return,-1521.202904
40453,820085808,3-31-24 22:28,119.65,Payment,Bill Payment,-1640.852904
40454,820085808,04-03-24 16:28,70.42,Deposit,Cash Deposit,-1570.432904
40455,820085808,04-04-24 21:28,2250,IncomingTransfer,Salary,679.5670963
40456,820085808,04-05-24 20:28,229.35,Withdrawal,ATM Withdrawal,450.2170963
40457,820085808,04-07-24 22:28,210.53,Deposit,Direct Deposit,660.7470963
40458,820085808,04-09-24 21:28,1800,Payment,Credit Card Payment,-1139.252904
40459,820085808,04-09-24 21:28,36.76,Purchase,Gas,-1176.012904
40460,820085808,04-12-24 16:28,223.9,Return,eBay Return,-952.1129037
40461,820085808,04-12-24 18:28,11.77,Purchase,Pharmacy,-963.8829037
40462,820085808,4-13-24 20:28,141.37,IncomingTransfer,Freelance Payment,-822.5129037
40463,820085808,4-14-24 12:28,163.16,Return,eBay Return,-659.3529037
40464,820085808,4-15-24 21:28,1000,Payment,Rent Payment,-1659.352904
40465,820085808,4-16-24 13:28,110.02,Payment,Bill Payment,-1769.372904
40466,820085808,4-17-24 13:28,199.36,Deposit,Direct Deposit,-1570.012904
40467,820085808,4-17-24 15:28,94.61,Deposit,Cash Deposit,-1475.402904
40468,820085808,4-17-24 20:28,214.84,Deposit,Cash Deposit,-1260.562904
40469,820085808,4-19-24 9:28,25.67,Purchase,Pharmacy,-1286.232904
40470,820085808,4-25-24 16:28,208.54,Payment,Bill Payment,-1494.772904
40471,820085808,05-01-24 22:28,46.88,OnlineShopping,Best Buy,-1541.652904
40472,820085808,05-02-24 20:28,225.07,Withdrawal,ATM Withdrawal,-1766.722904
40473,820085808,05-03-24 21:28,2250,IncomingTransfer,Salary,483.2770963
40474,820085808,05-04-24 10:28,164.38,Withdrawal,Branch Withdrawal,318.8970963
40475,820085808,05-06-24 16:28,244.97,IncomingTransfer,Freelance Payment,563.8670963
40476,820085808,05-08-24 21:28,1900,Payment,Credit Card Payment,-1336.132904
40477,820085808,05-11-24 13:28,150.42,Payment,Mortgage Payment,-1486.552904
40478,820085808,5-15-24 21:28,900,Payment,Rent Payment,-2386.552904
40479,820085808,5-15-24 23:28,66.78,Deposit,Cash Deposit,-2319.772904
40480,820085808,5-21-24 12:28,33.38,Return,Best Buy Return,-2286.392904
40481,820085808,5-21-24 16:28,97.86,Payment,Bill Payment,-2384.252904
40482,820085808,5-25-24 15:28,217.74,Purchase,Furniture,-2601.992904
40483,820085808,5-28-24 9:28,79.79,Deposit,Check Deposit,-2522.202904
40484,820085808,5-28-24 20:28,185.64,OnlineShopping,Target,-2707.842904
40485,820085808,5-30-24 17:28,39.8,Return,Target Return,-2668.042904
40486,820085808,06-01-24 19:28,52.4,OnlineShopping,Etsy,-2720.442904
40487,820085808,06-02-24 14:28,35.13,Deposit,Mobile Deposit,-2685.312904
40488,820085808,06-03-24 19:28,173.59,Deposit,Check Deposit,-2511.722904
40489,820085808,06-04-24 14:28,55.57,OutgoingTransfer,Peer-to-Peer Transfer,-2567.292904
40490,820085808,06-04-24 21:28,2250,IncomingTransfer,Salary,-317.2929037
40491,820085808,06-09-24 21:28,1700,Payment,Credit Card Payment,-2017.292904
40492,820085808,06-11-24 12:28,207.07,Withdrawal,Branch Withdrawal,-2224.362904
40493,820085808,06-11-24 21:28,900,Payment,Rent Payment,-3124.362904
40494,820085808,6-15-24 20:28,95.79,OutgoingTransfer,International Transfer,-3220.152904
40495,820085808,6-17-24 17:28,229.08,Deposit,Cash Deposit,-2991.072904
40496,820085808,6-18-24 17:28,75.18,OnlineShopping,AliExpress,-3066.252904
40497,820085808,6-20-24 10:28,139.47,Purchase,Clothing,-3205.722904
40498,820085808,6-22-24 10:28,134.8,Withdrawal,Mobile App Withdrawal,-3340.522904
40499,820085808,6-22-24 17:28,72.19,IncomingTransfer,Freelance Payment,-3268.332904
40500,820085808,6-25-24 16:28,25.09,Deposit,Mobile Deposit,-3243.242904
40501,820085808,6-26-24 14:28,112.94,OnlineShopping,eBay,-3356.182904
40502,820085808,6-27-24 11:28,68.16,OutgoingTransfer,Peer-to-Peer Transfer,-3424.342904
40503,820085808,6-29-24 11:28,21.02,Payment,Loan Payment,-3445.362904
40504,820085808,07-05-24 14:28,152.53,Deposit,Check Deposit,-3292.832904
40505,820085808,07-05-24 21:28,2250,IncomingTransfer,Salary,-1042.832904
40506,820085808,07-07-24 10:28,56.62,Deposit,Mobile Deposit,-986.2129037
40507,820085808,07-07-24 10:28,134.64,Purchase,Gas,-1120.852904
40508,820085808,07-08-24 17:28,179.84,Deposit,Cash Deposit,-941.0129037
40509,820085808,07-10-24 15:28,196.04,IncomingTransfer,Freelance Payment,-744.9729037
40510,820085808,07-10-24 21:28,1600,Payment,Credit Card Payment,-2344.972904
40511,820085808,07-11-24 9:28,111.55,Return,Etsy Return,-2233.422904
40512,820085808,07-12-24 16:28,143.29,OutgoingTransfer,Wire Transfer,-2376.712904
40513,820085808,7-13-24 14:28,135.21,Return,Walmart Return,-2241.502904
40514,820085808,7-14-24 18:28,45.63,Payment,Mortgage Payment,-2287.132904
40515,820085808,7-14-24 21:28,1100,Payment,Rent Payment,-3387.132904
13286,714499908,1-22-24 10:28,239.7,OutgoingTransfer,Bank Transfer,697.5069074
13287,714499908,1-26-24 12:28,91.28,Purchase,Clothing,606.2269074
13288,714499908,1-29-24 10:28,246.25,Return,Walmart Return,852.4769074
13289,714499908,1-30-24 20:28,57.09,OnlineShopping,eBay,795.3869074
13290,714499908,1-30-24 23:28,149.75,Deposit,Mobile Deposit,945.1369074
13291,714499908,1-31-24 15:28,318.17,Withdrawal,Mobile App Withdrawal,626.9669074
13292,714499908,02-03-24 13:28,379.91,Withdrawal,Mobile App Withdrawal,247.0569074
13293,714499908,02-03-24 21:28,3850,IncomingTransfer,Salary,4097.056907
13294,714499908,02-07-24 16:28,123.82,Return,Etsy Return,4220.876907
13295,714499908,02-08-24 21:28,1600,Payment,Credit Card Payment,2620.876907
13296,714499908,02-10-24 14:28,263.65,Deposit,Cash Deposit,2884.526907
13297,714499908,02-10-24 15:28,158.23,Withdrawal,Branch Withdrawal,2726.296907
13298,714499908,2-13-24 10:28,158.07,Deposit,Direct Deposit,2884.366907
13299,714499908,2-14-24 18:28,355.52,Deposit,Cash Deposit,3239.886907
13300,714499908,2-14-24 20:28,43.14,Return,eBay Return,3283.026907
13301,714499908,2-14-24 21:28,2300,Payment,Rent Payment,983.0269074
13302,714499908,2-15-24 20:28,252.94,Deposit,Mobile Deposit,1235.966907
13303,714499908,2-17-24 17:28,193.54,Return,Amazon Return,1429.506907
13304,714499908,2-26-24 14:28,30.66,Withdrawal,Mobile App Withdrawal,1398.846907
13305,714499908,2-28-24 20:28,30.27,Deposit,Mobile Deposit,1429.116907
13306,714499908,03-02-24 11:28,332.03,IncomingTransfer,Freelance Payment,1761.146907
13307,714499908,03-04-24 14:28,165.37,OutgoingTransfer,Wire Transfer,1595.776907
13308,714499908,03-05-24 21:28,3850,IncomingTransfer,Salary,5445.776907
13309,714499908,03-09-24 16:28,274.03,Return,Best Buy Return,5719.806907
13310,714499908,03-10-24 21:28,1600,Payment,Credit Card Payment,4119.806907
13311,714499908,03-11-24 21:28,1300,Payment,Rent Payment,2819.806907
13312,714499908,3-16-24 11:28,151.87,Withdrawal,Branch Withdrawal,2667.936907
13313,714499908,3-24-24 14:28,109.89,OnlineShopping,eBay,2558.046907
13314,714499908,04-04-24 21:28,3850,IncomingTransfer,Salary,6408.046907
13315,714499908,04-06-24 21:28,143.11,IncomingTransfer,Freelance Payment,6551.156907
13316,714499908,04-09-24 21:28,1700,Payment,Credit Card Payment,4851.156907
13317,714499908,04-11-24 12:28,228.93,OutgoingTransfer,Peer-to-Peer Transfer,4622.226907
13318,714499908,4-15-24 18:28,287.32,Payment,Mortgage Payment,4334.906907
13319,714499908,4-17-24 18:28,397.97,Deposit,Direct Deposit,4732.876907
13320,714499908,4-17-24 19:28,251.97,Payment,Mortgage Payment,4480.906907
13321,714499908,4-17-24 21:28,379.63,Purchase,Home Improvement,4101.276907
13322,714499908,4-18-24 21:28,2200,Payment,Rent Payment,1901.276907
13323,714499908,4-26-24 23:28,244.2,Purchase,Pharmacy,1657.076907
13324,714499908,4-28-24 10:28,386.49,Purchase,Restaurant,1270.586907
13325,714499908,4-29-24 23:28,308.59,Withdrawal,ATM Withdrawal,961.9969074
13326,714499908,05-02-24 19:28,255.3,Purchase,Pharmacy,706.6969074
13327,714499908,05-04-24 21:28,3850,IncomingTransfer,Salary,4556.696907
13328,714499908,05-08-24 13:28,316.54,Deposit,Check Deposit,4873.236907
13329,714499908,05-09-24 21:28,1500,Payment,Credit Card Payment,3373.236907
13330,714499908,05-11-24 20:28,109.06,OnlineShopping,Target,3264.176907
13331,714499908,5-15-24 21:28,2000,Payment,Rent Payment,1264.176907
13332,714499908,5-15-24 21:28,74.38,Purchase,Home Improvement,1189.796907
13333,714499908,5-16-24 9:28,102.59,Deposit,Mobile Deposit,1292.386907
13334,714499908,5-17-24 11:28,208.27,IncomingTransfer,Freelance Payment,1500.656907
13335,714499908,5-26-24 17:28,388.61,OnlineShopping,Walmart,1112.046907
13336,714499908,5-26-24 17:28,85.27,Payment,Bill Payment,1026.776907
13337,714499908,5-29-24 17:28,122.22,Purchase,Electronics,904.5569074
13338,714499908,06-01-24 21:28,3850,IncomingTransfer,Salary,4754.556907
13339,714499908,06-02-24 12:28,121.45,OnlineShopping,Etsy,4633.106907
13340,714499908,06-02-24 18:28,85.43,Payment,Loan Payment,4547.676907
13341,714499908,06-06-24 21:28,1600,Payment,Credit Card Payment,2947.676907
13342,714499908,06-11-24 12:28,150.06,Purchase,Clothing,2797.616907
13343,714499908,6-13-24 20:28,62.27,Withdrawal,Branch Withdrawal,2735.346907
13344,714499908,6-13-24 22:28,280.73,Deposit,Check Deposit,3016.076907
13345,714499908,6-16-24 20:28,115.98,OutgoingTransfer,Wire Transfer,2900.096907
13346,714499908,6-17-24 18:28,229.52,Purchase,Grocery,2670.576907
13347,714499908,6-18-24 21:28,2100,Payment,Rent Payment,570.5769074
13348,714499908,6-20-24 10:28,28.34,Payment,Mortgage Payment,542.2369074
13349,714499908,6-20-24 15:28,40.42,Deposit,Check Deposit,582.6569074
13350,714499908,6-21-24 10:28,58.94,Purchase,Pharmacy,523.7169074
13351,714499908,6-21-24 17:28,315.16,Purchase,Clothing,208.5569074
13352,714499908,6-22-24 19:28,120.94,Deposit,Check Deposit,329.4969074
13353,714499908,6-23-24 22:28,335.3,Withdrawal,Branch Withdrawal,-5.803092591
13354,714499908,6-26-24 14:28,383.67,Deposit,Cash Deposit,377.8669074
13355,714499908,6-26-24 20:28,353.14,Purchase,Restaurant,24.72690741
13356,714499908,6-26-24 23:28,113.83,OutgoingTransfer,Wire Transfer,-89.10309259
13357,714499908,07-02-24 12:28,303.49,Deposit,Mobile Deposit,214.3869074
13358,714499908,07-03-24 15:28,174.49,Deposit,Cash Deposit,388.8769074
13359,714499908,07-03-24 18:28,291.41,OnlineShopping,AliExpress,97.46690741
13360,714499908,07-03-24 19:28,170.28,OnlineShopping,AliExpress,-72.81309259
13361,714499908,07-03-24 21:28,3850,IncomingTransfer,Salary,3777.186907
13362,714499908,07-05-24 9:28,117.37,Withdrawal,ATM Withdrawal,3659.816907
13363,714499908,07-08-24 21:28,1800,Payment,Credit Card Payment,1859.816907
13364,714499908,07-11-24 21:28,1300,Payment,Rent Payment,559.8169074
13365,714499908,07-12-24 13:28,42.64,Deposit,Check Deposit,602.4569074
13366,714499908,7-16-24 11:28,208.93,OutgoingTransfer,Peer-to-Peer Transfer,393.5269074
17797,716966808,1-27-24 19:28,698.69,Withdrawal,Branch Withdrawal,269.3571936
17798,716966808,1-29-24 16:28,463.78,OutgoingTransfer,Bank Transfer,-194.4228064
17799,716966808,1-30-24 16:28,189.52,OutgoingTransfer,Peer-to-Peer Transfer,-383.9428064
17800,716966808,02-05-24 19:28,343.54,Withdrawal,Branch Withdrawal,-727.4828064
17801,716966808,02-05-24 21:28,7750,IncomingTransfer,Salary,7022.517194
17802,716966808,02-10-24 10:28,588.21,Payment,Mortgage Payment,6434.307194
17803,716966808,02-10-24 21:28,1900,Payment,Credit Card Payment,4534.307194
17804,716966808,2-18-24 21:28,3500,Payment,Rent Payment,1034.307194
17805,716966808,2-19-24 18:28,390.4,Payment,Loan Payment,643.9071936
17806,716966808,2-20-24 9:28,153.81,OutgoingTransfer,Bank Transfer,490.0971936
17807,716966808,2-24-24 19:28,146.09,Payment,Bill Payment,344.0071936
17808,716966808,2-28-24 14:28,413.49,Purchase,Restaurant,-69.48280645
17809,716966808,03-04-24 21:28,7750,IncomingTransfer,Salary,7680.517194
17810,716966808,03-08-24 14:28,616.85,Deposit,Mobile Deposit,8297.367194
17811,716966808,03-09-24 21:28,1700,Payment,Credit Card Payment,6597.367194
17812,716966808,03-12-24 21:28,2100,Payment,Rent Payment,4497.367194
17813,716966808,3-24-24 10:28,378.5,Deposit,Check Deposit,4875.867194
17814,716966808,3-24-24 11:28,670.05,OutgoingTransfer,Wire Transfer,4205.817194
17815,716966808,3-29-24 18:28,364.14,OnlineShopping,eBay,3841.677194
17816,716966808,3-31-24 20:28,321.77,Withdrawal,Branch Withdrawal,3519.907194
17817,716966808,04-04-24 21:28,7750,IncomingTransfer,Salary,11269.90719
17818,716966808,04-09-24 21:28,2400,Payment,Credit Card Payment,8869.907194
17819,716966808,04-11-24 13:28,261.96,Deposit,Direct Deposit,9131.867194
17820,716966808,04-12-24 22:28,291.09,Payment,Loan Payment,8840.777194
17821,716966808,4-14-24 22:28,493.96,Purchase,Pharmacy,8346.817194
17822,716966808,4-16-24 12:28,681.01,Deposit,Check Deposit,9027.827194
17823,716966808,4-17-24 21:28,2000,Payment,Rent Payment,7027.827194
17824,716966808,4-23-24 22:28,586.7,Return,Amazon Return,7614.527194
17825,716966808,05-05-24 19:28,610.54,Withdrawal,Mobile App Withdrawal,7003.987194
17826,716966808,05-05-24 21:28,7750,IncomingTransfer,Salary,14753.98719
17827,716966808,05-10-24 21:28,1800,Payment,Credit Card Payment,12953.98719
17828,716966808,5-18-24 21:28,3400,Payment,Rent Payment,9553.987194
17829,716966808,5-22-24 10:28,189.91,Purchase,Travel,9364.077194
17830,716966808,06-04-24 12:28,213.29,Purchase,Home Improvement,9150.787194
17831,716966808,06-05-24 9:28,560.44,Purchase,Travel,8590.347194
17832,716966808,06-05-24 21:28,7750,IncomingTransfer,Salary,16340.34719
17833,716966808,06-05-24 22:28,489.63,OnlineShopping,Target,15850.71719
17834,716966808,06-10-24 21:28,2500,Payment,Credit Card Payment,13350.71719
17835,716966808,06-10-24 22:28,419.56,Purchase,Home Improvement,12931.15719
17836,716966808,6-15-24 21:28,5000,Payment,Rent Payment,7931.157194
17837,716966808,6-18-24 13:28,367.86,OnlineShopping,Etsy,7563.297194
17838,716966808,6-20-24 22:28,535.01,Deposit,Mobile Deposit,8098.307194
17839,716966808,6-24-24 11:28,263.51,OnlineShopping,AliExpress,7834.797194
17840,716966808,07-02-24 13:28,522.08,Deposit,Mobile Deposit,8356.877194
17841,716966808,07-04-24 21:28,7750,IncomingTransfer,Salary,16106.87719
17842,716966808,07-08-24 18:28,618.28,Purchase,Home Improvement,15488.59719
17843,716966808,07-08-24 20:28,686.22,OutgoingTransfer,Wire Transfer,14802.37719
17844,716966808,07-09-24 21:28,2000,Payment,Credit Card Payment,12802.37719
17845,716966808,07-11-24 13:28,740.85,OutgoingTransfer,International Transfer,12061.52719
17846,716966808,07-11-24 14:28,253.68,Deposit,Direct Deposit,12315.20719
17847,716966808,7-13-24 12:28,240.42,Purchase,Gas,12074.78719
17848,716966808,7-16-24 21:28,2700,Payment,Rent Payment,9374.787194
17849,716966808,7-17-24 9:28,467.62,Deposit,Direct Deposit,9842.407194
14986,715485483,1-22-24 17:28,171.26,OnlineShopping,AliExpress,-171.26
14987,715485483,1-23-24 20:28,147.63,Purchase,Furniture,-318.89
14988,715485483,1-28-24 11:28,172.54,Return,Walmart Return,-146.35
14989,715485483,02-05-24 19:28,158.99,Purchase,Travel,-305.34
14990,715485483,02-05-24 21:28,2650,IncomingTransfer,Salary,2344.66
14991,715485483,02-07-24 22:28,180.23,OnlineShopping,Etsy,2164.43
14992,715485483,2-18-24 21:28,800,Payment,Rent Payment,1364.43
14993,715485483,2-19-24 18:28,242.61,Deposit,Cash Deposit,1607.04
14994,715485483,2-22-24 12:28,89.59,OutgoingTransfer,Wire Transfer,1517.45
14995,715485483,03-02-24 21:28,2650,IncomingTransfer,Salary,4167.45
14996,715485483,03-10-24 17:28,60.8,Deposit,Direct Deposit,4228.25
14997,715485483,3-15-24 21:28,1100,Payment,Rent Payment,3128.25
14998,715485483,3-18-24 14:28,29.7,OnlineShopping,Target,3098.55
14999,715485483,3-20-24 10:28,166.48,Withdrawal,Branch Withdrawal,2932.07
15000,715485483,04-02-24 12:28,116.76,Deposit,Cash Deposit,3048.83
15001,715485483,04-04-24 10:28,35.94,Purchase,Home Improvement,3012.89
15002,715485483,04-05-24 21:28,2650,IncomingTransfer,Salary,5662.89
15003,715485483,04-06-24 21:28,60.34,Return,Best Buy Return,5723.23
15004,715485483,04-10-24 15:28,204.59,Purchase,Pharmacy,5518.64
15005,715485483,04-11-24 17:28,20.74,Deposit,Cash Deposit,5539.38
15006,715485483,4-14-24 13:28,81.62,IncomingTransfer,Freelance Payment,5621
15007,715485483,4-14-24 21:28,800,Payment,Rent Payment,4821
15008,715485483,4-16-24 17:28,75.84,OnlineShopping,Amazon,4745.16
15009,715485483,4-18-24 17:28,50.79,Purchase,Gas,4694.37
15010,715485483,4-19-24 16:28,153.99,OnlineShopping,AliExpress,4540.38
15011,715485483,4-19-24 18:28,216.57,OutgoingTransfer,Bank Transfer,4323.81
15012,715485483,4-20-24 16:28,200.39,Withdrawal,Branch Withdrawal,4123.42
15013,715485483,4-21-24 10:28,81.42,Deposit,Check Deposit,4204.84
15014,715485483,05-04-24 21:28,2650,IncomingTransfer,Salary,6854.84
15015,715485483,05-06-24 12:28,52.56,Deposit,Cash Deposit,6907.4
15016,715485483,05-10-24 10:28,49.71,Deposit,Check Deposit,6957.11
15017,715485483,05-12-24 21:28,1200,Payment,Rent Payment,5757.11
15018,715485483,5-16-24 10:28,201.97,Withdrawal,Mobile App Withdrawal,5555.14
15019,715485483,5-16-24 23:28,202.95,OutgoingTransfer,Wire Transfer,5352.19
15020,715485483,5-18-24 22:28,54.63,Purchase,Home Improvement,5297.56
15021,715485483,5-20-24 18:28,160.19,Purchase,Entertainment,5137.37
15022,715485483,5-25-24 10:28,120.58,OnlineShopping,Best Buy,5016.79
15023,715485483,5-28-24 15:28,107.19,Purchase,Grocery,4909.6
15024,715485483,5-31-24 13:28,182.07,Deposit,Cash Deposit,5091.67
15025,715485483,06-02-24 15:28,203.46,OnlineShopping,Amazon,4888.21
15026,715485483,06-05-24 17:28,106.27,Withdrawal,ATM Withdrawal,4781.94
15027,715485483,06-05-24 21:28,2650,IncomingTransfer,Salary,7431.94
15028,715485483,06-10-24 20:28,224.57,Withdrawal,Mobile App Withdrawal,7207.37
15029,715485483,06-10-24 21:28,1300,Payment,Rent Payment,5907.37
15030,715485483,6-17-24 10:28,207.08,Payment,Bill Payment,5700.29
15031,715485483,6-20-24 21:28,69.32,Return,AliExpress Return,5769.61
15032,715485483,6-22-24 15:28,50.6,Deposit,Check Deposit,5820.21
15033,715485483,6-30-24 12:28,202.24,Return,Best Buy Return,6022.45
15034,715485483,07-02-24 12:28,191.56,Deposit,Mobile Deposit,6214.01
15035,715485483,07-02-24 21:28,2650,IncomingTransfer,Salary,8864.01
15036,715485483,07-02-24 22:28,217.28,Deposit,Direct Deposit,9081.29
15037,715485483,07-03-24 17:28,94.06,Deposit,Check Deposit,9175.35
15038,715485483,07-08-24 12:28,243.23,OutgoingTransfer,Wire Transfer,8932.12
15039,715485483,07-10-24 21:28,1500,Payment,Rent Payment,7432.12
15040,715485483,07-11-24 22:28,65.02,Deposit,Cash Deposit,7497.14
15041,715485483,7-17-24 9:28,127.83,OutgoingTransfer,Bank Transfer,7369.31
30386,778888083,1-20-24 20:28,102.66,Deposit,Mobile Deposit,102.66
30387,778888083,1-31-24 21:28,251.24,OutgoingTransfer,Wire Transfer,-148.58
30388,778888083,02-03-24 21:28,4150,IncomingTransfer,Salary,4001.42
30389,778888083,02-11-24 18:28,107.9,Deposit,Mobile Deposit,4109.32
30390,778888083,02-12-24 17:28,384.75,Deposit,Direct Deposit,4494.07
30391,778888083,2-14-24 21:28,1500,Payment,Rent Payment,2994.07
30392,778888083,2-16-24 20:28,107.3,Withdrawal,Mobile App Withdrawal,2886.77
30393,778888083,2-18-24 20:28,296.41,Purchase,Home Improvement,2590.36
30394,778888083,2-18-24 20:28,113.74,Purchase,Travel,2476.62
30395,778888083,2-19-24 10:28,191.34,Deposit,Cash Deposit,2667.96
30396,778888083,2-20-24 11:28,269.2,Return,Target Return,2937.16
30397,778888083,2-22-24 13:28,269.71,OutgoingTransfer,International Transfer,2667.45
30398,778888083,2-24-24 14:28,59.44,Withdrawal,Mobile App Withdrawal,2608.01
30399,778888083,2-24-24 17:28,202.91,Purchase,Entertainment,2405.1
30400,778888083,2-26-24 21:28,385.85,Payment,Loan Payment,2019.25
30401,778888083,2-29-24 9:28,55.4,Withdrawal,ATM Withdrawal,1963.85
30402,778888083,03-03-24 21:28,299.9,Purchase,Entertainment,1663.95
30403,778888083,03-04-24 17:28,204.95,Purchase,Electronics,1459
30404,778888083,03-04-24 21:28,156.07,Deposit,Cash Deposit,1615.07
30405,778888083,03-05-24 21:28,4150,IncomingTransfer,Salary,5765.07
30406,778888083,03-06-24 13:28,308.56,OnlineShopping,Best Buy,5456.51
30407,778888083,3-14-24 15:28,390.53,Purchase,Home Improvement,5065.98
30408,778888083,3-14-24 21:28,1600,Payment,Rent Payment,3465.98
30409,778888083,3-17-24 14:28,376.17,Deposit,Cash Deposit,3842.15
30410,778888083,3-24-24 22:28,230.51,OutgoingTransfer,Bank Transfer,3611.64
30411,778888083,3-29-24 11:28,398.81,Deposit,Mobile Deposit,4010.45
30412,778888083,3-29-24 23:28,99.37,OutgoingTransfer,Wire Transfer,3911.08
30413,778888083,04-03-24 21:28,245.08,Return,Walmart Return,4156.16
30414,778888083,04-05-24 16:28,358.57,OutgoingTransfer,Bank Transfer,3797.59
30415,778888083,04-05-24 21:28,4150,IncomingTransfer,Salary,7947.59
30416,778888083,04-05-24 21:28,127.69,OnlineShopping,Best Buy,7819.9
30417,778888083,04-09-24 12:28,117.31,OutgoingTransfer,Wire Transfer,7702.59
30418,778888083,4-18-24 12:28,261.96,Deposit,Cash Deposit,7964.55
30419,778888083,4-18-24 21:28,2300,Payment,Rent Payment,5664.55
30420,778888083,4-22-24 10:28,354.3,Deposit,Cash Deposit,6018.85
30421,778888083,4-22-24 12:28,143.59,OutgoingTransfer,Peer-to-Peer Transfer,5875.26
30422,778888083,4-25-24 10:28,256.13,Purchase,Entertainment,5619.13
30423,778888083,05-01-24 13:28,374.56,Withdrawal,Branch Withdrawal,5244.57
30424,778888083,05-02-24 13:28,207.05,Deposit,Cash Deposit,5451.62
30425,778888083,05-02-24 21:28,306,Purchase,Furniture,5145.62
30426,778888083,05-03-24 9:28,52.24,Deposit,Check Deposit,5197.86
30427,778888083,05-04-24 20:28,121.49,Deposit,Direct Deposit,5319.35
30428,778888083,05-05-24 21:28,4150,IncomingTransfer,Salary,9469.35
30429,778888083,05-09-24 10:28,239.61,Purchase,Entertainment,9229.74
30430,778888083,05-09-24 13:28,285.73,Purchase,Clothing,8944.01
30431,778888083,05-10-24 23:28,391.32,Withdrawal,ATM Withdrawal,8552.69
30432,778888083,5-15-24 21:28,1800,Payment,Rent Payment,6752.69
30433,778888083,5-23-24 21:28,24.33,Return,Etsy Return,6777.02
30434,778888083,5-26-24 13:28,176.9,Payment,Bill Payment,6600.12
30435,778888083,5-30-24 17:28,290.15,Payment,Bill Payment,6309.97
30436,778888083,5-31-24 22:28,80.63,Withdrawal,Mobile App Withdrawal,6229.34
30437,778888083,06-02-24 21:28,39.4,Purchase,Grocery,6189.94
30438,778888083,06-03-24 21:28,4150,IncomingTransfer,Salary,10339.94
30439,778888083,06-10-24 20:28,213.06,IncomingTransfer,Freelance Payment,10553
30440,778888083,06-12-24 19:28,70.01,Purchase,Pharmacy,10482.99
30441,778888083,06-12-24 21:28,2100,Payment,Rent Payment,8382.99
30442,778888083,6-14-24 13:28,236.23,Purchase,Electronics,8146.76
30443,778888083,6-15-24 17:28,100.28,Withdrawal,ATM Withdrawal,8046.48
30444,778888083,6-15-24 22:28,244.63,Purchase,Travel,7801.85
30445,778888083,6-21-24 13:28,157.7,Deposit,Mobile Deposit,7959.55
30446,778888083,6-21-24 17:28,353.89,OnlineShopping,Etsy,7605.66
30447,778888083,6-22-24 13:28,72.19,Deposit,Check Deposit,7677.85
30448,778888083,6-27-24 23:28,394.16,Deposit,Check Deposit,8072.01
30449,778888083,07-01-24 12:28,295.39,Withdrawal,ATM Withdrawal,7776.62
30450,778888083,07-04-24 16:28,65.99,Deposit,Cash Deposit,7842.61
30451,778888083,07-04-24 21:28,4150,IncomingTransfer,Salary,11992.61
30452,778888083,07-06-24 21:28,178.81,Return,AliExpress Return,12171.42
30453,778888083,07-09-24 21:28,53.07,Withdrawal,Mobile App Withdrawal,12118.35
30454,778888083,07-11-24 14:28,115.17,Withdrawal,Branch Withdrawal,12003.18
30455,778888083,7-13-24 17:28,34.74,Withdrawal,Branch Withdrawal,11968.44
30456,778888083,7-13-24 22:28,385.25,OutgoingTransfer,Peer-to-Peer Transfer,11583.19
30457,778888083,7-14-24 11:28,138.12,Purchase,Travel,11445.07
30458,778888083,7-15-24 11:28,298.77,Purchase,Restaurant,11146.3
30459,778888083,7-16-24 21:28,2600,Payment,Rent Payment,8546.3
15231,715705683,1-25-24 18:28,11.41,Payment,Mortgage Payment,691.3100448
15232,715705683,1-26-24 9:28,119.1,Payment,Loan Payment,572.2100448
15233,715705683,1-27-24 11:28,243.75,OutgoingTransfer,Bank Transfer,328.4600448
15234,715705683,1-29-24 11:28,30.47,Deposit,Check Deposit,358.9300448
15235,715705683,1-29-24 21:28,48.83,Purchase,Clothing,310.1000448
15236,715705683,1-31-24 13:28,86.11,Withdrawal,Mobile App Withdrawal,223.9900448
15237,715705683,1-31-24 20:28,103.7,Withdrawal,Mobile App Withdrawal,120.2900448
15238,715705683,02-03-24 14:28,71.63,Purchase,Gas,48.66004479
15239,715705683,02-04-24 15:28,24.77,Withdrawal,ATM Withdrawal,23.89004479
15240,715705683,02-04-24 16:28,184.73,Withdrawal,Mobile App Withdrawal,-160.8399552
15241,715705683,02-04-24 21:28,2350,IncomingTransfer,Salary,2189.160045
15242,715705683,02-05-24 23:28,128.55,Payment,Bill Payment,2060.610045
15243,715705683,02-06-24 22:28,229.69,Purchase,Travel,1830.920045
15244,715705683,02-09-24 14:28,34.8,Purchase,Clothing,1796.120045
15245,715705683,02-09-24 21:28,1200,Payment,Credit Card Payment,596.1200448
15246,715705683,2-14-24 11:28,113.05,Withdrawal,Branch Withdrawal,483.0700448
15247,715705683,2-16-24 23:28,66.03,OnlineShopping,Etsy,417.0400448
15248,715705683,2-17-24 21:28,1400,Payment,Rent Payment,-982.9599552
15249,715705683,2-19-24 10:28,21.59,Deposit,Cash Deposit,-961.3699552
15250,715705683,2-20-24 16:28,109.81,Payment,Mortgage Payment,-1071.179955
15251,715705683,2-24-24 19:28,238.15,Payment,Loan Payment,-1309.329955
15252,715705683,2-25-24 14:28,10.42,Deposit,Direct Deposit,-1298.909955
15253,715705683,2-27-24 11:28,98.62,OnlineShopping,Target,-1397.529955
15254,715705683,2-27-24 19:28,99.78,Purchase,Travel,-1497.309955
15255,715705683,03-01-24 21:28,207.34,Deposit,Mobile Deposit,-1289.969955
15256,715705683,03-02-24 12:28,95.18,Purchase,Travel,-1385.149955
15257,715705683,03-02-24 12:28,140.32,Withdrawal,Mobile App Withdrawal,-1525.469955
15258,715705683,03-03-24 11:28,92.07,OutgoingTransfer,Wire Transfer,-1617.539955
15259,715705683,03-03-24 14:28,42.04,Withdrawal,Mobile App Withdrawal,-1659.579955
15260,715705683,03-04-24 21:28,2350,IncomingTransfer,Salary,690.4200448
15261,715705683,03-08-24 12:28,73.65,OnlineShopping,Walmart,616.7700448
15262,715705683,03-09-24 21:28,1500,Payment,Credit Card Payment,-883.2299552
15263,715705683,03-12-24 13:28,232.85,Purchase,Travel,-1116.079955
15264,715705683,3-16-24 22:28,166.44,Purchase,Clothing,-1282.519955
15265,715705683,3-18-24 21:28,1400,Payment,Rent Payment,-2682.519955
15266,715705683,3-22-24 18:28,52.5,Payment,Loan Payment,-2735.019955
15267,715705683,3-22-24 23:28,12.36,OutgoingTransfer,Peer-to-Peer Transfer,-2747.379955
15268,715705683,3-27-24 21:28,47.96,Deposit,Direct Deposit,-2699.419955
15269,715705683,3-27-24 21:28,21.63,Purchase,Gas,-2721.049955
15270,715705683,3-29-24 13:28,105.31,Purchase,Entertainment,-2826.359955
15271,715705683,3-30-24 18:28,111.97,Payment,Mortgage Payment,-2938.329955
15272,715705683,3-31-24 14:28,184.43,Withdrawal,Mobile App Withdrawal,-3122.759955
15273,715705683,04-02-24 12:28,223.7,Return,Store Return,-2899.059955
15274,715705683,04-04-24 21:28,240.96,Deposit,Cash Deposit,-2658.099955
15275,715705683,04-05-24 21:28,2350,IncomingTransfer,Salary,-308.0999552
15276,715705683,04-07-24 16:28,21.55,OutgoingTransfer,Bank Transfer,-329.6499552
15277,715705683,04-10-24 21:28,1300,Payment,Credit Card Payment,-1629.649955
15278,715705683,4-17-24 21:28,1200,Payment,Rent Payment,-2829.649955
15279,715705683,4-23-24 19:28,10.62,Withdrawal,ATM Withdrawal,-2840.269955
15280,715705683,4-23-24 19:28,245.74,OnlineShopping,Walmart,-3086.009955
15281,715705683,4-26-24 16:28,142.18,Purchase,Clothing,-3228.189955
15282,715705683,4-30-24 19:28,89.33,OutgoingTransfer,Bank Transfer,-3317.519955
15283,715705683,05-03-24 21:28,2350,IncomingTransfer,Salary,-967.5199552
15284,715705683,05-07-24 22:28,212.14,Purchase,Electronics,-1179.659955
15285,715705683,05-08-24 21:28,1300,Payment,Credit Card Payment,-2479.659955
15286,715705683,05-09-24 12:28,72.88,Payment,Mortgage Payment,-2552.539955
15287,715705683,05-09-24 12:28,177.47,Deposit,Direct Deposit,-2375.069955
15288,715705683,05-10-24 21:28,900,Payment,Rent Payment,-3275.069955
15289,715705683,05-12-24 10:28,94.57,Payment,Mortgage Payment,-3369.639955
15290,715705683,05-12-24 22:28,143.88,Purchase,Clothing,-3513.519955
15291,715705683,5-13-24 22:28,48.34,Deposit,Cash Deposit,-3465.179955
15292,715705683,5-15-24 11:28,96.95,Purchase,Grocery,-3562.129955
15293,715705683,5-16-24 18:28,111.75,Payment,Loan Payment,-3673.879955
15294,715705683,5-18-24 19:28,23.18,Return,Walmart Return,-3650.699955
15295,715705683,5-22-24 15:28,138.85,Withdrawal,Mobile App Withdrawal,-3789.549955
15296,715705683,5-24-24 15:28,105.78,Payment,Mortgage Payment,-3895.329955
15297,715705683,5-24-24 19:28,202.8,Purchase,Electronics,-4098.129955
15298,715705683,5-25-24 12:28,151.13,Return,AliExpress Return,-3946.999955
15299,715705683,5-30-24 10:28,139.13,Purchase,Grocery,-4086.129955
15300,715705683,06-03-24 12:28,202.32,OnlineShopping,Amazon,-4288.449955
15301,715705683,06-05-24 21:28,2350,IncomingTransfer,Salary,-1938.449955
15302,715705683,06-08-24 12:28,121.51,OutgoingTransfer,Peer-to-Peer Transfer,-2059.959955
15303,715705683,06-09-24 16:28,226.27,OnlineShopping,AliExpress,-2286.229955
15304,715705683,06-10-24 10:28,211.99,Purchase,Furniture,-2498.219955
15305,715705683,06-10-24 21:28,1300,Payment,Credit Card Payment,-3798.219955
15306,715705683,06-12-24 19:28,208.12,Purchase,Clothing,-4006.339955
15307,715705683,06-12-24 21:28,700,Payment,Rent Payment,-4706.339955
15308,715705683,6-13-24 12:28,243.02,OutgoingTransfer,International Transfer,-4949.359955
15309,715705683,6-17-24 20:28,166.11,Withdrawal,Branch Withdrawal,-5115.469955
15310,715705683,6-29-24 15:28,12.23,Deposit,Check Deposit,-5103.239955
15311,715705683,07-02-24 19:28,135.16,Withdrawal,ATM Withdrawal,-5238.399955
15312,715705683,07-05-24 21:28,2350,IncomingTransfer,Salary,-2888.399955
15313,715705683,07-06-24 16:28,124.39,Deposit,Mobile Deposit,-2764.009955
15314,715705683,07-08-24 20:28,14.33,Purchase,Clothing,-2778.339955
15315,715705683,07-09-24 19:28,40.08,OutgoingTransfer,International Transfer,-2818.419955
15316,715705683,07-10-24 21:28,1600,Payment,Credit Card Payment,-4418.419955
15317,715705683,07-12-24 9:28,155.65,Return,Target Return,-4262.769955
15318,715705683,7-14-24 21:28,1200,Payment,Rent Payment,-5462.769955
